Date,NO Consume,SE Consume,FI Consume,DK Consume,Nordic Consume,EE Consume,LV Consume,LT Consume,Baltic Consume
01-01-2014,366427,384749,222609,83837,1.05764e+06,19487,17885,22959,60331
02-01-2014,399918,411970,246089,99705,1.15768e+06,23373,21578,27295,72246
03-01-2014,394838,412474,252240,98515,1.15808e+06,24053,22123,27322,73498
04-01-2014,373405,390819,239997,89931,1.09417e+06,21959,20152,24993,67104
05-01-2014,369245,388306,229357,88121,1.07503e+06,21025,19587,24387,64999
06-01-2014,403916,403736,235181,106722,1.14956e+06,24258,22621,28333,75212
07-01-2014,390178,424245,249519,106674,1.17062e+06,24441,22707,28536,75684
08-01-2014,392452,429362,245834,105888,1.17355e+06,24196,22177,28314,74687
09-01-2014,413342,443218,247173,109110,1.21285e+06,24021,22371,28118,74510
10-01-2014,429543,463875,261582,106588,1.2616e+06,24591,22169,27639,74399
11-01-2014,422670,431245,258779,93996,1.2067e+06,22821,20097,24713,67631
12-01-2014,442077,456611,260660,92250,1.25161e+06,22514,19543,24347,66404
13-01-2014,502913,538963,290887,110391,1.44317e+06,26303,23019,29001,78323
14-01-2014,497240,525510,305437,107974,1.43616e+06,27373,23505,29232,80110
15-01-2014,488335,518387,307855,107664,1.42225e+06,27884,23801,29588,81273
16-01-2014,484556,513415,311563,112181,1.42172e+06,28403,24407,30309,83119
17-01-2014,486450,523841,317499,108661,1.43647e+06,28231,24611,30974,83816
18-01-2014,466279,481553,303536,98479,1.34986e+06,26120,21876,27850,75846
19-01-2014,453734,474909,300360,100607,1.32962e+06,25580,21783,26500,73863
20-01-2014,485931,521899,320256,116427,1.44452e+06,28759,25166,31119,85044
21-01-2014,489459,520674,311348,114541,1.43603e+06,29621,25743,31868,87232
22-01-2014,497550,522528,311512,115552,1.44715e+06,30404,26085,32940,89429
23-01-2014,495954,533996,318617,118856,1.46743e+06,31069,26246,33439,90754
24-01-2014,489866,519498,316081,115301,1.44074e+06,31496,26395,32900,90791
25-01-2014,463497,482263,279513,103964,1.32924e+06,28282,24025,29768,82075
26-01-2014,453660,475926,262966,105188,1.29776e+06,27068,23458,28383,78909
27-01-2014,486716,523259,292747,117910,1.42064e+06,30019,26247,31947,88213
28-01-2014,472297,512713,300011,117243,1.40227e+06,30589,26293,32041,88923
29-01-2014,471806,523438,302929,119748,1.41792e+06,31266,26551,32444,90261
30-01-2014,488194,534829,307966,119014,1.45002e+06,31867,26805,33028,91700
31-01-2014,477196,529315,314443,113942,1.43490e+06,31434,26660,33280,91374
01-02-2014,449662,461742,285103,100576,1.29708e+06,27543,23464,29132,80139
02-02-2014,415070,430691,264396,92290,1.20245e+06,25150,22420,28153,75723
03-02-2014,428934,461330,275032,108182,1.27349e+06,27771,25023,32082,84876
04-02-2014,433068,469669,269455,110349,1.28255e+06,27872,24370,30863,83105
05-02-2014,431760,470851,272563,108814,1.28399e+06,28023,24359,30421,82803
06-02-2014,436406,469745,278352,110323,1.29483e+06,28253,24082,30306,82641
07-02-2014,427900,456863,279692,109105,1.27357e+06,26968,23553,29547,80068
08-02-2014,400446,414958,255354,95483,1.16625e+06,23656,20813,26036,70505
09-02-2014,390891,411411,243198,93525,1.13903e+06,22633,20259,25161,68053
10-02-2014,415263,455591,262034,105170,1.23807e+06,25578,23489,30091,79158
11-02-2014,418027,458178,259647,108954,1.24482e+06,25921,23767,29762,79450
12-02-2014,421715,465822,261301,108970,1.25781e+06,25783,23453,28966,78202
13-02-2014,427237,464971,264434,108320,1.26497e+06,25744,23400,29431,78575
14-02-2014,418112,448067,268344,102628,1.23716e+06,25543,23184,29210,77937
15-02-2014,399187,415821,252835,96203,1.16406e+06,22528,20585,25291,68404
16-02-2014,384399,408057,244843,93842,1.13115e+06,22448,19857,24031,66336
17-02-2014,415790,439097,262780,104205,1.22189e+06,25056,22498,27715,75269
18-02-2014,434008,453639,263122,105786,1.25656e+06,24686,22415,27985,75086
19-02-2014,442808,466660,264869,106154,1.28049e+06,25343,22788,29526,77657
20-02-2014,451585,463655,271407,105968,1.29261e+06,25772,22528,29430,77730
21-02-2014,435610,453456,273696,102094,1.26486e+06,25574,22214,28332,76120
22-02-2014,398612,401701,254556,93135,1.14801e+06,22314,19521,25309,67144
23-02-2014,384988,386999,239203,90351,1.10155e+06,21375,18739,24335,64449
24-02-2014,398761,422096,251764,101860,1.17449e+06,21142,21358,28289,70789
25-02-2014,395311,436348,250381,101201,1.18325e+06,24183,21779,27959,73921
26-02-2014,402901,447317,256786,101914,1.20893e+06,25330,22444,29006,76780
27-02-2014,404951,446758,257502,103742,1.21296e+06,25063,22311,28985,76359
28-02-2014,406188,430019,257200,100050,1.19346e+06,24860,21909,28117,74886
01-03-2014,389838,401619,237676,88903,1.11804e+06,22391,19569,25128,67088
02-03-2014,388873,407017,235961,88111,1.11997e+06,21643,18954,24138,64735
03-03-2014,410206,444943,256490,103045,1.2147e+06,24567,21704,27817,74088
04-03-2014,405882,439360,255104,102740,1.2031e+06,24317,21767,28136,74220
05-03-2014,407085,447597,252983,104229,1.21191e+06,23925,21893,28409,74227
06-03-2014,399575,433557,253497,103297,1.18993e+06,24324,22177,28604,75105
07-03-2014,395345,415595,252948,101774,1.16567e+06,23973,21592,27809,73374
08-03-2014,376527,376292,235088,85646,1.07356e+06,21445,19075,23753,64273
09-03-2014,360607,365411,226513,83528,1.03607e+06,20392,18411,22853,61656
10-03-2014,387633,409950,239876,96287,1.13376e+06,22965,20766,24623,68354
11-03-2014,392387,416420,239226,97812,1.14586e+06,23260,21249,22559,67068
12-03-2014,385124,411412,238134,98392,1.13307e+06,23201,21121,25914,70236
13-03-2014,389715,401839,235318,98407,1.12529e+06,22960,20888,25691,69539
14-03-2014,394291,397350,240457,96986,1.12909e+06,22501,20278,25636,68415
15-03-2014,376026,383855,237254,89935,1.08708e+06,21546,18742,23338,63626
16-03-2014,375912,381859,235260,87365,1.08040e+06,21257,18240,22637,62134
17-03-2014,400695,425936,264195,100952,1.19178e+06,24099,21341,27001,72441
18-03-2014,408293,430854,265350,100787,1.2053e+06,24093,21529,27111,72733
19-03-2014,416226,445044,266288,101715,1.22928e+06,24474,21819,26990,73283
20-03-2014,405955,428130,267964,99841,1.2019e+06,24319,21218,26551,72088
21-03-2014,386765,392354,253713,96521,1.12937e+06,23317,20624,25260,69201
22-03-2014,375099,360471,228498,83670,1.04774e+06,20559,18232,22808,61599
23-03-2014,367938,363771,224785,82206,1.0387e+06,20376,18104,22275,60755
24-03-2014,391579,413079,234704,96990,1.13636e+06,23185,21251,26346,70782
25-03-2014,386337,415927,235371,98477,1.13613e+06,23750,21548,26390,71688
26-03-2014,396714,431806,236297,101169,1.166e+06,23074,20857,26700,70631
27-03-2014,389129,420067,237083,100640,1.14694e+06,23026,20506,25607,69139
28-03-2014,363674,389045,239878,96407,1.08902e+06,22574,20065,25033,67672
29-03-2014,340592,348076,222275,82498,993445,20398,17981,22574,60953
30-03-2014,321453,332100,208105,76694,938368,18981,16827,21161,56969
31-03-2014,365261,401511,238829,95555,1.10116e+06,22865,20481,26325,69671
01-04-2014,370354,408721,241327,98423,1.11884e+06,23631,20592,27025,71248
02-04-2014,373772,405219,239417,98800,1.11722e+06,23551,20769,27697,72017
03-04-2014,370593,402780,235651,97647,1.10668e+06,23825,20604,27809,72238
04-04-2014,367412,396080,241200,96654,1.10135e+06,23122,20511,26466,70099
05-04-2014,359660,363951,223863,86723,1.03421e+06,20510,18252,23136,61898
06-04-2014,345780,346871,216175,83274,992111,20372,17639,22697,60708
07-04-2014,350049,392338,235618,96125,1.07414e+06,23281,20840,26751,70872
08-04-2014,353183,396266,230838,97441,1.07775e+06,22182,20834,27108,70124
09-04-2014,368900,411922,230517,97819,1.10917e+06,22439,20943,26982,70364
10-04-2014,376233,414770,232315,96953,1.12028e+06,22810,19797,27502,70109
11-04-2014,361898,386639,238851,93529,1.08093e+06,22662,19453,26356,68471
12-04-2014,350611,345939,218087,82027,996672,19609,17466,23746,60821
13-04-2014,335659,343632,212096,81346,972739,19414,16624,22733,58771
14-04-2014,358299,379797,230259,94933,1.06329e+06,21857,19608,26553,68018
15-04-2014,358742,382295,232603,92322,1.06597e+06,22035,19982,26621,68638
16-04-2014,349392,385322,235572,88136,1.05843e+06,22068,19857,26639,68564
17-04-2014,335431,369630,233903,78269,1.01724e+06,21786,19543,26387,67716
18-04-2014,321718,334673,213177,77019,946593,18439,17032,25695,61166
19-04-2014,312451,313467,210138,74318,910385,17914,16633,23254,57801
20-04-2014,297582,295651,199748,70199,863189,17276,15388,18800,51464
21-04-2014,298576,304114,199118,73283,875165,20219,15974,19777,55970
22-04-2014,317429,340931,215665,87714,961741,20449,17463,24723,62635
23-04-2014,316793,363109,220900,91625,992435,20347,18610,24909,63866
24-04-2014,327210,371681,221587,93805,1.01429e+06,20753,18768,24797,64318
25-04-2014,327866,354070,223985,87804,993733,21028,18583,24951,64562
26-04-2014,299753,310856,204979,75543,891139,19228,15959,22643,57830
27-04-2014,286214,301939,198989,73963,861113,18475,15256,21648,55379
28-04-2014,313495,343328,219202,88220,964253,20488,18029,25070,63587
29-04-2014,322653,349070,218854,88656,976053,20298,18430,25400,64128
30-04-2014,333832,355896,223651,88390,1.00177e+06,20148,18171,23855,62174
01-05-2014,320652,320653,209649,83573,934534,18561,16349,21598,56508
02-05-2014,330314,345769,222696,84949,983734,19384,16514,23557,59455
03-05-2014,318701,320251,214370,75826,929153,18222,15703,21683,55608
04-05-2014,312879,319521,209423,75059,916883,18403,15506,20587,54496
05-05-2014,340265,367090,226074,91015,1.02445e+06,21826,16589,24834,63249
06-05-2014,340055,371632,220896,91835,1.02442e+06,21876,18912,25562,66350
07-05-2014,345265,377052,221038,92689,1.03605e+06,21616,19997,26289,67902
08-05-2014,348649,370675,223089,92751,1.03517e+06,21319,19368,26191,66878
09-05-2014,338482,355896,225160,89332,1.00888e+06,20961,19061,25631,65653
10-05-2014,305134,311957,203121,78655,898871,18233,17534,22707,58474
11-05-2014,290194,308838,192470,77950,870475,17611,15824,21770,55205
12-05-2014,321520,345759,213332,92103,972725,19886,18687,25936,64509
13-05-2014,326398,343714,211742,92922,974786,21040,18828,25750,65618
14-05-2014,327869,350709,212794,93959,985332,20392,18713,25608,64713
15-05-2014,329225,346000,217471,90926,984285,20188,18512,25073,63773
16-05-2014,310852,321248,216775,76505,925389,20265,17934,25135,63334
17-05-2014,270742,281104,193155,73887,818892,17441,15623,22035,55099
18-05-2014,270820,280733,180018,74417,805988,16799,15219,21909,53927
19-05-2014,289712,331187,198862,89476,909246,19633,18593,25303,63529
20-05-2014,290649,324870,195014,89139,899684,19617,19121,26188,64926
21-05-2014,287503,322124,197237,90156,897031,19675,18987,26137,64799
22-05-2014,287714,322343,199384,90824,900271,19703,19012,25807,64522
23-05-2014,284930,318296,197001,88638,888864,19442,18889,25212,63543
24-05-2014,266867,277910,179960,74808,799548,16839,16043,22877,55759
25-05-2014,265915,274254,175304,73971,789441,16355,15939,21726,54020
26-05-2014,291923,321513,196947,89055,899452,18880,18257,24752,61889
27-05-2014,285470,326180,200673,91019,903347,19597,17970,24994,62561
28-05-2014,282126,341213,207641,91473,922456,20123,17740,24873,62736
29-05-2014,266131,301777,193423,76465,837806,20507,18191,24999,63697
30-05-2014,276108,305970,200886,80455,863425,19917,17689,24548,62154
31-05-2014,263713,282630,186152,73075,805574,16999,15386,21528,53913
01-06-2014,259650,283517,180981,74558,798717,16449,14951,20578,51978
02-06-2014,281176,328343,201866,90441,901837,19492,17865,24560,61917
03-06-2014,274649,335153,204507,92094,906406,19701,18417,24902,63020
04-06-2014,273479,333239,202400,91693,900809,19887,18352,25035,63274
05-06-2014,275737,319648,204133,81683,881204,19802,18497,24990,63289
06-06-2014,273320,276087,203487,84768,835629,19739,18572,24952,63263
07-06-2014,254390,264234,183515,73364,775522,16786,15669,21985,54440
08-06-2014,244707,265342,177924,70580,758555,16016,15029,21277,52322
09-06-2014,252468,314014,199037,73714,839247,18821,17893,24868,61582
10-06-2014,277870,318469,197544,90460,884358,19106,18045,25238,62389
11-06-2014,279871,322851,195886,92816,891999,18598,18314,25421,62333
12-06-2014,281497,318915,197268,91251,888940,19295,18432,25876,63603
13-06-2014,283514,318964,197131,90413,890032,19079,18037,25343,62459
14-06-2014,264764,281285,181315,76360,803736,16644,15617,22496,54757
15-06-2014,261823,276385,175796,75182,789194,15970,14749,21687,52406
16-06-2014,289385,327077,191177,91350,898993,18796,17394,24808,60998
17-06-2014,291578,332804,194666,92169,911226,19358,17556,24925,61839
18-06-2014,289352,326599,184961,93337,894253,19773,18066,24968,62807
19-06-2014,285255,315798,176769,93984,871820,19807,17841,25288,62936
20-06-2014,286312,271420,160148,90591,808479,19122,17872,24751,61745
21-06-2014,272776,264922,156412,75971,770085,16522,15886,22316,54724
22-06-2014,267008,270945,160941,76953,775850,16205,15138,21092,52435
23-06-2014,290771,324872,185879,90332,891414,15313,14388,22703,52404
24-06-2014,287880,322931,198703,91205,900729,15177,13786,20893,49856
25-06-2014,288688,324928,202879,91263,907773,18616,17145,24729,60490
26-06-2014,287870,328874,202202,91433,910386,19329,17807,25568,62704
27-06-2014,284121,316099,202326,89091,891647,19163,17936,25432,62531
28-06-2014,263949,286821,188234,75590,814600,16691,15908,22555,55154
29-06-2014,257740,282649,182570,73564,796531,16715,15564,22068,54347
30-06-2014,283032,322961,200533,88392,894928,18934,18179,25942,63055
01-07-2014,278655,319643,203872,89942,892117,19665,18376,26962,65003
02-07-2014,275364,311807,203179,90375,880743,19123,17985,28105,65213
03-07-2014,273663,310497,201103,91766,877035,18392,17925,25810,62127
04-07-2014,270592,302771,200418,87144,860938,18612,17866,25773,62251
05-07-2014,250442,262278,182713,75565,771008,16340,16050,22785,55175
06-07-2014,243547,257578,178110,73730,752965,15984,15946,21920,53850
07-07-2014,265606,297067,195678,88253,846610,18789,18499,26341,63629
08-07-2014,263829,297692,194952,88835,845327,18688,19075,26971,64734
09-07-2014,258749,295144,192705,90129,836735,18530,18875,26729,64134
10-07-2014,259388,289523,189886,89641,828451,18216,18621,26516,63353
11-07-2014,255252,278276,190386,85528,809447,17864,17893,25405,61162
12-07-2014,240679,255697,177758,73355,748273,15703,15637,22923,54263
13-07-2014,234288,260286,177282,72000,743862,15730,15609,22383,53722
14-07-2014,255226,280497,193236,83239,812203,18020,17938,25601,61559
15-07-2014,253623,273111,193329,81065,801140,18289,18168,26382,62839
16-07-2014,254124,271990,191700,79100,796918,18367,18202,26412,62981
17-07-2014,257741,273778,191276,79481,802281,18345,18294,26409,63048
18-07-2014,256706,271697,192720,78156,799290,17888,18308,25940,62136
19-07-2014,238777,246521,180915,71282,737509,16064,16108,23247,55419
20-07-2014,231730,244418,177049,71161,724366,15425,15565,21544,52534
21-07-2014,249790,269079,194035,80576,793485,17819,18168,25689,61676
22-07-2014,252101,271637,191990,82010,797749,17988,18300,26169,62457
23-07-2014,252057,274086,194923,81601,802683,18376,18445,25982,62803
24-07-2014,250358,274193,195688,81963,802230,18462,18399,26488,63349
25-07-2014,252885,271593,193207,81522,799210,18287,18536,26787,63610
26-07-2014,241516,255577,179003,74257,750361,16200,16451,23930,56581
27-07-2014,235677,250700,172380,73165,731931,15864,15975,23183,55022
28-07-2014,255350,280788,189553,84549,810250,18558,18761,27172,64491
29-07-2014,256362,278041,190204,85141,809760,18937,19119,27775,65831
30-07-2014,257348,280303,191290,85349,814305,19156,19244,27411,65811
31-07-2014,254840,275260,190128,85406,805634,18869,18955,27780,65604
01-08-2014,255635,273772,191960,84056,805436,18637,18336,27274,64247
02-08-2014,242076,252425,180020,75352,749884,16505,16320,24203,57028
03-08-2014,237699,254697,174384,75477,742261,16322,16557,23326,56205
04-08-2014,259090,296841,197508,88274,841718,19261,19411,27139,65811
05-08-2014,259910,303811,198059,90334,852127,19400,19460,27242,66102
06-08-2014,264727,304192,197123,89117,855176,19577,19526,27284,66387
07-08-2014,265539,298906,199383,89908,853750,19550,19432,27754,66736
08-08-2014,262240,297297,201096,87158,847806,19039,19013,27696,65748
09-08-2014,246365,261038,181424,77719,766558,16692,16484,24532,57708
10-08-2014,241174,262819,176398,74818,755213,15956,15991,23635,55582
11-08-2014,268321,316486,199886,92836,877540,19549,19001,27353,65903
12-08-2014,271393,310009,199249,91206,871864,19403,18812,27194,65409
13-08-2014,274399,311728,200968,90490,877601,18899,18395,26809,64103
14-08-2014,277234,317674,201528,89578,886027,19249,18599,26422,64270
15-08-2014,274197,307071,202191,85742,869209,18835,18230,22918,59983
16-08-2014,259070,269601,186928,75592,791210,16536,16016,22607,55159
17-08-2014,259159,279797,181503,78088,798556,17106,15543,22139,54788
18-08-2014,281131,313093,203630,91971,889831,18782,18001,25417,62200
19-08-2014,281485,310894,200586,92208,885180,18388,18239,25634,62261
20-08-2014,282215,312379,204857,91715,891165,16957,18340,25765,61062
21-08-2014,283962,318339,204489,90506,897305,18877,18331,26623,63831
22-08-2014,282905,308675,205787,88689,886057,19016,18323,25738,63077
23-08-2014,266733,278964,193195,75451,814350,16935,16342,23091,56368
24-08-2014,263008,280185,189226,76922,809349,16578,15976,22597,55151
25-08-2014,285556,332601,208929,89352,916450,19776,18359,25316,63451
26-08-2014,285893,325967,204660,90533,907065,19731,18339,25882,63952
27-08-2014,286716,319462,203857,90623,900667,19760,18702,25946,64408
28-08-2014,283704,328141,204046,90962,906859,19614,18727,25977,64318
29-08-2014,282351,316297,207453,88704,894814,19606,18445,25870,63921
30-08-2014,266128,283656,193317,77174,820286,17049,16104,23461,56614
31-08-2014,261581,280357,189894,76412,808259,16519,15685,22570,54774
01-09-2014,286739,328980,211183,88012,914923,19023,17806,25952,62781
02-09-2014,286162,328134,212139,90472,916917,19799,18552,27197,65548
03-09-2014,284230,326764,209294,91228,911518,19522,18737,27343,65602
04-09-2014,285226,326613,206311,92144,910296,19925,18956,27057,65938
05-09-2014,283935,320417,206727,76158,887238,19485,19012,26744,65241
06-09-2014,266377,280810,191574,75933,814700,17113,16801,24039,57953
07-09-2014,258866,275945,186201,76195,797222,16691,16278,23454,56423
08-09-2014,286773,325949,205536,90788,909060,19194,18618,27013,64825
09-09-2014,289815,322403,206211,93024,911462,19577,19027,27850,66454
10-09-2014,285137,324391,201790,90980,902305,19909,18976,27453,66338
11-09-2014,288791,328164,204233,91731,912933,19885,18995,27802,66682
12-09-2014,288381,319243,211520,88835,907991,19786,19113,27276,66175
13-09-2014,269597,282268,191993,77502,821355,17324,16731,24260,58315
14-09-2014,265419,280468,188116,76566,810575,16850,15939,23340,56129
15-09-2014,290936,327773,211510,91723,921958,20115,18554,26455,65124
16-09-2014,293582,327869,211604,91394,924456,20344,19033,26992,66369
17-09-2014,296591,333205,210954,91605,932366,20452,19001,27009,66462
18-09-2014,301117,335004,212276,91334,939734,20403,18791,26929,66123
19-09-2014,300299,329282,213882,87074,930550,20000,18456,26159,64615
20-09-2014,283084,291273,196246,76219,846833,17588,16310,23134,57032
21-09-2014,277282,290068,188842,76382,832584,16999,15879,22991,55869
22-09-2014,313808,350943,213786,92237,970777,20551,19227,28031,67809
23-09-2014,330140,367358,222262,93018,1.01279e+06,21375,19265,27816,68456
24-09-2014,329068,364434,220552,94415,1.00848e+06,21617,19296,27875,68788
25-09-2014,327129,353993,221458,94057,996649,21197,19608,28163,68968
26-09-2014,316088,343794,216287,90889,967059,21119,19327,28133,68579
27-09-2014,297332,302146,194426,78001,871917,18059,16860,24209,59128
28-09-2014,285406,299005,190407,76872,851699,17500,16578,23800,57878
29-09-2014,313258,337970,211370,91326,953926,20579,19403,27389,67371
30-09-2014,320530,350418,214172,94566,979691,20939,19554,27476,67969
01-10-2014,324203,358336,220515,95265,998332,21152,19849,27557,68558
02-10-2014,318366,355296,221799,93916,989384,21586,20091,27276,68953
03-10-2014,323016,334290,221498,90727,969537,21467,19776,27159,68402
04-10-2014,294384,301174,203299,78549,877419,18551,17128,24259,59938
05-10-2014,290152,299071,200617,76851,866699,18207,16477,23006,57690
06-10-2014,316688,353289,226640,93851,990473,21963,19913,27144,69020
07-10-2014,334815,362711,224356,98872,1.02076e+06,22151,20133,26804,69088
08-10-2014,333150,353278,223374,94493,1.0043e+06,22877,20658,27749,71284
09-10-2014,333875,351132,222358,94766,1.00214e+06,22539,20814,27912,71265
10-10-2014,324062,343676,225660,91220,984628,22079,20016,27367,69462
11-10-2014,319728,316983,208855,77630,923203,18849,17480,24239,60568
12-10-2014,315404,314600,205292,76378,911678,18401,17522,23237,59160
13-10-2014,346187,366540,225618,93564,1.03192e+06,21277,19762,27086,68125
14-10-2014,351830,364644,224958,94564,1.036e+06,21708,20728,27747,70183
15-10-2014,352429,375621,232886,94902,1.05585e+06,22307,20896,28298,71501
16-10-2014,371694,386174,240225,92988,1.09109e+06,22754,21019,28442,72215
17-10-2014,376474,372455,247226,90989,1.08716e+06,22854,20525,28231,71610
18-10-2014,347268,328587,232139,80480,988482,20555,18564,24526,63645
19-10-2014,313109,322396,221324,81936,938770,20320,18114,24120,62554
20-10-2014,337606,372606,238294,97200,1.04572e+06,22589,20371,27714,70674
21-10-2014,354119,380123,247238,97556,1.07904e+06,23620,20683,28250,72553
22-10-2014,364274,391344,254035,97987,1.10765e+06,24230,21373,28905,74508
23-10-2014,370493,398392,261055,97248,1.1272e+06,25091,21916,29155,76162
24-10-2014,350648,384058,255058,95062,1.08483e+06,25593,21901,29090,76584
25-10-2014,326352,331608,229671,82368,970001,22475,19332,25631,67438
26-10-2014,331630,333240,222197,85018,972095,22353,19334,26033,67720
27-10-2014,339563,359162,227064,97248,1.02304e+06,23724,20946,28410,73080
28-10-2014,342760,356767,226423,95528,1.02149e+06,23031,20693,28703,72427
29-10-2014,346200,372517,226486,97168,1.04238e+06,22819,20735,28835,72389
30-10-2014,375872,397657,232149,97827,1.10352e+06,22889,21386,29661,73936
31-10-2014,382015,391871,243429,95030,1.11234e+06,22890,21108,28959,72957
01-11-2014,343550,343216,232430,81457,1.00067e+06,21076,18967,23623,63666
02-11-2014,324005,321508,221600,81355,948479,20557,17934,24025,62516
03-11-2014,350745,360654,229717,98318,1.03944e+06,23198,20661,28279,72138
04-11-2014,370030,377005,230162,98593,1.0758e+06,22794,20568,28256,71618
05-11-2014,394133,407535,239792,99297,1.14076e+06,23220,20884,28361,72465
06-11-2014,403176,433376,255091,99812,1.19146e+06,23908,21090,28522,73520
07-11-2014,412160,419514,262188,96688,1.19056e+06,23268,21436,28744,73448
08-11-2014,369602,372201,244119,84955,1.07089e+06,21001,18514,25280,64795
09-11-2014,346438,350265,222911,82602,1.00222e+06,20469,17918,24243,62630
10-11-2014,371052,389113,237417,99521,1.09711e+06,23894,21399,28424,73717
11-11-2014,378505,385283,233620,98510,1.07719e+06,23522,21527,28983,74032
12-11-2014,387456,396583,234730,101045,1.11982e+06,23440,21629,29078,74147
13-11-2014,388729,404359,244392,99332,1.13681e+06,23536,21859,29357,74752
14-11-2014,383134,392974,248422,98224,1.12287e+06,23963,21626,28970,74559
15-11-2014,361681,357657,229898,88121,1.03735e+06,21205,19213,25288,65706
16-11-2014,362386,360284,219592,88768,1.03104e+06,20997,18247,24087,63331
17-11-2014,397957,411530,245694,100618,1.15581e+06,24801,19199,28398,72398
18-11-2014,403608,409752,249586,102320,1.16498e+06,25517,18638,29049,73204
19-11-2014,405199,424549,249568,102236,1.18157e+06,26550,21969,29982,78501
20-11-2014,412346,425086,255360,102367,1.19527e+06,26758,22572,30405,79735
21-11-2014,413297,419305,264948,98763,1.19632e+06,26449,23146,30636,80231
22-11-2014,393459,390141,247335,88078,1.11861e+06,22795,21346,27265,71406
23-11-2014,375888,378061,236860,87588,1.07842e+06,22031,19464,26013,67508
24-11-2014,392652,413182,248644,100811,1.1553e+06,25746,22290,29908,77944
25-11-2014,402909,417890,248913,101133,1.1711e+06,26332,22774,31424,80530
26-11-2014,413183,436418,247839,103282,1.20074e+06,25941,23232,31568,80741
27-11-2014,419188,440196,248061,103490,1.211e+06,26175,23220,31718,81113
28-11-2014,418434,429110,251928,102559,1.20213e+06,26482,23369,31546,81397
29-11-2014,399446,398061,238659,91517,1.12769e+06,24407,21350,28589,74346
30-11-2014,393640,396797,238638,91381,1.12046e+06,24354,21023,28107,73484
01-12-2014,424670,452783,264696,106203,1.24837e+06,28352,24349,32181,84882
02-12-2014,430328,454484,263806,108492,1.25712e+06,29024,24556,32401,85981
03-12-2014,427488,444583,251947,107859,1.23189e+06,27558,24559,32557,84674
04-12-2014,420690,444436,252379,106797,1.2243e+06,26777,24545,32752,84074
05-12-2014,417738,433869,257824,104180,1.21362e+06,26398,23898,31896,82192
06-12-2014,406860,392948,235635,88962,1.12441e+06,24122,21486,28786,74394
07-12-2014,388296,385884,232453,91191,1.09784e+06,22758,20177,27132,70067
08-12-2014,429657,433047,248489,105585,1.21678e+06,26223,23149,31212,80584
09-12-2014,446410,446899,245373,106626,1.24531e+06,26230,23173,31376,80779
10-12-2014,424970,452353,243447,109949,1.23073e+06,26303,23157,30886,80346
11-12-2014,427618,444683,245318,109527,1.22714e+06,26778,23288,31715,81781
12-12-2014,429100,438467,252434,107464,1.22748e+06,26352,22982,30829,80163
13-12-2014,416184,405919,239715,91144,1.15297e+06,23530,20320,26740,70590
14-12-2014,409790,401840,234034,92062,1.13774e+06,22575,19330,26460,68365
15-12-2014,422203,440826,248995,106808,1.21884e+06,25920,22611,30878,79409
16-12-2014,444387,453287,249971,107902,1.25556e+06,25469,22537,30710,78716
17-12-2014,458769,470672,252639,107789,1.28987e+06,25662,22740,30366,78768
18-12-2014,445241,451123,256315,107910,1.2606e+06,25706,22882,30671,79259
19-12-2014,434988,425345,253474,102328,1.21614e+06,25236,22150,29007,76393
20-12-2014,420482,405315,241327,95638,1.16276e+06,22859,19843,26220,68922
21-12-2014,417030,414667,235064,92358,1.15913e+06,22674,19477,25668,67819
22-12-2014,427267,434905,246146,100341,1.20867e+06,25311,22183,28731,76225
23-12-2014,429765,422044,247954,98052,1.19783e+06,24555,21505,27364,73424
24-12-2014,432686,407041,240302,89366,1.16941e+06,22850,19373,24188,66411
25-12-2014,447235,432158,241215,86743,1.20736e+06,22305,18634,22059,62998
26-12-2014,461079,451980,234711,89187,1.23696e+06,22696,19673,23971,66340
27-12-2014,466936,454412,243755,91422,1.25653e+06,23423,20131,25886,69440
28-12-2014,469610,489870,254943,92506,1.30694e+06,24164,20735,26620,71519
29-12-2014,473175,511412,287465,98060,1.37012e+06,26047,22762,29437,78246
30-12-2014,446102,447531,270934,94471,1.25905e+06,26361,22736,29999,79096
31-12-2014,410704,391979,243979,87336,1.13401e+06,23614,20195,28297,72106
01-01-2015,384768,376407,225827,86554,1.07357e+06,20635,17523,22845,61003
02-01-2015,399788,399194,241504,96446,1.13694e+06,22421,19196,25494,67111
03-01-2015,408319,410298,237890,91213,1.14773e+06,22417,18858,24528,65803
04-01-2015,419646,422985,244148,89668,1.17646e+06,23106,19485,24773,67364
05-01-2015,455799,465652,285065,104662,1.31118e+06,27011,22978,29617,79606
06-01-2015,440289,445645,289062,106717,1.28172e+06,28213,24263,31342,83818
07-01-2015,432585,471200,281907,106226,1.29193e+06,29009,24395,31319,84723
08-01-2015,424852,450537,265801,108854,1.25006e+06,28409,24230,30985,83624
09-01-2015,444703,457669,265908,107096,1.27538e+06,26543,23571,29635,79749
10-01-2015,430242,432201,256958,96235,1.21565e+06,23867,21533,26770,72170
11-01-2015,424704,450117,266791,94813,1.23643e+06,23737,20205,24985,68927
12-01-2015,457952,493823,294258,109097,1.35534e+06,27416,22861,29143,79420
13-01-2015,443683,462632,284256,104271,1.29484e+06,26737,22191,28955,77883
14-01-2015,445351,469095,269793,109060,1.2933e+06,26313,22277,29097,77687
15-01-2015,443725,468939,263251,110764,1.28669e+06,26126,22332,29450,77908
16-01-2015,430045,444371,265850,105687,1.24596e+06,26400,22241,29127,77768
17-01-2015,413755,401854,244282,91692,1.1516e+06,23147,19884,26290,69321
18-01-2015,418722,419722,239260,91290,1.169e+06,22668,19126,25761,67555
19-01-2015,468659,478718,270558,107178,1.32512e+06,25803,22581,30792,79176
20-01-2015,471586,485695,285678,109570,1.35254e+06,26491,23058,30791,80340
21-01-2015,469048,485183,293913,109581,1.35773e+06,27070,23537,30903,81510
22-01-2015,482854,483854,300367,107947,1.37503e+06,27761,23419,30821,82001
23-01-2015,490249,490124,298229,106146,1.38475e+06,27225,23220,30707,81152
24-01-2015,440044,451071,269369,96378,1.25686e+06,24333,20824,27476,72633
25-01-2015,433412,429149,250863,91244,1.20468e+06,23706,20412,26525,70643
26-01-2015,442783,472795,265816,106935,1.28833e+06,26753,22828,30331,79912
27-01-2015,442273,473528,260816,106604,1.28323e+06,27032,23009,30457,80498
28-01-2015,427775,464790,262832,108672,1.26408e+06,26944,22831,30592,80367
29-01-2015,436598,468762,264989,109939,1.2803e+06,26973,22524,29947,79444
30-01-2015,440856,467452,267572,106325,1.28221e+06,26144,22371,29315,77830
31-01-2015,424333,439884,252208,93667,1.2101e+06,23495,20319,26641,70455
01-02-2015,432747,435131,244452,92578,1.20492e+06,23026,19573,25087,67686
02-02-2015,473892,497375,268365,107995,1.34764e+06,25927,22173,28983,77083
03-02-2015,482624,505155,271208,109037,1.36804e+06,26129,22593,29981,78703
04-02-2015,490941,506785,271087,110103,1.37892e+06,27000,23280,29857,80137
05-02-2015,493108,499654,271479,108743,1.37299e+06,27614,23343,30325,81282
06-02-2015,464895,473635,268450,105077,1.31206e+06,27008,23509,29411,79928
07-02-2015,430297,421634,247095,93247,1.19228e+06,15539,20304,26263,62106
08-02-2015,428318,429373,250161,91938,1.19979e+06,23349,19582,25165,68096
09-02-2015,432367,444395,273689,101863,1.25232e+06,26644,22664,29881,79189
10-02-2015,421642,437893,251322,101929,1.2128e+06,25658,22102,29839,77599
11-02-2015,428323,446016,250244,103510,1.2281e+06,25639,22712,30245,78596
12-02-2015,440455,448849,257686,104364,1.25135e+06,26317,22525,29899,78741
13-02-2015,441799,452771,265408,102452,1.26244e+06,25768,22499,29396,77663
14-02-2015,413030,420640,249934,91664,1.17528e+06,23360,19934,25930,69224
15-02-2015,410497,417480,258115,92214,1.17832e+06,22822,19133,24368,66323
16-02-2015,443839,479463,278025,106862,1.3082e+06,26343,22275,24238,72856
17-02-2015,438597,478767,272104,106472,1.29595e+06,26561,22401,28337,77299
18-02-2015,412810,451129,256419,105041,1.22541e+06,26511,22427,29574,78512
19-02-2015,403144,439971,255624,106315,1.20506e+06,25936,22383,29676,77995
20-02-2015,404568,438801,253728,104623,1.20173e+06,25432,21525,28540,75497
21-02-2015,397325,407977,239893,91370,1.13657e+06,23173,19114,25207,67494
22-02-2015,400596,408125,235966,87790,1.13248e+06,22291,18633,24556,65480
23-02-2015,434817,466647,250897,105593,1.25796e+06,23253,21397,28883,73533
24-02-2015,426446,447447,252261,105425,1.23159e+06,22153,22046,29522,73721
25-02-2015,417413,434069,246798,102716,1.20101e+06,24838,21838,29103,75779
26-02-2015,430847,437007,246843,103434,1.21813e+06,25538,22016,29393,76947
27-02-2015,418460,443589,253025,99869,1.21494e+06,25192,22057,28940,76189
28-02-2015,397833,398399,237802,87899,1.12193e+06,22431,19611,25799,67841
01-03-2015,388794,409303,230990,91170,1.12027e+06,21887,18741,23900,64528
02-03-2015,409179,443497,249868,102932,1.20549e+06,24635,21447,28163,74245
03-03-2015,418659,444265,251246,102678,1.21686e+06,24991,21794,27886,74671
04-03-2015,425884,450943,250382,104323,1.23154e+06,25088,21615,28706,75409
05-03-2015,428592,442794,250846,101337,1.22358e+06,24721,21948,28596,75265
06-03-2015,401929,423172,253521,99033,1.17765e+06,24863,21880,28239,74982
07-03-2015,373107,386834,237559,87596,1.0851e+06,22399,19132,24728,66259
08-03-2015,360109,364480,224120,83901,1.03262e+06,20864,17836,22376,61076
09-03-2015,402389,410164,239836,95429,1.14783e+06,23785,20948,27093,71826
10-03-2015,399477,417184,246385,98455,1.16151e+06,24533,21165,27034,72732
11-03-2015,394983,419165,241359,96667,1.1521e+06,24310,20975,23207,68492
12-03-2015,399539,423806,244406,96507,1.16426e+06,24168,20766,26295,71229
13-03-2015,393382,417595,248574,96014,1.15557e+06,24070,20645,26041,70756
14-03-2015,377371,388206,234031,84470,1.08409e+06,21399,18422,23233,63054
15-03-2015,371237,378864,226077,84189,1.06037e+06,20498,17702,22569,60769
16-03-2015,396228,409751,245662,98863,1.15052e+06,23152,20335,25557,69044
17-03-2015,389903,408820,243438,98101,1.14026e+06,22542,20377,25490,68409
18-03-2015,391314,406582,239708,94852,1.13247e+06,22722,20426,25716,68864
19-03-2015,402547,409870,238625,95070,1.14612e+06,22698,20577,26357,69632
20-03-2015,402281,419393,242929,94957,1.15957e+06,23300,20972,26386,70658
21-03-2015,386746,401113,235887,86185,1.10995e+06,21624,19111,24216,64951
22-03-2015,395606,412775,236337,85834,1.13057e+06,21575,18434,23275,63284
23-03-2015,400062,431958,248680,98249,1.17896e+06,24585,21031,26961,72577
24-03-2015,394768,417125,238591,98243,1.14874e+06,24012,21310,27086,72408
25-03-2015,408764,428326,248046,99764,1.18490e+06,24321,20903,27603,72827
26-03-2015,432328,445423,251575,99919,1.22925e+06,24477,20652,26969,72098
27-03-2015,414248,424178,251373,96806,1.18662e+06,24384,20989,26901,72274
28-03-2015,383272,366967,230434,86365,1.06703e+06,21492,18757,24814,65063
29-03-2015,351761,359363,213726,80937,1.00579e+06,20180,17369,22282,59831
30-03-2015,385719,416439,247737,98447,1.14835e+06,24367,20936,26935,72238
31-03-2015,393033,426795,245474,102515,1.16782e+06,24145,20849,27365,72359
01-04-2015,379123,412672,245082,99989,1.13687e+06,24181,21040,27751,72972
02-04-2015,354403,412702,246147,84730,1.09799e+06,24433,20913,27801,73147
03-04-2015,353087,367757,226538,81059,1.02844e+06,21204,18614,27754,67572
04-04-2015,351504,356861,222992,78867,1.01023e+06,21031,18250,25340,64621
05-04-2015,354771,349735,214480,76650,995637,20575,17040,20991,58606
06-04-2015,355646,356813,217091,78340,1.0079e+06,23333,17558,21824,62715
07-04-2015,361828,382486,233319,96165,1.0738e+06,23643,20464,27119,71226
08-04-2015,363370,388976,231268,95129,1.07875e+06,23380,20378,27122,70880
09-04-2015,369702,385244,228171,93334,1.07646e+06,23107,20364,26217,69688
10-04-2015,352546,375461,226812,89726,1.04455e+06,22442,19921,25576,67939
11-04-2015,334615,339559,207849,78453,960483,19331,17695,23332,60358
12-04-2015,329241,345624,203662,80405,958939,19086,17168,22092,58346
13-04-2015,363811,382168,218636,94507,1.05914e+06,22723,20463,26622,69808
14-04-2015,372569,402380,222183,97738,1.09488e+06,23152,19780,26289,69221
15-04-2015,361704,397081,219285,96379,1.07446e+06,23013,20528,26612,70153
16-04-2015,359720,385816,223878,94250,1.06367e+06,22795,20211,25991,68997
17-04-2015,355420,386330,226329,89884,1.05797e+06,22841,20041,26557,69439
18-04-2015,329831,345923,211332,77977,965079,20092,17825,23841,61758
19-04-2015,312943,322442,202491,73919,911806,19761,17337,22956,60054
20-04-2015,326618,357233,217367,88110,989338,22317,19664,26243,68224
21-04-2015,325906,347699,215747,89754,979120,21892,20079,27122,69093
22-04-2015,327513,353833,217182,89748,988280,22216,20240,26815,69271
23-04-2015,327911,355952,219816,90767,994451,22252,19989,25677,67918
24-04-2015,342046,355948,221775,88314,1.0081e+06,22008,19827,25287,67122
25-04-2015,328769,322325,207455,78422,936975,19268,17783,22770,59821
26-04-2015,319701,320507,201399,77085,918699,18896,17404,22010,58310
27-04-2015,352613,365807,219703,91264,1.02939e+06,21476,19843,25405,66724
28-04-2015,351668,366495,216938,92058,1.02717e+06,21734,19973,25947,67654
29-04-2015,351094,367573,224758,92477,1.03591e+06,22420,19668,25515,67603
30-04-2015,352903,363672,216313,92598,1.0255e+06,21733,18532,24453,64718
01-05-2015,326603,331380,194130,77725,929849,18141,16061,21790,55992
02-05-2015,323857,328948,198663,74202,925682,18466,16072,21381,55919
03-05-2015,317862,313428,194084,74816,900201,18543,15666,21290,55499
04-05-2015,348901,369035,211944,91979,1.02186e+06,21390,15960,25381,62731
05-05-2015,339277,355685,206681,92895,994545,21483,18630,25870,65983
06-05-2015,320407,345196,202016,91118,958738,21288,19424,26708,67420
07-05-2015,329624,341347,203580,92510,967070,21383,19276,25471,66130
08-05-2015,330863,339735,208038,88206,966846,21138,19426,24926,65490
09-05-2015,322719,312690,194585,78450,908454,18088,16968,22154,57210
10-05-2015,313226,321917,186611,76849,898613,17685,15904,21680,55269
11-05-2015,337947,344743,206015,89052,977759,21130,18821,26133,66084
12-05-2015,332366,351320,207740,92406,983835,20954,19204,25799,65957
13-05-2015,327756,353226,215644,92228,988865,20969,19294,25735,65998
14-05-2015,312768,324626,199614,76866,913876,20910,19600,26033,66543
15-05-2015,325377,339331,207012,78790,950514,21262,19190,25752,66204
16-05-2015,312719,316348,195330,75399,899806,18497,16565,22802,57864
17-05-2015,304188,327250,187035,75248,893728,18055,16142,21879,56076
18-05-2015,329306,354489,206487,89919,980220,21249,19033,25661,65943
19-05-2015,329215,357532,204613,91549,982926,21426,19036,26332,66794
20-05-2015,324293,352543,203325,90770,970943,20978,18958,26912,66848
21-05-2015,323807,340778,202669,90757,957156,21654,19247,26813,67714
22-05-2015,320839,330748,200100,87969,939662,20922,18514,25767,65203
23-05-2015,295865,290055,184951,75349,846227,18339,16334,22997,57670
24-05-2015,298256,289148,179276,71190,837882,17607,15584,22000,55191
25-05-2015,298470,339899,200833,74943,914147,20241,18028,25426,63695
26-05-2015,318137,343000,198388,88844,948379,20772,18672,26133,65577
27-05-2015,313572,343951,194313,89182,941024,20868,18681,26188,65737
28-05-2015,321957,345698,194876,92851,955391,20685,18574,25587,64846
29-05-2015,317291,334374,199498,87095,938263,20383,18115,25064,63562
30-05-2015,301590,312086,184102,75191,872976,17510,16212,22161,55883
31-05-2015,289667,308106,179555,74274,851607,17133,15672,21308,54113
01-06-2015,315426,343464,202460,88402,949764,20057,18065,24747,62869
02-06-2015,327764,351330,203502,92007,974613,20249,18302,25476,64027
03-06-2015,317656,350886,204419,89187,962160,20447,18189,25448,64084
04-06-2015,317724,338429,201873,86691,944716,20380,17933,24663,62976
05-06-2015,309157,317499,199735,74379,900779,19886,17882,24626,62394
06-06-2015,285290,278035,188807,70257,822398,17382,15604,21917,54903
07-06-2015,277530,297181,181265,70330,826317,16506,15181,21091,52778
08-06-2015,308384,343430,204029,87407,943258,19569,17516,24866,61951
09-06-2015,309088,339468,202822,88191,939575,19596,17847,25197,62640
10-06-2015,304665,332598,200811,87449,925535,19407,17968,25288,62663
11-06-2015,298088,334047,203399,88388,923920,19407,18082,25155,62644
12-06-2015,297850,323551,205337,84626,911372,19297,18114,26103,63514
13-06-2015,279894,287769,186665,74085,828386,16700,16042,22953,55695
14-06-2015,276959,288380,185311,70441,821097,16564,15620,22138,54322
15-06-2015,309942,337875,204301,85836,937956,19410,17585,25195,62190
16-06-2015,307443,339622,198919,87891,933876,18995,17852,25523,62370
17-06-2015,314981,349161,190011,88937,943098,18938,18025,25645,62608
18-06-2015,307746,344833,186770,88332,927683,19382,18032,25824,63238
19-06-2015,298767,287957,169202,85698,841629,19350,17939,25675,62964
20-06-2015,277275,273286,160392,72871,783834,17018,16125,22569,55712
21-06-2015,271139,281152,159828,73414,785540,16273,15399,21893,53565
22-06-2015,293949,333504,182687,87875,898028,16654,15734,24819,57207
23-06-2015,292095,336411,192792,87306,908606,14956,14521,24747,54224
24-06-2015,293628,331762,199797,87184,912376,15000,13704,21541,50245
25-06-2015,301015,338709,201103,87909,928747,18372,16740,24681,59793
26-06-2015,297279,328767,200946,84371,911369,19163,17382,24418,60963
27-06-2015,270367,291132,187075,73728,822311,16712,16687,22067,55466
28-06-2015,266928,278741,179549,72017,797242,15918,15422,21364,52704
29-06-2015,290870,328119,197856,86721,903574,18987,18023,24831,61841
30-06-2015,291373,322589,199889,87576,901440,19280,18053,25018,62351
01-07-2015,287782,320628,196103,87845,892362,19267,18038,25129,62434
02-07-2015,283741,310558,197067,87235,878608,19370,18278,25239,62887
03-07-2015,279367,306675,199415,86088,871553,19134,18517,25347,62998
04-07-2015,260823,269408,184738,75339,790313,16842,16543,22840,56225
05-07-2015,254014,273510,178114,74924,780570,16045,16061,21783,53889
06-07-2015,274061,300682,195763,84808,855324,18544,18477,21510,58531
07-07-2015,282608,306135,197871,87160,873786,18918,17747,24374,61039
08-07-2015,284376,310732,196056,85246,876419,19131,18365,25429,62925
09-07-2015,281317,301849,197808,83951,864926,18763,18248,24917,61928
10-07-2015,279032,304251,195669,79608,858571,18552,17707,24235,60494
11-07-2015,262268,271171,184309,71097,788858,16349,15769,21699,53817
12-07-2015,254992,268796,181641,69573,775006,15871,15403,21133,52407
13-07-2015,273008,290648,192927,79437,836027,17906,17737,24540,60183
14-07-2015,274034,288251,196897,80768,839979,18228,17760,25162,61150
15-07-2015,269632,290328,195350,81429,836741,18125,17822,24588,60535
16-07-2015,274385,289002,193196,81094,837685,18267,18102,24972,61341
17-07-2015,271571,276962,191797,78771,819108,18049,17795,24766,60610
18-07-2015,256481,259361,182241,70998,769092,16115,15711,23049,54875
19-07-2015,255490,263975,178641,70308,768421,15294,15164,22016,52474
20-07-2015,269966,282951,191205,77234,821362,17790,17538,25033,57279
21-07-2015,273437,282490,193453,78337,827727,17683,17754,25237,60674
22-07-2015,270633,286212,194645,78312,829809,18683,17683,25168,61534
23-07-2015,270810,283069,194014,77041,824940,16217,18058,25294,59569
24-07-2015,273396,284786,192820,75880,826891,17524,17738,24551,59813
25-07-2015,262509,272239,181891,70704,787350,15341,15830,21905,53076
26-07-2015,259481,277277,181342,69751,787853,15375,15747,21445,52567
27-07-2015,272843,295856,195446,79504,843660,17597,17800,24346,59743
28-07-2015,277352,294140,196481,81281,849270,18502,17822,25241,61565
29-07-2015,275961,297635,196111,80508,850227,18632,17950,25087,61669
30-07-2015,273982,289719,193910,81128,838745,18692,18079,25014,61785
31-07-2015,273200,287801,194606,78556,834172,18460,17862,24573,60895
01-08-2015,266816,270846,182012,69180,788852,16025,15655,22174,53854
02-08-2015,262471,274162,176164,69053,781859,15443,15146,21590,52179
03-08-2015,284692,304813,196448,83788,869744,18169,17900,25520,61589
04-08-2015,287370,304809,195966,88243,876398,18575,18299,26313,63187
05-08-2015,282529,315409,197638,86618,882212,18843,18956,26723,64522
06-08-2015,286261,312393,197371,87477,883504,19160,19359,27363,65882
07-08-2015,277471,306651,196452,84948,865538,18768,19124,27428,65320
08-08-2015,262011,270014,179089,72871,783991,16617,17097,24310,58024
09-08-2015,265779,273061,173578,71164,783588,15873,16564,23134,55571
10-08-2015,287601,321421,194349,87978,891416,18904,18956,27085,64945
11-08-2015,285689,320436,195260,89976,891366,19609,19269,27921,66799
12-08-2015,288496,326150,194957,88714,898328,19848,19696,28123,67667
13-08-2015,294357,317792,196591,88626,897379,19527,18736,26934,65197
14-08-2015,284767,306787,199396,86453,877411,19496,18578,26247,64321
15-08-2015,265976,276819,181362,75338,799498,16957,16462,22305,55724
16-08-2015,256052,274464,176655,73990,781169,16435,15927,22276,54638
17-08-2015,278275,314333,199400,89525,881541,19353,18055,25481,62889
18-08-2015,282656,311942,200831,90462,885899,19762,18158,26183,64103
19-08-2015,283164,318625,200883,90378,893065,19426,18370,25819,63615
20-08-2015,281844,318753,200017,92704,892426,17038,18369,25981,61388
21-08-2015,280184,313901,201586,89866,885571,18243,18352,25239,61834
22-08-2015,259246,280044,184557,76948,800797,16716,16598,22416,55730
23-08-2015,253502,274075,180251,75226,783075,16171,16228,21481,53880
24-08-2015,279760,326398,200281,91016,866429,19435,18662,25395,63492
25-08-2015,283075,323974,200079,92749,899876,19941,19202,26178,65321
26-08-2015,283345,323334,202455,91958,901097,19790,18843,26543,65176
27-08-2015,286748,325000,203731,92555,908137,20437,19052,26815,66304
28-08-2015,280630,313661,208175,87442,889913,20621,18736,26560,65917
29-08-2015,267777,278354,186950,75519,808607,17523,16052,22754,56329
30-08-2015,265868,285080,184069,75803,810829,17092,15903,22161,55156
31-08-2015,291674,330749,205661,90993,919082,19993,18642,25928,64563
01-09-2015,299095,338099,205359,92918,935474,20419,18635,26357,65411
02-09-2015,299746,336803,208592,91359,936504,20829,19251,26959,59910
03-09-2015,297030,330326,211413,90262,929035,20730,19109,26888,66727
04-09-2015,299325,327663,209403,88417,924817,20361,18711,26363,65435
05-09-2015,279453,294056,191933,76545,841992,18023,16691,23155,57869
06-09-2015,277589,293300,188713,75428,835043,17520,16085,22552,56157
07-09-2015,303819,339443,212361,88218,943853,21042,18664,26365,66071
08-09-2015,300759,343713,216627,90273,951376,21385,18652,26716,66753
09-09-2015,299098,348699,214672,91606,954094,21241,18622,26012,65875
10-09-2015,299676,345941,212422,91006,949048,21367,18725,26906,66998
11-09-2015,294100,330579,214274,88375,927334,21513,18629,26345,66487
12-09-2015,279045,292072,196110,76425,843657,18792,16449,23270,58511
13-09-2015,274836,293899,191331,76963,837045,18462,16138,22885,57485
14-09-2015,298966,331229,212015,91912,934127,21425,18574,25470,65469
15-09-2015,306558,332443,213052,92612,944681,21232,19226,26825,67283
16-09-2015,307634,337316,214628,92240,951828,21579,19766,27242,
17-09-2015,309274,326338,209524,92443,937589,21678,19850,27512,69040
18-09-2015,299246,313299,162966,89057,864580,21249,19072,26309,66630
19-09-2015,287791,289368,166643,76591,820400,18274,16875,22924,58073
20-09-2015,286389,292824,182520,75690,837432,18143,16442,22938,57523
21-09-2015,315076,340569,208010,89978,953643,21638,19331,26882,67851
22-09-2015,319830,345611,210868,92542,968854,21708,19157,26858,67723
23-09-2015,314296,343304,212503,92255,962374,22000,19401,27029,68430
24-09-2015,310067,339538,211449,92160,953215,21982,19469,27565,69016
25-09-2015,310441,326511,209051,88585,934612,21752,19170,27557,68479
26-09-2015,297517,299915,194815,75344,867606,19165,16865,24256,60286
27-09-2015,297013,304471,193943,74439,869874,18508,16353,23167,58028
28-09-2015,320925,348034,215856,89312,971494,21701,19114,26613,67428
29-09-2015,318024,346474,218807,91389,973726,21706,19372,27377,68455
30-09-2015,319489,343334,216896,90948,970682,22128,19361,26911,68400
01-10-2015,317364,338202,214889,91699,962164,22406,19467,26935,68808
02-10-2015,315711,340444,218207,88174,962545,21709,18876,26828,67413
03-10-2015,304573,313388,204594,79475,902040,19433,16856,24341,60630
04-10-2015,303012,317367,203871,77148,901400,19075,16593,23669,59337
05-10-2015,332056,364926,225046,91284,1.01332e+06,22232,19222,27386,68840
06-10-2015,332951,369157,232981,92031,1.02712e+06,23343,19185,27138,69666
07-10-2015,341767,378825,234406,92670,1.04768e+06,23568,19680,27704,70952
08-10-2015,347132,387135,237344,95517,1.06714e+06,24188,20273,28609,73070
09-10-2015,346936,382702,242259,91325,1.06323e+06,24426,20708,28311,68472
10-10-2015,323249,358312,225034,79807,986411,21697,18497,25149,65343
11-10-2015,316766,346150,217296,77599,957812,20556,17827,24212,62595
12-10-2015,343998,391640,233047,93677,1.06237e+06,23650,20903,28486,73039
13-10-2015,350636,386819,230091,95956,1.06351e+06,23566,21034,28347,72947
14-10-2015,357817,388937,229728,95971,1.07246e+06,23817,21114,28322,73253
15-10-2015,360926,388484,231534,94067,1.07502e+06,23635,21141,27779,72555
16-10-2015,362442,384119,227692,92415,1.06668e+06,23780,21270,27578,72628
17-10-2015,344946,357737,214144,81846,998684,21136,18479,24449,64064
18-10-2015,335720,342693,207187,80901,966508,20357,17727,24212,62296
19-10-2015,365777,391865,228522,96044,1.08222e+06,23631,20917,28212,72760
20-10-2015,363080,386585,235329,97915,1.08292e+06,24366,20925,28805,74096
21-10-2015,363556,379274,234298,96089,1.07323e+06,24077,20947,29301,74325
22-10-2015,342959,373492,232082,97036,1.04558e+06,24367,21182,29091,74640
23-10-2015,340562,369657,227503,91481,1.02920e+06,23368,20598,28054,72020
24-10-2015,330470,335751,214527,82239,963001,20371,18101,24689,63161
25-10-2015,337087,344761,218249,81642,981753,20823,18411,24860,64094
26-10-2015,358109,391434,230395,95551,1.0755e+06,23135,20370,27563,71068
27-10-2015,368524,395620,238876,96834,1.09986e+06,23547,20741,28407,72695
28-10-2015,372602,400751,249449,95198,1.11801e+06,24029,20958,28299,73286
29-10-2015,378597,405309,248256,98838,1.13101e+06,24805,21391,28938,72669
30-10-2015,374299,383065,250003,94000,1.10138e+06,25187,21201,28592,74980
31-10-2015,338509,333428,224806,81004,977760,21911,18737,25000,65648
01-11-2015,328443,335472,214467,81237,959628,20735,17847,22981,61563
02-11-2015,352607,369618,232731,95876,1.05083e+06,23269,20704,27729,71702
03-11-2015,358981,382474,229463,98259,1.06918e+06,23336,21157,28541,73034
04-11-2015,362887,386306,231512,100152,1.08087e+06,23960,21552,29396,74908
05-11-2015,374766,396213,242669,100058,1.11372e+06,23940,21060,29282,74282
06-11-2015,368615,375328,242304,97019,1.08328e+06,24200,21382,28958,74540
07-11-2015,333016,338545,224179,82548,978294,21384,18684,25237,65305
08-11-2015,334333,336125,214185,78114,962765,20714,18019,24110,62843
09-11-2015,368459,387345,239608,94351,1.08976e+06,23817,20670,28286,72773
10-11-2015,374551,390656,238348,95780,1.09934e+06,23926,20647,28030,72603
11-11-2015,383920,389043,243175,94494,1.11064e+06,24024,20565,28180,72769
12-11-2015,385450,401610,247041,92250,1.12636e+06,24473,20914,28660,74047
13-11-2015,377052,395883,248369,92740,1.11405e+06,23980,20438,28394,72812
14-11-2015,360725,365804,226229,82705,1.03547e+06,21120,18144,24957,64221
15-11-2015,363855,370909,220447,82076,1.0373e+06,20621,18015,24203,62839
16-11-2015,404999,415264,244879,95052,1.1602e+06,24183,21330,28638,74151
17-11-2015,406965,414350,242392,97698,1.16142e+06,24303,21220,29309,74832
18-11-2015,409507,412581,245749,96589,1.16443e+06,24675,18658,28905,72238
19-11-2015,422294,410624,245243,98465,1.17664e+06,24442,21184,28879,74505
20-11-2015,442739,438583,250451,97482,1.22926e+06,24324,21083,28774,74181
21-11-2015,431020,419639,237107,87649,1.17542e+06,21900,18898,25707,66505
22-11-2015,433312,429308,235145,86378,1.18416e+06,21779,18978,25553,66310
23-11-2015,459682,487407,259603,103401,1.3101e+06,25389,22606,29756,77751
24-11-2015,437404,455185,261260,101456,1.25531e+06,26301,22494,29783,78578
25-11-2015,433939,440289,252474,102864,1.22957e+06,26220,22378,29659,78257
26-11-2015,442012,435479,249889,102142,1.22953e+06,26627,22938,30624,80189
27-11-2015,398873,405899,247026,99439,1.15124e+06,25284,22062,30407,77753
28-11-2015,387528,380590,227627,86149,1.08192e+06,22197,19815,27181,61345
29-11-2015,393313,390914,226225,84522,1.09498e+06,21740,19256,26287,67283
30-11-2015,434546,450723,247659,98569,1.23151e+06,25291,21766,30621,77678
01-12-2015,438985,452549,250087,101701,1.24332e+06,25598,21968,29546,77112
02-12-2015,429678,451538,256090,101607,1.23893e+06,25686,22253,30140,78079
03-12-2015,426550,425700,253385,101929,1.20757e+06,25760,22498,30657,78915
04-12-2015,417956,421030,256307,96251,1.19155e+06,25336,21842,29481,76659
05-12-2015,381963,381197,235935,82063,1.08116e+06,22065,19310,25433,66808
06-12-2015,374980,377228,223463,83851,1.05953e+06,21412,18756,24212,64380
07-12-2015,417942,435379,248010,98359,1.1997e+06,24471,21419,36579,82469
08-12-2015,413299,439405,253196,98931,1.20484e+06,25300,21818,30011,77129
09-12-2015,398754,416800,249092,100236,1.16489e+06,25532,22361,28789,76682
10-12-2015,401799,423572,247414,101981,1.17478e+06,25153,22235,28923,76311
11-12-2015,427478,429415,247483,99976,1.20436e+06,24767,22278,29437,76482
12-12-2015,419647,406305,237167,88320,1.15145e+06,22279,19671,25909,67859
13-12-2015,428019,429794,238472,88073,1.18436e+06,21870,19259,25508,66637
14-12-2015,476663,489069,267011,103874,531869,25275,22495,29907,77677
15-12-2015,480399,489754,269046,104245,1.34346e+06,25987,22396,30223,78606
16-12-2015,472062,483551,266233,105988,1.32784e+06,25912,22675,30297,78884
17-12-2015,448344,456840,266619,101055,1.27286e+06,26091,23035,31566,80692
18-12-2015,415310,416980,256237,97452,1.186e+06,25279,22104,29476,76859
19-12-2015,379977,365501,233254,87089,1.06583e+06,21632,19295,25505,66432
20-12-2015,364911,356862,221410,83586,1.02678e+06,21086,18640,24808,64534
21-12-2015,389694,403492,228809,95763,1.11777e+06,23318,20828,28657,72803
22-12-2015,401480,410845,226431,96421,1.13518e+06,22891,21059,28069,72019
23-12-2015,400712,391625,224867,92305,1.10951e+06,22005,20353,27169,69527
24-12-2015,376732,353489,205724,82347,1.0183e+06,19831,17745,23549,61125
25-12-2015,369196,356213,197415,77826,1.00066e+06,19225,16758,21737,57720
26-12-2015,401043,377448,208409,81722,1.06863e+06,19761,17552,22584,59897
27-12-2015,430764,403898,227057,81882,1.14361e+06,21553,18385,24172,64110
28-12-2015,460792,447464,262716,90857,1.26183e+06,24647,21134,27826,73607
29-12-2015,444728,449451,276103,91147,1.26144e+06,24972,21781,28807,75560
30-12-2015,424703,441610,267571,90837,1.22473e+06,26260,22249,29342,77851
31-12-2015,406275,415554,255072,86049,1.16296e+06,25132,20883,28991,75006
01-01-2016,393811,393138,253018,80280,1.12026e+06,22911,18889,25070,66870
02-01-2016,420780,432857,269913,86591,1.21016e+06,25405,20584,26974,72963
03-01-2016,449122,456162,269226,90047,1.26456e+06,25528,21212,28763,75503
04-01-2016,499773,518798,297791,105833,1.42221e+06,29795,24468,32932,87195
05-01-2016,511110,526033,312776,108221,1.45815e+06,30573,25316,34521,90410
06-01-2016,525431,537973,318080,109280,1.49077e+06,31533,25799,35337,92669
07-01-2016,534342,570837,343148,108248,1.55658e+06,32043,26144,35781,93968
08-01-2016,532117,533371,336351,105402,1.50725e+06,32954,26491,35627,95072
09-01-2016,511449,498521,306685,92354,1.40902e+06,30352,23548,30968,84868
10-01-2016,488489,475488,300098,90759,1.35484e+06,29821,22225,29288,81334
11-01-2016,494320,503535,311743,101654,1.41126e+06,32144,24988,32666,89798
12-01-2016,497493,506270,303969,102911,1.41065e+06,31662,24869,32486,89017
13-01-2016,507107,540365,309821,103821,1.46112e+06,31109,24327,31582,87018
14-01-2016,526644,569023,308426,107618,1.51172e+06,31259,24329,31958,87546
15-01-2016,532789,578448,312098,107381,1.53072e+06,31015,24624,33268,88907
16-01-2016,507829,538233,303327,98034,1.44742e+06,27549,22846,30079,80474
17-01-2016,507294,527985,298157,96541,1.42998e+06,27084,21561,28811,77456
18-01-2016,532560,558201,326815,111246,1.52883e+06,29097,23898,31852,84847
19-01-2016,535284,553125,324529,110637,1.52358e+06,28863,24754,32479,86096
20-01-2016,539116,568783,328778,112217,1.54891e+06,29299,24670,32351,86320
21-01-2016,542203,573212,328734,114222,1.55838e+06,29862,25020,33582,88464
22-01-2016,530807,554212,333488,109920,1.52845e+06,30407,24715,33369,88491
23-01-2016,477770,486810,285551,97015,1.34715e+06,27490,22681,29914,80085
24-01-2016,454188,453564,262467,92176,1.2624e+06,26365,21865,28949,77179
25-01-2016,461638,483650,278387,103323,1.32701e+06,28488,23870,31897,84255
26-01-2016,446886,461675,273216,102269,1.28406e+06,28111,23697,31335,83143
27-01-2016,434821,458074,261632,100691,1.25522e+06,27529,23010,30784,81323
28-01-2016,441812,459411,264222,98876,1.26432e+06,27409,22391,30036,79836
29-01-2016,436023,456385,269945,100140,1.2625e+06,26976,21835,29148,77959
30-01-2016,423025,421213,244935,86743,1.17592e+06,23556,19231,25748,68535
31-01-2016,420532,427871,239260,89096,1.17676e+06,23049,18913,25066,67028
01-02-2016,463594,486248,264943,104054,1.3188e+06,26131,21664,29358,77153
02-02-2016,451866,473436,268677,102366,1.29647e+06,26775,21928,29071,77774
03-02-2016,453225,475178,267506,102675,1.29886e+06,26898,22093,29103,78094
04-02-2016,464635,486534,271899,103170,1.32622e+06,26899,22366,30058,79323
05-02-2016,468288,483641,275867,102393,1.32971e+06,26864,21884,28932,77680
06-02-2016,420266,422917,259852,88024,1.19113e+06,24046,19590,26463,70099
07-02-2016,404398,395654,239991,84961,1.12563e+06,22993,18987,24843,66823
08-02-2016,432877,446227,255839,100308,1.23514e+06,26080,21679,29067,76826
09-02-2016,434195,447052,255965,102275,1.2395e+06,25648,21901,28884,76433
10-02-2016,442413,472479,252775,105375,1.26432e+06,25860,22273,29468,77601
11-02-2016,457098,466552,252227,104311,1.2802e+06,26208,22520,30305,79033
12-02-2016,472144,475975,260936,101391,1.31046e+06,26034,21965,29384,77383
13-02-2016,456276,448446,245584,91271,1.24159e+06,23019,19612,25728,68359
14-02-2016,458553,448709,239865,89279,1.23699e+06,22673,19286,25476,67435
15-02-2016,495689,510792,261172,102962,1.37062e+06,25784,21872,27813,75469
16-02-2016,492597,504965,265631,104074,1.36728e+06,26338,22260,25286,73884
17-02-2016,467277,490743,265646,103330,1.32615e+06,26308,22194,28951,77453
18-02-2016,472798,504724,265189,105596,1.33714e+06,26940,22816,29503,79259
19-02-2016,464786,487992,265657,100505,1.304e+06,26462,22533,29985,78980
20-02-2016,434528,455251,248032,85808,1.20689e+06,23559,20192,27036,70787
21-02-2016,424264,428945,242117,82586,1.16459e+06,22810,19590,25993,68393
22-02-2016,457191,476228,262975,95460,1.27569e+06,25740,21997,29727,77464
23-02-2016,459011,482265,264039,97839,1.28809e+06,24785,21912,29744,76441
24-02-2016,456167,485086,262832,100029,1.29096e+06,22384,22001,29895,74280
25-02-2016,462529,489577,261725,101972,1.30147e+06,24986,21920,29912,76818
26-02-2016,454288,480943,269715,97465,1.28775e+06,25154,21817,29336,76307
27-02-2016,434837,449688,258279,89543,1.21965e+06,22638,19252,26307,68197
28-02-2016,428176,448231,245553,89174,1.1972e+06,21976,18832,25682,66490
29-02-2016,467754,503601,268050,103099,1.32675e+06,25463,21809,29603,76875
01-03-2016,468967,486994,262262,102714,1.32095e+06,26096,21864,29918,77878
02-03-2016,466987,480415,263285,104020,1.31472e+06,26329,21870,29994,78193
03-03-2016,462235,471869,270486,103402,1.30799e+06,26362,21865,30058,78285
04-03-2016,449329,464679,268568,100953,1.28354e+06,25792,21622,30227,77641
05-03-2016,423564,426882,246959,88282,1.18569e+06,23101,19439,26562,69102
06-03-2016,419594,435732,237945,89067,1.18235e+06,22252,18918,25426,66596
07-03-2016,448206,473517,255985,102821,1.28054e+06,25423,21659,29560,76642
08-03-2016,447358,462297,255502,104035,1.26917e+06,25733,22231,30313,78277
09-03-2016,444595,458952,252172,101337,1.25707e+06,25149,21919,29746,76814
10-03-2016,438730,459022,252240,102824,1.25281e+06,25466,21680,28730,75876
11-03-2016,438989,447424,256818,100167,1.24341e+06,25453,21730,25716,72899
12-03-2016,416639,415044,244684,89873,1.16625e+06,22194,19176,25750,67120
13-03-2016,399547,410299,239545,87373,1.13677e+06,22165,18872,24790,65827
14-03-2016,410448,434946,250753,99796,1.19595e+06,24754,21470,29716,75940
15-03-2016,395605,418225,242937,97922,1.15471e+06,25041,21662,30020,76723
16-03-2016,395497,416093,234869,97614,1.14407e+06,24992,21611,29666,76269
17-03-2016,405368,419094,243512,97493,1.16547e+06,24233,21438,29238,74909
18-03-2016,400956,422946,259612,95906,1.17943e+06,25232,21496,28811,75539
19-03-2016,380304,390902,248080,84016,1.10331e+06,22644,19813,26062,68519
20-03-2016,370330,383039,240833,80381,1.07459e+06,22278,19051,26433,67762
21-03-2016,398527,425544,256813,92992,1.17388e+06,25449,21723,29898,77070
22-03-2016,400994,437297,258644,95507,1.19245e+06,25843,21580,30191,77615
23-03-2016,391740,434060,258809,93095,1.17772e+06,25725,21792,29733,77250
24-03-2016,384749,426530,255144,83431,1.14986e+06,25328,21270,29364,75963
25-03-2016,369413,380150,237530,80531,1.06764e+06,22007,18958,29198,70163
26-03-2016,364164,346679,229666,77793,1.01831e+06,21272,18592,25980,65844
27-03-2016,332959,332901,208595,74316,948777,19676,16624,20389,56689
28-03-2016,360194,347598,217983,77220,1.00301e+06,22972,17615,21549,62136
29-03-2016,387546,391952,232154,91154,1.10282e+06,23160,20131,26651,69942
30-03-2016,396496,414001,237681,96638,1.14482e+06,23508,20542,28109,72159
31-03-2016,408522,408392,239352,94035,1.1503e+06,23883,20497,27793,72173
01-04-2016,403785,406031,241166,92224,1.14322e+06,23831,20942,27482,72255
02-04-2016,375946,364147,226319,78950,1.04536e+06,20470,18392,23868,62730
03-04-2016,363477,347825,219606,79225,1.01015e+06,20342,17518,22932,60792
04-04-2016,381742,389988,235478,92972,1.10019e+06,23136,19840,26550,69526
05-04-2016,377497,391587,235541,95510,1.10014e+06,23294,20062,27112,70468
06-04-2016,374400,391785,232564,92266,1.09102e+06,22792,20233,26666,69691
07-04-2016,377581,391218,228787,94436,1.09204e+06,22847,20038,26808,69693
08-04-2016,382171,388296,231276,90316,1.09207e+06,22545,19762,26363,68670
09-04-2016,361415,352232,221031,79226,1.01383e+06,19435,17481,23655,60571
10-04-2016,350906,352894,210930,76723,991464,19041,16906,22511,58458
11-04-2016,368365,387272,227258,90471,1.07338e+06,21964,19376,26702,68042
12-04-2016,368055,384432,223208,92953,1.06866e+06,21377,19815,27538,68730
13-04-2016,369462,386631,226051,93407,1.07555e+06,21312,19955,28346,69613
14-04-2016,372080,394980,231397,93478,1.09195e+06,22033,20350,27679,70062
15-04-2016,376589,384210,237431,90701,1.08892e+06,22192,19650,26307,68149
16-04-2016,345308,350059,213187,79779,988345,18902,17378,23330,59610
17-04-2016,344272,352620,205215,76967,979089,18694,17022,23195,58911
18-04-2016,365683,387634,223782,91849,1.06896e+06,21987,19580,26567,68134
19-04-2016,364708,391699,226544,91277,1.07424e+06,22145,19919,27672,69736
20-04-2016,361492,388575,228321,90808,1.0692e+06,22569,20018,27573,70160
21-04-2016,357622,386412,230604,88488,1.06314e+06,22544,19831,27127,69502
22-04-2016,364827,381381,233463,76827,1.05651e+06,22161,19615,27330,69106
23-04-2016,356602,357337,218337,75994,1.00827e+06,19972,17454,24723,62149
24-04-2016,354123,362888,212676,77499,1.0072e+06,20123,17607,24117,61847
25-04-2016,380170,409792,229162,93038,1.11217e+06,22709,19968,27916,70593
26-04-2016,374026,401987,232276,93752,1.10205e+06,23907,20494,28746,73147
27-04-2016,368243,400931,225060,93969,1.08822e+06,22930,19677,27687,70294
28-04-2016,368944,407842,225122,94392,1.09630e+06,22640,19820,27930,70390
29-04-2016,364091,377394,221887,89478,1.05286e+06,21799,19413,27145,68357
30-04-2016,350768,338573,204036,77928,971302,18254,16900,24270,59424
01-05-2016,330920,319866,192603,76141,919536,17303,15951,22726,55980
02-05-2016,358319,359269,211486,88223,1.01731e+06,20591,18723,26664,65978
03-05-2016,347486,354476,204590,89696,996254,20947,18409,26959,66315
04-05-2016,341193,350551,208583,88445,988786,20883,16232,26426,63541
05-05-2016,314943,313800,194031,74685,897454,20964,18175,26069,65208
06-05-2016,318941,322307,198081,75115,914458,20712,18357,26224,65293
07-05-2016,293109,298385,188132,68772,848410,17624,16368,23528,57520
08-05-2016,279707,285256,179879,68501,813350,17014,15772,22993,55779
09-05-2016,306743,308582,196250,83982,895399,20201,18726,26761,65688
10-05-2016,309100,313217,194501,86656,903484,20542,18943,26991,66476
11-05-2016,308294,323557,193657,86421,911931,20073,18546,26665,65284
12-05-2016,314722,332184,200399,86762,934080,20256,18526,26126,64908
13-05-2016,327572,331071,203585,83370,945608,19947,18363,25933,64243
14-05-2016,307949,310503,191585,71600,881642,17580,16624,24246,58450
15-05-2016,295950,313666,186582,70310,866508,16956,16037,22920,55913
16-05-2016,302955,356596,204565,71210,935340,19741,18604,25881,64226
17-05-2016,298936,341370,203181,83736,927235,20338,18827,26790,65955
18-05-2016,328944,342897,206680,88847,967376,20746,19082,26530,66358
19-05-2016,326006,338564,205510,89758,959848,20753,19000,26238,65991
20-05-2016,323766,323825,204969,85999,938563,20473,18515,25877,64865
21-05-2016,294657,286401,185515,73813,840394,17628,16294,23009,56931
22-05-2016,287595,282950,178091,71089,819738,17094,15925,22983,56002
23-05-2016,315725,322167,194216,87592,919711,19989,18814,25562,64365
24-05-2016,321978,317341,192624,88218,920175,20153,19083,23890,63126
25-05-2016,315910,335122,191145,85644,927824,20008,18902,25839,64749
26-05-2016,310851,342528,195415,87136,935932,20328,19357,25843,65528
27-05-2016,300454,333193,199358,83637,916649,19597,18599,25274,63470
28-05-2016,273517,289924,183407,71554,818410,16845,16384,22854,56083
29-05-2016,268643,286781,178489,70206,804122,16263,16163,22499,54925
30-05-2016,289864,327584,200549,86238,904243,19394,19197,26402,64993
31-05-2016,285399,328301,199196,87617,900521,20012,19588,26842,66442
01-06-2016,281953,324785,200342,88725,895814,19881,19669,26918,66468
02-06-2016,281084,317776,201897,89916,890680,19487,19572,27116,66175
03-06-2016,277482,312133,200737,87156,877510,19411,19032,26970,65413
04-06-2016,263593,277115,181272,75369,797356,16575,16209,22999,55783
05-06-2016,257856,271598,180976,72913,783352,16559,15281,21402,53242
06-06-2016,283434,286079,204899,87962,862377,19405,17732,25344,62481
07-06-2016,286956,323294,201416,89485,901151,19707,17971,26503,64181
08-06-2016,290453,327344,202259,88596,908665,19748,18443,26914,65105
09-06-2016,298282,332588,205912,88596,925383,19382,17928,26407,63717
10-06-2016,297080,323899,207875,84142,913000,19545,17841,26513,63899
11-06-2016,275518,292787,191232,73358,832899,17564,15898,23164,56626
12-06-2016,268582,284646,186610,72227,812077,16781,15106,22552,54439
13-06-2016,292171,323652,204961,86823,907610,19498,17472,26711,63681
14-06-2016,287636,322574,202757,89451,902430,19361,18018,27021,64400
15-06-2016,289235,322197,199498,91167,902107,19596,18440,28085,66121
16-06-2016,289033,318358,199464,91728,898590,20201,18803,28025,67029
17-06-2016,286887,312618,202660,86753,888929,19599,18607,27305,65511
18-06-2016,270243,278061,186804,72637,807752,16778,16356,23010,56144
19-06-2016,270288,277443,177231,70893,795863,16628,15844,22629,55101
20-06-2016,298952,318220,187668,86407,891249,19214,18866,26619,64699
21-06-2016,292018,319127,185711,88499,885356,19327,18872,26963,65162
22-06-2016,290972,315614,177902,88942,873438,18217,18109,27091,63417
23-06-2016,285483,309045,174657,89403,858594,15430,15100,26607,57137
24-06-2016,284163,267002,157607,86510,795287,15132,14330,23460,52922
25-06-2016,263404,247689,153142,75449,739690,15863,15875,23609,55347
26-06-2016,260543,263429,154385,71215,749582,16146,16456,23652,56254
27-06-2016,281135,306713,178234,86491,852589,18853,18308,26709,63870
28-06-2016,286328,310519,191499,88268,876619,18644,17955,26609,63208
29-06-2016,286445,317971,193989,89368,887779,18995,18153,27432,64580
30-06-2016,287118,318962,196310,87572,889974,19090,18825,27638,65553
01-07-2016,280443,304650,198725,83823,867645,19055,18881,27038,64974
02-07-2016,265332,269840,183556,69920,788654,16541,16793,23869,57203
03-07-2016,263025,271836,179911,70875,785653,16205,15990,23071,55266
04-07-2016,284320,308342,200638,82929,876242,19133,18042,25193,62368
05-07-2016,292815,313522,201307,87015,894663,19301,18029,25480,62810
06-07-2016,285134,308119,200788,83621,877670,19330,18074,22891,60295
07-07-2016,284552,308933,201201,82616,877317,19680,17936,25433,63049
08-07-2016,275812,299617,199401,82974,857805,19248,17497,25282,62027
09-07-2016,257878,263822,184190,68805,774705,16728,15530,23146,55404
10-07-2016,252069,266151,178854,70698,767780,16272,15058,22048,53378
11-07-2016,268619,292664,193714,82185,837196,18755,17994,26148,62897
12-07-2016,267984,292766,190774,81325,832861,18303,18341,26706,63350
13-07-2016,267027,292076,191991,80424,831534,18597,18100,26845,63542
14-07-2016,270332,292421,192164,82858,837776,18921,18003,26922,63846
15-07-2016,269633,281519,197903,77546,826613,19023,17706,26275,63004
16-07-2016,254837,256841,182674,67449,761810,16132,15589,23512,55233
17-07-2016,250387,256177,177546,65947,750061,15905,15143,23269,54317
18-07-2016,268649,279796,195057,75238,818741,18403,17712,26609,62724
19-07-2016,270501,276201,192953,76563,816227,18755,17886,27113,63754
20-07-2016,261354,279454,190037,77168,808022,18743,17941,27094,63778
21-07-2016,260624,275908,189751,76183,802469,18665,18221,27726,64612
22-07-2016,259343,274305,194436,76122,804208,18710,18002,27639,64351
23-07-2016,246377,263247,183618,68918,762169,16539,15971,24559,57069
24-07-2016,241335,248978,179076,67956,737355,16156,15777,23989,55922
25-07-2016,259968,277285,193861,77477,808601,18685,18694,27790,65169
26-07-2016,258588,267377,192409,76136,794525,19143,19014,28494,66651
27-07-2016,262183,272356,194064,76498,805101,19275,19058,27760,66093
28-07-2016,264372,271671,192893,77091,806029,19167,19229,28115,66511
29-07-2016,265817,273084,195995,77101,812003,18823,18419,27302,64544
30-07-2016,252068,251038,183616,69084,755819,16522,16232,24473,57227
31-07-2016,247078,245982,177429,67224,737725,16157,15673,23953,55783
01-08-2016,269364,273834,195618,77434,816255,18906,18299,27220,64425
02-08-2016,274864,273873,198116,79559,826416,19215,18082,26989,64286
03-08-2016,274067,281007,193870,81716,830671,19402,18367,27377,65146
04-08-2016,273508,285114,197272,80959,836862,19500,18579,27459,65538
05-08-2016,271563,278046,200187,78299,828110,19505,18787,27759,66051
06-08-2016,258023,253598,186961,68446,767038,17066,16586,24505,58157
07-08-2016,257926,256348,182090,70212,766583,16468,15401,22904,54773
08-08-2016,278378,289996,197737,83598,849722,19645,18381,26707,64733
09-08-2016,289140,301772,202478,83724,877114,20117,18655,28644,67416
10-08-2016,297614,308017,205096,86960,897703,20080,18321,28253,66654
11-08-2016,300164,305919,207400,87879,901372,20051,18264,27811,66126
12-08-2016,299105,303538,203202,84887,890745,19906,18185,27724,65815
13-08-2016,272851,277007,190818,71560,812233,17561,16478,25133,59172
14-08-2016,261713,276054,185289,71028,794084,17232,15907,23780,56919
15-08-2016,287600,319335,205246,86128,898320,20020,18362,23605,61987
16-08-2016,290514,322289,204576,88816,906213,21060,18771,27288,67119
17-08-2016,288559,326016,204910,89349,908842,20739,18925,28021,67685
18-08-2016,285523,331200,204757,88664,910155,20647,18790,28264,67701
19-08-2016,280003,322261,203675,87280,893231,20215,18644,28162,67021
20-08-2016,265576,279236,188678,76990,810492,17262,16678,25695,59635
21-08-2016,261260,283436,184848,74548,804108,17119,16476,24696,58291
22-08-2016,287327,320648,203679,89230,900893,20603,19066,29156,68825
23-08-2016,289967,317442,202333,90528,900282,20445,18924,29203,68572
24-08-2016,288899,321420,201680,89928,901946,20749,18869,28841,68459
25-08-2016,291458,320986,208868,90537,911855,20728,18807,29019,68554
26-08-2016,286811,312191,207600,85871,892489,20751,18824,28402,67977
27-08-2016,266528,273782,190429,72798,803542,17459,16655,25466,59580
28-08-2016,273114,282638,186124,72977,814860,17124,15876,24858,57858
29-08-2016,295672,323169,208777,84986,912618,20201,18495,28733,67429
30-08-2016,297286,323699,206680,88141,915812,20531,18504,28348,67383
31-08-2016,294623,328417,205639,89715,918400,20421,18375,28920,67716
01-09-2016,291099,325906,209252,87826,914093,20205,18179,28683,67067
02-09-2016,291306,312605,207275,84137,895329,20244,17995,28485,66724
03-09-2016,269561,277570,193825,71612,812578,17954,16216,25108,59278
04-09-2016,269979,274910,186666,73590,805151,17311,15872,24561,57744
05-09-2016,294742,328863,203974,86739,914318,20548,18365,27881,66794
06-09-2016,295982,327798,208871,88065,920726,20737,18730,28249,67716
07-09-2016,289287,328462,206493,90797,915042,20835,18963,28521,67390
08-09-2016,289101,325071,206553,89201,909929,20676,18946,29224,68846
09-09-2016,283194,322135,211067,86426,902825,20662,18552,28600,67814
10-09-2016,267677,283819,196530,72729,820759,17599,16491,9968,44058
11-09-2016,261294,278092,187340,71181,797911,17124,16321,24990,58435
12-09-2016,290053,331614,206274,86822,914783,20128,18784,28571,67483
13-09-2016,290615,334176,209366,89596,924001,20626,18866,28502,67994
14-09-2016,287844,329816,208976,89458,916096,20793,18777,28443,68013
15-09-2016,287735,328364,208497,89504,914115,15811,18891,28455,63157
16-09-2016,286128,319638,210389,84665,900826,20597,18795,28196,67588
17-09-2016,270760,292765,196162,72648,832344,17742,16584,24915,59241
18-09-2016,266523,294548,189861,72065,823008,17425,16243,23961,57629
19-09-2016,293157,332576,211043,87731,892529,20782,19011,27598,67391
20-09-2016,293337,329642,213843,88839,925671,20714,19431,27466,67611
21-09-2016,296836,333858,214930,89744,935384,20608,19577,27252,67437
22-09-2016,295295,337674,214089,88228,935302,21085,19785,27926,68796
23-09-2016,296842,324818,218609,84484,924767,21613,19403,27636,68652
24-09-2016,285412,292937,201636,72640,852640,18719,17059,24278,60056
25-09-2016,269976,283937,191737,69693,815350,18154,16433,23613,58200
26-09-2016,295629,332779,210505,87928,896233,21287,19149,27449,67885
27-09-2016,305623,332907,211537,87711,937784,21977,19498,28443,69918
28-09-2016,303045,336416,215299,85272,940024,22400,19865,28323,70588
29-09-2016,307471,337834,216134,85817,947263,22087,19555,28007,69649
30-09-2016,309556,329179,215072,83263,937069,21531,19138,27299,67968
01-10-2016,298197,301364,199947,74754,874267,18315,16669,24225,58361
02-10-2016,298245,303497,199026,74540,875291,18163,16898,23854,58915
03-10-2016,329580,349519,222410,86948,988469,21002,19412,27874,68288
04-10-2016,337424,360465,225739,88875,1.01242e+06,22086,19522,27494,69102
05-10-2016,338051,366611,230314,87829,1.02281e+06,22230,20092,28744,71066
06-10-2016,340413,363297,234128,87713,1.02556e+06,22377,20349,29197,71923
07-10-2016,331478,355748,232892,85569,1.0057e+06,22451,20327,29716,72494
08-10-2016,317484,330475,215363,73781,937104,20093,18142,26472,64707
09-10-2016,327121,336672,212218,74967,950985,19442,17816,25685,62943
10-10-2016,359162,372771,233728,90304,1.05597e+06,22836,20498,29635,72969
11-10-2016,366466,381989,236416,92942,1.07783e+06,23399,19961,29848,73208
12-10-2016,370974,393196,237427,93328,1.09494e+06,23660,20924,30119,74703
13-10-2016,376316,391857,243132,91721,1.10304e+06,24219,21251,29782,75252
14-10-2016,382178,385097,245367,84569,1.09722e+06,24171,21135,30745,76051
15-10-2016,358420,345051,225356,74743,1.00357e+06,20695,18260,26134,65089
16-10-2016,350804,347901,216249,77504,992459,20136,17640,25363,63139
17-10-2016,365822,386618,236138,91023,1.07961e+06,23567,20655,29479,73701
18-10-2016,359870,381460,234223,93430,1.06899e+06,23891,20776,29789,74456
19-10-2016,355211,376359,238229,92360,1.06217e+06,24110,21003,29764,74877
20-10-2016,364864,380442,241491,89343,1.07614e+06,24364,21211,29699,75274
21-10-2016,371255,378179,244433,87940,1.08181e+06,24757,21135,29852,75744
22-10-2016,360796,360443,231991,78998,1.03223e+06,21835,18818,26376,67029
23-10-2016,362628,362513,223990,79407,1.02854e+06,20636,18245,25537,64418
24-10-2016,383584,402180,242551,93908,1.12145e+06,24021,21290,30067,75378
25-10-2016,386297,411157,243614,96759,1.13722e+06,25043,21826,30665,77534
26-10-2016,383776,410335,249265,95995,1.13938e+06,25075,21670,30524,77269
27-10-2016,365180,389752,245106,92662,1.09271e+06,24363,21301,30137,75801
28-10-2016,362022,371155,236620,86139,1.05594e+06,23902,20914,29760,74576
29-10-2016,352849,351925,226444,75141,1.00637e+06,20742,17984,25422,64148
30-10-2016,368317,367756,230247,81904,1.04824e+06,21289,18229,25647,65165
31-10-2016,372921,404948,245740,94622,1.11824e+06,24387,20960,28031,73378
01-11-2016,382704,404795,252961,90306,1.13077e+06,25336,22029,24911,72276
02-11-2016,399617,435800,257875,94838,1.18814e+06,26363,22105,29724,78192
03-11-2016,422774,441365,259402,99220,1.22277e+06,26728,22069,30735,79532
04-11-2016,425595,440933,262727,95971,1.22523e+06,26663,21799,30588,79050
05-11-2016,407357,399887,253844,84624,1.14572e+06,23654,19685,27124,70463
06-11-2016,415547,415519,256136,81700,1.16891e+06,23935,19761,26564,70260
07-11-2016,467350,485988,278957,99969,1.33226e+06,27667,22716,31299,81682
08-11-2016,480466,482725,276795,105178,1.34517e+06,27550,23013,30491,81054
09-11-2016,474625,487636,272932,105224,1.34042e+06,27560,23018,31524,82102
10-11-2016,471276,474571,274351,105891,1.3261e+06,27825,23059,31537,82421
11-11-2016,469368,470993,279178,101778,1.32132e+06,27534,22927,31394,81855
12-11-2016,436262,434499,262651,89448,1.22287e+06,24267,20171,28144,72582
13-11-2016,400395,421013,249464,87269,1.15815e+06,23542,19153,27048,69743
14-11-2016,413656,454338,268839,100426,1.23727e+06,27135,22226,30962,80323
15-11-2016,398959,436560,265843,99196,1.20057e+06,27207,22658,31428,81293
16-11-2016,405540,434391,257973,98604,1.19651e+06,26863,22689,31784,81336
17-11-2016,414668,427622,250634,97907,1.19084e+06,26284,22067,31159,79510
18-11-2016,418392,418899,252164,95514,1.18498e+06,25853,18819,29951,74623
19-11-2016,400771,392283,233025,85202,1.11129e+06,22106,18513,26849,67468
20-11-2016,401553,386093,226064,83465,1.09718e+06,22144,18727,25805,66676
21-11-2016,426939,415229,237839,97533,1.17754e+06,25105,22045,29703,76853
22-11-2016,419053,403116,238356,96941,1.15747e+06,25838,22555,30821,79214
23-11-2016,403273,404991,240868,96845,1.14598e+06,26267,22761,31437,80465
24-11-2016,421824,434709,248614,98171,1.20333e+06,26061,22303,31267,79631
25-11-2016,406954,438091,259363,93726,1.19814e+06,26356,21925,30750,79031
26-11-2016,380225,383556,240295,78698,1.08279e+06,22587,19332,26687,68606
27-11-2016,396318,409924,243655,79182,1.12909e+06,22782,18888,26214,67884
28-11-2016,446614,470575,269750,100777,1.28772e+06,27174,22271,31221,80666
29-11-2016,443307,448580,275972,100370,1.26798e+06,27798,22966,32611,83375
30-11-2016,441857,446207,259116,99306,1.24651e+06,27284,23037,31842,82163
01-12-2016,438223,450731,260310,98146,1.24742e+06,26897,22709,31604,81210
02-12-2016,443557,461226,268908,96785,1.27048e+06,27354,23010,32334,82698
03-12-2016,431512,449463,263235,86790,1.23101e+06,24846,20560,28444,73850
04-12-2016,412426,427305,265560,83005,1.18831e+06,24543,20090,27475,72108
05-12-2016,420212,446623,261837,96464,1.18162e+06,26703,22748,31260,78362
06-12-2016,446769,480319,269362,101390,1.24801e+06,28295,23050,32070,83415
07-12-2016,431296,468626,268725,99522,1.22298e+06,27998,23124,32395,83517
08-12-2016,403615,421202,257192,96755,1.17877e+06,27024,22708,31657,81389
09-12-2016,404229,415620,264866,93366,1.17809e+06,26368,22052,30571,78991
10-12-2016,396880,406249,265258,82572,1.10472e+06,24245,19855,28662,72762
11-12-2016,407569,424824,269357,83385,1.18514e+06,24703,19797,28166,72666
12-12-2016,449808,490750,290942,100449,1.33195e+06,28137,22903,32633,83673
13-12-2016,445258,472122,284256,102412,1.30405e+06,28029,23198,32708,83935
14-12-2016,463011,478510,279159,103181,1.32387e+06,27721,23073,32658,83452
15-12-2016,465759,502167,274425,102729,1.34503e+06,27584,23227,32710,83521
16-12-2016,441540,479866,276042,102815,1.29925e+06,26903,22753,31620,81276
17-12-2016,416105,431044,260361,89290,1.19681e+06,23948,20538,28603,73089
18-12-2016,418118,411819,247935,86756,1.16463e+06,23299,19912,27586,70797
19-12-2016,427577,436647,261551,100886,1.22667e+06,26108,22580,31435,80123
20-12-2016,420902,436094,252141,101203,1.21034e+06,25808,22564,32029,80401
21-12-2016,421776,451756,248937,98804,1.22128e+06,25747,22201,32182,29867
22-12-2016,424712,433159,244312,97180,1.19938e+06,25222,22473,32317,80012
23-12-2016,422260,416582,231496,90382,1.16073e+06,23946,21520,30891,76357
24-12-2016,392755,370574,215600,78741,1.05768e+06,21224,18710,25618,65552
25-12-2016,380751,371226,206729,79059,1.03778e+06,20305,17254,22895,60454
26-12-2016,393744,376151,212567,76749,1.05923e+06,20969,17979,23391,62339
27-12-2016,416034,429355,236819,84903,1.16712e+06,23744,21347,27898,72989
28-12-2016,425590,444472,256792,86704,1.21356e+06,24848,21171,28330,74349
29-12-2016,416207,411174,256649,85025,1.12410e+06,24536,21049,29072,74657
30-12-2016,400931,400401,251285,84419,1.13703e+06,23729,20387,28536,72652
31-12-2016,375721,354309,234753,76218,1.041e+06,21383,18826,26156,66365
01-01-2017,386494,374228,239140,74998,1.07487e+06,19593,16675,22583,58851
02-01-2017,456079,478835,272174,95738,1.30283e+06,24814,20385,29008,74207
03-01-2017,462886,497661,286127,96636,1.34332e+06,26840,21976,30592,79408
04-01-2017,477197,514413,305396,96926,1.39394e+06,28925,23111,31097,83133
05-01-2017,514575,575948,324598,107769,1.20276e+06,30777,24642,32940,88359
06-01-2017,497030,544262,314774,106805,1.46288e+06,31106,25091,35267,91464
07-01-2017,437705,489759,281922,90743,1.30014e+06,28470,22879,32600,83949
08-01-2017,434056,473074,256885,89232,766072,26006,21420,30864,78290
09-01-2017,443353,480671,266846,99779,1.24346e+06,27898,24023,34118,86039
10-01-2017,437960,486782,262976,100724,1.28845e+06,27777,24082,34923,86782
11-01-2017,433004,488043,267486,98184,1.27601e+06,28848,24258,33767,86873
12-01-2017,447221,487602,272543,98487,1.30587e+06,29255,24064,33697,87016
13-01-2017,458897,490616,269410,100637,1.27010e+06,27936,23382,32442,83760
14-01-2017,445585,459927,252294,87555,1.24537e+06,24752,20631,29323,74706
15-01-2017,456571,474289,253914,87749,1.27253e+06,24220,19895,28310,72425
16-01-2017,496565,531345,280495,105442,1.41385e+06,27797,23236,33252,84285
17-01-2017,477768,521459,278695,107186,1.38511e+06,27726,23663,33827,85216
18-01-2017,451214,492719,267341,101873,1.31315e+06,27755,23566,33309,84630
19-01-2017,439731,470102,262050,99868,1.27172e+06,27078,23218,33667,83963
20-01-2017,425899,453460,270275,94502,1.24415e+06,26871,22777,32873,81484
21-01-2017,410782,434343,258550,86969,1.19066e+06,24020,20137,28776,72933
22-01-2017,416310,444216,248550,86663,1.19574e+06,23405,19690,27692,70787
23-01-2017,452287,478431,265932,100710,1.29736e+06,26730,22718,32500,81948
24-01-2017,460949,497432,275585,101153,1.33512e+06,27367,22923,32470,82760
25-01-2017,442765,482024,284006,102670,1.31147e+06,28068,23438,32345,83851
26-01-2017,435327,471860,269532,105649,1.28238e+06,27482,23464,33040,83986
27-01-2017,444319,479732,266179,98889,1.24048e+06,26443,22525,32597,81565
28-01-2017,422006,454459,255752,86864,1.21909e+06,23460,19859,28797,72116
29-01-2017,414945,453981,248815,85638,1.15548e+06,23204,19501,27675,70380
30-01-2017,444768,474485,267107,100904,1.28727e+06,26921,22980,32405,82306
31-01-2017,458923,488050,269272,101952,1.3182e+06,26900,22823,33513,83236
01-02-2017,461621,488887,273048,101531,1.32509e+06,26941,23112,33789,83842
02-02-2017,455099,486440,278094,101816,1.32146e+06,27504,23367,33352,84223
03-02-2017,443677,483034,276896,99163,1.30278e+06,26989,22686,32727,82402
04-02-2017,424338,441791,257188,87618,1.21095e+06,24046,20200,28675,72921
05-02-2017,421601,446285,256940,85587,1.21043e+06,23850,19785,27865,71500
06-02-2017,456472,496320,293047,99696,1.34554e+06,28384,23337,32447,84168
07-02-2017,485778,519812,308652,103555,1.41781e+06,30039,24470,33410,87919
08-02-2017,503789,529257,307226,105222,1.44551e+06,30103,24527,34370,89000
09-02-2017,509846,522069,309991,107571,1.44949e+06,29742,24464,34041,88247
10-02-2017,494166,506563,303957,102960,1.40765e+06,30035,24173,32885,87093
11-02-2017,461226,462033,282999,87531,1.2938e+06,26995,21495,29716,78206
12-02-2017,452183,470222,262228,86858,1.2715e+06,25397,20918,28942,75257
13-02-2017,471036,495732,266895,104804,1.33848e+06,27500,23726,33471,84697
14-02-2017,468301,466656,255242,103256,1.29347e+06,26147,22883,32006,81036
15-02-2017,469973,474481,264878,101582,1.31093e+06,26800,22867,32542,82209
16-02-2017,456801,475135,268191,98922,1.29906e+06,26800,22870,27854,77524
17-02-2017,440753,447964,263936,96027,1.24852e+06,26765,22527,29915,79207
18-02-2017,429026,423705,248239,82779,1.18375e+06,23245,19792,27499,70536
19-02-2017,401483,400183,244108,79764,1.12554e+06,23002,19065,25859,67926
20-02-2017,422715,444494,268612,93528,1.22936e+06,25599,21896,29972,77467
21-02-2017,430105,456504,273053,92149,1.25182e+06,26073,21887,30011,77971
22-02-2017,436896,464980,281384,93759,1.27702e+06,27265,22523,30734,80522
23-02-2017,448634,470301,276634,99140,1.29472e+06,25947,22284,30163,78394
24-02-2017,454354,474572,282002,94722,1.30565e+06,23605,21969,30672,76246
25-02-2017,438477,439058,267552,85695,1.23079e+06,23661,19833,26649,70143
26-02-2017,413138,420799,262270,83266,1.17948e+06,23711,19523,25770,69004
27-02-2017,431566,459116,280097,94248,1.26504e+06,26166,22193,30602,78961
28-02-2017,428699,451467,266138,95272,1.24159e+06,25514,21687,29506,76707
01-03-2017,431775,452847,258372,99646,1.24266e+06,25900,22365,30216,78481
02-03-2017,444472,452134,258381,100540,1.20762e+06,25647,21851,30097,77595
03-03-2017,441357,451697,267713,96713,1.25749e+06,25723,21604,30031,77358
04-03-2017,422576,421427,258990,85845,1.14086e+06,23308,19054,26131,68493
05-03-2017,426117,437560,256676,86894,1.20725e+06,23153,19256,25195,67604
06-03-2017,461425,489838,279992,99202,1.33047e+06,26369,22601,30811,79781
07-03-2017,470046,506460,279169,104391,1.30812e+06,27471,23022,31005,81498
08-03-2017,468175,492060,272940,103338,1.33652e+06,26443,22423,30805,79671
09-03-2017,447408,470341,266265,99810,1.28384e+06,26029,22041,31245,79315
10-03-2017,426817,444910,263807,92696,1.18086e+06,25393,21985,30648,78026
11-03-2017,404771,406710,245174,82577,1.13925e+06,22729,19759,26634,69122
12-03-2017,394730,406590,237346,82135,1.12082e+06,22607,19011,25916,67534
13-03-2017,426273,449484,255403,97871,1.22905e+06,25927,21773,30529,78229
14-03-2017,411749,436428,258615,95386,1.20218e+06,25871,21730,30045,77646
15-03-2017,403328,423896,249360,94070,1.17067e+06,24897,21502,29241,75640
16-03-2017,410434,425964,247143,94001,1.17755e+06,24696,21125,29637,75458
17-03-2017,406527,413387,255775,91221,1.16692e+06,25381,21355,29518,76254
18-03-2017,394150,396656,239025,84328,1.11417e+06,22486,18870,25160,66516
19-03-2017,401820,413135,235071,87498,1.13753e+06,21880,18259,23972,64111
20-03-2017,419542,444441,251818,96698,1.21251e+06,25434,21234,28444,75112
21-03-2017,408916,418465,253673,93637,1.1747e+06,24662,21091,28281,74034
22-03-2017,411606,428865,248694,94061,1.18324e+06,24433,20949,28016,73398
23-03-2017,419612,425775,245911,97078,1.14207e+06,24607,20832,28049,73488
24-03-2017,414832,419934,251038,92811,1.17862e+06,24619,20514,27241,72374
25-03-2017,376247,372092,236065,79480,1.0639e+06,22289,18720,24976,65985
26-03-2017,336378,341274,211635,77510,966807,20887,17245,23000,61132
27-03-2017,371372,391496,235840,91081,1.08979e+06,23918,20156,26688,70762
28-03-2017,379105,396054,235326,94319,1.10481e+06,24168,20265,27550,71983
29-03-2017,393866,419477,245143,96015,1.15451e+06,24560,20917,28602,74079
30-03-2017,408611,427878,247881,95431,1.17981e+06,24489,20734,28045,73268
31-03-2017,398070,406181,249354,89062,1.14267e+06,25195,20865,28241,74301
01-04-2017,357772,360177,232978,76841,1.02777e+06,22201,17638,23901,63740
02-04-2017,346520,347385,223185,77070,994166,20319,16577,22916,59812
03-04-2017,373255,393917,240897,90025,1.0981e+06,24118,20077,26649,70844
04-04-2017,376783,389698,235712,92499,1.09471e+06,23875,19770,27080,70725
05-04-2017,377660,391546,232943,89744,1.09190e+06,23773,19694,27353,70820
06-04-2017,387652,401574,233441,90844,1.11352e+06,23638,20092,27694,71424
07-04-2017,364660,381252,239468,85427,1.07081e+06,23779,20309,27554,71642
08-04-2017,344033,351889,227411,76308,999648,20975,18183,24138,63296
09-04-2017,339155,342662,216802,74564,973190,20186,17474,23477,61137
10-04-2017,359495,386288,231257,83954,1.06101e+06,22695,19922,26488,69105
11-04-2017,372553,403021,234922,87177,1.09768e+06,22982,20427,24726,68135
12-04-2017,363833,407428,242311,87131,1.10071e+06,23728,20782,27780,72290
13-04-2017,355685,407543,247482,75705,1.08643e+06,24453,20354,28378,73185
14-04-2017,360482,381154,236548,75329,1.00968e+06,21379,18019,28699,68097
15-04-2017,364783,375775,237503,79373,1.05744e+06,21082,18019,25659,63894
16-04-2017,361933,371815,228632,78332,1.04072e+06,21045,16335,21279,58659
17-04-2017,370865,379372,228947,78505,1.014e+06,23919,17327,23179,64425
18-04-2017,394008,421273,240751,91591,1.14764e+06,24446,20405,28495,73346
19-04-2017,393563,411612,234996,95294,1.13547e+06,24515,20498,29214,74227
20-04-2017,381506,399726,234002,90623,1.10586e+06,24182,20491,28973,73646
21-04-2017,372838,383031,233283,86084,1.07525e+06,23772,20289,28610,72671
22-04-2017,358345,358312,220150,78095,1.01491e+06,20762,18039,24417,63218
23-04-2017,356259,358877,214204,75388,1.00474e+06,20298,17493,24049,61840
24-04-2017,389010,399792,229367,85039,1.10321e+06,23138,19895,28269,71302
25-04-2017,388942,413386,232806,90789,1.12594e+06,24035,20687,28578,73300
26-04-2017,381684,401291,232990,95478,1.06849e+06,23291,20488,28332,72111
27-04-2017,386643,389658,232417,89249,1.09798e+06,23599,20175,28783,72557
28-04-2017,382290,385338,232756,91227,1.09164e+06,23166,20015,28692,71873
29-04-2017,347728,363800,219713,79856,1.01111e+06,21591,18470,25506,65567
30-04-2017,332555,348729,215345,74382,971019,20313,17317,23754,61384
01-05-2017,329672,330717,204767,79699,944866,19641,17417,23636,60694
02-05-2017,337807,354648,218937,86080,997485,22013,19348,27359,68720
03-05-2017,327576,354345,214194,87033,983153,22298,19427,27367,69092
04-05-2017,326955,350096,213149,84493,974689,22366,17517,27009,66892
05-05-2017,319468,344686,213937,85514,963613,22053,17620,27480,67153
06-05-2017,289502,303675,195353,75293,863836,18443,16743,24082,59268
07-05-2017,294050,314650,196739,72993,874378,18421,16284,22705,57410
08-05-2017,341088,384349,220120,82713,1.02727e+06,22027,18950,26858,67835
09-05-2017,354530,394240,218069,91223,1.05806e+06,22853,19372,28311,70536
10-05-2017,369277,395269,222045,94051,1.03859e+06,22978,19873,28768,71619
11-05-2017,365524,394564,221440,91856,1.03177e+06,23101,19815,28353,71269
12-05-2017,341900,367555,220940,72996,964995,22596,19696,27182,69474
13-05-2017,314107,323094,203554,72408,913166,19382,17651,23865,60898
14-05-2017,304120,316783,192342,72367,885613,18212,16314,23020,57546
15-05-2017,322882,362475,209431,85977,980772,21597,19183,27017,67797
16-05-2017,329300,355426,210509,88894,984138,22051,19067,27043,68161
17-05-2017,293612,350546,209132,89345,942643,21985,19134,27038,68157
18-05-2017,315048,327963,210096,86877,940019,21901,19206,27579,68686
19-05-2017,310934,317593,204506,84137,882844,21198,19045,27463,67706
20-05-2017,288035,284235,189946,71038,833260,17998,17046,24440,59484
21-05-2017,286886,286573,184527,70932,828936,17368,16221,23326,56915
22-05-2017,317261,334904,196767,86507,902016,20308,18504,26462,65274
23-05-2017,319602,334913,192777,88309,935621,20688,18755,26394,65837
24-05-2017,308972,329110,198834,84921,921846,19575,18613,26586,64774
25-05-2017,293924,292158,191582,73184,850888,20781,18764,26494,66039
26-05-2017,294891,302141,197397,77646,872083,20284,18631,26578,65493
27-05-2017,274288,283947,193309,72649,790796,17510,16367,23723,57600
28-05-2017,270538,279748,186093,71298,773712,17055,16133,23130,56318
29-05-2017,300809,326211,202745,88231,849716,20009,18449,26761,64314
30-05-2017,308768,329333,205156,89552,932839,20412,18688,27256,66356
31-05-2017,309965,332859,204272,84803,931905,21033,18933,27128,66212
01-06-2017,310536,334071,205094,85849,935555,20510,18617,26974,66101
02-06-2017,309624,322358,211875,86636,930952,21071,18062,27100,66233
03-06-2017,288236,287151,193853,74680,842069,18472,16177,23762,58411
04-06-2017,277922,283580,188480,71016,821005,17907,15823,22678,56408
05-06-2017,279190,307127,204743,72503,863571,21529,18629,26656,66814
06-06-2017,294647,286102,202219,85402,868371,21181,18642,27204,67027
07-06-2017,290519,323129,197384,89333,900374,20741,18668,27412,66821
08-06-2017,297217,333322,200537,86452,917535,21301,18638,27439,67378
09-06-2017,296151,321577,200090,84963,902780,18686,18372,27376,64434
10-06-2017,275553,284399,184244,71304,815510,17606,16624,24130,58360
11-06-2017,274848,287913,180879,70812,814466,17148,15739,23312,56199
12-06-2017,298115,326154,204419,84108,877682,20680,18322,27152,66154
13-06-2017,293666,322426,202516,84277,902904,21053,18708,27199,66960
14-06-2017,295903,321853,198520,85435,901720,20898,18556,27139,66593
15-06-2017,287958,318722,199163,87630,893479,20837,18537,27496,66870
16-06-2017,284272,309742,199733,84188,877942,20517,18547,27588,66652
17-06-2017,271356,278089,183213,71604,804268,17742,16451,24246,58439
18-06-2017,266550,274978,178684,72099,792318,17355,15965,23355,56675
19-06-2017,294220,323566,193375,89268,900435,20295,18476,27570,66341
20-06-2017,297878,316835,188914,87998,891632,20599,18449,27831,66879
21-06-2017,300362,325818,184320,88243,898752,20172,18297,27333,65802
22-06-2017,300918,319279,180155,90643,891009,18766,17967,27898,64631
23-06-2017,294605,267995,165611,86544,814772,15761,14851,27467,58079
24-06-2017,270638,259360,159647,72690,730786,15156,13606,23246,52008
25-06-2017,269190,267758,158391,71120,766460,15823,14561,22907,53291
26-06-2017,293894,311100,184970,83945,873917,19344,17251,26688,63283
27-06-2017,297229,326027,196133,86179,905578,19634,17699,27018,64351
28-06-2017,293549,320108,197064,85917,896640,19843,18013,27481,65337
29-06-2017,291772,325981,197845,87458,903059,19725,18085,28100,65910
30-06-2017,282904,315478,196061,84978,879438,20430,18216,27659,66305
01-07-2017,263484,278016,177804,71853,791160,17356,16170,23907,57433
02-07-2017,260653,271897,175606,70230,778398,16901,15421,23265,55587
03-07-2017,285034,319898,195965,84150,885052,19311,17579,26193,63083
04-07-2017,293871,316902,197427,86014,894214,19742,17852,27279,64873
05-07-2017,290924,323292,197999,86069,711140,19726,17954,26835,64515
06-07-2017,292463,321658,202159,86447,902743,19768,17759,23601,61128
07-07-2017,286738,308012,198982,84176,877915,19349,17399,25030,61778
08-07-2017,264765,275631,184603,71149,796154,16759,15532,23594,55885
09-07-2017,262620,271223,177878,69781,781513,16519,15072,23198,54789
10-07-2017,278228,304878,193824,84976,861916,19210,17589,26763,63562
11-07-2017,281548,300686,193427,85473,861139,19929,18387,28150,66466
12-07-2017,278838,295279,194611,85462,854195,19944,18182,27661,65787
13-07-2017,281489,301371,194412,83387,860664,19868,17904,27021,64793
14-07-2017,280783,292991,193661,80492,847939,18928,17512,26482,62922
15-07-2017,264798,267188,182327,69864,784191,16533,15602,23530,55665
16-07-2017,254387,259761,177128,68615,728026,16164,15234,22730,54128
17-07-2017,275361,283432,192699,76001,827501,18704,17727,25845,62276
18-07-2017,275494,281649,190401,77432,792359,19011,18256,26081,63348
19-07-2017,272725,288415,191833,77764,830745,19020,18205,26427,63652
20-07-2017,268351,283297,189341,78278,819281,19079,18213,26175,63467
21-07-2017,268549,283268,191095,77868,820783,18620,18088,26752,63460
22-07-2017,256907,259546,181318,67725,765503,16599,15603,24068,56270
23-07-2017,248148,254084,175969,68378,746591,16083,15338,23527,54948
24-07-2017,267676,283317,191824,77246,820059,18746,18017,27058,63821
25-07-2017,268573,278945,193202,76741,817467,19177,18536,27420,64203
26-07-2017,269313,285534,190600,77012,822470,19452,18572,27917,65941
27-07-2017,270217,278932,192489,77745,819393,19614,18923,27342,65879
28-07-2017,269178,279045,196616,75167,820025,19466,18583,27211,65260
29-07-2017,259622,259321,180593,69256,768796,16292,16205,23851,56348
30-07-2017,256167,261542,178022,69734,765480,16117,15798,23600,55515
31-07-2017,273727,280987,194566,79710,727233,19327,18910,27786,66023
01-08-2017,276824,280381,191470,81339,829989,19340,18980,28200,66520
02-08-2017,273428,282431,193996,81480,831345,19655,18864,28907,67426
03-08-2017,281128,281419,191262,84090,837903,19901,18815,28587,67303
04-08-2017,273853,274818,196717,80827,826217,19877,18469,28373,66719
05-08-2017,262417,265256,181314,70403,779398,17216,16184,24946,58346
06-08-2017,260697,263490,181048,69145,774392,16779,15758,24255,56792
07-08-2017,288997,297656,201071,84628,872361,19628,18289,27653,65570
08-08-2017,290827,299302,201707,86444,878283,19986,18540,28466,66992
09-08-2017,294376,305937,200511,88814,889650,20035,19046,28974,68055
10-08-2017,289365,309642,199734,88614,887359,20199,19327,30221,69747
11-08-2017,288341,297677,197597,85560,869193,19795,19093,29723,68611
12-08-2017,270943,269024,183691,73718,797379,16964,17486,26569,61019
13-08-2017,272280,265296,181203,71157,789938,16053,16123,25034,57210
14-08-2017,297401,318040,199842,86914,902206,19280,18512,27051,64843
15-08-2017,302074,318925,200749,87638,909394,19982,18983,25196,64161
16-08-2017,293985,327828,203640,89502,914967,20878,19419,29225,69522
17-08-2017,296276,320556,203461,89744,910043,20976,19582,29848,70406
18-08-2017,292691,321504,204931,87471,906611,20730,19188,29873,69791
19-08-2017,271597,276681,188545,74737,811565,18210,17536,26660,62406
20-08-2017,270541,282285,177953,73398,804177,17894,16180,25553,59627
21-08-2017,293712,326480,201866,88166,910241,20626,18517,28553,67696
22-08-2017,302944,322272,202466,92064,919759,21113,18741,28560,68414
23-08-2017,300253,327597,202253,93734,923843,21259,18774,28152,68185
24-08-2017,304003,336099,203468,90366,933942,21329,18771,27960,68060
25-08-2017,298362,328310,210342,86592,923620,21354,18528,28328,68210
26-08-2017,283439,295652,199851,76285,855238,18308,16782,25644,60734
27-08-2017,277634,289503,195983,74738,837867,17721,16075,25100,58896
28-08-2017,302678,329416,212503,90353,934962,20853,18799,28761,68413
29-08-2017,299059,320856,210303,90707,920939,21202,19106,29048,69356
30-08-2017,301920,329676,210176,91860,933651,21332,19433,28616,69381
31-08-2017,303957,330848,210218,90665,935697,21466,19236,28749,69451
01-09-2017,301238,321325,208387,86696,917645,21027,18561,28724,68312
02-09-2017,282366,294792,200603,75315,853085,18544,16942,25847,61333
03-09-2017,277011,294585,194930,74756,841290,17736,16396,24981,59113
04-09-2017,302490,342554,214102,88827,912813,21065,19258,28791,69114
05-09-2017,305668,344065,213130,90790,953586,21478,19240,29106,69824
06-09-2017,303741,343695,217545,92527,957519,21751,19223,29361,70335
07-09-2017,308062,350143,220039,91929,970177,22229,19278,29386,70893
08-09-2017,309522,341943,217385,87732,956586,21950,19045,29177,70172
09-09-2017,290617,310779,204638,77059,883105,19300,16928,25904,62132
10-09-2017,284254,285246,194180,74973,838664,18609,16760,25957,61326
11-09-2017,305542,333162,206662,89348,934718,21243,19315,30050,70608
12-09-2017,308151,342304,210403,90034,950902,21854,19730,30546,72130
13-09-2017,309431,349009,211471,91049,960969,21556,19405,29592,70553
14-09-2017,316226,351976,212995,90937,972138,21983,19617,29275,70875
15-09-2017,313284,334366,213941,87072,948679,21437,19141,29299,69877
16-09-2017,294030,307377,200195,77186,878789,19098,16904,25841,61843
17-09-2017,292420,305369,191936,76637,866368,18315,16641,25865,60821
18-09-2017,311336,349227,212121,91082,963772,21942,20348,29557,71847
19-09-2017,314849,356366,211133,91794,974143,21581,20199,29661,71441
20-09-2017,321236,361209,211853,92062,986368,21592,20066,29433,71091
21-09-2017,326080,364333,208053,91956,990430,21749,20423,29524,71696
22-09-2017,322101,351929,212453,88611,975100,21693,19803,28701,70197
23-09-2017,300291,318283,199022,77752,895354,18895,17136,24793,60824
24-09-2017,291603,308523,194120,76796,871044,18614,16643,24064,59321
25-09-2017,311819,346014,214846,90891,963590,21541,19502,28429,69472
26-09-2017,314629,331172,218740,91798,956354,21939,19896,29071,70906
27-09-2017,313488,331533,219239,92257,956527,22004,20191,29138,71333
28-09-2017,318993,327238,218557,92565,957351,22388,20515,29366,72269
29-09-2017,321665,332893,222291,89331,966199,22368,20167,28995,71530
30-09-2017,303703,301090,211533,79239,895574,20052,18092,25607,63751
01-10-2017,303407,302866,205649,78317,890245,19714,17697,24964,62375
02-10-2017,326093,341447,220035,94197,945950,22922,20507,28393,71822
03-10-2017,328877,337538,223866,93669,983953,23805,21461,30266,75532
04-10-2017,338365,346907,216440,97059,998778,23280,20963,30055,74298
05-10-2017,345553,354614,220365,96737,1.01728e+06,23043,20849,29483,73375
06-10-2017,338800,349748,222706,91190,1.00245e+06,22956,20481,29200,72637
07-10-2017,324192,324353,211632,81801,941986,20136,18001,25623,63760
08-10-2017,322653,323808,203939,78073,928486,19772,17645,24955,62372
09-10-2017,354223,365930,216691,92733,1.02958e+06,23433,20678,29584,73695
10-10-2017,359929,370294,217988,95156,1.04338e+06,24072,21218,30039,75329
11-10-2017,356878,369084,222132,96201,1.0443e+06,24034,21075,29760,74869
12-10-2017,347267,361128,226807,96325,1.03153e+06,24377,21415,30201,75993
13-10-2017,355271,359710,224822,92640,995259,23671,20972,29539,74182
14-10-2017,320818,313877,209696,79638,888094,20698,18440,26793,65931
15-10-2017,318243,311414,204447,78573,912680,19573,17507,24897,61977
16-10-2017,332940,344800,220904,92027,990674,23344,20878,29586,73808
17-10-2017,342772,353482,225159,92411,1.01383e+06,23960,20940,30156,75056
18-10-2017,349368,361873,227211,93162,1.03162e+06,23233,20912,29462,73607
19-10-2017,370860,380605,234405,92371,1.07824e+06,23499,20814,29514,73827
20-10-2017,369303,381853,243734,90169,1.08506e+06,23995,21058,29885,74938
21-10-2017,345615,345142,233745,80136,1.00465e+06,21580,18720,26896,67196
22-10-2017,344928,346980,230201,79888,1.002e+06,21477,18784,26129,66390
23-10-2017,382522,394451,253738,94113,1.12484e+06,24817,21672,30671,77160
24-10-2017,390115,391755,258535,97322,1.13774e+06,25811,21805,31061,78677
25-10-2017,376564,385570,253160,96854,1.11216e+06,26110,22134,31706,79950
26-10-2017,372004,383901,253465,97507,1.10688e+06,26223,21661,30678,78562
27-10-2017,371422,376846,249097,94845,1.09222e+06,25859,21300,30671,77830
28-10-2017,347597,341957,230880,83920,1.00436e+06,22375,19144,26847,68366
29-10-2017,371441,372485,234416,85710,1.06407e+06,22154,19121,26262,67537
30-10-2017,405203,419816,248232,98104,1.17136e+06,25575,21919,29919,77413
31-10-2017,396303,416165,252083,99321,1.16389e+06,25927,21695,29908,77530
01-11-2017,382520,395437,257806,98501,1.13426e+06,26537,22089,25494,74120
02-11-2017,379979,389136,255540,97771,1.12244e+06,26254,22140,30529,78923
03-11-2017,390332,392419,249065,95096,1.12692e+06,25882,21792,30251,77925
04-11-2017,364242,351765,222541,83383,1.02194e+06,22369,19304,26679,68352
05-11-2017,355552,352599,213275,82841,1.00428e+06,21218,18662,25934,65814
06-11-2017,398262,397128,233144,97645,1.12586e+06,24665,21646,31715,78026
07-11-2017,409315,414220,244282,100364,1.16819e+06,24072,21791,32862,78725
08-11-2017,393794,420868,243792,99578,1.11592e+06,25608,22051,31018,78677
09-11-2017,386712,403952,238151,100812,1.12964e+06,25824,22344,31717,79885
10-11-2017,404753,408355,239678,99399,1.10889e+06,25096,21768,31127,77991
11-11-2017,397534,378831,227808,86249,1.09043e+06,22173,19197,26777,68147
12-11-2017,396125,393697,223670,84533,1.09804e+06,22002,18718,26051,66771
13-11-2017,429047,444257,246123,101113,1.22055e+06,25558,22022,31795,79375
14-11-2017,435436,455217,249606,103131,1.2434e+06,25970,22020,32010,80000
15-11-2017,423493,441072,247847,100912,1.21334e+06,26039,22338,32042,80419
16-11-2017,426107,438632,251316,103337,1.0774e+06,26038,22155,31372,79565
17-11-2017,419608,420180,247968,98298,1.18606e+06,25971,21847,31115,78933
18-11-2017,409725,386062,236448,88326,1.12178e+06,22881,18792,27573,69246
19-11-2017,414645,414980,231560,87757,1.14895e+06,22764,18639,26726,68129
20-11-2017,464701,481650,252481,102629,1.30147e+06,25990,19516,31476,76982
21-11-2017,477553,485279,258589,105265,1.3267e+06,26608,22101,32510,81219
22-11-2017,487442,477281,259068,104240,1.32736e+06,27566,22924,32645,83135
23-11-2017,435692,424324,262610,102964,1.2256e+06,27804,22940,32161,82905
24-11-2017,431651,413575,250327,99173,1.15003e+06,26464,22490,31965,80919
25-11-2017,418967,404033,234997,90242,1.14825e+06,23474,19821,28141,71436
26-11-2017,408404,398814,233107,89565,1.1299e+06,23243,19089,26493,68825
27-11-2017,453508,437844,251874,104104,1.24734e+06,26216,22098,31596,79910
28-11-2017,463045,458163,253392,105285,1.2799e+06,26387,22557,32192,81136
29-11-2017,468163,468982,255279,106957,1.2994e+06,26976,22777,32894,82647
30-11-2017,481424,469037,252449,108837,1.31176e+06,26761,23140,33534,83435
01-12-2017,479908,468935,259489,104279,1.31263e+06,27203,22676,32773,82652
02-12-2017,445733,419396,244146,92082,1.20136e+06,24127,19924,28639,72690
03-12-2017,429584,399733,230376,90449,1.15014e+06,23494,19361,27557,70412
04-12-2017,466845,473308,256084,106242,1.30248e+06,26681,22700,32872,82253
05-12-2017,454534,467783,264986,103597,1.29091e+06,27228,22566,32397,82191
06-12-2017,445521,465212,254221,103925,1.26888e+06,27123,22599,33017,82739
07-12-2017,427712,445954,271760,104186,1.24961e+06,27639,23021,32856,83516
08-12-2017,437027,443773,262253,101999,1.24506e+06,26503,22689,32381,81573
09-12-2017,424830,415754,240422,92577,1.17359e+06,23616,20279,28615,72510
10-12-2017,446465,429444,234464,93051,1.20343e+06,23611,19758,27541,70910
11-12-2017,478127,476220,258013,109110,987273,27200,22605,32326,82131
12-12-2017,489165,481266,261847,109033,1.34132e+06,27705,22685,31720,82110
13-12-2017,489972,482728,262796,107843,1.34334e+06,27498,22672,32357,82527
14-12-2017,486431,478843,265131,108578,1.33899e+06,27712,23031,33142,83885
15-12-2017,485540,470899,266130,105102,1.32768e+06,27586,23016,32479,83081
16-12-2017,471801,441070,252542,95319,1.26075e+06,24523,20728,29381,74632
17-12-2017,476876,463617,247469,95462,1.28343e+06,23999,20099,28102,72200
18-12-2017,484514,493492,266060,108860,1.35294e+06,27268,22957,33046,83271
19-12-2017,476106,477893,264473,107955,1.32644e+06,26931,23263,33167,83361
20-12-2017,450874,460319,257071,104923,1.2732e+06,27538,23005,33260,83803
21-12-2017,458720,460266,253131,99913,1.27203e+06,27318,23288,33199,83805
22-12-2017,455809,456665,255699,95067,1.26325e+06,26350,21897,31568,79815
23-12-2017,410667,404073,237089,86137,1.13797e+06,23799,19672,28482,71953
24-12-2017,408280,380576,230380,82476,1.10172e+06,22454,18366,25504,66324
25-12-2017,411373,386422,230542,78034,1.10639e+06,22280,17623,23801,63704
26-12-2017,417954,401729,232710,82112,1.13451e+06,21776,18075,24653,64504
27-12-2017,444623,437779,246624,95826,1.22485e+06,24128,20654,29215,73997
28-12-2017,452013,434616,254946,99067,1.24065e+06,24467,20902,28665,74034
29-12-2017,453293,429921,253481,95393,1.2321e+06,24433,20894,32080,77407
30-12-2017,447796,423239,241130,95845,1.15968e+06,22843,19145,31514,73502
31-12-2017,438228,405661,237444,92396,1.17373e+06,22463,18624,31155,72242
01-01-2018,420628,395601,240677,82283,1.13921e+06,20840,17010,27836,65686
02-01-2018,453387,437498,256824,97792,1.24551e+06,24329,20491,33880,78700
03-01-2018,470349,449380,257788,104997,1.28252e+06,25598,21978,35619,83195
04-01-2018,466056,466901,262665,105990,1.30162e+06,26027,22352,36019,84398
05-01-2018,470882,461843,262404,104428,1.29956e+06,25705,22295,35862,83862
06-01-2018,464448,444727,246793,94299,1.25027e+06,23399,19728,32266,75393
07-01-2018,469121,456062,252089,95397,1.27268e+06,23389,19191,31626,74206
08-01-2018,480008,485897,275098,109543,1.35056e+06,27032,22294,36616,85942
09-01-2018,487467,483181,272630,102655,1.34594e+06,27181,22580,37096,86857
10-01-2018,489755,500907,278612,106295,1.37558e+06,27546,22877,38066,88489
11-01-2018,476834,488453,285564,106837,1.3577e+06,28134,23407,38510,90051
12-01-2018,476711,486038,290233,103216,1.35622e+06,28615,23238,38177,90030
13-01-2018,457175,450983,267725,92467,1.26836e+06,26466,21458,34042,81966
14-01-2018,453704,448226,254700,91686,1.24833e+06,26061,21195,33888,81144
15-01-2018,488175,492745,281607,105157,1.3677e+06,30263,24267,39016,93546
16-01-2018,472776,488899,290555,107186,1.35941e+06,29363,24406,39293,93062
17-01-2018,471261,489727,292618,108401,1.36202e+06,31289,24974,39561,95824
18-01-2018,485022,489454,287086,108791,1.37034e+06,30229,24491,38326,93046
19-01-2018,486455,489413,291614,104992,1.37248e+06,29220,23614,38154,90988
20-01-2018,463525,457329,280018,92733,1.29362e+06,26163,21024,34393,81580
21-01-2018,459408,462883,280282,91731,1.2943e+06,24878,20219,33320,78417
22-01-2018,498753,511697,305235,106537,1.42225e+06,28594,23950,38703,91247
23-01-2018,488805,509019,310739,106571,1.41515e+06,28854,24383,39552,92789
24-01-2018,459999,459666,293795,102579,1.31605e+06,29165,24659,39870,93694
25-01-2018,449510,443627,270480,101672,1.2653e+06,27879,23540,38622,90041
26-01-2018,459341,443759,267824,101276,1.27222e+06,26878,23241,37516,87635
27-01-2018,458604,416397,254582,89908,1.2195e+06,24018,20548,33806,78372
28-01-2018,436477,419512,252742,85573,1.19430e+06,23899,20090,32800,76789
29-01-2018,467007,461222,271394,100157,1.29981e+06,26856,22607,36891,86354
30-01-2018,472668,472828,277033,110823,1.33338e+06,27842,22795,37168,87805
31-01-2018,462673,467688,281834,105514,1.31773e+06,27775,22833,37051,87659
01-02-2018,465488,466473,287101,104112,1.32321e+06,27758,23202,37634,88594
02-02-2018,495489,489327,275574,104372,1.36477e+06,26941,22818,36933,86692
03-02-2018,488519,474548,277138,96753,1.33696e+06,24850,20394,32984,78228
04-02-2018,486469,477300,287009,93204,1.344e+06,25123,20075,32495,77693
05-02-2018,509026,540844,307040,110203,1.46712e+06,28869,23593,37812,90274
06-02-2018,503304,537795,306538,113656,1.4613e+06,29377,23779,38308,91464
07-02-2018,500173,524299,300264,112209,1.43696e+06,29103,23742,37719,90564
08-02-2018,493560,502484,295214,111052,1.40232e+06,29641,24238,38233,92112
09-02-2018,475068,488523,290512,107463,1.36157e+06,30436,23929,38450,92815
10-02-2018,449829,455362,272057,97283,1.27454e+06,27136,21644,34659,83439
11-02-2018,446541,449089,268779,92520,1.25694e+06,25750,20856,33519,80125
12-02-2018,477704,484457,284339,103921,1.35043e+06,28477,23357,37614,89448
13-02-2018,478291,474160,276324,107920,1.3367e+06,28409,23177,37493,89079
14-02-2018,466032,471526,266811,106523,1.3109e+06,28249,22992,37555,88796
15-02-2018,473555,476558,274039,106544,1.3307e+06,29286,23522,37433,90241
16-02-2018,469717,474981,284538,100441,1.32968e+06,28951,23291,32710,84952
17-02-2018,451978,433546,275290,91411,1.25223e+06,26124,20640,32475,79239
18-02-2018,439624,431650,275625,89680,1.23659e+06,25336,20159,32380,77875
19-02-2018,472224,484141,302226,105168,1.36379e+06,28839,23332,36783,88954
20-02-2018,481128,503198,308590,105451,1.39837e+06,30009,23676,37445,91130
21-02-2018,482002,513588,311614,106710,1.41392e+06,31128,24328,38188,93644
22-02-2018,481616,511573,313278,106715,1.41319e+06,31290,24624,39191,95105
23-02-2018,477937,500699,311710,104874,1.34175e+06,29802,24647,39710,94159
24-02-2018,457640,478743,303690,91778,1.33187e+06,27520,22156,35756,85432
25-02-2018,460651,484225,285238,94266,1.32438e+06,27456,21979,35401,84836
26-02-2018,506836,532216,298716,108202,1.44597e+06,31213,24661,40245,96119
27-02-2018,514598,556956,316301,112721,1.50059e+06,32301,24667,40859,97827
28-02-2018,530676,581538,321620,116178,1.55002e+06,32847,25212,41312,99371
01-03-2018,529751,548040,313460,116267,1.50754e+06,31989,25051,40999,98039
02-03-2018,520734,533314,308019,112984,1.47506e+06,30679,24044,39517,94240
03-03-2018,485228,483163,291945,100856,1.3612e+06,26756,21526,36568,84850
04-03-2018,464953,464996,283233,95869,1.30906e+06,26739,20924,34448,82111
05-03-2018,498228,503217,300317,109017,1.41078e+06,29900,23522,39018,92440
06-03-2018,496524,486310,296842,107260,1.38695e+06,29763,23070,37831,90664
07-03-2018,485176,486982,293500,108358,1.37403e+06,29391,23431,38334,91156
08-03-2018,477835,486309,294153,109149,1.31575e+06,29316,23279,37856,90451
09-03-2018,473079,473653,281350,106362,1.33444e+06,28494,22759,36323,87576
10-03-2018,449242,443789,259207,94419,1.24667e+06,25171,20219,32585,77975
11-03-2018,450431,437104,251146,94178,1.23287e+06,24135,19446,31279,74860
12-03-2018,469878,467817,271468,106174,1.31535e+06,27356,21791,35415,84562
13-03-2018,458471,467272,266005,107647,1.29941e+06,27133,21997,36117,85247
14-03-2018,462197,473809,272003,107629,1.31564e+06,27663,22311,36004,85978
15-03-2018,468100,492662,282775,110372,1.35391e+06,27792,22408,36397,86597
16-03-2018,484959,505284,291884,109904,1.39204e+06,28322,22861,36833,88016
17-03-2018,468386,470077,277538,100508,1.31651e+06,25514,20682,33455,79651
18-03-2018,456259,450009,256010,95931,1.25821e+06,24351,19932,32325,76608
19-03-2018,464909,471167,266675,105581,1.30834e+06,27272,22341,35923,79570
20-03-2018,449628,458767,275046,102885,1.28634e+06,27630,22440,36188,86258
21-03-2018,446277,448637,282129,105659,1.28271e+06,28019,22508,36057,86584
22-03-2018,437283,445514,267223,106380,1.2564e+06,27510,22504,36667,86681
23-03-2018,441023,439148,276434,103268,1.25986e+06,27215,21725,35763,84703
24-03-2018,401748,407997,263534,91222,1.16452e+06,24494,19593,31935,76022
25-03-2018,375030,373236,236522,84773,1.06956e+06,22929,18343,29301,70573
26-03-2018,430716,453495,272397,99235,1.25585e+06,26829,21832,35113,83774
27-03-2018,441398,474178,279642,102402,1.29764e+06,27023,22045,35432,84500
28-03-2018,434230,469735,277315,103835,1.28512e+06,27337,22032,35727,85096
29-03-2018,417530,454499,271468,92758,1.23627e+06,26574,21603,36077,84254
30-03-2018,413935,414419,253801,88147,1.17031e+06,23403,19852,35862,79117
31-03-2018,409110,397592,250554,87145,1.14441e+06,22793,18889,31612,73294
01-04-2018,399574,396167,244859,83638,1.12424e+06,21985,18169,28201,68355
02-04-2018,411875,397025,248045,84142,1.14109e+06,26192,18847,28741,73780
03-04-2018,444179,439256,260617,99908,1.24397e+06,25566,21069,34073,80708
04-04-2018,433782,421420,261299,94799,1.21131e+06,25674,21338,33593,80605
05-04-2018,426102,407852,252304,96847,1.18312e+06,24704,21046,33126,78876
06-04-2018,408919,408805,251340,93883,1.16298e+06,24842,21294,33256,79392
07-04-2018,391851,367469,234090,82756,1.07617e+06,21788,18437,29492,69717
08-04-2018,384650,349985,226896,78999,1.04054e+06,20865,17250,27625,65740
09-04-2018,410469,386736,241742,91811,1.13076e+06,23285,19886,30565,73736
10-04-2018,400511,389952,240238,91525,1.12224e+06,24384,20490,31090,75964
11-04-2018,390460,400791,239410,94741,1.12541e+06,23959,20432,31247,75638
12-04-2018,382316,388759,238678,93150,1.10291e+06,24092,20271,31067,75430
13-04-2018,366892,366270,233730,89014,1.05592e+06,23733,19894,30945,74572
14-04-2018,337124,330099,210234,80660,958132,20410,17627,27248,65285
15-04-2018,324402,331548,205707,80937,942603,19818,17064,26085,62967
16-04-2018,357489,443545,223498,93701,1.11824e+06,22618,19561,30509,72688
17-04-2018,354794,375778,226245,92927,1.04975e+06,23344,20393,31400,75137
18-04-2018,348108,364372,225001,90094,1.02758e+06,23273,19901,31117,74291
19-04-2018,341582,356992,218312,90224,1.00712e+06,23168,19958,31271,74397
20-04-2018,342518,340526,220716,85189,988954,22751,19618,30594,72963
21-04-2018,329628,313414,208992,75049,927092,20015,18120,27445,65580
22-04-2018,330827,318119,210208,76215,935374,19870,16761,26715,63346
23-04-2018,359791,367367,225950,88688,1.0418e+06,23032,19275,31042,73349
24-04-2018,360515,376117,226899,90684,1.05422e+06,22938,19660,31923,74521
25-04-2018,357862,374409,221525,91895,1.04611e+06,23257,20192,32752,76201
26-04-2018,359420,370073,222705,89164,1.04137e+06,23016,19950,32470,75436
27-04-2018,357224,367415,224273,76817,1.02573e+06,22937,19724,32086,74747
28-04-2018,341140,336611,210818,77108,965681,19747,17358,28677,65782
29-04-2018,334269,332632,206617,76334,949862,18836,16432,27639,62907
30-04-2018,352502,353436,216722,88651,1.01132e+06,20848,17453,30388,68689
01-05-2018,352714,346210,208584,86090,993597,19320,16914,27999,64233
02-05-2018,353718,370093,226788,93299,1.04391e+06,22584,19044,32085,73713
03-05-2018,352845,368189,220621,94499,1.03616e+06,22627,18983,32283,73893
04-05-2018,354711,353800,225951,88066,1.02254e+06,22276,16631,31699,70606
05-05-2018,318124,311739,208942,76419,915222,19088,16071,28609,63768
06-05-2018,303613,301080,194915,74922,874536,17760,16182,27673,61615
07-05-2018,328730,333778,208064,89133,959918,21298,18991,31526,71815
08-05-2018,323192,327910,201611,90777,943494,20723,18926,32184,71833
09-05-2018,308570,326235,208161,90766,934074,20487,19088,32224,71799
10-05-2018,294554,308483,198872,79043,880957,20982,19023,32503,72508
11-05-2018,310840,315909,203351,78822,908956,20727,18908,32043,71678
12-05-2018,294425,296123,190159,74126,854838,17667,16732,28619,63018
13-05-2018,286627,295075,179581,74775,836060,16893,16304,27916,61113
14-05-2018,304337,328031,196141,89514,916910,20742,19042,31661,71445
15-05-2018,302393,328619,192676,90161,913911,21073,19298,32314,72685
16-05-2018,302001,326147,192180,93397,914101,21007,19239,31922,72168
17-05-2018,288586,327572,192906,92093,901161,21123,19479,32155,72757
18-05-2018,301828,321277,197601,88136,908841,20782,18927,31682,71391
19-05-2018,285298,283249,185094,75943,829591,17681,16649,28175,62505
20-05-2018,275130,276869,177938,73511,803448,17215,15951,27330,60496
21-05-2018,280143,322789,193270,78391,874212,20545,18948,31092,70585
22-05-2018,306383,319061,195223,91509,912603,21053,19124,31387,71564
23-05-2018,306754,323414,195947,92955,919077,20691,19548,31518,71757
24-05-2018,298061,319475,197144,95066,909753,19999,20140,31666,71805
25-05-2018,293531,311532,199296,89990,894355,20807,19087,32167,72061
26-05-2018,275172,282779,180719,77679,816688,18113,17132,29458,64703
27-05-2018,270889,277012,178576,76573,803054,17520,16675,28435,62630
28-05-2018,292135,321407,197791,91398,868513,20456,19378,32968,72802
29-05-2018,289509,318880,197279,93406,899079,20784,19924,33589,74297
30-05-2018,287549,322573,194062,93353,897538,20823,19999,33940,74762
31-05-2018,286845,318843,196036,92627,859966,20669,19495,33033,73197
01-06-2018,286144,310275,199810,89828,885412,20549,19101,32407,72057
02-06-2018,271239,273086,183157,78395,805505,17563,16834,28514,62911
03-06-2018,267938,273001,179273,77178,797395,16997,16367,27431,60795
04-06-2018,292358,328366,200996,89321,909235,20329,19243,31912,71484
05-06-2018,300721,328027,206213,82591,881636,20260,18742,31075,70077
06-06-2018,301513,301461,204919,91651,899193,20757,18839,31179,70775
07-06-2018,297194,315585,210096,92459,915336,20843,19050,31426,71319
08-06-2018,295208,314145,207982,90520,908279,20448,18913,31440,70801
09-06-2018,273264,283237,192093,78736,827331,17745,16480,28163,62388
10-06-2018,272208,274653,184903,78160,809850,17080,16433,27365,60878
11-06-2018,297599,316702,198611,92044,904510,20520,19214,31867,71601
12-06-2018,302312,320159,199268,92503,914251,21056,19261,31738,72055
13-06-2018,301793,325044,204243,93046,924137,20861,18926,32207,71994
14-06-2018,296216,311839,202768,93632,904454,21009,19060,32524,72593
15-06-2018,291742,307435,198180,87498,884865,20827,19365,32266,72458
16-06-2018,273863,278802,184270,76326,813269,17880,16977,28665,63522
17-06-2018,273093,281803,179324,75235,809455,17272,16467,27813,61552
18-06-2018,297565,321900,195264,88645,868801,20132,19168,32703,72003
19-06-2018,297741,320739,191554,89542,899606,20520,18771,32723,72014
20-06-2018,304330,329866,187233,92073,913509,20406,18859,32494,71759
21-06-2018,306892,318159,185525,89655,900238,20623,19409,32799,72831
22-06-2018,301519,274886,173986,89025,839419,18926,18142,31704,68772
23-06-2018,286741,265678,166362,78302,797089,15904,15039,27943,58886
24-06-2018,274847,267712,165578,75377,783521,15870,14323,26721,56914
25-06-2018,295632,309903,187184,90410,883128,19654,17917,31157,68728
26-06-2018,296671,317400,194146,91262,899485,19892,18510,31704,70106
27-06-2018,294776,321922,199886,92223,874246,20179,18885,32350,71414
28-06-2018,294511,316304,201779,92582,905181,20391,18804,32887,72082
29-06-2018,289591,313266,205656,88020,896539,20067,18459,32161,70687
30-06-2018,271471,277980,191417,77622,818495,17123,16176,27727,61026
01-07-2018,264093,279401,184481,75745,803725,16799,15733,26833,59365
02-07-2018,280421,317897,202132,89763,890215,20382,18393,31040,69815
03-07-2018,283732,308637,203956,91571,887900,20558,18650,31787,70995
04-07-2018,286081,315780,204631,90961,897464,20363,18615,31530,70508
05-07-2018,285166,314481,204839,90829,895319,20312,18378,30689,69379
06-07-2018,280969,308396,202764,88757,880896,20247,18361,27217,65825
07-07-2018,265533,270220,187286,77202,800250,17173,16409,27108,60690
08-07-2018,259896,269213,183084,75718,787918,16407,15777,27007,59191
09-07-2018,280115,300068,198669,89434,834562,19463,16960,31061,67484
10-07-2018,278623,301614,195694,89193,760395,19606,19060,32165,70831
11-07-2018,278039,299325,197251,90058,864682,19765,19266,32447,71478
12-07-2018,275399,296198,196471,89866,857939,19924,19376,32550,71850
13-07-2018,277037,291764,196397,85403,850610,19820,19048,31950,70818
14-07-2018,260579,259668,185022,72883,778149,17057,16469,28636,62162
15-07-2018,256691,258602,182391,72333,770023,16663,16092,27812,60567
16-07-2018,271227,282404,199662,82735,836028,19404,19065,31909,70378
17-07-2018,269113,281832,200119,85098,836164,19975,19523,32844,72342
18-07-2018,268572,284052,195928,84628,833186,19252,19697,33236,72185
19-07-2018,267850,278351,194983,81876,823071,19697,19432,32558,71687
20-07-2018,269520,279128,193571,79633,821858,19473,19421,32586,71480
21-07-2018,256743,255302,189261,72195,773504,17475,17163,29238,63876
22-07-2018,252619,252078,183359,71643,759703,16491,16666,28179,61336
23-07-2018,271596,278758,198467,80479,829305,18931,19266,32107,70304
24-07-2018,272039,277242,200172,83377,832834,19909,19579,32437,71925
25-07-2018,267326,280463,201785,84740,834317,20094,19446,32579,72119
26-07-2018,269469,282677,201963,85039,839157,20479,19493,33141,73113
27-07-2018,267133,280998,204041,82978,835158,20191,19248,32735,72174
28-07-2018,253277,260535,192268,76200,782284,18050,17468,29877,65395
29-07-2018,246991,254621,186750,73089,761453,18065,17136,29066,64267
30-07-2018,269658,278351,200575,84906,833491,20842,20013,33068,73923
31-07-2018,272819,281303,205376,86372,845870,21205,20262,33661,75128
01-08-2018,270722,287586,204626,86451,849393,21100,20348,33771,75219
02-08-2018,275441,282989,208690,87111,854238,21144,20392,34136,75672
03-08-2018,272512,282216,205476,85680,845891,20735,20254,33865,74854
04-08-2018,258436,254857,190334,75995,779627,17739,17542,30077,65358
05-08-2018,251900,254304,184701,74355,765265,17022,16963,28703,62688
06-08-2018,282021,296978,200812,88932,838417,20071,19363,32460,71894
07-08-2018,284467,297551,201222,91634,874882,20452,19315,32805,72572
08-08-2018,287164,307876,205048,92982,893071,20685,20025,33417,74127
09-08-2018,282959,306565,209469,91011,890009,21368,20503,33740,75611
10-08-2018,283564,298924,211754,87675,848875,21203,20355,33261,74819
11-08-2018,265230,268229,192785,72995,799246,17895,17253,29147,64295
12-08-2018,271560,273956,189378,71039,805936,16935,16195,27358,60488
13-08-2018,297879,313241,207029,87793,905947,19868,18852,31234,69954
14-08-2018,297369,313327,207685,88559,906946,20250,19188,31798,71236
15-08-2018,295212,312741,209561,88190,905705,20882,19333,28321,68536
16-08-2018,291866,313956,212348,90099,908279,20995,19346,31346,71687
17-08-2018,284475,306690,212931,85606,889703,20835,19542,31776,72153
18-08-2018,272324,274646,193649,74519,815363,17872,17462,29067,64401
19-08-2018,271353,280592,189509,73709,808326,17212,16630,28101,61943
20-08-2018,300352,313971,208327,86688,907061,17779,19418,32845,70042
21-08-2018,301749,317820,207363,86743,913679,20068,19180,32677,71925
22-08-2018,302973,326330,209146,88884,927343,19679,18903,32423,71005
23-08-2018,297012,324968,210193,90255,922436,20460,19082,32621,72163
24-08-2018,299076,322708,211042,85447,918280,20580,19388,31773,71741
25-08-2018,284110,285064,193042,72799,835025,17927,17089,28982,63998
26-08-2018,278945,282370,191306,71300,823925,17062,16391,27514,60967
27-08-2018,310604,324048,207264,88425,930341,19998,18783,31288,70069
28-08-2018,306772,327496,208986,87394,930650,20685,18974,31995,71654
29-08-2018,307830,326319,207519,87488,929162,20866,19303,32225,72394
30-08-2018,299846,329902,209990,88746,928489,21002,19368,32284,72654
31-08-2018,301796,327059,210997,84760,924617,20520,19142,32135,71797
01-09-2018,286742,293826,196656,73609,850841,17658,17148,28595,63401
02-09-2018,276682,285358,189871,73269,825187,17000,16652,27903,61555
03-09-2018,300820,327016,209035,87213,924089,20143,19188,31878,71209
04-09-2018,305232,333234,210606,88745,937825,20502,19311,32328,72141
05-09-2018,306817,331766,212222,89588,940400,20666,19394,32599,72659
06-09-2018,308386,329196,210392,89294,937278,21207,19773,32889,73869
07-09-2018,301318,322680,210819,87719,922539,20949,19436,32359,72744
08-09-2018,282733,282892,196519,75341,837490,18158,16909,28556,63623
09-09-2018,279751,285971,190202,74079,830011,17964,16347,27929,62240
10-09-2018,299786,323775,210651,88150,922260,20605,19058,32080,71743
11-09-2018,306633,338500,215437,93151,948777,20619,19393,32420,72432
12-09-2018,315968,329814,215552,90836,952175,20642,19046,32725,72413
13-09-2018,321491,333340,215465,89826,960120,20919,19108,32357,72384
14-09-2018,318974,325082,215807,87787,947650,20702,19212,32105,72019
15-09-2018,303054,295696,202484,74554,875794,17951,16858,28824,63633
16-09-2018,304908,299685,194075,75710,874380,17324,16245,27687,61256
17-09-2018,324350,337804,216316,88586,967054,20709,18945,32008,71662
18-09-2018,314747,327458,216278,90928,949416,20365,19267,32414,72046
19-09-2018,310100,325707,215678,92225,943715,20178,19521,32691,72390
20-09-2018,319303,330290,212888,90544,953151,20187,19570,33275,73032
21-09-2018,323621,323863,213934,88683,950108,20187,19378,32888,72453
22-09-2018,308806,303062,200850,76661,889386,18075,16847,29010,63932
23-09-2018,312664,304098,198789,75132,890685,17972,16017,28044,62033
24-09-2018,350912,351060,219718,91418,1.01312e+06,20951,17268,32293,70512
25-09-2018,358319,355203,220168,92564,1.02626e+06,21358,19413,32676,73447
26-09-2018,338113,356075,225347,95679,1.01522e+06,22658,20465,33579,76702
27-09-2018,354430,360627,229102,96122,1.04028e+06,21938,19997,33047,74982
28-09-2018,360623,356885,233927,89939,1.00082e+06,22426,19947,32934,75307
29-09-2018,340089,332941,222617,78083,973735,20005,17619,29484,67108
30-09-2018,326151,317770,209747,77764,931423,19529,17355,28838,65722
01-10-2018,358158,362740,226019,92309,1.03922e+06,22096,20196,33023,75315
02-10-2018,371142,378499,228020,99054,1.07672e+06,22393,20571,33812,76776
03-10-2018,371653,384723,226340,96202,1.07892e+06,23092,21045,34202,78339
04-10-2018,377433,387971,234777,94617,680954,23146,20771,34397,78314
05-10-2018,356004,355389,235662,90922,1.03798e+06,23519,20638,34611,78768
06-10-2018,348191,334209,217124,80169,979693,20345,17886,29905,68136
07-10-2018,349184,334760,216384,78858,979191,20228,17918,29436,67582
08-10-2018,357812,377103,238346,94533,1.0678e+06,23537,20411,33750,77698
09-10-2018,347857,366121,224062,95012,995391,23931,20251,34174,78356
10-10-2018,339373,355910,219920,93601,1.00881e+06,23714,20475,33816,78005
11-10-2018,338595,349708,228854,91967,971738,22741,20479,33967,77187
12-10-2018,338158,345230,227937,88975,1.00031e+06,22068,20043,33497,75608
13-10-2018,315879,305958,213655,77689,913184,19440,17632,30009,67081
14-10-2018,306752,297889,202486,75115,882248,18729,17269,29032,65030
15-10-2018,343837,340565,223477,89040,996920,21817,19698,32901,74416
16-10-2018,361050,348210,230030,90573,1.02987e+06,22100,20007,33554,75661
17-10-2018,347377,345501,233933,90903,979636,22291,20361,34023,76675
18-10-2018,354489,350965,231684,90212,1.02735e+06,22206,20399,34167,76772
19-10-2018,369542,372416,238271,89041,1.06928e+06,22567,20292,34114,76973
20-10-2018,353537,336256,230455,78786,999037,20472,18468,30863,69803
21-10-2018,333327,325977,220259,80148,959716,19870,17882,29685,67437
22-10-2018,366651,364182,233568,93052,1.01704e+06,22810,20712,34662,78184
23-10-2018,372152,386133,241896,95500,1.09568e+06,23712,20964,35664,80340
24-10-2018,388106,401160,244214,97135,1.13062e+06,23962,21127,35598,80687
25-10-2018,384712,399230,249209,95815,1.12898e+06,24559,21304,35529,81392
26-10-2018,402911,414092,253595,93771,1.16437e+06,24275,21015,35243,80533
27-10-2018,394554,394935,245727,84831,1.12005e+06,22894,18716,32037,73647
28-10-2018,418909,415228,255043,89435,1.17862e+06,22748,18840,31810,73398
29-10-2018,441602,439197,268564,100461,1.24983e+06,25816,21684,36503,84003
30-10-2018,440012,430288,264743,100603,1.23565e+06,26216,21998,35803,84017
31-10-2018,408977,401621,251329,98237,1.16016e+06,25191,21666,34269,81126
01-11-2018,400558,389604,244344,97804,1.13232e+06,24470,21477,29350,75297
02-11-2018,386554,379250,249358,94728,1.1099e+06,23953,21148,32544,77645
03-11-2018,377013,345108,229313,84895,1.03634e+06,21140,18370,30853,70363
04-11-2018,352182,356400,228599,84556,1.02174e+06,20765,17907,30683,69355
05-11-2018,381549,401637,244163,97451,1.12481e+06,24496,21367,35594,81457
06-11-2018,383591,389129,242933,98910,1.11457e+06,24762,21341,35904,82007
07-11-2018,380670,396641,237716,99603,1.11548e+06,24834,21312,35807,81953
08-11-2018,378527,399699,239302,99001,1.11653e+06,24937,21665,36402,83004
09-11-2018,380329,387111,245342,96796,1.10958e+06,24830,21533,36302,82665
10-11-2018,358982,349731,236617,85537,1.03087e+06,22697,19030,32253,73980
11-11-2018,342019,347713,230618,82624,1.00298e+06,21935,18392,31404,71731
12-11-2018,364299,393729,250039,97525,1.06473e+06,25606,21868,35919,83393
13-11-2018,375892,385965,244329,99415,1.10561e+06,25710,22105,36500,84315
14-11-2018,397442,392084,242158,99329,1.13102e+06,24807,21623,35980,82410
15-11-2018,370352,393239,242834,98072,1.1045e+06,24788,21727,36308,82823
16-11-2018,366973,382149,242128,95872,1.08712e+06,24679,21645,36749,83073
17-11-2018,360010,365696,231198,87583,1.0445e+06,21789,19604,33385,74778
18-11-2018,374418,369293,233383,87049,1.06415e+06,21641,17952,31622,71215
19-11-2018,426502,428880,261845,103085,1.22032e+06,25901,18927,36952,81780
20-11-2018,435896,439503,262945,105611,1.24396e+06,26248,22162,37614,86024
21-11-2018,438143,441905,262790,106081,1.24892e+06,26496,22492,37934,86922
22-11-2018,452034,460537,265082,105388,1.28305e+06,26131,22694,38530,87355
23-11-2018,463206,466458,269861,103835,1.30336e+06,26257,22542,38099,86898
24-11-2018,439067,439638,253555,92442,1.22471e+06,23140,20528,34810,78478
25-11-2018,438361,444683,256800,91828,1.23168e+06,23552,19621,33276,76449
26-11-2018,474000,486536,276245,107739,1.34453e+06,27277,23227,38258,88762
27-11-2018,486409,514427,275355,109194,1.33219e+06,27410,23079,38325,88814
28-11-2018,484632,519580,275982,111632,1.34076e+06,28173,23911,39829,91913
29-11-2018,448074,486417,273158,111986,1.31965e+06,28863,24438,39905,93206
30-11-2018,412715,461235,270740,104221,1.24892e+06,28431,23717,39747,91895
01-12-2018,386276,415128,256041,90647,1.1481e+06,26460,21579,36739,84778
02-12-2018,384996,402918,254477,90204,1.13422e+06,25865,20949,35258,82072
03-12-2018,401877,428556,273144,103340,1.213e+06,29065,23852,39299,92216
04-12-2018,427263,439160,266432,106457,1.23932e+06,27719,23181,38949,89849
05-12-2018,455418,474016,265520,104815,1.29977e+06,26464,23081,38797,88342
06-12-2018,466673,468995,257715,105368,1.29875e+06,27438,23541,39457,90436
07-12-2018,461640,444010,269307,98919,1.27388e+06,27359,23678,39112,90149
08-12-2018,431458,407562,258337,93353,1.19071e+06,24209,20883,34945,80037
09-12-2018,428086,405961,244366,90765,1.16918e+06,23205,19870,33183,76258
10-12-2018,451968,457447,264208,105743,1.27992e+06,27098,22953,37375,87426
11-12-2018,459598,460545,267005,106531,1.29369e+06,27647,23660,38339,89646
12-12-2018,484525,478467,272488,106120,1.3416e+06,27858,23609,38742,90209
13-12-2018,498626,487402,279605,108161,1.37380e+06,28141,24002,39117,91260
14-12-2018,510690,498588,286679,105333,1.4013e+06,28441,23707,38599,90747
15-12-2018,481211,458671,278214,93096,1.31119e+06,25975,21149,34959,82083
16-12-2018,461810,452967,271258,95347,1.28138e+06,25951,20768,34529,81248
17-12-2018,482316,493934,286150,107982,1.31852e+06,28868,23910,39310,92088
18-12-2018,490999,486934,281535,106618,1.36609e+06,28637,23744,39857,92238
19-12-2018,472035,475912,279338,106960,1.28475e+06,29274,23723,39747,92744
20-12-2018,453019,472757,280574,103293,1.30964e+06,29902,23852,40259,94013
21-12-2018,452306,467957,283652,99073,1.30299e+06,29282,23546,38931,91759
22-12-2018,446273,456662,277185,92083,1.27220e+06,26903,21053,34943,82899
23-12-2018,444589,465217,269222,90977,1.27002e+06,25361,20444,34334,80139
24-12-2018,453445,448090,265275,88079,1.2549e+06,24182,20048,33282,77512
25-12-2018,415984,392619,237356,85561,1.13152e+06,22977,18865,30377,72219
26-12-2018,412410,388044,234786,85939,1.12118e+06,22599,18968,30694,72261
27-12-2018,420413,399175,249133,89549,1.15828e+06,24978,21104,34526,80608
28-12-2018,433974,424991,262942,88552,1.16342e+06,24837,20879,33835,79551
29-12-2018,423291,405951,259479,85563,1.17429e+06,23914,19462,32500,75876
30-12-2018,426529,406290,256064,86712,1.1756e+06,23440,18916,31896,74252
31-12-2018,421564,413081,272725,85559,1.19293e+06,23295,19181,33712,76188
01-01-2019,410564,383617,252819,84659,1.13166e+06,20707,17307,29757,67771
02-01-2019,454919,466157,284691,98864,1.30464e+06,25007,21458,35864,82329
03-01-2019,457991,473677,308267,104761,1.29445e+06,27478,22842,37754,88074
04-01-2019,429673,439736,293880,102569,1.21912e+06,27995,23287,38536,89818
05-01-2019,401216,415149,279979,89429,1.18577e+06,25275,20908,34831,81014
06-01-2019,402811,415655,271111,90429,1.18001e+06,25071,20447,34261,79779
07-01-2019,449011,459577,275258,103042,1.28689e+06,27677,23723,39449,90849
08-01-2019,451888,461525,280027,106334,1.25004e+06,27327,23639,39267,90233
09-01-2019,456176,486311,284201,108301,1.33499e+06,28287,23848,39644,91779
10-01-2019,455205,494265,291708,108753,1.34994e+06,28580,24291,41014,93885
11-01-2019,445467,465779,279647,102569,1.24423e+06,27709,23898,40761,92368
12-01-2019,440771,443846,267962,93195,1.24578e+06,24650,20394,35410,80454
13-01-2019,436760,430336,273554,92253,1.23291e+06,25047,19978,33655,78680
14-01-2019,481502,498339,286997,107567,1.37441e+06,27892,22985,38224,89101
15-01-2019,483308,507603,291973,107826,1.39072e+06,28511,23391,38951,90853
16-01-2019,485553,500243,294917,105626,1.38635e+06,28620,23284,38611,90515
17-01-2019,499129,516555,300234,106148,1.42207e+06,28634,22836,38196,89666
18-01-2019,499268,525110,311395,105609,1.44138e+06,28814,22339,38326,89479
19-01-2019,465869,476713,299474,95703,1.33776e+06,25701,20129,34842,80672
20-01-2019,468845,482176,289903,93981,1.33491e+06,25431,19685,34159,79275
21-01-2019,498528,535808,321336,106682,1.46236e+06,30381,23137,38927,92445
22-01-2019,504255,511325,323456,109406,1.39423e+06,32462,23941,39834,96237
23-01-2019,493626,516556,298532,110624,1.3647e+06,30885,23774,40220,94879
24-01-2019,491264,528069,311635,113497,1.3896e+06,30384,23790,41290,95464
25-01-2019,489193,516676,312881,110875,1.42963e+06,30815,23924,40665,95404
26-01-2019,470875,485044,300574,98172,1.35467e+06,28566,21527,36686,86779
27-01-2019,473275,489893,310976,95367,1.36951e+06,28470,21108,35629,85207
28-01-2019,505708,514321,329015,107014,1.45606e+06,31151,24131,39807,95089
29-01-2019,518826,518088,308820,108607,1.45435e+06,30826,23952,39633,94411
30-01-2019,518315,547614,298911,108798,1.47364e+06,29426,23180,39434,92040
31-01-2019,510701,534879,300100,110399,1.45608e+06,29685,23868,39792,93345
01-02-2019,484029,509413,307587,106101,1.35393e+06,28797,23197,38312,90306
02-02-2019,472834,475470,297684,95541,1.34153e+06,25430,20497,34268,80195
03-02-2019,466315,490403,285393,93257,1.33538e+06,24455,19668,33154,77277
04-02-2019,504040,527951,298095,109569,1.43966e+06,28462,22987,38357,89806
05-02-2019,492351,502309,297859,107198,1.34644e+06,28086,23058,38637,89781
06-02-2019,500047,523467,299784,106118,1.3764e+06,28586,23342,38293,90221
07-02-2019,484615,481361,291050,106816,1.36385e+06,28519,23526,37985,90030
08-02-2019,465813,466488,278412,103437,1.26562e+06,27340,22646,37618,87604
09-02-2019,426094,425586,261796,94403,1.20788e+06,23732,19839,33417,76988
10-02-2019,416053,416172,253569,89929,1.17573e+06,23648,19335,31864,74847
11-02-2019,454458,465789,268727,103639,1.29262e+06,27312,22462,36401,86175
12-02-2019,464205,476889,273610,105551,1.32027e+06,26815,22669,36503,85987
13-02-2019,427426,443876,280910,103063,1.20758e+06,27486,22909,36958,87353
14-02-2019,428494,440014,273570,101986,1.24407e+06,26601,22424,35723,84748
15-02-2019,416207,430319,264231,96819,1.20758e+06,26245,22241,35696,84182
16-02-2019,406842,396928,251307,86374,1.14146e+06,22526,19362,30528,72416
17-02-2019,406268,403068,247403,84658,1.1414e+06,22633,19079,30385,72097
18-02-2019,420739,436581,273954,98676,1.18386e+06,25926,22227,35488,83641
19-02-2019,417852,431269,262308,102075,1.21351e+06,25676,22271,35350,83297
20-02-2019,436140,458378,270447,102426,1.21784e+06,26056,22328,36022,84406
21-02-2019,440345,474877,291281,102821,1.25848e+06,27071,22543,36728,86342
22-02-2019,430502,482849,299404,100178,1.31293e+06,27583,22923,37137,87643
23-02-2019,392546,412309,258718,88615,1.15219e+06,24055,20696,34281,79032
24-02-2019,385698,394375,244230,85499,1.1098e+06,22510,19625,32161,74296
25-02-2019,420223,429494,256803,99030,1.20556e+06,25029,22032,36521,83582
26-02-2019,409534,411551,261216,98406,1.13634e+06,26083,22446,36706,85235
27-02-2019,418417,417892,256658,97067,1.1448e+06,26122,22342,36335,84799
28-02-2019,420250,429287,263425,97193,1.21016e+06,25613,22046,36046,83705
01-03-2019,427793,453769,278931,96521,1.25702e+06,26915,22390,36892,86197
02-03-2019,415096,412815,265557,88404,1.18187e+06,23837,19913,33362,77112
03-03-2019,403726,403066,267740,86805,1.16134e+06,23667,19508,32092,75267
04-03-2019,433616,461658,286310,100235,1.2323e+06,26737,21892,36156,84785
05-03-2019,456126,487307,284070,101746,1.32925e+06,27176,21919,36054,85149
06-03-2019,461099,490052,290000,100992,1.34215e+06,27978,22308,36320,86606
07-03-2019,449060,456075,278627,100920,1.28469e+06,27277,22365,35763,85405
08-03-2019,444392,444208,270829,98309,1.2091e+06,25106,21408,35094,81608
09-03-2019,431445,426805,261498,90428,1.21018e+06,22773,19245,31923,73941
10-03-2019,427354,428645,258115,86742,1.20087e+06,22716,18958,30894,72568
11-03-2019,460123,477089,281079,100246,1.31854e+06,26564,21743,31474,79781
12-03-2019,470475,474803,279377,102461,1.32712e+06,27328,22246,36224,85798
13-03-2019,447950,462605,282381,103636,1.29657e+06,26335,21990,36203,84528
14-03-2019,449032,454380,266211,103093,1.27272e+06,26078,21827,36272,84177
15-03-2019,438408,446632,266541,100826,1.25267e+06,25572,21594,35742,82908
16-03-2019,411145,404674,252368,89535,1.15772e+06,23051,19194,32312,74557
17-03-2019,410090,400178,244122,88899,1.14329e+06,22355,18691,31135,72181
18-03-2019,427669,443724,254958,100001,1.22636e+06,24900,21242,35318,81460
19-03-2019,424596,436033,251492,98386,1.21051e+06,25687,21612,35628,82927
20-03-2019,403520,431207,256292,98718,1.14471e+06,25568,21555,35673,82796
21-03-2019,391315,409250,253602,97741,1.15192e+06,25224,21525,35628,82377
22-03-2019,409983,403653,252448,95706,1.11864e+06,24297,21095,34478,79870
23-03-2019,384430,361920,243820,83447,1.07363e+06,21728,18891,31080,71699
24-03-2019,389239,374904,232543,82902,1.0796e+06,20636,18264,29933,68833
25-03-2019,410504,413516,253810,97256,1.17509e+06,24367,21110,34523,80000
26-03-2019,415551,415669,254484,98464,1.13901e+06,24835,21565,35963,82363
27-03-2019,395418,405842,258549,97755,1.15757e+06,25276,21748,35757,82781
28-03-2019,386867,391769,250272,96356,1.12527e+06,24245,21677,35413,81335
29-03-2019,376918,374159,241966,91379,1.08442e+06,23237,20782,34338,78357
30-03-2019,372334,354401,230098,80810,1.03764e+06,20859,17973,30326,69158
31-03-2019,361106,342789,220368,78656,1.00292e+06,20346,16991,28424,65761
01-04-2019,411060,412856,245552,94416,1.16389e+06,24074,20457,33897,78428
02-04-2019,399677,400164,238376,93996,1.13222e+06,24244,20841,34189,79274
03-04-2019,399364,400478,234563,93191,1.0849e+06,23700,20506,33978,78184
04-04-2019,383976,385512,234710,87478,1.09168e+06,23157,20265,33920,77342
05-04-2019,369665,380719,239114,84395,1.07391e+06,23022,20286,33431,76739
06-04-2019,357379,347797,221369,75062,1.00161e+06,20159,18027,29855,68041
07-04-2019,354987,345058,215370,75241,990659,19796,17535,29117,66448
08-04-2019,387301,407044,239614,86570,1.0767e+06,24187,20503,33596,78286
09-04-2019,396049,424487,239460,91446,1.15097e+06,24093,21302,34860,80255
10-04-2019,401071,438288,244320,96205,1.18155e+06,25061,21407,35121,81589
11-04-2019,404182,436549,241332,98041,1.1801e+06,24890,21541,35482,81913
12-04-2019,396515,423792,244488,95079,1.15988e+06,24237,21123,35151,80511
13-04-2019,365737,377563,229078,84138,1.05651e+06,21231,18617,31694,71542
14-04-2019,354471,370289,217417,82272,1.02445e+06,20385,18111,30205,68701
15-04-2019,369922,404333,231449,92673,1.09838e+06,23348,20544,34559,78451
16-04-2019,362485,394562,226831,93148,1.07703e+06,23149,20493,34696,78338
17-04-2019,347449,384216,223042,90876,1.0456e+06,23025,20311,34331,77667
18-04-2019,316605,355985,219395,78683,970669,22396,19835,33871,76102
19-04-2019,304761,318310,203718,76566,903361,18973,17529,33129,69631
20-04-2019,297214,300879,203051,76022,877168,18374,17115,30133,65622
21-04-2019,290660,298897,198362,73741,861668,18145,15846,26159,60150
22-04-2019,295371,298427,200024,75768,835436,20798,16555,26505,63858
23-04-2019,315595,336109,207828,88860,948392,20841,19290,31886,72017
24-04-2019,318950,333989,205846,90334,949107,21109,19599,32484,73192
25-04-2019,317101,333824,208329,90791,913890,21218,19567,32383,73168
26-04-2019,315221,331704,208409,87684,943386,21049,19367,32359,72775
27-04-2019,293598,303928,194663,78412,870604,18190,17128,29372,64690
28-04-2019,292552,313240,197118,76455,879372,17333,16096,28448,61877
29-04-2019,316530,347711,219582,89560,973383,20961,18814,31615,71390
30-04-2019,307467,335407,214140,90780,947799,21027,18872,31924,71823
01-05-2019,298796,314082,204927,87041,904853,18447,17434,29311,65192
02-05-2019,333536,366035,227601,93096,1.02027e+06,21945,19194,32431,73570
03-05-2019,356834,369104,240607,92223,1.05878e+06,22078,18913,32432,73423
04-05-2019,335836,340830,223757,81721,982147,19466,17136,29509,66111
05-05-2019,335932,328212,210556,79319,954027,18488,16703,28277,63468
06-05-2019,365397,370330,218165,92723,1.04662e+06,21000,17516,32717,71233
07-05-2019,363434,379840,214933,93299,1.05152e+06,21164,19671,32932,73767
08-05-2019,354111,374667,211572,93784,1.03413e+06,21397,20007,33033,74437
09-05-2019,357768,366489,206800,93590,1.02466e+06,20996,19740,33044,73780
10-05-2019,342325,345990,213249,90142,991715,22076,19672,33204,74952
11-05-2019,316534,306623,199893,79401,902451,19171,17346,29333,65850
12-05-2019,318841,317435,192574,78177,907026,17572,16507,28497,62576
13-05-2019,341965,355833,207820,91465,997090,22023,19875,32611,74509
14-05-2019,333303,350059,203732,93767,980865,22133,19966,33315,75414
15-05-2019,322758,341093,199571,93283,956706,21332,19460,32813,73605
16-05-2019,306076,332095,196585,92220,926981,21158,19367,32950,73475
17-05-2019,267234,324627,196069,82708,870650,20750,19311,33019,73080
18-05-2019,275637,288902,181659,76969,823169,17763,17165,29540,64468
19-05-2019,276563,282646,176565,76398,812172,17660,16526,28845,63031
20-05-2019,299473,319407,192174,90697,901756,20942,19352,33098,73392
21-05-2019,299606,313124,187533,93447,893716,21149,19913,33733,74795
22-05-2019,295755,310958,186476,94129,887322,20989,20177,33466,74632
23-05-2019,302228,324505,192274,92240,911256,20739,19930,33493,74162
24-05-2019,309303,323734,201878,89068,923989,21047,18960,32833,72840
25-05-2019,295544,295370,194036,76792,861742,18735,16899,29117,64751
26-05-2019,290746,301356,190957,76653,859717,18507,16401,28469,63377
27-05-2019,320532,344003,202823,89151,956514,21637,18907,32548,73092
28-05-2019,324924,342386,201195,90323,958835,21616,19498,33397,74511
29-05-2019,324345,343238,200657,89739,957984,21150,19531,32947,73628
30-05-2019,310318,317435,194800,81160,903721,21292,19061,32451,72804
31-05-2019,314949,321171,202823,79615,918561,21072,18954,32855,72881
01-06-2019,295254,301012,188518,74828,859615,17798,16564,29072,63434
02-06-2019,290274,290846,186790,74287,842204,17355,16018,28068,61441
03-06-2019,309211,339497,201291,87542,937541,19481,18996,32548,71025
04-06-2019,306684,323972,198010,87324,915990,19898,19543,33782,73223
05-06-2019,312742,314049,193907,78337,899043,20077,19697,34083,73857
06-06-2019,301033,279212,196990,90472,867711,21014,19774,34412,75200
07-06-2019,295329,294439,197375,87430,874578,20874,19633,34113,74620
08-06-2019,272335,270761,183963,77903,804965,17729,17277,30326,65332
09-06-2019,265567,274341,177867,74131,791913,16773,16496,28920,62189
10-06-2019,275803,319790,194884,76043,866524,20046,18950,32993,71989
11-06-2019,300902,324564,195417,91150,912039,20887,19837,34691,75415
12-06-2019,305570,334785,196769,92789,929918,20697,20147,35385,76229
13-06-2019,303982,334539,202147,91045,931721,21375,20427,35457,77259
14-06-2019,298479,315113,202586,88141,904327,21600,19432,34419,75451
15-06-2019,278625,281360,185197,76593,821783,17820,16783,30515,65118
16-06-2019,273811,284149,175699,74582,808241,17372,16192,29175,62739
17-06-2019,295897,319657,186750,91366,893675,20364,18989,33156,72509
18-06-2019,298775,318128,180131,89934,886971,20266,19225,33512,73003
19-06-2019,301537,322501,176820,91646,892502,20246,19505,33618,73369
20-06-2019,300224,315403,175424,91631,882681,19873,20082,34138,74093
21-06-2019,293031,266360,157382,88736,805522,19551,19516,33701,72768
22-06-2019,278601,262413,149085,75667,765771,16283,17675,29408,63366
23-06-2019,278141,270034,152304,73663,774148,15001,17659,27698,60358
24-06-2019,303051,314740,176852,91074,885723,15244,14727,28131,58102
25-06-2019,304631,320187,189912,94628,909360,19099,18655,33126,70880
26-06-2019,297698,322618,196241,95915,912476,19692,19531,34113,73336
27-06-2019,295644,323847,193987,90275,903763,19890,18907,32870,71667
28-06-2019,298039,312882,193056,89630,893617,19137,18526,31950,69613
29-06-2019,274943,281560,183189,78079,817776,16758,16528,28296,61582
30-06-2019,270197,278379,177447,78349,804376,16481,16457,28163,61101
01-07-2019,287635,322935,193938,91722,896233,19191,18833,32305,70329
02-07-2019,295911,322868,193295,91282,903359,18802,18451,32252,69505
03-07-2019,301485,319663,193302,91437,905897,19172,18159,31855,69186
04-07-2019,302361,325537,195509,92953,916361,18855,17982,31512,68349
05-07-2019,301152,314641,196353,87153,899308,18943,17599,31097,67639
06-07-2019,279376,281123,185548,77484,823536,16488,15527,26757,58772
07-07-2019,276344,274209,182219,75634,808406,16390,15244,26705,58339
08-07-2019,291167,308923,194275,89421,883789,18646,17986,30796,67428
09-07-2019,289264,307706,194573,88608,880145,19222,18426,31318,68966
10-07-2019,285596,302560,188310,87443,863912,19042,18584,31329,68955
11-07-2019,284040,296268,195090,88875,864276,18888,18482,31540,68910
12-07-2019,279215,288870,194265,84431,846787,18627,18233,31400,68260
13-07-2019,261330,261264,185188,73291,781076,16496,16196,28013,60705
14-07-2019,260036,256519,182657,73272,772487,16142,15765,27073,58980
15-07-2019,278592,283975,188860,82932,834362,18195,18038,31068,67301
16-07-2019,278238,282234,187475,83867,831821,18442,18385,31380,68207
17-07-2019,273239,280256,188145,82969,824614,18293,18200,30955,67448
18-07-2019,274057,283398,191081,81838,830385,18451,18171,30894,67516
19-07-2019,269258,280286,191505,80415,821468,18526,18166,31197,67889
20-07-2019,256030,254115,180878,71752,762774,16560,16125,28595,61280
21-07-2019,249006,253038,178329,70786,751167,16395,16025,28153,60573
22-07-2019,267426,275835,188471,79676,811416,19106,17935,31212,68253
23-07-2019,263873,277674,188807,80376,810730,19204,18498,31735,69437
24-07-2019,261560,278063,187689,81651,808981,19297,18630,32437,70364
25-07-2019,261353,277468,190904,81926,811656,19117,18794,32419,70330
26-07-2019,263115,277628,194102,82542,817391,19004,18623,31701,69328
27-07-2019,248016,259434,183696,75813,766966,17098,17278,28904,63280
28-07-2019,246993,262443,178127,74228,761797,17081,17129,28759,62969
29-07-2019,270520,279778,193226,85476,829009,19540,19258,33056,71854
30-07-2019,269058,279451,190840,86548,825909,19724,18647,32431,70802
31-07-2019,273330,283739,191744,86162,834979,20250,18612,31386,70248
01-08-2019,274972,284033,192371,84571,835952,19999,18643,31569,70211
02-08-2019,276484,278055,196296,81883,832728,19840,18685,31310,69835
03-08-2019,257128,258699,187695,73272,776794,17253,16525,28387,62165
04-08-2019,254848,259422,184631,72478,771386,17106,15958,27424,60488
05-08-2019,282480,297621,196611,87750,864462,19894,18449,30974,69317
06-08-2019,282895,296470,193707,89871,862950,20813,19201,32160,72174
07-08-2019,280326,301647,194474,89889,866337,21245,19500,32398,73143
08-08-2019,281749,300894,195096,89802,867548,21194,19547,32360,73101
09-08-2019,284641,298429,197982,86977,868038,20377,18959,31557,70893
10-08-2019,264466,272624,185772,78240,801106,17362,16977,28767,63106
11-08-2019,251519,271036,183304,78060,783918,17404,16661,27781,61846
12-08-2019,279206,308801,199569,90854,878434,20237,19295,31954,71486
13-08-2019,285948,309230,201009,91516,887708,20046,19467,32524,72037
14-08-2019,292571,305810,199818,90664,888865,20169,19200,31778,71147
15-08-2019,295775,313846,202196,92383,904200,20387,19284,28177,67848
16-08-2019,288866,307549,204314,88504,889237,20188,19160,30050,69398
17-08-2019,270680,282902,190106,80158,823853,18411,17464,28138,64013
18-08-2019,266544,281087,182812,78274,808723,17496,16975,27869,62340
19-08-2019,291519,313429,202717,91847,899526,19939,19582,32783,72304
20-08-2019,294515,313749,200589,91252,900106,18412,19350,32980,70742
21-08-2019,297220,316991,200775,91361,906350,20483,19465,32783,72731
22-08-2019,301415,317268,202002,92987,913678,20364,19350,32276,71990
23-08-2019,299610,312912,206845,88588,907962,20438,19311,32141,71890
24-08-2019,272611,279947,190366,76902,819832,17567,17187,28865,63619
25-08-2019,266600,278196,185736,76571,807107,17376,16627,28077,62080
26-08-2019,289475,325351,200932,91499,907258,20502,19338,32692,72532
27-08-2019,288867,319522,199883,93184,901467,21032,19687,33304,74023
28-08-2019,286114,319591,199249,94571,899529,20829,19819,33156,73804
29-08-2019,285429,324997,201282,92860,904571,20447,19584,33409,73440
30-08-2019,285760,316025,204692,88676,895155,20552,19572,33423,73547
31-08-2019,272046,281102,188453,78187,819798,17643,16913,29673,64229
01-09-2019,267005,285201,185186,76951,814344,17177,16622,28529,62328
02-09-2019,295767,322807,204607,88333,911515,20407,18781,32488,71676
03-09-2019,300053,327344,200839,88964,917210,20558,19069,32697,72324
04-09-2019,311133,330631,200855,90670,933290,20517,19182,32555,72254
05-09-2019,308810,328721,202419,90984,930941,20977,19404,32579,72960
06-09-2019,316007,323808,204191,88302,932312,20560,18892,32167,71619
07-09-2019,297109,295162,194507,76824,863604,17699,16751,28755,63205
08-09-2019,295349,292371,187385,77795,852905,17572,16935,28277,62784
09-09-2019,311559,333433,204072,92218,941289,20616,19640,32235,72491
10-09-2019,307901,328103,198125,94156,928287,20315,19569,32056,71940
11-09-2019,304625,321479,195850,91869,913830,20566,19528,32366,72460
12-09-2019,306723,322681,199182,91567,920155,20727,19435,32684,72846
13-09-2019,308752,312875,203221,87974,912831,21472,19324,32157,72953
14-09-2019,306258,294170,193119,77350,870904,18495,16826,27946,63267
15-09-2019,293589,298605,190899,76300,859392,18698,16473,27883,63054
16-09-2019,320431,343914,206935,89753,961040,21523,18540,31690,71753
17-09-2019,330204,351361,210803,91876,984249,22104,18973,32204,73281
18-09-2019,328104,349466,216546,93217,987337,22473,19086,32754,74313
19-09-2019,341261,352937,216042,92307,1.00255e+06,22427,19439,33301,75167
20-09-2019,326915,346784,220599,90935,985237,22380,19526,33083,74989
21-09-2019,296606,291119,208660,78914,875301,19401,17379,29765,66545
22-09-2019,293753,298372,203359,76469,871960,18936,17275,29209,65420
23-09-2019,321403,345521,225533,91467,983925,22487,19928,33390,75805
24-09-2019,323945,349126,230703,93387,997165,22711,20126,34008,76845
25-09-2019,323432,355137,221671,94676,994916,22986,20469,34525,77980
26-09-2019,322218,347137,220652,96373,986382,23342,20274,33717,77333
27-09-2019,324517,341987,218664,92767,977942,22156,19901,33476,75533
28-09-2019,298856,306648,202103,81229,888843,19141,17570,30719,67430
29-09-2019,297381,307189,194919,80327,879822,18864,17140,29310,65314
30-09-2019,335753,347347,208818,96599,988521,21622,20041,34013,75676
01-10-2019,343081,356754,212544,97467,1.00985e+06,21921,19568,33891,75380
02-10-2019,342128,371875,216844,98445,1.02929e+06,22508,19876,34477,76861
03-10-2019,355692,385101,225900,96104,1.0628e+06,23083,19931,34272,77286
04-10-2019,363369,389990,233847,95187,1.08239e+06,23746,20132,34555,78433
05-10-2019,353424,367494,223310,84078,1.02832e+06,21440,17983,31105,70528
06-10-2019,349990,362771,217531,83479,1.01378e+06,21134,17762,30568,69464
07-10-2019,383928,408413,232905,97033,1.12229e+06,24210,20620,35101,79931
08-10-2019,379904,409683,232286,98518,1.1204e+06,24559,20988,34894,80441
09-10-2019,368666,387906,234031,96403,1.08701e+06,24289,21070,34068,79427
10-10-2019,356092,371621,235070,97044,1.05984e+06,24080,20811,34148,79039
11-10-2019,355192,362860,232672,95587,1.04632e+06,23200,20664,33748,77612
12-10-2019,333390,330751,219171,85596,968914,20393,17923,30477,68793
13-10-2019,334976,331008,214662,80928,961580,20115,17443,29502,67060
14-10-2019,363687,380628,236125,92930,1.07338e+06,23997,20303,32911,77211
15-10-2019,371137,380531,236199,93811,1.08168e+06,23285,20400,33361,77046
16-10-2019,373445,379299,234622,94694,1.08206e+06,23650,20185,33053,76888
17-10-2019,370957,379618,236490,93974,1.08104e+06,23943,20418,34339,78700
18-10-2019,364213,357987,234353,90705,1.04726e+06,23390,20178,33201,76769
19-10-2019,350272,323839,212051,79588,965753,20209,17670,29977,67856
20-10-2019,356275,335253,213398,80361,985297,20236,17303,29117,66656
21-10-2019,393366,385688,234896,96319,1.11027e+06,23308,19930,33358,76596
22-10-2019,378161,367727,226522,96826,1.06925e+06,23469,20317,34401,78187
23-10-2019,368308,375883,224569,98051,1.06681e+06,23136,20102,34430,77668
24-10-2019,366936,371100,224284,98541,1.06086e+06,22660,20100,34304,77064
25-10-2019,358860,355926,220112,96728,1.03163e+06,23126,20068,34613,77807
26-10-2019,359934,349311,216607,84575,1.01043e+06,20829,17715,30574,69118
27-10-2019,379846,372820,233085,88741,1.07449e+06,21273,18194,30634,70101
28-10-2019,401991,406519,246465,99198,1.15418e+06,23603,20244,34471,78318
29-10-2019,414365,419118,249483,100465,1.18343e+06,25047,20840,35455,81342
30-10-2019,421336,431050,250974,103403,1.20677e+06,25941,21262,36459,83662
31-10-2019,405731,410119,244929,100471,1.16125e+06,25707,21341,35961,83009
01-11-2019,411205,409260,252740,99269,1.17248e+06,24936,21054,30003,75993
02-11-2019,395477,375019,233507,89408,1.09342e+06,22466,19113,31091,72670
03-11-2019,401261,374463,228158,84655,1.08854e+06,21861,18592,30378,70831
04-11-2019,433208,433938,256663,103516,1.22733e+06,24883,21296,34821,81000
05-11-2019,452932,452753,264781,104542,1.27501e+06,25599,21471,35161,82231
06-11-2019,462691,461764,275968,103874,1.30430e+06,25884,21710,35392,82986
07-11-2019,465968,454825,278372,103572,1.30274e+06,26544,21604,35343,83491
08-11-2019,469975,435783,272061,100139,1.27796e+06,25505,21131,35373,82009
09-11-2019,446183,407351,242823,86321,1.18268e+06,21911,18595,31688,72194
10-11-2019,440705,410351,229641,88766,1.16946e+06,21441,18162,30770,70373
11-11-2019,477615,446609,251936,102575,1.27874e+06,25137,20983,35035,81155
12-11-2019,458371,432546,251896,106869,1.24968e+06,24586,21516,36046,82148
13-11-2019,439893,431467,239582,104784,1.21574e+06,24705,21567,35531,81803
14-11-2019,441450,430446,235957,104410,1.21226e+06,24491,21272,35898,81661
15-11-2019,437826,421069,245694,104211,1.20881e+06,25476,21166,35882,82524
16-11-2019,420231,383275,239787,89441,1.13274e+06,22619,18578,32083,73280
17-11-2019,407307,379781,228850,88792,1.10473e+06,21435,17796,31037,70268
18-11-2019,440312,413748,245918,101938,1.20192e+06,24479,17817,35619,77915
19-11-2019,424531,408439,238402,103255,1.17463e+06,24775,21105,36360,82240
20-11-2019,436291,406499,235974,103518,1.18228e+06,25072,21702,37007,83781
21-11-2019,427018,409301,239469,104367,1.18016e+06,25444,21896,37469,84809
22-11-2019,413042,409058,248046,101488,1.17164e+06,26475,22117,37878,86470
23-11-2019,395055,379049,244005,92738,1.11085e+06,23989,19721,34592,78302
24-11-2019,397402,390447,242740,91050,1.12165e+06,24153,19268,33598,77019
25-11-2019,428627,435964,259307,103766,1.22767e+06,27857,22666,38704,89227
26-11-2019,432637,431323,250786,104860,1.21961e+06,27907,22921,39247,90075
27-11-2019,437680,428597,254438,104359,1.22508e+06,27613,23046,39055,89714
28-11-2019,448999,431730,250448,104772,1.23596e+06,27043,22528,38726,88297
29-11-2019,459388,450889,253312,105921,1.26951e+06,26218,22038,37970,86226
30-11-2019,450872,442073,249901,93245,1.2361e+06,24530,19678,34339,78547
01-12-2019,453188,444023,243243,93194,1.23366e+06,23487,19531,33757,76775
02-12-2019,482401,488639,259037,107389,1.33747e+06,27447,22731,38625,88803
03-12-2019,462014,478005,265321,111829,1.31717e+06,28031,22995,38997,90023
04-12-2019,437820,445671,247948,108194,1.23964e+06,27315,22677,38959,88951
05-12-2019,429463,434197,241838,110888,1.21639e+06,26338,22430,38835,87603
06-12-2019,428268,422209,231808,108780,1.19107e+06,26218,22547,38143,86908
07-12-2019,418838,392200,232283,96196,1.13952e+06,23436,20077,34563,78076
08-12-2019,424274,408344,230733,98649,1.16200e+06,22616,19109,33075,74800
09-12-2019,450282,442131,234481,109034,1.23593e+06,25849,21761,37399,85009
10-12-2019,479076,485117,251132,110531,1.32586e+06,26998,22316,37896,87210
11-12-2019,438159,463480,246270,109144,1.25706e+06,27777,22913,39110,89800
12-12-2019,436210,452064,244299,106114,1.23869e+06,27811,23260,39206,90277
13-12-2019,441266,452174,252877,102544,1.24886e+06,27102,22837,38173,88112
14-12-2019,422215,415080,238737,92693,1.16873e+06,24076,20594,34417,79087
15-12-2019,415792,411436,232929,92707,1.15287e+06,23584,19645,33218,76447
16-12-2019,453105,447028,251153,103616,1.2549e+06,25984,22207,37148,85339
17-12-2019,460688,437476,250404,104851,1.25342e+06,25029,22205,37272,84506
18-12-2019,469338,441593,253257,106769,1.27096e+06,25233,21863,36600,83696
19-12-2019,472747,447669,253472,106023,1.27992e+06,26022,21881,36845,84748
20-12-2019,441854,418473,249711,100654,1.2107e+06,25567,21833,36175,83575
21-12-2019,407474,382793,234499,91857,1.11663e+06,23172,19764,32946,75882
22-12-2019,407024,381602,221879,88327,1.09884e+06,22221,18838,31967,73026
23-12-2019,429045,398944,221337,93465,1.1428e+06,22716,20016,33447,54837
24-12-2019,420220,371505,212020,85976,1.08973e+06,21282,18268,30322,69872
25-12-2019,415527,377500,211261,82556,1.08684e+06,20779,17131,27782,65692
26-12-2019,434658,403934,216217,84816,1.13963e+06,21932,18113,29311,69356
27-12-2019,460167,437592,241661,93113,1.23254e+06,24133,19943,32877,76953
28-12-2019,442388,441166,251740,92159,1.22745e+06,23841,19371,32318,75530
29-12-2019,394046,396131,231863,91624,1.11366e+06,23689,18901,31866,74456
30-12-2019,394922,389466,229510,96420,1.11033e+06,23980,19782,33985,77747
31-12-2019,410930,335013,240828,89113,985495,8478,18300,32882,27356
