Date,Hour,NO Prod,SE Prod,FI Prod,DK Prod,Nordic Prod,EE Prod,LV Prod,LT Prod,Baltic Prod,Total Prod
01-01-2014,0,13352,16916,7456,4121,41845,855,258,418,1531,43376
01-01-2014,1,12767,16407,7306,3925,40406,851,236,327,1414,41820
01-01-2014,2,12060,16124,7264,3980,39429,828,244,254,1326,40755
01-01-2014,3,11168,15684,7231,3946,38028,785,243,246,1274,39302
01-01-2014,4,10598,15530,7270,3675,37073,787,244,245,1276,38349
01-01-2014,5,10696,15670,7339,3664,37372,768,245,233,1246,38618
01-01-2014,6,10630,16031,7384,3662,37707,776,306,233,1315,39022
01-01-2014,7,10869,16406,7533,3827,38635,772,314,227,1313,39948
01-01-2014,8,11157,16613,7667,3908,39347,772,369,231,1372,40719
01-01-2014,9,11312,17033,7766,3860,39972,739,436,230,1405,41377
01-01-2014,10,12255,17684,7796,3900,41635,800,536,253,1589,43224
01-01-2014,11,13338,18017,7871,4081,43306,813,545,268,1626,44932
01-01-2014,12,13944,18522,7922,3967,44357,761,547,268,1576,45933
01-01-2014,13,14090,18816,7938,4009,44854,769,570,274,1613,46467
01-01-2014,14,14684,19260,8040,3928,45910,769,584,284,1637,47547
01-01-2014,15,15175,19991,8281,3773,47221,759,737,373,1869,49090
01-01-2014,16,18498,19699,8290,3919,50407,782,815,473,2070,52477
01-01-2014,17,20384,20290,8329,4156,53160,840,731,459,2030,55190
01-01-2014,18,18803,20017,8296,4401,51517,888,723,430,2041,53558
01-01-2014,19,16957,19318,8163,4580,49018,898,719,335,1952,50970
01-01-2014,20,14858,19032,8070,4581,46541,882,650,314,1846,48387
01-01-2014,21,14394,18693,7992,4478,45557,806,495,285,1586,47143
01-01-2014,22,13645,17907,7900,4551,44005,750,408,226,1384,45389
01-01-2014,23,12368,16983,7757,4533,41641,747,276,252,1275,42916
02-01-2014,0,11201,16126,7758,4430,39516,741,207,196,1144,40660
02-01-2014,1,10344,15728,7769,4420,38261,737,195,194,1126,39387
02-01-2014,2,10113,15672,7799,4469,38053,737,195,272,1204,39257
02-01-2014,3,10103,15644,7802,4210,37760,748,194,273,1215,38975
02-01-2014,4,10269,15832,7844,4584,38530,799,220,192,1211,39741
02-01-2014,5,11792,16442,7972,4821,41027,848,346,201,1395,42422
02-01-2014,6,13915,17527,8252,5238,44933,1046,433,277,1756,46689
02-01-2014,7,16290,19013,8330,5503,49136,1252,545,577,2374,51510
02-01-2014,8,17619,20172,8311,5780,51881,1289,580,618,2487,54368
02-01-2014,9,18126,20441,8330,5720,52617,1339,591,629,2559,55176
02-01-2014,10,18871,21174,8417,5560,54021,1370,596,629,2595,56616
02-01-2014,11,19618,21716,8370,5603,55308,1396,581,609,2586,57894
02-01-2014,12,19494,22155,8378,5413,55439,1420,571,610,2601,58040
02-01-2014,13,19462,22575,8389,5311,55738,1431,584,644,2659,58397
02-01-2014,14,19755,22627,8615,5102,56100,1441,612,666,2719,58819
02-01-2014,15,20149,22700,8791,4910,56550,1431,797,718,2946,59496
02-01-2014,16,20830,22932,8791,4683,57235,1408,833,730,2971,60206
02-01-2014,17,21104,23148,8711,4619,57583,1400,761,752,2913,60496
02-01-2014,18,20601,22890,8685,4453,56628,1392,725,738,2855,59483
02-01-2014,19,19798,22570,8481,4396,55245,1380,665,692,2737,57982
02-01-2014,20,18942,22236,8391,4283,53853,1133,508,285,1926,55779
02-01-2014,21,18379,21407,8217,4259,52262,1143,463,281,1887,54149
02-01-2014,22,17548,20171,8003,4040,49761,1025,430,274,1729,51490
02-01-2014,23,16174,18837,7893,3765,46670,1029,341,302,1672,48342
03-01-2014,0,12792,17250,7812,3706,41560,985,229,268,1482,43042
03-01-2014,1,11335,16691,7781,3254,39062,928,228,271,1427,40489
03-01-2014,2,10688,16468,7760,3105,38021,885,229,239,1353,39374
03-01-2014,3,10539,16439,7754,3071,37803,896,241,235,1372,39175
03-01-2014,4,10731,16544,7810,3153,38238,932,248,238,1418,39656
03-01-2014,5,11553,16979,8018,3485,40036,998,521,232,1751,41787
03-01-2014,6,13985,18486,8272,4054,44797,1317,565,238,2120,46917
03-01-2014,7,17986,19934,8497,4529,50946,1422,746,309,2477,53423
03-01-2014,8,19333,20621,8589,4738,53281,1426,809,321,2556,55837
03-01-2014,9,19830,20992,8524,5157,54504,1432,861,311,2604,57108
03-01-2014,10,19033,21191,8454,5592,54268,1435,800,231,2466,56734
03-01-2014,11,18659,20856,8541,5816,53871,1416,764,235,2415,56286
03-01-2014,12,18792,21032,8515,5893,54232,1407,793,232,2432,56664
03-01-2014,13,18786,21286,8547,5995,54615,1389,815,243,2447,57062
03-01-2014,14,18480,21808,8818,6100,55205,1417,921,285,2623,57828
03-01-2014,15,17936,21643,8790,6040,54410,1409,1103,481,2993,57403
03-01-2014,16,18632,21968,8732,6007,55340,1429,1100,492,3021,58361
03-01-2014,17,19433,22368,8727,6080,56606,1428,1063,394,2885,59491
03-01-2014,18,18764,22606,8761,5961,56092,1425,944,227,2596,58688
03-01-2014,19,17858,22028,8506,5663,54056,1432,880,268,2580,56636
03-01-2014,20,16377,21190,8323,5351,51242,1212,795,266,2273,53515
03-01-2014,21,14477,20366,8230,4932,48005,1270,621,268,2159,50164
03-01-2014,22,13873,19916,8030,4832,46650,1000,474,274,1748,48398
03-01-2014,23,12978,18895,7791,4740,44403,972,281,270,1523,45926
04-01-2014,0,12273,17618,7653,4443,41988,884,221,292,1397,43385
04-01-2014,1,11030,17139,7502,4707,40378,847,206,291,1344,41722
04-01-2014,2,10693,16912,7479,4752,39836,838,208,281,1327,41163
04-01-2014,3,10339,16665,7491,4583,39078,836,211,302,1349,40427
04-01-2014,4,10524,16514,7527,4515,39080,843,264,293,1400,40480
04-01-2014,5,10993,16574,7718,4647,39933,862,297,303,1462,41395
04-01-2014,6,11668,17023,7878,4843,41412,897,357,302,1556,42968
04-01-2014,7,12764,17734,7809,4924,43232,942,502,294,1738,44970
04-01-2014,8,14403,19135,7898,5172,46608,969,607,296,1872,48480
04-01-2014,9,16521,19810,7978,5370,49679,970,682,287,1939,51618
04-01-2014,10,17403,20228,8015,5333,50978,1000,751,271,2022,53000
04-01-2014,11,18000,20513,8065,5155,51732,1014,769,301,2084,53816
04-01-2014,12,18051,20560,8145,4903,51657,1031,773,275,2079,53736
04-01-2014,13,18029,20779,8189,4582,51581,1048,783,260,2091,53672
04-01-2014,14,18166,20945,8372,4151,51635,1162,762,267,2191,53826
04-01-2014,15,18886,21064,8647,4002,52598,1301,896,278,2475,55073
04-01-2014,16,19909,21210,8745,4187,54049,1294,992,295,2581,56630
04-01-2014,17,20249,21319,8724,4365,54658,1296,981,294,2571,57229
04-01-2014,18,20135,21309,8564,4488,54496,1294,923,258,2475,56971
04-01-2014,19,19035,20818,8370,4570,52793,1150,840,267,2257,55050
04-01-2014,20,16670,20019,8179,4504,49372,1023,744,225,1992,51364
04-01-2014,21,16148,19472,8125,4437,48181,1128,436,211,1775,49956
04-01-2014,22,15359,19115,8041,4165,46682,1014,326,195,1535,48217
04-01-2014,23,13927,18099,7717,3855,43599,923,252,190,1365,44964
05-01-2014,0,12414,17139,7441,3560,40556,883,205,219,1307,41863
05-01-2014,1,11812,16062,7479,3166,38518,845,201,228,1274,39792
05-01-2014,2,11576,15809,7476,3047,37910,846,198,232,1276,39186
05-01-2014,3,11156,15775,7410,2962,37302,843,199,243,1285,38587
05-01-2014,4,11161,15793,7387,2893,37236,836,201,248,1285,38521
05-01-2014,5,11283,15903,7385,2908,37480,838,206,258,1302,38782
05-01-2014,6,11833,16412,7421,2873,38538,854,266,295,1415,39953
05-01-2014,7,12594,17110,7563,2946,40212,854,297,324,1475,41687
05-01-2014,8,13728,17899,7574,2960,42162,832,376,281,1489,43651
05-01-2014,9,15734,18134,7746,2978,44593,864,493,303,1660,46253
05-01-2014,10,18966,18783,7886,3019,48654,886,583,289,1758,50412
05-01-2014,11,20745,19374,7982,3040,51140,898,612,272,1782,52922
05-01-2014,12,20943,19901,7947,2981,51770,939,638,263,1840,53610
05-01-2014,13,19471,19380,7962,3165,49979,932,647,257,1836,51815
05-01-2014,14,18003,18954,8221,3245,48424,935,689,237,1861,50285
05-01-2014,15,18906,18951,8458,3337,49653,1091,809,295,2195,51848
05-01-2014,16,21326,19929,8367,3517,53140,1166,876,344,2386,55526
05-01-2014,17,21744,21063,8397,3637,54842,1163,859,352,2374,57216
05-01-2014,18,21450,21022,8335,3570,54378,1168,845,289,2302,56680
05-01-2014,19,20931,20413,8352,3520,53216,1046,803,254,2103,55319
05-01-2014,20,20121,19909,8106,3549,51686,955,741,212,1908,53594
05-01-2014,21,18060,19200,8033,3765,49057,926,279,203,1408,50465
05-01-2014,22,16375,18444,7847,3777,46444,916,214,206,1336,47780
05-01-2014,23,13035,17445,7616,3514,41612,876,183,211,1270,42882
06-01-2014,0,11571,16343,7489,3304,38706,823,196,267,1286,39992
06-01-2014,1,11337,16040,7395,3042,37814,799,200,261,1260,39074
06-01-2014,2,10912,15984,7357,3250,37503,782,200,263,1245,38748
06-01-2014,3,11024,15968,7352,3578,37921,766,201,304,1271,39192
06-01-2014,4,11246,16136,7382,4030,38793,772,204,300,1276,40069
06-01-2014,5,11909,16524,7520,4595,40547,833,461,311,1605,42152
06-01-2014,6,13774,17732,7656,4872,44037,1067,701,313,2081,46118
06-01-2014,7,15529,18727,7829,5448,47532,1188,883,342,2413,49945
06-01-2014,8,16535,19843,7866,5720,49965,1233,916,399,2548,52513
06-01-2014,9,16728,20106,7906,5856,50596,1239,910,396,2545,53141
06-01-2014,10,16943,20304,7979,5856,51080,1238,913,390,2541,53621
06-01-2014,11,17227,20537,8017,5933,51713,1232,879,370,2481,54194
06-01-2014,12,17352,20987,8060,5832,52230,1236,884,390,2510,54740
06-01-2014,13,17679,21308,8319,5820,53126,1222,883,380,2485,55611
06-01-2014,14,17416,21573,8633,5810,53432,1228,914,357,2499,55931
06-01-2014,15,18171,21833,8861,5760,54625,1289,950,400,2639,57264
06-01-2014,16,19895,22154,8860,5794,56702,1321,964,450,2735,59437
06-01-2014,17,20885,22285,8760,5809,57740,1324,971,412,2707,60447
06-01-2014,18,19948,22122,8671,5750,56490,1302,917,368,2587,59077
06-01-2014,19,19090,21874,8563,5682,55208,1136,868,321,2325,57533
06-01-2014,20,17863,20942,8274,5476,52555,993,788,318,2099,54654
06-01-2014,21,15660,20321,8257,5249,49488,970,394,257,1621,51109
06-01-2014,22,14844,19385,7982,5059,47268,920,296,240,1456,48724
06-01-2014,23,13551,18302,7789,4644,44287,921,239,238,1398,45685
07-01-2014,0,12625,17238,7681,4204,41749,942,196,241,1379,43128
07-01-2014,1,12180,16755,7677,4102,40714,938,194,327,1459,42173
07-01-2014,2,11707,16520,7684,4090,39999,934,195,253,1382,41381
07-01-2014,3,11503,16395,7702,4106,39706,966,193,270,1429,41135
07-01-2014,4,11693,16446,7829,4461,40429,994,203,259,1456,41885
07-01-2014,5,12324,16647,8224,4822,42018,1170,405,277,1852,43870
07-01-2014,6,14886,18438,8627,5388,47340,1422,799,295,2516,49856
07-01-2014,7,19274,20499,8732,5817,54322,1461,961,353,2775,57097
07-01-2014,8,20727,21105,8822,5998,56652,1518,899,354,2771,59423
07-01-2014,9,20010,21128,8913,6093,56144,1368,866,370,2604,58748
07-01-2014,10,19700,21043,8740,6096,55580,1362,853,405,2620,58200
07-01-2014,11,20096,21069,8660,6073,55899,1338,852,411,2601,58500
07-01-2014,12,19381,20945,8727,5914,54967,1336,858,394,2588,57555
07-01-2014,13,19542,21082,8773,5843,55239,1328,838,385,2551,57790
07-01-2014,14,19549,21109,8945,5785,55388,1336,835,478,2649,58037
07-01-2014,15,20175,21494,8906,5765,56340,1329,1011,595,2935,59275
07-01-2014,16,20652,21798,8994,5817,57263,1320,980,567,2867,60130
07-01-2014,17,20980,21911,8924,5949,57764,1344,944,463,2751,60515
07-01-2014,18,20352,21744,8868,5939,56904,1374,867,346,2587,59491
07-01-2014,19,19333,21215,8706,5948,55202,1383,767,336,2486,57688
07-01-2014,20,18299,20957,8349,5814,53418,1270,749,322,2341,55759
07-01-2014,21,16434,20463,8179,5746,50825,1306,433,327,2066,52891
07-01-2014,22,14930,19870,8030,5574,48405,1092,419,326,1837,50242
07-01-2014,23,13472,18822,7687,5112,45093,989,393,315,1697,46790
08-01-2014,0,12350,17920,7553,4726,42549,946,394,297,1637,44186
08-01-2014,1,11526,17303,7472,4593,40895,915,390,281,1586,42481
08-01-2014,2,11275,17125,7429,4520,40351,890,387,290,1567,41918
08-01-2014,3,10945,16927,7453,4530,39855,894,390,302,1586,41441
08-01-2014,4,11370,17108,7573,4438,40487,937,393,322,1652,42139
08-01-2014,5,12576,17759,8007,4728,43071,1126,403,315,1844,44915
08-01-2014,6,16626,19518,8288,5278,49712,1336,507,349,2192,51904
08-01-2014,7,19710,21497,8554,5400,55160,1350,813,361,2524,57684
08-01-2014,8,20503,22057,8648,5508,56717,1362,702,391,2455,59172
08-01-2014,9,20176,21946,8547,5391,56059,1345,743,395,2483,58542
08-01-2014,10,19854,21736,8383,5385,55359,1334,730,372,2436,57795
08-01-2014,11,19505,21639,8389,5423,54956,1333,653,358,2344,57300
08-01-2014,12,18567,21414,8378,5250,53610,1349,708,361,2418,56028
08-01-2014,13,18650,21283,8385,5258,53576,1351,724,343,2418,55994
08-01-2014,14,19129,21372,8605,5294,54401,1318,746,387,2451,56852
08-01-2014,15,20465,21791,8728,5327,56311,1238,827,369,2434,58745
08-01-2014,16,21072,22287,8850,5501,57710,1241,887,350,2478,60188
08-01-2014,17,21253,22648,8789,5708,58399,1273,817,355,2445,60844
08-01-2014,18,20449,22586,8842,5697,57574,1284,719,371,2374,59948
08-01-2014,19,19688,22086,8788,5559,56121,1293,673,370,2336,58457
08-01-2014,20,18798,21629,8394,5375,54195,1172,516,351,2039,56234
08-01-2014,21,18053,21077,8292,5226,52647,1079,401,312,1792,54439
08-01-2014,22,16768,20315,7944,5022,50049,961,402,344,1707,51756
08-01-2014,23,15354,19042,7616,4723,46735,915,393,340,1648,48383
09-01-2014,0,13512,18262,7546,4185,43504,794,390,355,1539,45043
09-01-2014,1,12825,18036,7442,3837,42141,782,443,366,1591,43732
09-01-2014,2,12272,17741,7424,3524,40960,798,484,421,1703,42663
09-01-2014,3,12841,17544,7474,3508,41366,816,453,411,1680,43046
09-01-2014,4,13217,17726,7507,3297,41747,819,411,337,1567,43314
09-01-2014,5,14344,18535,8158,3238,44276,933,431,332,1696,45972
09-01-2014,6,19374,20116,8789,3407,51688,1266,691,376,2333,54021
09-01-2014,7,22202,22015,9192,3888,57297,1291,851,569,2711,60008
09-01-2014,8,22617,22632,9273,4266,58789,1251,839,590,2680,61469
09-01-2014,9,21924,22293,9112,4684,58013,1202,841,578,2621,60634
09-01-2014,10,22005,21518,8848,5006,57376,1154,727,428,2309,59685
09-01-2014,11,21940,21085,8723,5281,57029,1227,696,374,2297,59326
09-01-2014,12,20537,20714,8592,5459,55302,1218,756,358,2332,57634
09-01-2014,13,20248,20373,8728,5692,55041,1193,792,361,2346,57387
09-01-2014,14,19898,20523,8968,5819,55209,1210,922,540,2672,57881
09-01-2014,15,20585,21199,9209,5840,56833,1232,972,592,2796,59629
09-01-2014,16,20965,21853,9267,5919,58005,1244,996,610,2850,60855
09-01-2014,17,21581,22027,9382,5990,58980,1248,857,617,2722,61702
09-01-2014,18,20569,21717,9111,5939,57338,1239,805,419,2463,59801
09-01-2014,19,19469,21291,8846,6200,55806,1233,789,418,2440,58246
09-01-2014,20,17712,20622,8575,6149,53057,1079,676,405,2160,55217
09-01-2014,21,16817,20399,8465,5980,51662,979,553,371,1903,53565
09-01-2014,22,15631,19894,8191,5719,49436,928,489,360,1777,51213
09-01-2014,23,14128,19278,7893,5719,47018,856,414,366,1636,48654
10-01-2014,0,13136,18986,7726,5266,45115,897,394,399,1690,46805
10-01-2014,1,12631,18787,7669,4975,44062,871,397,442,1710,45772
10-01-2014,2,12474,18507,7683,4891,43555,875,401,424,1700,45255
10-01-2014,3,12731,18490,7815,4792,43828,907,404,445,1756,45584
10-01-2014,4,13178,18822,7997,4774,44771,986,407,380,1773,46544
10-01-2014,5,13992,19550,8333,4851,46725,1213,611,382,2206,48931
10-01-2014,6,17220,21393,8967,5155,52734,1364,907,431,2702,55436
10-01-2014,7,21627,22975,9371,5363,59336,1378,1083,754,3215,62551
10-01-2014,8,22730,23545,9439,5498,61212,1361,1106,764,3231,64443
10-01-2014,9,21724,23159,9319,5646,59847,1356,1104,700,3160,63007
10-01-2014,10,20921,22758,9275,5790,58745,1365,883,426,2674,61419
10-01-2014,11,20471,22510,9249,5909,58139,1366,755,457,2578,60717
10-01-2014,12,19180,22259,9249,5978,56666,1372,731,456,2559,59225
10-01-2014,13,19183,21964,9347,6050,56544,1396,766,458,2620,59164
10-01-2014,14,20202,21920,9574,5810,57505,1433,1066,700,3199,60704
10-01-2014,15,21910,21966,9704,5734,59313,1449,1192,771,3412,62725
10-01-2014,16,22944,22425,9683,5666,60718,1454,1195,784,3433,64151
10-01-2014,17,22971,22947,9670,5889,61479,1469,1200,746,3415,64894
10-01-2014,18,22800,22563,9531,5890,60784,1487,855,420,2762,63546
10-01-2014,19,21836,22276,9356,5593,59062,1476,634,445,2555,61617
10-01-2014,20,20510,21545,8962,5362,56378,1377,608,430,2415,58793
10-01-2014,21,19109,20734,8808,5179,53830,1293,503,415,2211,56041
10-01-2014,22,18085,20253,8675,5118,52132,1209,362,393,1964,54096
10-01-2014,23,16620,19494,8453,4955,49522,1162,281,299,1742,51264
11-01-2014,0,15232,18874,8302,5147,47555,1085,211,360,1656,49211
11-01-2014,1,13853,18445,8325,4788,45411,1058,202,313,1573,46984
11-01-2014,2,13277,18364,8314,4862,44817,1040,197,261,1498,46315
11-01-2014,3,12959,18171,8288,4775,44194,1006,195,262,1463,45657
11-01-2014,4,13050,18138,8334,4563,44085,979,193,220,1392,45477
11-01-2014,5,13676,18401,8426,4674,45179,968,295,230,1493,46672
11-01-2014,6,14448,18842,8538,4720,46549,957,308,370,1635,48184
11-01-2014,7,16537,19742,8724,4823,49826,1035,371,332,1738,51564
11-01-2014,8,18076,20402,8833,4795,52106,1077,467,283,1827,53933
11-01-2014,9,19526,20813,8844,4838,54021,1073,519,386,1978,55999
11-01-2014,10,20623,21171,8859,4852,55506,1063,529,440,2032,57538
11-01-2014,11,20923,21547,8902,4785,56157,1062,597,398,2057,58214
11-01-2014,12,20454,21684,8923,4753,55814,1105,459,391,1955,57769
11-01-2014,13,20421,21678,9036,4804,55938,1119,432,398,1949,57887
11-01-2014,14,19842,21348,9327,4927,55443,1150,485,397,2032,57475
11-01-2014,15,19945,21156,9670,4977,55749,1157,691,500,2348,58097
11-01-2014,16,21099,21259,9640,5111,57107,1153,891,608,2652,59759
11-01-2014,17,22489,21776,9726,5374,59366,1155,878,584,2617,61983
11-01-2014,18,21718,21841,9703,5532,58794,1165,711,471,2347,61141
11-01-2014,19,20644,21421,9502,5674,57241,1156,549,386,2091,59332
11-01-2014,20,18343,20678,9234,5738,53994,1102,450,368,1920,55914
11-01-2014,21,16985,19988,9095,5617,51685,1148,385,308,1841,53526
11-01-2014,22,15969,19510,8868,5573,49920,1089,449,302,1840,51760
11-01-2014,23,15461,18864,8596,5579,48501,942,216,305,1463,49964
12-01-2014,0,15142,18775,8477,5123,47517,853,421,292,1566,49083
12-01-2014,1,14495,18758,8389,5284,46925,823,434,273,1530,48455
12-01-2014,2,14098,18588,8351,5309,46346,773,435,255,1463,47809
12-01-2014,3,14102,18401,8388,5378,46268,777,438,232,1447,47715
12-01-2014,4,14382,18444,8425,5319,46570,796,448,217,1461,48031
12-01-2014,5,14464,18649,8492,5379,46983,815,493,291,1599,48582
12-01-2014,6,14582,18797,8545,5525,47447,828,535,380,1743,49190
12-01-2014,7,15401,19299,8601,5368,48668,837,575,375,1787,50455
12-01-2014,8,16271,19506,8638,5422,49837,852,642,433,1927,51764
12-01-2014,9,17209,19746,8653,5528,51136,819,671,415,1905,53041
12-01-2014,10,18052,20139,8828,5459,52478,832,728,374,1934,54412
12-01-2014,11,18716,20341,8896,5255,53208,888,749,339,1976,55184
12-01-2014,12,18636,20541,8947,5209,53332,880,745,307,1932,55264
12-01-2014,13,18343,20641,8994,4974,52953,876,743,275,1894,54847
12-01-2014,14,18502,20796,9218,4773,53290,987,741,284,2012,55302
12-01-2014,15,19627,21386,9489,4178,54680,1136,772,279,2187,56867
12-01-2014,16,22674,22407,9626,4045,58752,1146,963,292,2401,61153
12-01-2014,17,24256,24088,9568,4171,62084,1146,956,295,2397,64481
12-01-2014,18,24474,24022,9587,3969,62053,1166,861,285,2312,64365
12-01-2014,19,24292,23760,9399,3713,61165,1181,818,281,2280,63445
12-01-2014,20,23722,23187,9206,3463,59577,1095,729,337,2161,61738
12-01-2014,21,23258,22085,9132,3042,57518,1063,712,298,2073,59591
12-01-2014,22,23214,21783,8981,3111,57088,1065,635,303,2003,59091
12-01-2014,23,21868,20974,8679,3151,54672,981,522,269,1772,56444
13-01-2014,0,18529,20242,8568,2910,50248,956,489,348,1793,52041
13-01-2014,1,16813,19316,8588,3086,47803,933,308,335,1576,49379
13-01-2014,2,16004,19001,8541,3424,46969,917,302,331,1550,48519
13-01-2014,3,15798,18964,8580,3546,46888,901,341,280,1522,48410
13-01-2014,4,16381,19170,8832,3768,48150,1108,526,279,1913,50063
13-01-2014,5,17596,20601,9480,4239,51916,1359,720,327,2406,54322
13-01-2014,6,22090,22872,9988,5173,60123,1337,967,669,2973,63096
13-01-2014,7,26152,24442,10336,6316,67246,1371,1129,743,3243,70489
13-01-2014,8,26177,24996,10385,7007,68565,1386,1167,731,3284,71849
13-01-2014,9,26220,24581,10423,6822,68045,1398,1223,650,3271,71316
13-01-2014,10,26040,24512,10449,7021,68022,1387,1155,405,2947,70969
13-01-2014,11,25906,24632,10451,7080,68068,1375,1101,351,2827,70895
13-01-2014,12,25998,24656,10425,6856,67934,1387,1138,391,2916,70850
13-01-2014,13,26010,24919,10310,6945,68184,1412,1144,326,2882,71066
13-01-2014,14,26075,24979,10523,6816,68394,1417,1143,564,3124,71518
13-01-2014,15,26423,25159,10778,6450,68811,1363,1153,582,3098,71909
13-01-2014,16,26512,25551,10801,6361,69225,1329,1189,667,3185,72410
13-01-2014,17,26425,25615,10794,6076,68911,1327,1229,561,3117,72028
13-01-2014,18,26217,25560,10675,5859,68311,1318,1085,532,2935,71246
13-01-2014,19,26119,25488,10303,5616,67525,1306,1032,492,2830,70355
13-01-2014,20,25698,24830,9993,5154,65675,1305,987,253,2545,68220
13-01-2014,21,25491,23821,9709,4546,63568,1296,911,221,2428,65996
13-01-2014,22,24614,22377,9450,4166,60607,1292,800,191,2283,62890
13-01-2014,23,23609,21110,9135,3835,57688,1205,728,168,2101,59789
14-01-2014,0,22228,20205,8909,3456,54799,1023,532,168,1723,56522
14-01-2014,1,21002,19615,8780,3246,52644,991,442,176,1609,54253
14-01-2014,2,20579,19260,8732,3313,51884,1003,440,176,1619,53503
14-01-2014,3,19568,19195,8820,3250,50834,1006,460,179,1645,52479
14-01-2014,4,20016,19223,9434,3200,51875,1081,543,181,1805,53680
14-01-2014,5,21953,20169,10584,3233,55941,1294,721,226,2241,58182
14-01-2014,6,25240,23082,10939,3659,62919,1306,1067,501,2874,65793
14-01-2014,7,26192,24604,11047,4883,66725,1304,1181,553,3038,69763
14-01-2014,8,26046,25007,11078,4962,67092,1306,1181,583,3070,70162
14-01-2014,9,25712,24730,11089,4665,66195,1307,1146,565,3018,69213
14-01-2014,10,25907,24772,10662,4701,66042,1305,1123,392,2820,68862
14-01-2014,11,25975,24714,10815,4584,66087,1296,1064,392,2752,68839
14-01-2014,12,25992,24711,10659,4548,65909,1294,1023,355,2672,68581
14-01-2014,13,26232,24776,10593,4472,66074,1297,1022,399,2718,68792
14-01-2014,14,26336,24961,10923,4546,66765,1296,1147,563,3006,69771
14-01-2014,15,26097,24857,11228,4732,66915,1275,1170,918,3363,70278
14-01-2014,16,26102,24930,11211,4866,67109,1315,1118,928,3361,70470
14-01-2014,17,25982,24815,11226,4901,66924,1312,1178,542,3032,69956
14-01-2014,18,25837,24772,10944,4836,66390,1305,1193,573,3071,69461
14-01-2014,19,26046,24440,10883,4708,66077,1242,1067,481,2790,68867
14-01-2014,20,26054,23731,10434,4220,64440,1226,866,330,2422,66862
14-01-2014,21,25366,22936,9928,4104,62334,1177,778,288,2243,64577
14-01-2014,22,24353,22122,9705,3845,60024,1144,678,276,2098,62122
14-01-2014,23,23062,20552,9424,3797,56835,1112,600,276,1988,58823
15-01-2014,0,22240,19404,9105,3503,54251,1041,550,273,1864,56115
15-01-2014,1,21292,18553,8905,3490,52239,1019,533,259,1811,54050
15-01-2014,2,20324,18320,8891,3430,50965,957,533,281,1771,52736
15-01-2014,3,19710,18113,8907,3543,50273,960,538,229,1727,52000
15-01-2014,4,19187,18127,9467,3538,50320,1022,578,240,1840,52160
15-01-2014,5,20990,19362,10319,3955,54625,1129,1043,259,2431,57056
15-01-2014,6,24448,22254,10930,4446,62081,1134,1165,593,2892,64973
15-01-2014,7,25768,23917,11209,5126,66021,1137,1228,986,3351,69372
15-01-2014,8,25618,23906,11134,5403,66062,1130,1236,913,3279,69341
15-01-2014,9,25885,23708,11063,5339,65995,1135,1236,689,3060,69055
15-01-2014,10,26036,23946,10892,5324,66200,1136,1088,604,2828,69028
15-01-2014,11,26080,23926,10580,5409,65995,1136,1142,446,2724,68719
15-01-2014,12,25885,24248,10508,5339,65981,1139,1179,391,2709,68690
15-01-2014,13,26119,24129,10653,5263,66164,1135,1180,401,2716,68880
15-01-2014,14,26060,24208,10904,5315,66487,1144,1187,649,2980,69467
15-01-2014,15,26075,24340,11163,5536,67115,1156,1200,785,3141,70256
15-01-2014,16,26162,24455,11202,5775,67593,1161,1226,808,3195,70788
15-01-2014,17,26026,24858,11194,6131,68208,1157,1225,803,3185,71393
15-01-2014,18,25532,24449,10983,6215,67180,1165,1102,500,2767,69947
15-01-2014,19,25321,23739,10708,6041,65810,1157,936,301,2394,68204
15-01-2014,20,24933,22742,10226,5646,63548,1152,884,245,2281,65829
15-01-2014,21,24120,21976,9860,5584,61540,1154,876,206,2236,63776
15-01-2014,22,23266,20459,9683,5523,58931,1122,722,254,2098,61029
15-01-2014,23,20971,19764,9428,5653,55815,1065,645,227,1937,57752
16-01-2014,0,18074,18951,9111,5419,51557,973,580,170,1723,53280
16-01-2014,1,16341,18352,8977,5481,49151,955,556,173,1684,50835
16-01-2014,2,15473,18339,8964,5458,48233,945,555,171,1671,49904
16-01-2014,3,15267,18453,8972,5526,48218,953,556,172,1681,49899
16-01-2014,4,15901,18785,9446,5637,49768,1050,599,176,1825,51593
16-01-2014,5,17443,20090,10546,5971,54048,1210,927,297,2434,56482
16-01-2014,6,21240,22268,11163,5918,60588,1226,1239,366,2831,63419
16-01-2014,7,24703,23819,11436,6233,66191,1231,1412,775,3418,69609
16-01-2014,8,25221,24440,11390,6533,67586,1242,1435,830,3507,71093
16-01-2014,9,24501,24467,11256,6683,66907,1277,1356,743,3376,70283
16-01-2014,10,24494,24381,10894,6698,66467,1305,1209,377,2891,69358
16-01-2014,11,24242,24402,10605,6740,65990,1302,1066,373,2741,68731
16-01-2014,12,23863,24396,10169,6781,65209,1304,943,377,2624,67833
16-01-2014,13,23707,24350,10584,6758,65399,1321,1139,377,2837,68236
16-01-2014,14,23762,24306,11325,6782,66174,1333,1302,388,3023,69197
16-01-2014,15,23716,24599,11373,6889,66578,1328,1378,704,3410,69988
16-01-2014,16,24409,24887,11433,7006,67735,1327,1416,753,3496,71231
16-01-2014,17,24561,24946,11400,7138,68045,1330,1380,705,3415,71460
16-01-2014,18,24277,24698,11084,7042,67100,1325,1161,385,2871,69971
16-01-2014,19,23661,24692,10883,6920,66158,1309,978,347,2634,68792
16-01-2014,20,22833,23800,10450,6974,64058,1271,923,255,2449,66507
16-01-2014,21,21770,22870,10134,6961,61734,1254,820,240,2314,64048
16-01-2014,22,20852,21936,9878,6957,59625,1231,727,205,2163,61788
16-01-2014,23,18518,21024,9586,6766,55894,1067,668,197,1932,57826
17-01-2014,0,17268,20151,9200,6131,52751,1035,649,203,1887,54638
17-01-2014,1,16367,19525,9116,5614,50622,1026,650,206,1882,52504
17-01-2014,2,15994,19468,9118,5273,49853,1042,650,202,1894,51747
17-01-2014,3,16092,19525,9154,5124,49895,1080,674,210,1964,51859
17-01-2014,4,16065,19902,9663,5117,50746,1292,735,251,2278,53024
17-01-2014,5,17912,21039,10788,5005,54745,1348,1050,371,2769,57514
17-01-2014,6,22250,23504,11374,5234,62362,1346,1374,596,3316,65678
17-01-2014,7,25234,25493,11476,5422,67625,1382,1481,838,3701,71326
17-01-2014,8,26030,26124,11403,5644,69200,1391,1480,848,3719,72919
17-01-2014,9,25853,26213,11409,5637,69113,1391,1414,836,3641,72754
17-01-2014,10,25718,26106,11256,5702,68782,1377,1287,525,3189,71971
17-01-2014,11,25649,26119,11140,5691,68598,1371,1233,529,3133,71731
17-01-2014,12,24989,25964,11033,5686,67673,1373,1225,468,3066,70739
17-01-2014,13,24754,25347,11074,5669,66844,1370,1240,480,3090,69934
17-01-2014,14,24546,24929,11249,5734,66456,1371,1295,687,3353,69809
17-01-2014,15,24659,24858,11260,5689,66466,1379,1380,802,3561,70027
17-01-2014,16,25126,25350,11282,5727,67486,1373,1435,915,3723,71209
17-01-2014,17,25287,25619,11266,5875,68048,1328,1401,799,3528,71576
17-01-2014,18,24760,25607,11079,5905,67349,1334,1329,430,3093,70442
17-01-2014,19,23989,24704,10944,5870,65508,1336,1124,360,2820,68328
17-01-2014,20,22988,23972,10446,5689,63095,1322,948,296,2566,65661
17-01-2014,21,22005,23196,10202,5520,60924,1323,864,278,2465,63389
17-01-2014,22,21651,22005,9986,5470,59113,1198,785,268,2251,61364
17-01-2014,23,19990,21112,9612,5483,56197,1041,699,267,2007,58204
18-01-2014,0,18537,20399,9230,5537,53702,1107,610,251,1968,55670
18-01-2014,1,16813,20094,9099,5745,51751,1027,602,248,1877,53628
18-01-2014,2,15836,19582,9041,5570,50029,1046,604,244,1894,51923
18-01-2014,3,15725,19252,9056,5572,49605,1061,556,241,1858,51463
18-01-2014,4,16127,19200,9094,5591,50011,1082,562,281,1925,51936
18-01-2014,5,15975,19371,9443,5636,50426,1282,617,261,2160,52586
18-01-2014,6,16326,20200,9683,5891,52099,1332,692,297,2321,54420
18-01-2014,7,18004,21328,9795,6110,55235,1332,738,340,2410,57645
18-01-2014,8,20885,22441,10077,6101,59504,1336,808,350,2494,61998
18-01-2014,9,21702,23349,10038,6223,61312,1323,827,419,2569,63881
18-01-2014,10,22193,23957,10151,6452,62751,1281,836,413,2530,65281
18-01-2014,11,21941,24089,10064,6467,62561,1275,836,335,2446,65007
18-01-2014,12,21167,23951,10123,6455,61696,1267,822,339,2428,64124
18-01-2014,13,20354,23670,10211,6430,60665,1266,819,345,2430,63095
18-01-2014,14,19771,23659,10397,6538,60365,1298,821,337,2456,62821
18-01-2014,15,20488,23984,10796,6545,61813,1286,931,362,2579,64392
18-01-2014,16,22194,24116,11035,6782,64127,1316,1194,383,2893,67020
18-01-2014,17,22648,24507,11108,6950,65213,1299,1214,421,2934,68147
18-01-2014,18,22163,24276,10810,7119,64370,1313,965,367,2645,67015
18-01-2014,19,21134,23567,10447,7159,62309,1299,870,305,2474,64783
18-01-2014,20,19801,22800,10085,7175,59861,1303,814,266,2383,62244
18-01-2014,21,18543,22070,10059,6923,57596,1311,794,265,2370,59966
18-01-2014,22,18121,21334,10015,6679,56150,1270,701,261,2232,58382
18-01-2014,23,16854,20372,9760,6601,53587,1145,634,283,2062,55649
19-01-2014,0,17004,19171,9437,6327,51938,987,457,256,1700,53638
19-01-2014,1,16961,18657,9339,6014,50971,950,444,269,1663,52634
19-01-2014,2,16506,18558,9369,5951,50383,950,460,278,1688,52071
19-01-2014,3,16443,18548,9481,5938,50410,966,465,286,1717,52127
19-01-2014,4,16348,18564,9595,5981,50487,960,467,286,1713,52200
19-01-2014,5,16537,18581,9657,6034,50809,1041,470,363,1874,52683
19-01-2014,6,16955,18737,9712,6086,51490,983,556,360,1899,53389
19-01-2014,7,16973,18989,9917,6281,52160,1005,627,300,1932,54092
19-01-2014,8,17828,19653,10168,6594,54242,1088,642,301,2031,56273
19-01-2014,9,18381,20415,10429,6995,56219,1130,721,296,2147,58366
19-01-2014,10,19422,21133,10497,7110,58162,1136,791,286,2213,60375
19-01-2014,11,19608,21542,10480,7267,58898,1116,762,281,2159,61057
19-01-2014,12,19436,21694,10276,7287,58693,1122,778,283,2183,60876
19-01-2014,13,19073,22283,10137,7314,58805,1116,748,305,2169,60974
19-01-2014,14,18652,22296,10267,7267,58481,1125,747,323,2195,60676
19-01-2014,15,18894,22714,10690,7330,59628,1148,916,327,2391,62019
19-01-2014,16,20113,23723,10666,7431,61935,1174,1113,346,2633,64568
19-01-2014,17,21574,24343,10669,7507,64091,1180,1143,346,2669,66760
19-01-2014,18,21302,24426,10572,7565,63865,1164,1092,339,2595,66460
19-01-2014,19,20836,23995,10386,7527,62744,1165,988,329,2482,65226
19-01-2014,20,20453,23527,10012,7159,61151,1167,813,333,2313,63464
19-01-2014,21,19771,23150,10031,7108,60060,1097,574,338,2009,62069
19-01-2014,22,18761,22279,9809,6773,57625,1048,559,341,1948,59573
19-01-2014,23,17068,21257,9835,6590,54751,984,543,337,1864,56615
20-01-2014,0,15774,20347,9538,6668,52326,1042,543,338,1923,54249
20-01-2014,1,15290,19675,9395,6525,50886,1035,541,342,1918,52804
20-01-2014,2,15075,19616,9344,6374,50410,1033,541,340,1914,52324
20-01-2014,3,14957,19584,9353,6304,50200,1066,543,343,1952,52152
20-01-2014,4,15082,19962,10003,6299,51347,1356,542,344,2242,53589
20-01-2014,5,16203,21037,10789,6560,54589,1537,994,411,2942,57531
20-01-2014,6,20556,23088,11187,6801,61633,1538,1333,697,3568,65201
20-01-2014,7,23136,24950,11391,6985,66462,1539,1509,908,3956,70418
20-01-2014,8,24313,25493,11439,7051,68296,1537,1534,819,3890,72186
20-01-2014,9,24658,25402,11357,7029,68447,1519,1540,800,3859,72306
20-01-2014,10,24489,25443,11114,6980,68026,1494,1151,546,3191,71217
20-01-2014,11,24242,25619,10925,7132,67918,1472,1030,531,3033,70951
20-01-2014,12,24087,25599,10945,7035,67667,1491,944,544,2979,70646
20-01-2014,13,23828,25581,10988,6889,67287,1495,901,516,2912,70199
20-01-2014,14,23758,25465,11212,6817,67251,1493,1363,570,3426,70677
20-01-2014,15,24046,25275,11362,6817,67502,1480,1432,712,3624,71126
20-01-2014,16,24861,25484,11382,6802,68529,1480,1535,842,3857,72386
20-01-2014,17,25255,25754,11355,6851,69215,1514,1497,734,3745,72960
20-01-2014,18,24651,25622,11145,6838,68257,1523,1185,439,3147,71404
20-01-2014,19,24083,25213,10984,6614,66893,1524,926,388,2838,69731
20-01-2014,20,23528,24623,10512,6197,64862,1479,911,334,2724,67586
20-01-2014,21,22560,23928,9973,6129,62589,1377,702,326,2405,64994
20-01-2014,22,21589,22725,9764,5990,60069,1359,598,328,2285,62354
20-01-2014,23,19752,21562,9630,5712,56655,1177,534,353,2064,58719
21-01-2014,0,19443,20139,9412,5435,54427,1219,534,323,2076,56503
21-01-2014,1,18898,19613,9375,5192,53077,1194,534,319,2047,55124
21-01-2014,2,18004,19299,9334,5057,51693,1168,534,320,2022,53715
21-01-2014,3,17391,19003,9374,4894,50662,1222,535,313,2070,52732
21-01-2014,4,17804,19287,9771,4864,51726,1507,542,306,2355,54081
21-01-2014,5,20907,20454,10605,4827,56794,1519,982,393,2894,59688
21-01-2014,6,23325,22879,10874,4850,61928,1524,1290,817,3631,65559
21-01-2014,7,25593,24939,11185,5382,67099,1521,1448,1076,4045,71144
21-01-2014,8,25190,25251,11251,5730,67423,1507,1508,944,3959,71382
21-01-2014,9,25617,24624,11226,5645,67113,1499,1489,894,3882,70995
21-01-2014,10,25581,24873,11289,5642,67386,1393,1437,555,3385,70771
21-01-2014,11,25458,25046,11080,5636,67219,1387,1313,534,3234,70453
21-01-2014,12,25425,24979,11104,5503,67010,1401,1392,525,3318,70328
21-01-2014,13,25374,24902,11208,5453,66937,1488,1262,440,3190,70127
21-01-2014,14,25424,24954,11367,5596,67342,1486,1393,584,3463,70805
21-01-2014,15,25469,24833,11388,5622,67312,1497,1443,765,3705,71017
21-01-2014,16,25632,24784,11410,5662,67488,1503,1541,990,4034,71522
21-01-2014,17,25402,24973,11393,5848,67616,1507,1520,970,3997,71613
21-01-2014,18,25246,25010,11233,5954,67441,1506,1531,596,3633,71074
21-01-2014,19,25138,24629,11058,5797,66621,1503,1205,353,3061,69682
21-01-2014,20,24671,24085,10571,5262,64589,1513,1123,253,2889,67478
21-01-2014,21,24041,22940,9942,5118,62041,1489,710,242,2441,64482
21-01-2014,22,22643,22280,9650,5128,59700,1393,691,240,2324,62024
21-01-2014,23,20532,21231,9615,5191,56567,1248,688,228,2164,58731
22-01-2014,0,20509,19197,9433,5135,54274,1246,787,223,2256,56530
22-01-2014,1,19824,18568,9331,5033,52755,1205,796,227,2228,54983
22-01-2014,2,19001,18342,9362,5176,51883,1170,796,221,2187,54070
22-01-2014,3,18875,18428,9410,5187,51899,1153,797,221,2171,54070
22-01-2014,4,19034,18676,9811,5331,52852,1191,866,215,2272,55124
22-01-2014,5,20972,19974,10706,5561,57213,1405,929,325,2659,59872
22-01-2014,6,22509,22732,11098,5923,62263,1417,1434,640,3491,65754
22-01-2014,7,24408,24593,11306,6622,66929,1420,1578,929,3927,70856
22-01-2014,8,24712,24663,11217,6768,67359,1428,1590,940,3958,71317
22-01-2014,9,25202,24612,11075,6770,67660,1436,1425,646,3507,71167
22-01-2014,10,25727,24666,11100,6826,68319,1433,1362,385,3180,71499
22-01-2014,11,25295,24624,10862,6655,67437,1431,999,343,2773,70210
22-01-2014,12,25082,24473,10814,6558,66927,1437,986,340,2763,69690
22-01-2014,13,24987,24396,10851,6511,66745,1428,1015,350,2793,69538
22-01-2014,14,25104,23897,11149,6472,66623,1433,1378,408,3219,69842
22-01-2014,15,25131,24184,11299,6568,67181,1435,1496,544,3475,70656
22-01-2014,16,25260,24743,11465,6688,68156,1442,1473,935,3850,72006
22-01-2014,17,25342,24990,11491,6718,68542,1434,1561,980,3975,72517
22-01-2014,18,25317,24753,11264,6732,68066,1445,1423,340,3208,71274
22-01-2014,19,25295,24458,10968,6452,67173,1439,1282,281,3002,70175
22-01-2014,20,24824,23578,10598,6266,65268,1435,896,233,2564,67832
22-01-2014,21,23717,23047,10005,6199,62967,1425,706,222,2353,65320
22-01-2014,22,22446,21960,9655,6216,60277,1435,678,216,2329,62606
22-01-2014,23,20749,20372,9519,6224,56864,1299,827,204,2330,59194
23-01-2014,0,18986,19521,9314,6077,53896,1280,662,201,2143,56039
23-01-2014,1,17835,19331,9243,6040,52450,1242,654,201,2097,54547
23-01-2014,2,17626,19349,9310,5956,52240,1193,655,203,2051,54291
23-01-2014,3,17438,19543,9354,5905,52241,1219,656,210,2085,54326
23-01-2014,4,17865,19963,9801,5919,53551,1418,685,207,2310,55861
23-01-2014,5,19633,21129,10743,5999,57502,1430,1101,328,2859,60361
23-01-2014,6,22544,23521,11276,6319,63659,1411,1323,684,3418,67077
23-01-2014,7,25413,24994,11555,6776,68737,1427,1466,907,3800,72537
23-01-2014,8,25681,25153,11705,6968,69506,1423,1488,940,3851,73357
23-01-2014,9,25620,25065,11616,7044,69345,1423,1480,717,3620,72965
23-01-2014,10,25649,25027,11483,7081,69238,1422,1374,474,3270,72508
23-01-2014,11,25455,24947,11241,7070,68711,1411,1153,364,2928,71639
23-01-2014,12,25331,24869,11196,7060,68455,1410,1043,303,2756,71211
23-01-2014,13,24812,25004,11227,7212,68255,1408,1148,353,2909,71164
23-01-2014,14,24667,24777,11556,7193,68193,1398,1317,419,3134,71327
23-01-2014,15,24869,24716,11617,7114,68319,1404,1363,569,3336,71655
23-01-2014,16,25524,25023,11666,7090,69303,1420,1490,914,3824,73127
23-01-2014,17,25680,25589,11722,7191,70182,1433,1561,917,3911,74093
23-01-2014,18,25001,25506,11521,7206,69235,1444,1398,380,3222,72457
23-01-2014,19,24243,24752,11365,7108,67467,1457,1078,285,2820,70287
23-01-2014,20,23432,23889,10855,7081,65258,1447,869,253,2569,67827
23-01-2014,21,22761,23164,10282,6901,63108,1434,684,216,2334,65442
23-01-2014,22,21109,22228,9922,6821,60080,1398,656,226,2280,62360
23-01-2014,23,18951,21204,9987,6867,57008,1301,686,216,2203,59211
24-01-2014,0,18239,19944,9507,6669,54358,1332,659,213,2204,56562
24-01-2014,1,17399,19269,9408,6570,52646,1221,658,217,2096,54742
24-01-2014,2,16708,19216,9428,6529,51880,1170,657,225,2052,53932
24-01-2014,3,16423,19249,9506,6415,51595,1193,666,217,2076,53671
24-01-2014,4,16918,19605,9932,6259,52714,1493,744,224,2461,55175
24-01-2014,5,18633,21092,10640,6135,56500,1570,938,359,2867,59367
24-01-2014,6,22587,22815,11543,6315,63260,1583,1243,724,3550,66810
24-01-2014,7,25372,24569,11632,6634,68208,1579,1379,955,3913,72121
24-01-2014,8,25481,24938,11452,6788,68659,1579,1359,966,3904,72563
24-01-2014,9,25325,24921,11452,6819,68518,1594,1172,883,3649,72167
24-01-2014,10,25358,24924,11280,7059,68622,1594,1109,509,3212,71834
24-01-2014,11,25395,24338,10897,7002,67632,1586,979,450,3015,70647
24-01-2014,12,25273,24072,10752,6859,66958,1576,966,395,2937,69895
24-01-2014,13,24891,24431,10823,6719,66866,1586,998,354,2938,69804
24-01-2014,14,24534,23998,11124,6658,66313,1586,1145,386,3117,69430
24-01-2014,15,24430,23906,11220,6512,66069,1595,1114,438,3147,69216
24-01-2014,16,25049,24402,11368,6219,67038,1545,1198,908,3651,70689
24-01-2014,17,25621,25139,11458,6197,68416,1421,1223,934,3578,71994
24-01-2014,18,25215,24845,11159,6234,67454,1463,1101,382,2946,70400
24-01-2014,19,24276,24245,10744,6107,65372,1538,943,269,2750,68122
24-01-2014,20,22894,23589,10138,6215,62836,1572,805,231,2608,65444
24-01-2014,21,21959,22562,9792,6242,60555,1561,655,232,2448,63003
24-01-2014,22,20670,22037,9455,6251,58412,1515,636,221,2372,60784
24-01-2014,23,19725,21308,9363,5980,56376,1392,714,236,2342,58718
25-01-2014,0,19121,20237,9180,5473,54012,1210,620,228,2058,56070
25-01-2014,1,17934,19767,9074,5447,52222,1124,610,210,1944,54166
25-01-2014,2,16411,19652,9039,5551,50654,1059,609,202,1870,52524
25-01-2014,3,15660,19807,9018,5631,50118,1041,611,216,1868,51986
25-01-2014,4,15400,19758,8953,5947,50058,1071,610,209,1890,51948
25-01-2014,5,15532,20049,8877,6059,50518,1170,608,209,1987,52505
25-01-2014,6,16310,20776,9037,6171,52294,1248,610,254,2112,54406
25-01-2014,7,17896,21666,9201,6366,55129,1320,729,277,2326,57455
25-01-2014,8,19336,22780,9283,6463,57862,1380,919,225,2524,60386
25-01-2014,9,20841,23231,9316,6575,59962,1394,1021,269,2684,62646
25-01-2014,10,21731,23196,9335,6715,60977,1392,1064,222,2678,63655
25-01-2014,11,21786,23367,9311,6900,61364,1394,1045,172,2611,63975
25-01-2014,12,21359,23597,9121,6937,61014,1375,1013,177,2565,63579
25-01-2014,13,20686,23702,9146,6924,60458,1346,949,179,2474,62932
25-01-2014,14,19963,23445,9269,6880,59558,1337,921,183,2441,61999
25-01-2014,15,20150,23400,9667,6859,60075,1341,999,190,2530,62605
25-01-2014,16,21403,23726,10003,6980,62113,1341,1122,206,2669,64782
25-01-2014,17,22685,24109,10114,7278,64186,1353,1146,226,2725,66911
25-01-2014,18,21927,23918,9928,7324,63097,1379,1139,231,2749,65846
25-01-2014,19,20924,23295,9611,7305,61136,1351,1048,213,2612,63748
25-01-2014,20,19273,22446,9298,7119,58135,1316,906,228,2450,60585
25-01-2014,21,17626,21907,9094,6934,55564,1365,637,248,2250,57814
25-01-2014,22,17278,21550,8948,6701,54477,1225,634,253,2112,56589
25-01-2014,23,16331,21065,8826,6491,52714,1063,635,270,1968,54682
26-01-2014,0,14510,20275,8749,6317,49849,1010,614,249,1873,51722
26-01-2014,1,13558,19886,8593,6163,48201,1001,618,259,1878,50079
26-01-2014,2,13151,19553,8596,6077,47378,990,618,286,1894,49272
26-01-2014,3,13163,19422,8601,5886,47073,965,619,284,1868,48941
26-01-2014,4,13379,19430,8633,5898,47339,966,618,280,1864,49203
26-01-2014,5,13892,19609,8732,6069,48302,1007,613,279,1899,50201
26-01-2014,6,14227,19763,8886,6045,48923,1092,630,302,2024,50947
26-01-2014,7,14687,20803,8994,6056,50541,1136,671,269,2076,52617
26-01-2014,8,15706,21234,9091,6255,52286,1204,803,276,2283,54569
26-01-2014,9,17623,22159,9295,6344,55421,1242,928,282,2452,57873
26-01-2014,10,19271,22635,9221,6462,57589,1245,942,285,2472,60061
26-01-2014,11,20110,22939,9242,6543,58835,1230,941,270,2441,61276
26-01-2014,12,20206,23034,9135,6688,59062,1221,940,265,2426,61488
26-01-2014,13,18768,23183,9104,6643,57698,1222,916,268,2406,60104
26-01-2014,14,18079,23141,9212,6697,57128,1225,883,282,2390,59518
26-01-2014,15,18633,23252,9335,6706,57927,1245,928,304,2477,60404
26-01-2014,16,20667,23452,9492,6756,60368,1259,1221,325,2805,63173
26-01-2014,17,22565,23843,9565,6656,62628,1275,1236,336,2847,65475
26-01-2014,18,22000,23997,9515,6800,62312,1260,1181,336,2777,65089
26-01-2014,19,20702,23821,9305,6913,60742,1272,1047,320,2639,63381
26-01-2014,20,19580,22934,9149,6865,58528,1235,936,312,2483,61011
26-01-2014,21,18451,22502,9083,6717,56752,1196,727,310,2233,58985
26-01-2014,22,17115,21899,8940,6559,54514,1118,691,312,2121,56635
26-01-2014,23,15567,21074,8865,6451,51956,925,662,329,1916,53872
27-01-2014,0,14217,20733,8832,6290,50074,901,534,345,1780,51854
27-01-2014,1,13662,20363,8758,6179,48963,911,502,349,1762,50725
27-01-2014,2,13610,20279,8765,6076,48730,912,504,349,1765,50495
27-01-2014,3,13592,20422,8760,6068,48843,937,505,345,1787,50630
27-01-2014,4,14047,20756,9069,6165,50039,1009,518,345,1872,51911
27-01-2014,5,14898,21713,9869,6383,52864,1438,723,387,2548,55412
27-01-2014,6,18133,23777,10746,6887,59544,1522,899,476,2897,62441
27-01-2014,7,22833,25674,11174,7032,66714,1552,1028,740,3320,70034
27-01-2014,8,23332,26327,11208,7196,68066,1528,1064,583,3175,71241
27-01-2014,9,23583,26232,11117,7037,67969,1504,1063,649,3216,71185
27-01-2014,10,23928,26494,10843,6926,68191,1502,1049,488,3039,71230
27-01-2014,11,23445,26334,10379,6839,66995,1435,996,474,2905,69900
27-01-2014,12,23275,26238,10243,6542,66298,1448,1002,479,2929,69227
27-01-2014,13,23340,26202,10454,6331,66328,1457,998,458,2913,69241
27-01-2014,14,23326,26250,10810,6169,66555,1480,982,520,2982,69537
27-01-2014,15,23432,26092,11122,5944,66589,1527,1023,541,3091,69680
27-01-2014,16,24173,26196,11293,5862,67525,1570,1092,499,3161,70686
27-01-2014,17,25148,26237,11299,5926,68609,1589,1112,485,3186,71795
27-01-2014,18,24645,26045,10825,5872,67387,1601,1062,439,3102,70489
27-01-2014,19,23704,25850,10197,5597,65348,1544,1010,383,2937,68285
27-01-2014,20,22316,25500,9826,5443,63086,1419,948,340,2707,65793
27-01-2014,21,21569,24637,9637,5437,61279,1459,724,332,2515,63794
27-01-2014,22,19448,23693,9541,5429,58112,1300,543,308,2151,60263
27-01-2014,23,17436,22541,9280,5254,54510,1154,525,313,1992,56502
28-01-2014,0,17072,21255,9156,5256,52739,1137,520,324,1981,54720
28-01-2014,1,16594,20296,9042,5472,51404,1164,521,332,2017,53421
28-01-2014,2,16120,19951,9111,5552,50733,1191,521,329,2041,52774
28-01-2014,3,15233,20164,9061,5710,50168,1183,518,332,2033,52201
28-01-2014,4,15652,20281,9435,5722,51090,1336,526,331,2193,53283
28-01-2014,5,17122,21511,10301,5835,54769,1598,631,376,2605,57374
28-01-2014,6,20806,23165,11040,6059,61069,1571,838,547,2956,64025
28-01-2014,7,23652,24812,11246,6335,66045,1492,908,852,3252,69297
28-01-2014,8,23943,25353,11263,6541,67102,1498,930,747,3175,70277
28-01-2014,9,23521,24903,11086,6675,66185,1478,975,876,3329,69514
28-01-2014,10,23764,24720,10747,6815,66046,1466,955,513,2934,68980
28-01-2014,11,23659,24720,10552,6581,65513,1406,917,443,2766,68279
28-01-2014,12,23175,24707,10511,6535,64928,1475,889,440,2804,67732
28-01-2014,13,23203,24421,10517,6538,64681,1485,905,471,2861,67542
28-01-2014,14,23055,24591,10841,6423,64910,1499,844,709,3052,67962
28-01-2014,15,22932,24969,11225,6305,65430,1517,872,749,3138,68568
28-01-2014,16,23344,25302,11319,6558,66523,1536,958,1082,3576,70099
28-01-2014,17,23908,25589,11339,6750,67586,1530,1041,932,3503,71089
28-01-2014,18,22916,25540,10951,6990,66397,1539,945,593,3077,69474
28-01-2014,19,22304,25107,10595,6592,64598,1543,933,406,2882,67480
28-01-2014,20,21340,24652,10115,6247,62355,1536,814,349,2699,65054
28-01-2014,21,20556,24063,9619,6036,60275,1541,585,350,2476,62751
28-01-2014,22,19168,23147,9332,5924,57570,1403,534,358,2295,59865
28-01-2014,23,17439,22034,9237,5753,54461,1260,531,353,2144,56605
29-01-2014,0,16518,21218,9162,5500,52397,1193,528,352,2073,54470
29-01-2014,1,15703,20421,9123,5618,50865,1165,529,349,2043,52908
29-01-2014,2,14598,20232,9074,5863,49767,1141,516,357,2014,51781
29-01-2014,3,13980,20169,9156,5810,49115,1150,510,363,2023,51138
29-01-2014,4,14426,20158,9608,5842,50034,1415,522,368,2305,52339
29-01-2014,5,16300,21039,10492,6057,53889,1538,766,408,2712,56601
29-01-2014,6,20286,22593,10990,6305,60174,1536,917,761,3214,63388
29-01-2014,7,23381,24614,11162,6575,65734,1530,1023,1058,3611,69345
29-01-2014,8,23890,25046,11170,6808,66913,1455,1043,1011,3509,70422
29-01-2014,9,23781,25017,11083,6808,66688,1450,1059,913,3422,70110
29-01-2014,10,23695,25166,10846,6856,66562,1463,961,496,2920,69482
29-01-2014,11,23306,25026,10886,6950,66169,1463,854,495,2812,68981
29-01-2014,12,22921,25133,10820,6923,65797,1461,838,495,2794,68591
29-01-2014,13,22604,25275,10819,6955,65655,1464,820,492,2776,68431
29-01-2014,14,22610,25375,11062,7102,66149,1491,915,665,3071,69220
29-01-2014,15,23031,25116,11180,6972,66298,1497,973,823,3293,69591
29-01-2014,16,24014,25079,11194,6885,67171,1494,1056,1073,3623,70794
29-01-2014,17,24683,25717,11287,6900,68586,1542,1100,1039,3681,72267
29-01-2014,18,24123,25549,11038,6744,67455,1541,1006,598,3145,70600
29-01-2014,19,23654,24906,10781,6539,65879,1508,926,421,2855,68734
29-01-2014,20,23107,24221,10228,6446,64002,1473,764,373,2610,66612
29-01-2014,21,21871,23585,9843,6103,61404,1438,545,367,2350,63754
29-01-2014,22,20169,23156,9563,5636,58524,1366,530,341,2237,60761
29-01-2014,23,18051,21962,9363,5466,54842,1221,529,334,2084,56926
30-01-2014,0,16684,21278,9249,5268,52478,1200,528,329,2057,54535
30-01-2014,1,16002,20989,9173,5234,51399,1174,532,324,2030,53429
30-01-2014,2,15574,20904,9129,5251,50859,1141,531,325,1997,52856
30-01-2014,3,15445,20903,9222,5346,50917,1180,530,330,2040,52957
30-01-2014,4,15685,20939,9694,5609,51928,1446,532,338,2316,54244
30-01-2014,5,17552,21630,10653,5756,55591,1533,721,441,2695,58286
30-01-2014,6,20973,23929,11111,6068,62082,1511,947,933,3391,65473
30-01-2014,7,24365,25362,11367,6188,67284,1514,1038,1050,3602,70886
30-01-2014,8,25515,25753,11337,6287,68891,1514,1049,1055,3618,72509
30-01-2014,9,25087,25729,11273,6295,68386,1500,1056,1004,3560,71946
30-01-2014,10,25063,25657,11037,6434,68191,1505,1050,542,3097,71288
30-01-2014,11,24934,25665,10956,6478,68035,1491,1017,530,3038,71073
30-01-2014,12,25037,25407,11004,6380,67828,1484,990,507,2981,70809
30-01-2014,13,24897,25373,11016,6257,67543,1462,934,515,2911,70454
30-01-2014,14,24922,25416,11310,6097,67745,1492,1021,565,3078,70823
30-01-2014,15,24825,25579,11446,5982,67832,1507,1031,959,3497,71329
30-01-2014,16,25171,25752,11474,5964,68361,1537,1093,1103,3733,72094
30-01-2014,17,25544,26199,11469,6153,69367,1553,1123,1028,3704,73071
30-01-2014,18,25244,26008,11271,6155,68678,1572,1049,487,3108,71786
30-01-2014,19,24713,25671,10913,5798,67096,1567,958,412,2937,70033
30-01-2014,20,24070,24796,10481,5422,64771,1545,846,374,2765,67536
30-01-2014,21,23140,24364,9988,5271,62762,1547,603,370,2520,65282
30-01-2014,22,21743,23253,9779,5070,59846,1452,561,365,2378,62224
30-01-2014,23,20300,22256,9526,4862,56944,1371,537,363,2271,59215
31-01-2014,0,18546,21397,9340,4616,53900,1304,532,360,2196,56096
31-01-2014,1,17485,20853,9255,4703,52297,1242,528,356,2126,54423
31-01-2014,2,17077,20573,9211,4958,51819,1213,528,358,2099,53918
31-01-2014,3,17297,20431,9425,5110,52263,1344,530,363,2237,54500
31-01-2014,4,17738,20823,10095,5162,53818,1507,540,402,2449,56267
31-01-2014,5,18068,21627,10942,5413,56049,1604,827,463,2894,58943
31-01-2014,6,21399,24124,11424,5925,62874,1596,1281,662,3539,66413
31-01-2014,7,24568,25341,11617,6467,67992,1595,1337,1053,3985,71977
31-01-2014,8,24851,25712,11678,6742,68983,1594,1340,1055,3989,72972
31-01-2014,9,24805,25865,11633,6516,68819,1608,1367,907,3882,72701
31-01-2014,10,24839,25869,11492,6621,68821,1609,1171,487,3267,72088
31-01-2014,11,24604,25879,11301,6414,68198,1640,1146,552,3338,71536
31-01-2014,12,24284,25667,11310,6381,67644,1625,1096,501,3222,70866
31-01-2014,13,24164,25324,11106,6260,66854,1629,1110,502,3241,70095
31-01-2014,14,24095,25230,11331,5884,66541,1632,1347,554,3533,70074
31-01-2014,15,23991,25084,11414,5497,65987,1629,1431,567,3627,69614
31-01-2014,16,24215,25298,11398,5378,66289,1634,1489,1023,4146,70435
31-01-2014,17,24566,25568,11402,5210,66745,1660,1471,903,4034,70779
31-01-2014,18,24154,25343,11200,5263,65960,1628,1282,478,3388,69348
31-01-2014,19,23709,24584,10844,5398,64534,1592,1045,405,3042,67576
31-01-2014,20,22547,24068,10081,4783,61477,1589,938,359,2886,64363
31-01-2014,21,21585,23150,9432,4435,58602,1566,771,373,2710,61312
31-01-2014,22,20016,22623,8991,4502,56132,1550,723,374,2647,58779
31-01-2014,23,18202,21063,8873,4477,52616,1515,531,440,2486,55102
01-02-2014,0,17621,19708,8690,4409,50429,1400,489,360,2249,52678
01-02-2014,1,16064,19146,8592,4494,48297,1269,488,358,2115,50412
01-02-2014,2,15399,18807,8464,4695,47366,1180,484,353,2017,49383
01-02-2014,3,15140,18808,8444,4900,47292,1177,484,349,2010,49302
01-02-2014,4,15012,18776,8504,5025,47317,1200,484,344,2028,49345
01-02-2014,5,15208,18839,8643,5174,47865,1328,505,339,2172,50037
01-02-2014,6,15783,19392,8923,5235,49332,1321,596,395,2312,51644
01-02-2014,7,16467,20146,9143,5574,51332,1404,686,410,2500,53832
01-02-2014,8,17451,21193,9378,6053,54076,1398,787,331,2516,56592
01-02-2014,9,18470,22142,9441,6189,56243,1404,896,335,2635,58878
01-02-2014,10,18812,22788,9388,6409,57397,1416,927,337,2680,60077
01-02-2014,11,19196,22923,9334,6488,57941,1392,920,338,2650,60591
01-02-2014,12,18653,23052,9267,6495,57467,1376,901,335,2612,60079
01-02-2014,13,18329,22791,9233,6416,56769,1335,858,340,2533,59302
01-02-2014,14,18299,22889,9391,6451,57030,1397,837,323,2557,59587
01-02-2014,15,19632,22972,9773,6380,58758,1390,879,338,2607,61365
01-02-2014,16,20861,23551,10044,6439,60895,1434,1151,344,2929,63824
01-02-2014,17,22153,23983,10116,6309,62562,1432,1207,337,2976,65538
01-02-2014,18,21888,23923,9991,6206,62008,1408,1053,350,2811,64819
01-02-2014,19,20730,23706,9604,6074,60116,1293,973,347,2613,62729
01-02-2014,20,19489,23308,9199,5838,57836,1311,820,342,2473,60309
01-02-2014,21,19111,22646,9053,5735,56544,1358,555,346,2259,58803
01-02-2014,22,18364,21701,8883,5641,54589,1335,487,342,2164,56753
01-02-2014,23,16618,20776,8529,5233,51155,1222,481,335,2038,53193
02-02-2014,0,15109,19722,8256,4843,47930,1001,482,396,1879,49809
02-02-2014,1,14372,18885,8154,4838,46250,958,482,354,1794,48044
02-02-2014,2,13543,18434,8078,4695,44751,963,480,347,1790,46541
02-02-2014,3,12790,18315,8039,4716,43861,1109,477,346,1932,45793
02-02-2014,4,13092,18364,8104,4704,44264,955,478,357,1790,46054
02-02-2014,5,13333,18409,8268,4685,44696,976,477,318,1771,46467
02-02-2014,6,13334,18687,8288,4732,45042,1082,493,319,1894,46936
02-02-2014,7,13632,19023,8500,4869,46026,1085,586,321,1992,48018
02-02-2014,8,14254,19472,8551,5128,47404,1116,715,299,2130,49534
02-02-2014,9,16630,20165,8623,5461,50879,1158,830,293,2281,53160
02-02-2014,10,17986,21271,8683,5660,53602,1153,848,266,2267,55869
02-02-2014,11,18521,21685,8711,5600,54518,1164,890,261,2315,56833
02-02-2014,12,18624,21928,8653,5496,54701,1156,873,261,2290,56991
02-02-2014,13,18175,21936,8732,5466,54308,1143,857,252,2252,56560
02-02-2014,14,17332,22068,8811,5316,53526,1161,852,246,2259,55785
02-02-2014,15,17868,22128,9181,5178,54353,1204,920,237,2361,56714
02-02-2014,16,19736,22374,9458,5137,56705,1253,1171,242,2666,59371
02-02-2014,17,21106,23024,9483,5271,58885,1269,1189,282,2740,61625
02-02-2014,18,21078,23185,9354,5185,58802,1249,1183,261,2693,61495
02-02-2014,19,20707,23000,9028,4933,57669,1210,1112,213,2535,60204
02-02-2014,20,19686,22595,8785,4861,55928,1161,977,207,2345,58273
02-02-2014,21,19105,22090,8725,4820,54740,1107,522,203,1832,56572
02-02-2014,22,18249,21481,8576,4564,52871,1089,494,195,1778,54649
02-02-2014,23,16628,20543,8497,4464,50134,960,464,232,1656,51790
03-02-2014,0,16159,19802,8293,4100,48355,980,461,218,1659,50014
03-02-2014,1,15988,19153,8156,3981,47278,998,460,230,1688,48966
03-02-2014,2,15816,19070,8135,3928,46949,1004,458,214,1676,48625
03-02-2014,3,16311,18824,8193,3764,47094,1008,457,239,1704,48798
03-02-2014,4,16590,19097,8534,3677,47900,1163,461,187,1811,49711
03-02-2014,5,17581,20113,9189,3644,50528,1446,717,243,2406,52934
03-02-2014,6,20541,21733,10072,3817,56164,1461,1015,303,2779,58943
03-02-2014,7,23776,22948,10346,4064,61134,1465,1181,442,3088,64222
03-02-2014,8,24048,23668,10239,4195,62150,1460,1159,481,3100,65250
03-02-2014,9,23905,23481,10246,4176,61808,1450,1167,481,3098,64906
03-02-2014,10,23849,23347,10127,4013,61337,1465,1175,474,3114,64451
03-02-2014,11,23580,23265,9733,4040,60619,1425,1046,469,2940,63559
03-02-2014,12,23209,23329,9587,4075,60200,1437,1056,469,2962,63162
03-02-2014,13,22999,23261,9455,4053,59768,1440,1060,468,2968,62736
03-02-2014,14,22858,23050,9783,4018,59709,1470,1003,467,2940,62649
03-02-2014,15,23053,23219,9893,3921,60085,1477,1005,468,2950,63035
03-02-2014,16,23278,23466,10123,4194,61060,1473,1167,467,3107,64167
03-02-2014,17,23898,23656,10022,4745,62320,1475,1226,462,3163,65483
03-02-2014,18,22954,23733,9532,5040,61258,1458,1174,416,3048,64306
03-02-2014,19,21729,23323,9094,5085,59232,1404,1103,370,2877,62109
03-02-2014,20,20673,22646,8729,5144,57192,1331,1085,211,2627,59819
03-02-2014,21,19607,22476,8580,5200,55862,1252,585,185,2022,57884
03-02-2014,22,18107,21701,8357,5097,53311,1138,531,185,1854,55165
03-02-2014,23,16017,20478,8196,4885,49575,1081,492,184,1757,51332
04-02-2014,0,15514,19621,8123,4633,47891,1116,510,231,1857,49748
04-02-2014,1,15263,19153,8096,4602,47116,1130,528,289,1947,49063
04-02-2014,2,14307,18910,8050,5050,46317,1127,529,292,1948,48265
04-02-2014,3,14572,18926,8064,5043,46605,1101,530,263,1894,48499
04-02-2014,4,15688,19205,8302,4743,47939,1157,531,250,1938,49877
04-02-2014,5,16428,20357,8844,4653,50282,1439,605,333,2377,52659
04-02-2014,6,19564,22088,9922,4516,56089,1473,905,404,2782,58871
04-02-2014,7,22642,23644,9992,4676,60955,1499,945,592,3036,63991
04-02-2014,8,23198,24072,9869,4295,61435,1565,1026,595,3186,64621
04-02-2014,9,23122,23975,9881,4271,61249,1478,1094,540,3112,64361
04-02-2014,10,23234,24089,9833,4258,61412,1480,1078,499,3057,64469
04-02-2014,11,22980,24145,9487,4467,61079,1458,993,361,2812,63891
04-02-2014,12,23041,23780,9377,4372,60571,1450,980,361,2791,63362
04-02-2014,13,22943,23743,9530,4316,60532,1446,982,356,2784,63316
04-02-2014,14,23017,23689,9645,4249,60602,1488,982,447,2917,63519
04-02-2014,15,23065,23559,9889,4261,60774,1492,953,427,2872,63646
04-02-2014,16,23706,23682,10142,4245,61774,1497,1151,398,3046,64820
04-02-2014,17,24499,24005,9996,4508,63008,1508,1221,424,3153,66161
04-02-2014,18,23911,24492,9567,4613,62583,1500,1140,344,2984,65567
04-02-2014,19,23281,23672,9137,4439,60528,1427,1086,301,2814,63342
04-02-2014,20,22605,22917,8697,4330,58549,1311,981,262,2554,61103
04-02-2014,21,21743,22133,8489,4127,56492,1241,731,253,2225,58717
04-02-2014,22,20364,20961,8487,3877,53687,1205,613,242,2060,55747
04-02-2014,23,19139,19745,8266,3627,50778,1165,524,240,1929,52707
05-02-2014,0,17063,18656,8088,3331,47137,1120,517,235,1872,49009
05-02-2014,1,16023,18105,8019,3178,45325,1087,507,229,1823,47148
05-02-2014,2,14559,17945,7970,3287,43761,1058,507,231,1796,45557
05-02-2014,3,13325,17442,7971,3431,42169,1062,514,246,1822,43991
05-02-2014,4,13951,17490,8208,3547,43197,1191,525,236,1952,45149
05-02-2014,5,15536,18886,8941,3774,47136,1585,628,288,2501,49637
05-02-2014,6,20398,21229,9809,4311,55746,1604,885,414,2903,58649
05-02-2014,7,23258,22840,10098,4794,60990,1605,1016,449,3070,64060
05-02-2014,8,23415,23381,9914,4872,61582,1600,1051,557,3208,64790
05-02-2014,9,23115,23124,9800,5079,61118,1594,1046,510,3150,64268
05-02-2014,10,22878,23036,9821,5189,60924,1594,1055,476,3125,64049
05-02-2014,11,22403,23147,9671,5284,60505,1581,895,322,2798,63303
05-02-2014,12,22170,22996,9520,5268,59953,1574,937,330,2841,62794
05-02-2014,13,22279,22793,9565,5240,59877,1529,935,320,2784,62661
05-02-2014,14,22432,22821,9528,5009,59791,1542,935,437,2914,62705
05-02-2014,15,22366,22888,9762,4822,59839,1538,938,425,2901,62740
05-02-2014,16,22770,23124,10292,5033,61219,1584,975,509,3068,64287
05-02-2014,17,23534,23605,10370,5106,62616,1620,1107,539,3266,65882
05-02-2014,18,23108,23881,10102,5011,62103,1644,1037,357,3038,65141
05-02-2014,19,22442,23481,9759,4963,60645,1599,966,329,2894,63539
05-02-2014,20,21677,23136,9263,4862,58939,1475,912,282,2669,61608
05-02-2014,21,19982,22616,8860,4918,56377,1310,577,260,2147,58524
05-02-2014,22,18428,21675,8675,4662,53439,1189,524,248,1961,55400
05-02-2014,23,16042,20040,8417,4462,48961,1172,523,257,1952,50913
06-02-2014,0,14532,18729,8337,3767,45364,1122,522,251,1895,47259
06-02-2014,1,13894,18175,8289,4033,44393,1120,524,239,1883,46276
06-02-2014,2,13721,18051,8282,4265,44318,1097,529,247,1873,46191
06-02-2014,3,13727,18001,8347,4261,44335,1101,529,239,1869,46204
06-02-2014,4,13942,18285,8779,4526,45533,1201,538,240,1979,47512
06-02-2014,5,15422,19027,9305,4884,48637,1580,672,282,2534,51171
06-02-2014,6,18941,21533,10055,5176,55704,1621,905,403,2929,58633
06-02-2014,7,22687,22844,10179,5670,61380,1652,1129,430,3211,64591
06-02-2014,8,22989,23113,10034,5797,61934,1671,1113,486,3270,65204
06-02-2014,9,22671,23062,9965,5822,61520,1647,1099,485,3231,64751
06-02-2014,10,22567,22941,9908,5941,61357,1615,1075,436,3126,64483
06-02-2014,11,21376,22644,9755,6041,59817,1561,980,334,2875,62692
06-02-2014,12,19869,22549,9643,6022,58083,1495,978,330,2803,60886
06-02-2014,13,19478,22312,9633,5975,57397,1463,1007,331,2801,60198
06-02-2014,14,20671,22114,9702,5923,58411,1515,1019,380,2914,61325
06-02-2014,15,21836,22674,9996,5941,60449,1505,1057,365,2927,63376
06-02-2014,16,22372,23275,10336,5875,61860,1534,1099,484,3117,64977
06-02-2014,17,23314,23572,10333,5701,62918,1605,1168,573,3346,66264
06-02-2014,18,22932,23713,10032,5476,62152,1569,1085,311,2965,65117
06-02-2014,19,21863,23432,9791,5313,60399,1547,1052,268,2867,63266
06-02-2014,20,20633,23089,9292,5180,58194,1487,997,220,2704,60898
06-02-2014,21,19215,22167,8976,4815,55174,1350,548,209,2107,57281
06-02-2014,22,18049,20977,8836,4547,52410,1168,507,196,1871,54281
06-02-2014,23,15273,19742,8635,4452,48103,1067,497,194,1758,49861
07-02-2014,0,13068,18822,8528,4212,44630,1003,468,195,1666,46296
07-02-2014,1,12604,18264,8478,4146,43492,1010,470,188,1668,45160
07-02-2014,2,12371,18071,8467,4283,43192,1028,469,187,1684,44876
07-02-2014,3,12644,18118,8490,4586,43838,1044,473,191,1708,45546
07-02-2014,4,12771,18361,8822,4832,44787,1159,531,207,1897,46684
07-02-2014,5,13532,19212,9510,4989,47243,1462,658,269,2389,49632
07-02-2014,6,16859,21471,10249,5585,54164,1599,980,354,2933,57097
07-02-2014,7,20515,23621,10267,6130,60532,1576,1242,395,3213,63745
07-02-2014,8,21231,23691,10277,6244,61443,1603,1065,551,3219,64662
07-02-2014,9,21371,23706,10209,5987,61273,1597,1055,552,3204,64477
07-02-2014,10,21207,24178,10211,5881,61476,1595,1028,463,3086,64562
07-02-2014,11,20311,24337,9894,6060,60602,1493,888,375,2756,63358
07-02-2014,12,19554,24012,9926,5750,59243,1485,877,383,2745,61988
07-02-2014,13,18205,23689,9722,5688,57304,1451,880,409,2740,60044
07-02-2014,14,17907,23429,9682,5512,56532,1409,971,466,2846,59378
07-02-2014,15,18375,24064,9896,5557,57892,1428,941,544,2913,60805
07-02-2014,16,19169,24345,10172,5522,59208,1485,1030,537,3052,62260
07-02-2014,17,20742,24624,10081,5666,61114,1566,1131,536,3233,64347
07-02-2014,18,19998,24275,9695,5887,59856,1563,879,420,2862,62718
07-02-2014,19,19110,23481,9280,5924,57795,1507,817,363,2687,60482
07-02-2014,20,17063,22942,8957,6183,55146,1347,753,333,2433,57579
07-02-2014,21,15713,22360,8725,6367,53168,1182,565,345,2092,55260
07-02-2014,22,14901,21512,8597,6330,51340,1133,464,345,1942,53282
07-02-2014,23,13795,20656,8296,5913,48661,1125,476,327,1928,50589
08-02-2014,0,13227,19656,8146,5454,46483,997,445,315,1757,48240
08-02-2014,1,12726,18724,8074,5222,44747,949,444,312,1705,46452
08-02-2014,2,12471,18676,8038,4940,44125,950,443,308,1701,45826
08-02-2014,3,11775,18694,7986,4516,42972,960,445,303,1708,44680
08-02-2014,4,11647,18730,7948,4569,42895,978,451,301,1730,44625
08-02-2014,5,11727,18954,8074,4434,43188,995,458,319,1772,44960
08-02-2014,6,12433,19267,8277,4197,44173,997,465,323,1785,45958
08-02-2014,7,13124,20216,8362,4595,46297,1151,543,323,2017,48314
08-02-2014,8,14762,21004,8523,4808,49097,1228,637,353,2218,51315
08-02-2014,9,14873,21973,8581,5131,50557,1303,716,341,2360,52917
08-02-2014,10,14472,22098,8690,5363,50623,1274,771,314,2359,52982
08-02-2014,11,14498,22155,8670,5621,50943,1247,774,284,2305,53248
08-02-2014,12,14605,22304,8741,5771,51421,1237,789,252,2278,53699
08-02-2014,13,13979,21995,8612,5393,49980,1217,788,236,2241,52221
08-02-2014,14,13945,21931,8702,5443,50021,1209,764,259,2232,52253
08-02-2014,15,14308,22131,8914,5845,51197,1288,769,243,2300,53497
08-02-2014,16,15096,22432,9195,5878,52602,1301,906,234,2441,55043
08-02-2014,17,17953,23077,8991,5935,55956,1296,940,286,2522,58478
08-02-2014,18,18320,23314,8795,5998,56426,1267,940,299,2506,58932
08-02-2014,19,17336,22772,8685,5870,54662,1147,851,302,2300,56962
08-02-2014,20,15116,22098,8455,5715,51385,1082,732,305,2119,53504
08-02-2014,21,14254,21245,8275,5317,49092,979,569,271,1819,50911
08-02-2014,22,13949,20881,8183,5325,48339,927,522,266,1715,50054
08-02-2014,23,12886,19760,8019,4818,45484,894,458,272,1624,47108
09-02-2014,0,12532,18101,7944,4284,42862,825,448,279,1552,44414
09-02-2014,1,12407,17468,7898,4078,41850,828,444,282,1554,43404
09-02-2014,2,11765,17319,7806,4191,41081,826,444,295,1565,42646
09-02-2014,3,11461,17185,7776,4306,40729,824,443,305,1572,42301
09-02-2014,4,11487,17158,7787,4265,40697,831,449,307,1587,42284
09-02-2014,5,11713,17223,7799,4263,40997,880,446,305,1631,42628
09-02-2014,6,12000,17786,7903,4498,42188,908,450,312,1670,43858
09-02-2014,7,12225,18535,8033,4727,43520,931,520,324,1775,45295
09-02-2014,8,12748,19606,8258,4962,45574,1034,524,326,1884,47458
09-02-2014,9,13815,20474,8314,5275,47877,1077,521,412,2010,49887
09-02-2014,10,14345,21062,8411,5380,49198,1088,570,406,2064,51262
09-02-2014,11,14632,21616,8461,5583,50293,1088,602,400,2090,52383
09-02-2014,12,14213,21628,8319,5668,49830,1082,615,403,2100,51930
09-02-2014,13,14140,21381,8359,5517,49397,1074,613,380,2067,51464
09-02-2014,14,14027,21382,8410,5512,49331,1083,610,373,2066,51397
09-02-2014,15,14114,21410,8475,5558,49556,1107,621,407,2135,51691
09-02-2014,16,14714,22063,8689,5833,51300,1172,757,407,2336,53636
09-02-2014,17,16718,22856,8807,6553,54934,1184,834,412,2430,57364
09-02-2014,18,17536,23346,8764,6629,56275,1195,837,400,2432,58707
09-02-2014,19,17060,22639,8620,6575,54893,1186,793,389,2368,57261
09-02-2014,20,16393,22000,8414,6416,53222,1127,786,333,2246,55468
09-02-2014,21,15269,21561,8279,6024,51131,1060,516,195,1771,52902
09-02-2014,22,14778,20982,8173,5653,49587,943,445,190,1578,51165
09-02-2014,23,12582,19989,8116,5504,46191,841,424,191,1456,47647
10-02-2014,0,12025,19074,7920,5124,44143,798,421,187,1406,45549
10-02-2014,1,11858,18584,7866,5021,43328,801,420,183,1404,44732
10-02-2014,2,11489,18243,7849,4859,42440,794,419,215,1428,43868
10-02-2014,3,11515,18396,7944,4605,42462,837,419,187,1443,43905
10-02-2014,4,11872,18951,8251,4327,43401,907,440,190,1537,44938
10-02-2014,5,13873,19996,8836,4462,47168,1355,547,205,2107,49275
10-02-2014,6,17317,22527,9578,4595,54018,1324,851,451,2626,56644
10-02-2014,7,20154,24143,9716,4513,58527,1378,924,557,2859,61386
10-02-2014,8,20885,24545,9669,4625,59723,1398,918,607,2923,62646
10-02-2014,9,20149,24247,9702,4594,58693,1370,946,590,2906,61599
10-02-2014,10,21016,24051,9620,4589,59278,1349,915,607,2871,62149
10-02-2014,11,20626,24172,9496,4820,59114,1340,891,436,2667,61781
10-02-2014,12,20560,24162,9379,4925,59026,1349,891,412,2652,61678
10-02-2014,13,20859,24112,9329,4206,58504,1341,901,412,2654,61158
10-02-2014,14,21379,24054,9374,3972,58779,1327,903,580,2810,61589
10-02-2014,15,21894,24073,9605,3739,59311,1348,907,546,2801,62112
10-02-2014,16,22234,24285,9818,3587,59925,1359,896,621,2876,62801
10-02-2014,17,22703,24580,9934,4156,61373,1364,969,626,2959,64332
10-02-2014,18,22296,24495,9464,4392,60646,1339,938,452,2729,63375
10-02-2014,19,21685,24204,9228,3942,59058,1326,918,405,2649,61707
10-02-2014,20,20830,23870,8978,3612,57289,1254,848,323,2425,59714
10-02-2014,21,19477,23597,8785,3660,55519,1177,619,190,1986,57505
10-02-2014,22,18172,22626,8501,3462,52760,1112,501,192,1805,54565
10-02-2014,23,16301,21698,8255,3375,49630,1018,421,168,1607,51237
11-02-2014,0,15247,20067,8133,3313,46760,1123,421,173,1717,48477
11-02-2014,1,14843,19584,8121,3219,45768,1005,421,176,1602,47370
11-02-2014,2,14217,19205,8113,3232,44767,948,422,174,1544,46311
11-02-2014,3,13180,18888,8062,3113,43243,943,456,173,1572,44815
11-02-2014,4,13278,18933,8331,3040,43585,986,471,173,1630,45215
11-02-2014,5,15276,20165,8691,3130,47262,1345,611,210,2166,49428
11-02-2014,6,19120,22536,9423,3156,54237,1461,860,369,2690,56927
11-02-2014,7,21834,23899,9558,3494,58784,1522,932,473,2927,61711
11-02-2014,8,22353,23710,9538,3759,59360,1522,971,529,3022,62382
11-02-2014,9,22387,23681,9300,3572,58942,1510,956,565,3031,61973
11-02-2014,10,22875,23747,9387,3591,59600,1509,924,597,3030,62630
11-02-2014,11,22689,23621,9168,3679,59157,1484,887,354,2725,61882
11-02-2014,12,21316,23422,9152,3389,57280,1486,874,365,2725,60005
11-02-2014,13,20320,23580,9260,3406,56567,1483,877,362,2722,59289
11-02-2014,14,20379,23833,9310,3390,56911,1486,890,518,2894,59805
11-02-2014,15,21756,23650,9170,3408,57984,1507,898,503,2908,60892
11-02-2014,16,22602,23602,9562,3401,59168,1514,970,484,2968,62136
11-02-2014,17,23508,24224,9678,3787,61197,1519,1026,500,3045,64242
11-02-2014,18,22926,24282,9321,3941,60471,1498,959,355,2812,63283
11-02-2014,19,21762,24075,9094,3830,58762,1402,958,292,2652,61414
11-02-2014,20,20397,23460,8953,3909,56719,1293,806,312,2411,59130
11-02-2014,21,17663,22871,8754,4303,53591,1225,674,253,2152,55743
11-02-2014,22,15717,21767,8458,4858,50799,1184,607,255,2046,52845
11-02-2014,23,13925,20367,8182,5138,47613,1120,484,267,1871,49484
12-02-2014,0,13064,19077,8004,4669,44814,1090,460,273,1823,46637
12-02-2014,1,12788,18215,7977,4432,43413,1081,442,281,1804,45217
12-02-2014,2,13135,18084,7988,4176,43382,1091,458,309,1858,45240
12-02-2014,3,13320,18455,8011,4144,43931,1078,466,318,1862,45793
12-02-2014,4,14045,19169,8164,4171,45549,1160,470,307,1937,47486
12-02-2014,5,15499,20150,8693,4321,48662,1487,618,300,2405,51067
12-02-2014,6,19347,22447,9418,4408,55620,1565,889,313,2767,58387
12-02-2014,7,22194,23836,9535,4769,60333,1551,1011,329,2891,63224
12-02-2014,8,22762,23887,9461,4832,60944,1547,942,548,3037,63981
12-02-2014,9,22370,23769,9304,4861,60304,1555,916,556,3027,63331
12-02-2014,10,22166,23690,9262,4899,60018,1571,905,431,2907,62925
12-02-2014,11,20680,23630,9136,4956,58401,1532,872,298,2702,61103
12-02-2014,12,19815,23413,9083,5072,57383,1538,861,308,2707,60090
12-02-2014,13,18967,23252,9009,5132,56359,1561,891,306,2758,59117
12-02-2014,14,19554,23588,9205,5088,57435,1566,953,370,2889,60324
12-02-2014,15,20392,23845,9402,4984,58624,1585,929,391,2905,61529
12-02-2014,16,21136,23949,9606,4881,59573,1573,961,405,2939,62512
12-02-2014,17,22555,23981,9604,4959,61098,1570,970,567,3107,64205
12-02-2014,18,21963,24003,9269,5304,60539,1554,917,369,2840,63379
12-02-2014,19,20500,23865,9015,5619,59000,1528,869,262,2659,61659
12-02-2014,20,18235,23157,8648,5849,55889,1346,798,259,2403,58292
12-02-2014,21,16028,22104,8363,5944,52440,1272,470,214,1956,54396
12-02-2014,22,14953,21071,8169,6214,50407,1128,452,198,1778,52185
12-02-2014,23,13728,20236,8035,5813,47812,1091,448,183,1722,49534
13-02-2014,0,12906,19480,8039,5663,46087,999,448,171,1618,47705
13-02-2014,1,12660,18924,8008,5496,45088,966,447,169,1582,46670
13-02-2014,2,12588,18870,8109,5332,44900,936,447,166,1549,46449
13-02-2014,3,12244,19002,8171,5257,44675,924,449,163,1536,46211
13-02-2014,4,12896,19531,8370,5210,46007,1046,463,162,1671,47678
13-02-2014,5,13493,20645,8905,5367,48411,1379,616,188,2183,50594
13-02-2014,6,15695,22590,9579,5835,53699,1409,826,289,2524,56223
13-02-2014,7,18810,24446,9766,6150,59173,1404,874,490,2768,61941
13-02-2014,8,19340,24976,9726,6033,60078,1397,950,494,2841,62919
13-02-2014,9,19309,24667,9607,6229,59812,1402,949,496,2847,62659
13-02-2014,10,18845,24303,9584,6406,59138,1397,915,492,2804,61942
13-02-2014,11,18331,24305,9513,6465,58614,1392,880,336,2608,61222
13-02-2014,12,18363,24772,9508,6313,58956,1397,895,353,2645,61601
13-02-2014,13,18636,24981,9435,6151,59204,1395,904,335,2634,61838
13-02-2014,14,18814,25111,9518,5960,59404,1396,912,500,2808,62212
13-02-2014,15,19177,25262,9641,5486,59565,1324,905,396,2625,62190
13-02-2014,16,19767,25272,9948,5300,60287,1278,977,493,2748,63035
13-02-2014,17,21390,25074,9957,5408,61828,1386,983,535,2904,64732
13-02-2014,18,21398,25011,9544,5299,61253,1381,946,373,2700,63953
13-02-2014,19,20459,24717,9279,5131,59585,1327,843,342,2512,62097
13-02-2014,20,19479,24302,9087,4594,57462,1337,752,290,2379,59841
13-02-2014,21,18346,23798,8997,4295,55436,1261,547,256,2064,57500
13-02-2014,22,17279,22551,8802,4227,52861,1197,499,224,1920,54781
13-02-2014,23,15611,21099,8482,4010,49200,1136,485,214,1835,51035
14-02-2014,0,13492,19927,8378,3771,45569,1014,453,230,1697,47266
14-02-2014,1,12530,18962,8313,3538,43343,983,453,246,1682,45025
14-02-2014,2,12056,18654,8234,3569,42514,953,453,229,1635,44149
14-02-2014,3,12020,18528,8233,3624,42404,944,453,229,1626,44030
14-02-2014,4,12637,18791,8513,3696,43638,1065,457,243,1765,45403
14-02-2014,5,14893,19993,9120,3855,47862,1441,543,260,2244,50106
14-02-2014,6,18825,22370,9790,4274,55257,1463,786,361,2610,57867
14-02-2014,7,21440,23767,10083,4526,59816,1452,909,395,2756,62572
14-02-2014,8,20987,23786,10553,4568,59894,1439,1052,715,3206,63100
14-02-2014,9,20925,23705,10486,4623,59739,1439,1114,574,3127,62866
14-02-2014,10,19271,23468,10543,4992,58274,1457,885,723,3065,61339
14-02-2014,11,18905,23440,10477,5123,57945,1465,824,546,2835,60780
14-02-2014,12,17744,23226,10456,5007,56432,1474,843,548,2865,59297
14-02-2014,13,17778,23296,10347,5170,56592,1481,840,528,2849,59441
14-02-2014,14,18285,23640,10474,4812,57212,1460,833,535,2828,60040
14-02-2014,15,18587,23695,10622,4673,57575,1467,740,409,2616,60191
14-02-2014,16,19230,23816,10471,4529,58047,1474,1034,749,3257,61304
14-02-2014,17,21235,24127,10109,4644,60115,1426,989,445,2860,62975
14-02-2014,18,21039,24175,9732,4599,59546,1409,915,318,2642,62188
14-02-2014,19,19775,24074,9303,4579,57731,1319,848,269,2436,60167
14-02-2014,20,18073,23302,8988,4844,55207,1186,764,233,2183,57390
14-02-2014,21,15740,22188,8827,5050,51804,1191,542,237,1970,53774
14-02-2014,22,14479,20882,8523,5489,49374,1143,459,181,1783,51157
14-02-2014,23,12446,19855,8369,5567,46235,971,418,185,1574,47809
15-02-2014,0,12374,18779,8114,5646,44913,866,417,178,1461,46374
15-02-2014,1,11978,18241,7971,5803,43992,839,418,173,1430,45422
15-02-2014,2,11555,18162,7902,5677,43298,839,418,169,1426,44724
15-02-2014,3,11646,18192,7850,5537,43225,845,418,173,1436,44661
15-02-2014,4,11878,18364,7895,5584,43721,865,433,171,1469,45190
15-02-2014,5,12165,18629,8075,5694,44564,1046,435,165,1646,46210
15-02-2014,6,12798,19081,8174,5592,45647,1313,526,189,2028,47675
15-02-2014,7,13280,20063,8404,5726,47473,1360,716,201,2277,49750
15-02-2014,8,13669,20788,8459,5940,48855,1360,748,394,2502,51357
15-02-2014,9,14117,21883,8545,6213,50758,1317,821,426,2564,53322
15-02-2014,10,14636,22493,8614,6412,52153,1289,847,429,2565,54718
15-02-2014,11,14486,22790,8540,6499,52315,1291,975,289,2555,54870
15-02-2014,12,14304,22670,8551,6216,51741,1303,785,466,2554,54295
15-02-2014,13,14157,22520,8548,6019,51244,1378,771,299,2448,53692
15-02-2014,14,13909,22457,8598,6046,51011,1371,749,359,2479,53490
15-02-2014,15,13802,22023,9031,6011,50868,1295,778,400,2473,53341
15-02-2014,16,14222,23020,9614,5941,52798,1336,717,359,2412,55210
15-02-2014,17,15973,23343,9737,6501,55554,1359,787,370,2516,58070
15-02-2014,18,16816,23806,9611,6531,56765,1352,756,365,2473,59238
15-02-2014,19,15788,23637,9248,6344,55017,1325,687,359,2371,57388
15-02-2014,20,14091,22670,8975,6137,51874,1224,583,346,2153,54027
15-02-2014,21,13710,21565,8814,5900,49990,1272,459,338,2069,52059
15-02-2014,22,13220,21311,8489,5693,48713,1226,436,321,1983,50696
15-02-2014,23,12866,20202,8295,5529,46894,1012,433,303,1748,48642
16-02-2014,0,12487,19344,8163,5460,45456,895,431,294,1620,47076
16-02-2014,1,12136,18810,8066,5303,44314,886,430,289,1605,45919
16-02-2014,2,12096,18230,7986,4926,43237,856,430,280,1566,44803
16-02-2014,3,11918,18441,7943,5143,43447,850,430,269,1549,44996
16-02-2014,4,11975,18485,7949,5292,43700,895,431,252,1578,45278
16-02-2014,5,11898,18816,8022,5302,44036,905,433,254,1592,45628
16-02-2014,6,12205,18974,8140,4909,44228,912,432,247,1591,45819
16-02-2014,7,12509,19433,8248,4834,45023,875,433,261,1569,46592
16-02-2014,8,12779,19855,8429,5325,46387,956,534,255,1745,48132
16-02-2014,9,13257,20742,8501,5480,47981,1014,631,267,1912,49893
16-02-2014,10,13434,21245,8684,5602,48965,1040,661,264,1965,50930
16-02-2014,11,13351,21493,8625,5839,49308,1039,693,261,1993,51301
16-02-2014,12,13449,21191,8591,5489,48721,1055,697,289,2041,50762
16-02-2014,13,13511,21615,8537,5580,49243,1035,683,280,1998,51241
16-02-2014,14,13330,21774,8499,5618,49221,1013,671,286,1970,51191
16-02-2014,15,13283,21909,8601,5564,49358,1077,661,280,2018,51376
16-02-2014,16,13385,22229,8939,5580,50134,1166,783,,,
16-02-2014,17,14627,22706,9152,5592,52077,1133,878,308,2319,54396
16-02-2014,18,17203,23251,9132,5844,55431,1126,895,295,2316,57747
16-02-2014,19,16918,23138,8961,5940,54957,1078,837,286,2201,57158
16-02-2014,20,16220,22696,8724,5919,53559,1045,728,308,2081,55640
16-02-2014,21,15211,22403,8569,5927,52110,1073,464,345,1882,53992
16-02-2014,22,15085,21716,8338,5855,50994,1062,462,351,1875,52869
16-02-2014,23,13405,20524,8118,5548,47595,934,463,341,1738,49333
17-02-2014,0,12709,19272,7873,5298,45154,889,463,342,1694,46848
17-02-2014,1,12517,18256,7758,4980,43511,864,473,344,1681,45192
17-02-2014,2,12224,18155,7759,4933,43070,871,483,357,1711,44781
17-02-2014,3,11581,18292,7839,4816,42529,880,489,363,1732,44261
17-02-2014,4,11622,18915,8016,4789,43341,955,505,350,1810,45151
17-02-2014,5,12756,20426,8496,4969,46646,1380,629,351,2360,49006
17-02-2014,6,16492,22981,8991,5108,53572,1596,776,589,2961,56533
17-02-2014,7,19927,24435,9119,5057,58537,1601,919,617,3137,61674
17-02-2014,8,20463,24736,9144,4957,59301,1583,896,741,3220,62521
17-02-2014,9,20256,24501,9145,5083,58985,1596,1014,595,3205,62190
17-02-2014,10,20485,24321,9114,5162,59082,1635,990,604,3229,62311
17-02-2014,11,19539,24200,8906,5268,57913,1643,845,583,3071,60984
17-02-2014,12,18905,23967,8977,5498,57347,1578,875,617,3070,60417
17-02-2014,13,18561,23973,8866,5374,56775,1523,879,619,3021,59796
17-02-2014,14,18830,23754,9057,5109,56750,1550,865,613,3028,59778
17-02-2014,15,19302,23734,8953,4454,56442,1625,877,590,3092,59534
17-02-2014,16,19836,23736,9167,4049,56786,1634,942,579,3155,59941
17-02-2014,17,21195,24512,9278,3927,58913,1650,912,834,3396,62309
17-02-2014,18,21899,24723,9064,3915,59600,1645,894,536,3075,62675
17-02-2014,19,21404,24326,8871,3777,58377,1499,869,524,2892,61269
17-02-2014,20,20099,24152,8745,3520,56516,1412,806,482,2700,59216
17-02-2014,21,19395,23633,8596,3394,55016,1343,715,345,2403,57419
17-02-2014,22,17936,22772,8413,3389,52510,1301,524,340,2165,54675
17-02-2014,23,16045,21629,8260,3338,49273,1272,487,319,2078,51351
18-02-2014,0,15425,20391,8183,3147,47146,1174,493,333,2000,49146
18-02-2014,1,15289,19664,8112,3183,46247,1014,490,323,1827,48074
18-02-2014,2,14849,19642,8109,3414,46015,1032,495,316,1843,47858
18-02-2014,3,14209,19643,8137,3460,45449,1019,497,322,1838,47287
18-02-2014,4,14596,19780,8135,3654,46165,1052,520,301,1873,48038
18-02-2014,5,16640,20947,8544,3620,49751,1297,678,309,2284,52035
18-02-2014,6,19651,22643,9006,3767,55066,1417,837,465,2719,57785
18-02-2014,7,22006,23644,9074,4282,59006,1517,882,561,2960,61966
18-02-2014,8,22567,24140,9215,4298,60219,1547,973,648,3168,63387
18-02-2014,9,22607,24112,9116,4474,60310,1553,935,627,3115,63425
18-02-2014,10,22396,23824,9055,4588,59863,1528,936,616,3080,62943
18-02-2014,11,22010,23725,9065,4540,59342,1463,833,544,2840,62182
18-02-2014,12,21171,23849,9022,4670,58712,1369,841,553,2763,61475
18-02-2014,13,21325,23783,9005,4593,58708,1386,825,545,2756,61464
18-02-2014,14,21610,23794,8983,4458,58845,1466,833,544,2843,61688
18-02-2014,15,21478,23764,8979,4417,58637,1474,865,519,2858,61495
18-02-2014,16,21897,23836,9075,4182,58991,1555,943,518,3016,62007
18-02-2014,17,23441,24109,9283,4200,61034,1553,1025,596,3174,64208
18-02-2014,18,23489,24094,9154,4244,60982,1538,933,395,2866,63848
18-02-2014,19,22725,23866,9023,4044,59658,1421,914,379,2714,62372
18-02-2014,20,21551,23413,8942,3906,57812,1316,829,349,2494,60306
18-02-2014,21,20390,22910,8842,3715,55858,1280,748,331,2359,58217
18-02-2014,22,19025,22264,8728,3434,53453,1246,604,262,2112,55565
18-02-2014,23,16979,21270,8508,3166,49924,1224,508,230,1962,51886
19-02-2014,0,16971,19978,8299,3020,48267,1012,492,212,1716,49983
19-02-2014,1,16575,19314,8310,2874,47073,992,480,194,1666,48739
19-02-2014,2,14425,19005,8248,2724,44403,992,480,182,1654,46057
19-02-2014,3,13582,18774,8234,2469,43060,955,480,174,1609,44669
19-02-2014,4,14521,19052,8343,2388,44303,999,529,215,1743,46046
19-02-2014,5,17268,20239,8808,2490,48805,1241,651,296,2188,50993
19-02-2014,6,21614,22568,9223,2831,56236,1426,781,519,2726,58962
19-02-2014,7,23583,23951,9508,3352,60395,1437,876,558,2871,63266
19-02-2014,8,23929,24220,9659,3521,61328,1446,1003,551,3000,64328
19-02-2014,9,24060,24233,9658,3647,61598,1447,956,568,2971,64569
19-02-2014,10,24208,24079,9525,3877,61690,1428,914,581,2923,64613
19-02-2014,11,23948,24014,9322,3889,61173,1432,748,544,2724,63897
19-02-2014,12,23647,24076,9306,3709,60739,1415,779,540,2734,63473
19-02-2014,13,22985,23998,9244,3791,60018,1410,802,539,2751,62769
19-02-2014,14,22745,23579,9289,3720,59335,1413,817,538,2768,62103
19-02-2014,15,22831,23519,9378,3555,59281,1431,943,558,2932,62213
19-02-2014,16,23239,23840,9506,3561,60146,1435,943,538,2916,63062
19-02-2014,17,24013,24215,9684,3588,61500,1424,930,729,3083,64583
19-02-2014,18,24421,24174,9633,3821,62048,1434,784,359,2577,64625
19-02-2014,19,23916,23947,9359,3833,61057,1447,743,316,2506,63563
19-02-2014,20,22837,23486,9189,3644,59155,1418,623,291,2332,61487
19-02-2014,21,22008,22823,9046,3432,57308,1318,575,256,2149,59457
19-02-2014,22,20592,21931,8869,3318,54710,1229,543,227,1999,56709
19-02-2014,23,18596,20889,8484,3417,51386,1195,526,213,1934,53320
20-02-2014,0,16718,19564,8393,3144,47818,1260,455,199,1914,49732
20-02-2014,1,15638,19052,8339,3029,46058,1054,447,198,1699,47757
20-02-2014,2,14502,18892,8213,3153,44760,991,447,196,1634,46394
20-02-2014,3,13863,18870,8199,2966,43898,972,447,197,1616,45514
20-02-2014,4,14257,18995,8436,2919,44608,1023,449,214,1686,46294
20-02-2014,5,16990,20015,9138,2872,49016,1391,519,282,2192,51208
20-02-2014,6,21202,22283,9683,3459,56626,1507,699,401,2607,59233
20-02-2014,7,23781,23643,9895,3962,61282,1511,765,515,2791,64073
20-02-2014,8,23974,23867,9936,4331,62109,1505,920,513,2938,65047
20-02-2014,9,23841,23900,9910,4385,62036,1501,919,518,2938,64974
20-02-2014,10,23251,23798,9805,4528,61382,1500,848,568,2916,64298
20-02-2014,11,23006,23416,9619,4620,60662,1498,732,425,2655,63317
20-02-2014,12,22431,22838,9551,4503,59324,1497,757,415,2669,61993
20-02-2014,13,22217,22815,9495,4512,59038,1537,768,406,2711,61749
20-02-2014,14,21887,22849,9647,4670,59055,1511,794,527,2832,61887
20-02-2014,15,21845,23231,9615,5082,59772,1519,783,492,2794,62566
20-02-2014,16,21947,23473,9844,5406,60671,1519,831,529,2879,63550
20-02-2014,17,23214,23710,9965,5546,62436,1526,1145,557,3228,65664
20-02-2014,18,22987,23969,9685,5782,62423,1523,779,352,2654,65077
20-02-2014,19,21523,23950,9390,5920,60784,1448,711,346,2505,63289
20-02-2014,20,19554,23770,9049,5893,58264,1324,653,270,2247,60511
20-02-2014,21,17511,23458,8901,5773,55642,1313,555,225,2093,57735
20-02-2014,22,15795,22180,8832,5532,52339,1113,454,200,1767,54106
20-02-2014,23,14613,20915,8566,5152,49247,1039,445,213,1697,50944
21-02-2014,0,13707,19926,8466,4759,46858,1059,428,204,1691,48549
21-02-2014,1,13449,19440,8444,4657,45989,1048,429,187,1664,47653
21-02-2014,2,13222,19512,8355,4537,45626,1032,429,179,1640,47266
21-02-2014,3,13228,19725,8434,4304,45693,1012,459,218,1689,47382
21-02-2014,4,13562,20046,8678,4261,46547,1065,548,226,1839,48386
21-02-2014,5,15030,20974,9323,4432,49759,1493,643,232,2368,52127
21-02-2014,6,18684,23348,9889,4864,56785,1602,804,268,2674,59459
21-02-2014,7,21527,24798,9949,4768,61042,1610,972,407,2989,64031
21-02-2014,8,22711,24961,9949,4483,62105,1596,999,422,3017,65122
21-02-2014,9,22807,24802,9815,4207,61630,1598,963,409,2970,64600
21-02-2014,10,22801,24876,9675,4131,61483,1592,1069,463,3124,64607
21-02-2014,11,22175,25050,9492,4090,60807,1613,855,394,2862,63669
21-02-2014,12,21795,25019,9475,3997,60287,1617,870,395,2882,63169
21-02-2014,13,20741,24658,9264,3892,58557,1617,899,369,2885,61442
21-02-2014,14,20180,24151,9265,3835,57432,1626,927,354,2907,60339
21-02-2014,15,19852,23810,9273,3630,56566,1640,932,289,2861,59427
21-02-2014,16,20444,23665,9473,3705,57288,1608,965,312,2885,60173
21-02-2014,17,21851,24193,9640,3831,59514,1624,1264,356,3244,62758
21-02-2014,18,21868,24469,9240,3921,59499,1631,1058,350,3039,62538
21-02-2014,19,20633,24263,9022,3933,57851,1426,889,350,2665,60516
21-02-2014,20,19040,23876,8580,4225,55721,1281,806,327,2414,58135
21-02-2014,21,17683,22914,8801,4444,53842,1273,689,278,2240,56082
21-02-2014,22,16880,21948,8590,4442,51859,1177,677,275,2129,53988
21-02-2014,23,15399,20864,8177,4510,48950,1179,427,268,1874,50824
22-02-2014,0,13733,19052,8119,4677,45581,969,379,262,1610,47191
22-02-2014,1,12990,18186,7975,4709,43860,939,363,250,1552,45412
22-02-2014,2,12389,17945,7838,4742,42914,935,360,244,1539,44453
22-02-2014,3,11982,17737,7819,4860,42399,935,361,222,1518,43917
22-02-2014,4,12172,17573,7817,4866,42430,942,362,217,1521,43951
22-02-2014,5,12512,17745,8062,5095,43413,898,380,258,1536,44949
22-02-2014,6,13185,18458,8375,5274,45292,953,476,241,1670,46962
22-02-2014,7,13507,19453,8526,5550,47037,1012,510,251,1773,48810
22-02-2014,8,15017,20740,8659,5761,50176,1132,654,261,2047,52223
22-02-2014,9,16003,21169,8783,6058,52015,1142,756,254,2152,54167
22-02-2014,10,15521,21312,8903,6172,51909,1138,754,241,2133,54042
22-02-2014,11,14843,21212,8915,6026,50998,1131,723,239,2093,53091
22-02-2014,12,14458,21217,8863,5682,50219,1128,697,241,2066,52285
22-02-2014,13,14300,21301,8788,5540,49930,1112,688,240,2040,51970
22-02-2014,14,14432,21637,8850,5683,50601,1108,683,232,2023,52624
22-02-2014,15,15199,22344,8735,5805,52084,1107,677,227,2011,54095
22-02-2014,16,16285,22564,8957,5609,53414,1183,740,225,2148,55562
22-02-2014,17,18173,22821,9186,5324,55504,1222,992,225,2439,57943
22-02-2014,18,18538,23126,9036,5327,56027,1226,895,235,2356,58383
22-02-2014,19,17679,23048,8850,5264,54844,1122,818,242,2182,57026
22-02-2014,20,16180,22864,8739,5136,52921,1027,734,240,2001,54922
22-02-2014,21,14915,22228,8565,5135,50844,977,553,204,1734,52578
22-02-2014,22,14527,21417,8263,4990,49197,968,492,227,1687,50884
22-02-2014,23,13491,20023,7917,4732,46162,936,411,240,1587,47749
23-02-2014,0,11985,18620,7711,4657,42972,912,386,226,1524,44496
23-02-2014,1,11202,17738,7542,4472,40953,904,382,221,1507,42460
23-02-2014,2,10776,17427,7522,4683,40408,902,385,217,1504,41912
23-02-2014,3,10467,17286,7509,4580,39841,908,366,212,1486,41327
23-02-2014,4,10597,17253,7535,4495,39880,909,365,209,1483,41363
23-02-2014,5,11166,17364,7603,4607,40741,910,367,233,1510,42251
23-02-2014,6,11137,17496,7727,4878,41237,907,368,206,1481,42718
23-02-2014,7,11217,17807,7819,4936,41779,908,457,204,1569,43348
23-02-2014,8,12305,18453,8012,5140,43909,944,557,241,1742,45651
23-02-2014,9,13136,19093,8141,5386,45755,991,650,231,1872,47627
23-02-2014,10,13691,19771,8241,5475,47180,965,687,233,1885,49065
23-02-2014,11,13745,20148,8340,5523,47755,957,686,236,1879,49634
23-02-2014,12,13361,20649,8304,5546,47862,954,666,237,1857,49719
23-02-2014,13,13293,20625,8207,5499,47623,944,633,236,1813,49436
23-02-2014,14,13323,20490,8198,5416,47428,925,588,239,1752,49180
23-02-2014,15,13298,20511,8077,5272,47158,954,599,240,1793,48951
23-02-2014,16,13514,20772,8270,5166,47721,1002,666,253,1921,49642
23-02-2014,17,15535,22035,8585,5693,51849,1046,875,264,2185,54034
23-02-2014,18,17035,23031,8522,5885,54473,1074,917,268,2259,56732
23-02-2014,19,16286,23014,8504,6070,53872,1035,852,272,2159,56031
23-02-2014,20,14491,22135,8448,6185,51260,1005,720,277,2002,53262
23-02-2014,21,13595,21431,8136,6077,49238,997,552,243,1792,51030
23-02-2014,22,13150,20915,7996,5980,48043,998,439,265,1702,49745
23-02-2014,23,11915,19736,7624,5838,45112,988,400,289,1677,46789
24-02-2014,0,11491,18702,7324,5400,42918,914,379,290,1583,44501
24-02-2014,1,11022,18261,7322,5095,41701,894,388,282,1564,43265
24-02-2014,2,10749,18137,7309,4869,41064,888,393,279,1560,42624
24-02-2014,3,10806,18067,7365,4591,40828,884,392,267,1543,42371
24-02-2014,4,10994,18406,7659,4310,41370,936,406,284,1626,42996
24-02-2014,5,11619,19696,8268,4093,43675,1240,600,289,2129,45804
24-02-2014,6,15858,22154,8575,4505,51092,1533,782,384,2699,53791
24-02-2014,7,18599,23709,8599,4514,55421,1544,938,442,2924,58345
24-02-2014,8,19323,23697,8680,4685,56385,1536,911,577,3024,59409
24-02-2014,9,18405,23624,8757,4827,55614,1550,905,568,3023,58637
24-02-2014,10,16443,23319,8686,5085,53534,1542,875,546,2963,56497
24-02-2014,11,15552,23149,8536,5353,52591,1511,772,381,2664,55255
24-02-2014,12,14788,22772,8528,5675,51763,1433,772,386,2591,54354
24-02-2014,13,14577,22665,8403,5902,51547,1409,784,385,2578,54125
24-02-2014,14,15281,22467,8441,5993,52181,1409,826,464,2699,54880
24-02-2014,15,15995,23285,8442,5837,53559,1409,815,404,2628,56187
24-02-2014,16,16669,23614,8651,5640,54575,1002,811,410,2223,56798
24-02-2014,17,18382,23854,8891,5528,56653,1509,943,478,2930,59583
24-02-2014,18,18858,24271,8605,5519,57254,1425,877,451,2753,60007
24-02-2014,19,18076,23920,8487,5260,55743,1392,828,404,2624,58367
24-02-2014,20,17163,23840,8221,4975,54200,1172,753,344,2269,56469
24-02-2014,21,16312,23250,8172,4730,52465,1102,678,330,2110,54575
24-02-2014,22,14607,22737,7945,4481,49770,1084,587,298,1969,51739
24-02-2014,23,13210,21124,7656,4091,46081,1067,479,300,1846,47927
25-02-2014,0,12638,19912,7592,3949,44091,1047,395,292,1734,45825
25-02-2014,1,11296,18891,7548,3814,41549,1028,376,277,1681,43230
25-02-2014,2,10651,18484,7470,3725,40331,1020,404,257,1681,42012
25-02-2014,3,10431,18303,7426,3630,39790,1015,412,256,1683,41473
25-02-2014,4,11213,18197,7671,3581,40663,1046,511,264,1821,42484
25-02-2014,5,13597,19620,8207,3689,45110,1321,605,334,2260,47370
25-02-2014,6,18304,21915,8603,4200,53020,1392,764,392,2548,55568
25-02-2014,7,20367,23436,8725,4420,56948,1425,825,544,2794,59742
25-02-2014,8,20904,23241,8780,4335,57262,1464,870,553,2887,60149
25-02-2014,9,20636,23071,8830,4373,56910,1448,863,558,2869,59779
25-02-2014,10,19756,22968,8804,4372,55901,1434,833,544,2811,58712
25-02-2014,11,18473,23428,8703,4437,55040,1366,727,402,2495,57535
25-02-2014,12,18055,23448,8689,4333,54526,1381,701,424,2506,57032
25-02-2014,13,18281,23390,8600,4650,54919,1306,717,442,2465,57384
25-02-2014,14,18175,23338,8586,4778,54878,1305,745,448,2498,57376
25-02-2014,15,18653,22949,8574,4115,54290,1287,733,457,2477,56767
25-02-2014,16,19079,22893,8515,4280,54766,1474,736,447,2657,57423
25-02-2014,17,20389,23064,9054,4395,56902,1538,1093,450,3081,59983
25-02-2014,18,20802,23367,8797,4399,57366,1454,894,458,2806,60172
25-02-2014,19,20199,23179,8660,4294,56334,1220,806,461,2487,58821
25-02-2014,20,18913,22992,8614,4093,54611,1115,776,419,2310,56921
25-02-2014,21,17961,22761,8563,3749,53033,1100,652,351,2103,55136
25-02-2014,22,17237,21977,8385,3449,51050,1100,554,260,1914,52964
25-02-2014,23,15923,20901,8270,3220,48315,1098,456,242,1796,50111
26-02-2014,0,14865,19738,8091,3047,45740,1070,392,233,1695,47435
26-02-2014,1,14270,19208,8059,2899,44435,1065,386,231,1682,46117
26-02-2014,2,14110,19075,8055,2815,44057,1041,389,230,1660,45717
26-02-2014,3,13952,19098,8035,2839,43923,1010,391,229,1630,45553
26-02-2014,4,14908,19675,8187,2882,45654,1031,527,229,1787,47441
26-02-2014,5,16237,20353,8623,2864,48077,1240,635,253,2128,50205
26-02-2014,6,19581,21936,8931,3171,53620,1446,733,420,2599,56219
26-02-2014,7,21370,23504,9093,3543,57511,1467,902,478,2847,60358
26-02-2014,8,21950,23479,9173,3674,58277,1455,953,460,2868,61145
26-02-2014,9,22198,23326,9196,3533,58254,1455,1011,472,2938,61192
26-02-2014,10,22015,23546,9053,3823,58436,1448,972,476,2896,61332
26-02-2014,11,21501,23292,8841,4337,57971,1447,827,477,2751,60722
26-02-2014,12,21471,23182,8789,3740,57183,1412,886,484,2782,59965
26-02-2014,13,21433,23218,8727,4003,57382,1388,843,491,2722,60104
26-02-2014,14,21497,23376,8857,3355,57086,1400,852,468,2720,59806
26-02-2014,15,21744,23393,8888,3278,57303,1377,780,443,2600,59903
26-02-2014,16,21461,23517,9023,3731,57734,1443,816,446,2705,60439
26-02-2014,17,22070,23745,9284,3692,58790,1444,1128,486,3058,61848
26-02-2014,18,22324,23824,9172,4354,59675,1427,911,456,2794,62469
26-02-2014,19,21683,23652,8919,3893,58146,1300,948,461,2709,60855
26-02-2014,20,20702,23122,8555,3356,55736,1227,812,403,2442,58178
26-02-2014,21,20293,22298,8429,2988,54008,1212,719,348,2279,56287
26-02-2014,22,19645,21243,8338,3060,52287,1023,667,219,1909,54196
26-02-2014,23,18096,20321,8258,2663,49340,999,441,233,1673,51013
27-02-2014,0,17214,19453,7976,2495,47136,1007,412,238,1657,48793
27-02-2014,1,16724,18928,7913,2472,46037,962,403,273,1638,47675
27-02-2014,2,16318,18994,7871,2502,45686,954,404,277,1635,47321
27-02-2014,3,16423,19168,7809,2558,45958,949,404,236,1589,47547
27-02-2014,4,16973,19155,8016,2580,46725,1010,518,284,1812,48537
27-02-2014,5,17780,20253,8581,2643,49255,1276,614,285,2175,51430
27-02-2014,6,20026,21996,8970,2865,53857,1450,765,434,2649,56506
27-02-2014,7,21712,23177,9132,3632,57651,1453,914,480,2847,60498
27-02-2014,8,22172,23496,9142,3827,58638,1442,1069,471,2982,61620
27-02-2014,9,22200,23426,9101,3816,58544,1440,1127,462,3029,61573
27-02-2014,10,22176,23487,9065,3936,58665,1432,1081,445,2958,61623
27-02-2014,11,21977,23448,8977,4089,58491,1434,867,455,2756,61247
27-02-2014,12,21333,23215,8890,4168,57606,1436,871,440,2747,60353
27-02-2014,13,20862,22913,8902,4205,56882,1449,873,437,2759,59641
27-02-2014,14,20868,22829,8998,4043,56737,1440,872,434,2746,59483
27-02-2014,15,20839,23089,9074,3952,56954,1403,856,440,2699,59653
27-02-2014,16,20716,23068,9212,3835,56831,1439,855,445,2739,59570
27-02-2014,17,21453,23456,9315,3742,57968,1449,1187,499,3135,61103
27-02-2014,18,21880,23669,9236,3921,58706,1449,965,479,2893,61599
27-02-2014,19,21172,23313,8912,4022,57419,1413,833,505,2751,60170
27-02-2014,20,20458,22506,8733,3978,55675,1183,781,416,2380,58055
27-02-2014,21,19735,21857,8437,3904,53933,1183,691,299,2173,56106
27-02-2014,22,18790,20660,8389,3755,51595,1007,593,303,1903,53498
27-02-2014,23,17236,19965,8104,3659,48964,981,449,268,1698,50662
28-02-2014,0,15488,19423,7996,3414,46321,905,397,236,1538,47859
28-02-2014,1,14802,18927,7972,3324,45024,892,360,296,1548,46572
28-02-2014,2,14751,18782,7956,3168,44658,890,359,290,1539,46197
28-02-2014,3,15455,18869,7996,2911,45232,891,374,233,1498,46730
28-02-2014,4,16456,18931,8150,2790,46327,922,447,296,1665,47992
28-02-2014,5,17066,20351,8713,2719,48849,1320,612,263,2195,51044
28-02-2014,6,19446,22306,9195,2744,53691,1333,737,463,2533,56224
28-02-2014,7,21543,23451,9485,3307,57786,1332,862,526,2720,60506
28-02-2014,8,21952,23684,9314,3605,58557,1334,999,544,2877,61434
28-02-2014,9,22121,23744,9347,3429,58641,1345,915,694,2954,61595
28-02-2014,10,22191,24008,9258,3364,58822,1346,907,522,2775,61597
28-02-2014,11,21921,24034,9033,3319,58307,1358,820,477,2655,60962
28-02-2014,12,21580,23942,8956,3213,57691,1352,812,482,2646,60337
28-02-2014,13,21177,23815,8779,3023,56795,1334,815,462,2611,59406
28-02-2014,14,20964,23637,8868,2878,56346,1322,786,421,2529,58875
28-02-2014,15,20611,23581,8881,2788,55861,1307,775,404,2486,58347
28-02-2014,16,20467,23659,9120,2961,56207,1293,794,409,2496,58703
28-02-2014,17,20864,23763,9285,3182,57095,1323,1040,526,2889,59984
28-02-2014,18,21022,23891,9067,3377,57358,1344,853,513,2710,60068
28-02-2014,19,20568,23439,8688,3211,55908,1291,792,436,2519,58427
28-02-2014,20,19601,22913,8400,2695,53610,1119,730,351,2200,55810
28-02-2014,21,18785,22222,8235,2581,51822,979,663,307,1949,53771
28-02-2014,22,18189,21270,7883,2281,49622,950,557,268,1775,51397
28-02-2014,23,17376,20155,7694,2187,47412,1000,431,271,1702,49114
01-03-2014,0,16797,19221,7686,2130,45835,871,372,200,1443,47278
01-03-2014,1,16238,18725,7717,2065,44746,842,364,195,1401,46147
01-03-2014,2,15986,18407,7675,2017,44086,829,365,191,1385,45471
01-03-2014,3,16194,18320,7636,1996,44147,839,363,188,1390,45537
01-03-2014,4,16685,18294,7622,1954,44556,874,376,190,1440,45996
01-03-2014,5,17266,18711,7711,1974,45662,924,466,196,1586,47248
01-03-2014,6,17122,19406,7786,2024,46338,965,563,203,1731,48069
01-03-2014,7,17489,20586,7897,2030,48001,952,644,257,1853,49854
01-03-2014,8,18796,21369,7982,2125,50272,993,720,261,1974,52246
01-03-2014,9,19611,22050,8190,2307,52157,1043,767,269,2079,54236
01-03-2014,10,20041,22064,8017,2196,52317,1091,782,278,2151,54468
01-03-2014,11,20178,22125,8060,2247,52610,1080,781,278,2139,54749
01-03-2014,12,19605,22067,8042,2174,51887,1033,780,256,2069,53956
01-03-2014,13,19264,21999,8004,2228,51495,1011,737,260,2008,53503
01-03-2014,14,19163,21808,8058,2146,51175,1001,718,249,1968,53143
01-03-2014,15,19416,21935,8159,2229,51739,1033,704,243,1980,53719
01-03-2014,16,19947,22126,8404,2475,52952,1130,764,245,2139,55091
01-03-2014,17,20842,22362,8635,2783,54622,1143,894,267,2304,56926
01-03-2014,18,21259,22793,8561,3289,55902,1144,928,248,2320,58222
01-03-2014,19,20340,22627,8329,3201,54498,1133,886,260,2279,56777
01-03-2014,20,19259,22054,8094,2593,52001,1013,788,268,2069,54070
01-03-2014,21,18373,21761,7951,2616,50700,982,662,205,1849,52549
01-03-2014,22,17424,21276,7912,2725,49338,961,503,207,1671,51009
01-03-2014,23,17013,20077,7735,2802,47628,960,379,193,1532,49160
02-03-2014,0,15732,19383,7705,2749,45570,905,359,175,1439,47009
02-03-2014,1,14773,18705,7659,2733,43869,855,356,248,1459,45328
02-03-2014,2,14386,18130,7621,2855,42993,854,355,243,1452,44445
02-03-2014,3,15165,18205,7584,3084,44039,855,356,175,1386,45425
02-03-2014,4,14593,18166,7595,3281,43635,859,357,177,1393,45028
02-03-2014,5,15071,18260,7634,3363,44327,860,483,218,1561,45888
02-03-2014,6,14073,18653,7655,3451,43832,832,498,248,1578,45410
02-03-2014,7,13767,19420,7718,3450,44354,820,543,200,1563,45917
02-03-2014,8,15196,20957,7837,3576,47565,892,625,217,1734,49299
02-03-2014,9,17064,21919,8005,3534,50524,967,629,224,1820,52344
02-03-2014,10,17693,22458,8101,3543,51794,1001,652,236,1889,53683
02-03-2014,11,17821,22864,8155,3676,52518,1002,649,246,1897,54415
02-03-2014,12,16623,22806,8196,3595,51219,996,649,260,1905,53124
02-03-2014,13,15383,21958,8130,3632,49103,985,655,251,1891,50994
02-03-2014,14,14443,21393,8123,3687,47646,1003,625,237,1865,49511
02-03-2014,15,14588,21434,8176,3598,47797,1026,627,241,1894,49691
02-03-2014,16,14826,22099,8502,3795,49219,1028,662,281,1971,51190
02-03-2014,17,17397,22770,8796,4084,53047,1032,1024,306,2362,55409
02-03-2014,18,19692,22924,8937,4356,55910,1041,978,299,2318,58228
02-03-2014,19,19071,23062,8448,4399,54981,1038,800,265,2103,57084
02-03-2014,20,17702,22703,8023,4397,52823,964,736,273,1973,54796
02-03-2014,21,17041,22422,7907,4186,51557,909,635,265,1809,53366
02-03-2014,22,15899,21874,7799,4051,49624,895,510,260,1665,51289
02-03-2014,23,14655,20216,7672,3780,46324,886,445,272,1603,47927
03-03-2014,0,13140,18821,7511,3786,43259,841,367,239,1447,44706
03-03-2014,1,12009,17812,7478,3819,41119,823,368,235,1426,42545
03-03-2014,2,11324,17268,7421,3764,39777,832,373,237,1442,41219
03-03-2014,3,11168,17242,7448,3648,39506,836,376,252,1464,40970
03-03-2014,4,12158,17499,7672,3870,41199,914,462,269,1645,42844
03-03-2014,5,13944,19285,8270,4429,45930,1312,684,297,2293,48223
03-03-2014,6,17800,21650,8516,4602,52570,1547,835,379,2761,55331
03-03-2014,7,19744,22718,8651,4853,55967,1545,938,569,3052,59019
03-03-2014,8,20495,22739,8752,4928,56914,1546,1017,579,3142,60056
03-03-2014,9,20065,22641,8721,5128,56554,1566,1111,546,3223,59777
03-03-2014,10,19635,22505,8841,5465,56445,1573,967,532,3072,59517
03-03-2014,11,18770,22105,8730,5667,55272,1554,937,468,2959,58231
03-03-2014,12,17922,22209,8624,5933,54688,1549,918,495,2962,57650
03-03-2014,13,17532,22296,8508,6132,54470,1535,943,490,2968,57438
03-03-2014,14,17241,22355,8559,6077,54233,1521,877,496,2894,57127
03-03-2014,15,17127,22321,8713,6164,54325,1503,864,470,2837,57162
03-03-2014,16,17800,22751,8816,5715,55082,1498,819,467,2784,57866
03-03-2014,17,18960,23247,8917,5571,56694,1496,990,752,3238,59932
03-03-2014,18,20234,23644,8672,5673,58223,1496,917,562,2975,61198
03-03-2014,19,19723,23492,8471,5424,57109,1465,916,513,2894,60003
03-03-2014,20,19011,23136,8096,4891,55135,1262,864,427,2553,57688
03-03-2014,21,18275,22764,8066,4500,53605,1202,601,327,2130,55735
03-03-2014,22,16941,22165,7887,4170,51163,1137,485,351,1973,53136
03-03-2014,23,15775,20968,7812,3731,48286,1102,391,323,1816,50102
04-03-2014,0,15226,20150,7689,3329,46394,1097,393,266,1756,48150
04-03-2014,1,15086,19548,7700,3096,45429,1080,399,243,1722,47151
04-03-2014,2,14738,19547,7687,2896,44868,1069,399,238,1706,46574
04-03-2014,3,15287,19549,7669,2819,45324,1082,402,244,1728,47052
04-03-2014,4,16185,19951,7745,2809,46690,1159,504,256,1919,48609
04-03-2014,5,17083,21125,8159,2677,49044,1408,673,329,2410,51454
04-03-2014,6,19518,22819,8673,3020,54030,1476,787,357,2620,56650
04-03-2014,7,21413,23690,8773,3574,57449,1511,924,548,2983,60432
04-03-2014,8,21987,23343,8869,4009,58210,1562,1051,505,3118,61328
04-03-2014,9,21887,22963,8960,3793,57604,1476,997,598,3071,60675
04-03-2014,10,21279,23428,8888,3728,57325,1456,957,464,2877,60202
04-03-2014,11,21004,22834,8725,3665,56229,1435,914,398,2747,58976
04-03-2014,12,20958,22706,8541,3363,55568,1445,929,397,2771,58339
04-03-2014,13,20866,23137,8462,3353,55819,1442,908,380,2730,58549
04-03-2014,14,20639,23481,8491,3353,55964,1373,904,377,2654,58618
04-03-2014,15,20706,23507,8514,3418,56143,1393,885,384,2662,58805
04-03-2014,16,20526,23673,8609,3501,56309,1418,867,382,2667,58976
04-03-2014,17,21344,23857,8883,3493,57577,1489,999,549,3037,60614
04-03-2014,18,21767,23836,8698,3724,58028,1465,963,389,2817,60845
04-03-2014,19,21280,23903,8566,3733,57483,1475,927,324,2726,60209
04-03-2014,20,19889,23654,8237,3436,55217,1411,889,308,2608,57825
04-03-2014,21,19346,23063,8127,3139,53676,1292,612,241,2145,55821
04-03-2014,22,18028,22488,7931,2783,51231,1172,484,238,1894,53125
04-03-2014,23,16855,21242,7812,2597,48504,1155,401,213,1769,50273
05-03-2014,0,15830,20023,7664,2500,46018,1148,385,195,1728,47746
05-03-2014,1,15440,19200,7639,2439,44720,1144,386,189,1719,46439
05-03-2014,2,15309,19107,7635,2359,44412,1132,393,191,1716,46128
05-03-2014,3,15861,19029,7676,2389,44956,1150,411,199,1760,46716
05-03-2014,4,16997,19432,7702,2413,46544,1248,535,214,1997,48541
05-03-2014,5,18162,20466,8035,2463,49128,1518,672,273,2463,51591
05-03-2014,6,19595,22174,8503,3109,53381,1558,806,431,2795,56176
05-03-2014,7,21533,23582,8662,3127,56905,1559,980,490,3029,59934
05-03-2014,8,22357,23603,8664,3229,57853,1539,1018,489,3046,60899
05-03-2014,9,22487,23529,8738,3217,57971,1529,1014,446,2989,60960
05-03-2014,10,22400,23588,8604,3421,58013,1517,935,453,2905,60918
05-03-2014,11,21636,23601,8564,3270,57071,1512,888,265,2665,59736
05-03-2014,12,21715,23215,8507,3192,56630,1500,884,265,2649,59279
05-03-2014,13,21559,23109,8415,3061,56145,1504,921,260,2685,58830
05-03-2014,14,21439,23177,8436,3019,56072,1499,920,275,2694,58766
05-03-2014,15,21076,23826,8420,2998,56320,1503,912,451,2866,59186
05-03-2014,16,20901,24064,8580,3043,56588,1500,900,434,2834,59422
05-03-2014,17,21499,24161,8949,3300,57910,1520,1032,457,3009,60919
05-03-2014,18,21932,24026,8763,3683,58403,1565,974,440,2979,61382
05-03-2014,19,21500,23840,8545,3762,57648,1584,939,270,2793,60441
05-03-2014,20,20544,23188,8342,3461,55535,1538,870,253,2661,58196
05-03-2014,21,20213,22407,8149,2987,53755,1497,607,173,2277,56032
05-03-2014,22,19052,21703,7995,2738,51488,1394,517,168,2079,53567
05-03-2014,23,17446,20814,7891,2651,48801,1254,402,163,1819,50620
06-03-2014,0,15623,20269,7807,2466,46165,1101,380,162,1643,47808
06-03-2014,1,14909,19940,7805,2496,45151,1074,379,161,1614,46765
06-03-2014,2,14035,19727,7753,2720,44236,1050,379,161,1590,45826
06-03-2014,3,14538,19912,7758,2779,44988,1068,379,184,1631,46619
06-03-2014,4,15512,20186,7846,2960,46503,1118,479,165,1762,48265
06-03-2014,5,16546,20701,8215,3117,48578,1328,687,246,2261,50839
06-03-2014,6,18807,22343,8623,3385,53158,1400,815,421,2636,55794
06-03-2014,7,20636,23396,8794,3776,56601,1416,995,467,2878,59479
06-03-2014,8,20704,23712,8885,4070,57370,1443,953,606,3002,60372
06-03-2014,9,19883,23380,8920,4266,56450,1448,1025,466,2939,59389
06-03-2014,10,19864,23037,8873,4400,56174,1461,989,432,2882,59056
06-03-2014,11,19490,22695,8634,4490,55310,1460,909,431,2800,58110
06-03-2014,12,19080,23016,8551,4673,55321,1450,911,433,2794,58115
06-03-2014,13,18800,22855,8376,4761,54792,1402,874,437,2713,57505
06-03-2014,14,18796,23191,8408,4822,55216,1329,870,437,2636,57852
06-03-2014,15,18632,23449,8444,4812,55337,1273,919,433,2625,57962
06-03-2014,16,18146,23172,8563,4682,54563,1415,914,430,2759,57322
06-03-2014,17,19330,23183,8947,4554,56015,1447,1068,462,2977,58992
06-03-2014,18,20366,23386,8816,4886,57453,1442,1014,430,2886,60339
06-03-2014,19,20035,23174,8447,4715,56372,1242,954,421,2617,58989
06-03-2014,20,18542,22896,8181,4833,54453,1206,788,426,2420,56873
06-03-2014,21,17557,22297,7972,4924,52750,1217,579,178,1974,54724
06-03-2014,22,15741,21672,7803,4919,50134,1156,431,161,1748,51882
06-03-2014,23,14210,20596,7630,4860,47298,1117,407,159,1683,48981
07-03-2014,0,13093,19486,7406,4708,44694,999,392,161,1552,46246
07-03-2014,1,12687,19341,7432,4584,44045,993,388,186,1567,45612
07-03-2014,2,12159,19288,7376,4696,43519,1009,387,187,1583,45102
07-03-2014,3,12611,19170,7446,4646,43873,995,388,208,1591,45464
07-03-2014,4,13159,19492,7553,4726,44931,1039,547,221,1807,46738
07-03-2014,5,14216,20217,8080,4853,47368,1440,704,244,2388,49756
07-03-2014,6,15974,22123,8562,5064,51723,1465,836,413,2714,54437
07-03-2014,7,17597,23671,8768,5177,55213,1446,1077,417,2940,58153
07-03-2014,8,18319,23948,8938,5365,56571,1475,1062,584,3121,59692
07-03-2014,9,18157,23976,8961,5557,56650,1460,1166,419,3045,59695
07-03-2014,10,17971,23918,8855,5615,56360,1469,1026,420,2915,59275
07-03-2014,11,17390,23778,8724,5820,55712,1489,955,424,2868,58580
07-03-2014,12,16430,23429,8625,5945,54429,1476,960,431,2867,57296
07-03-2014,13,15574,23246,8406,6309,53536,1475,940,437,2852,56388
07-03-2014,14,15145,22685,8304,6392,52525,1472,893,444,2809,55334
07-03-2014,15,15670,22729,8342,6356,53097,1486,823,460,2769,55866
07-03-2014,16,15449,23153,8541,6223,53365,1481,829,473,2783,56148
07-03-2014,17,15782,23668,8929,6204,54582,1483,967,480,2930,57512
07-03-2014,18,16433,23964,8648,6142,55188,1492,919,475,2886,58074
07-03-2014,19,15948,23699,8322,5826,53796,1372,855,488,2715,56511
07-03-2014,20,14900,23263,8076,5447,51686,1143,855,345,2343,54029
07-03-2014,21,14233,22823,7889,5427,50371,1131,665,371,2167,52538
07-03-2014,22,13608,21852,7720,5193,48376,1129,447,282,1858,50234
07-03-2014,23,12713,21211,7486,4855,46264,1078,368,326,1772,48036
08-03-2014,0,13044,20269,7302,4472,45087,938,219,308,1465,46552
08-03-2014,1,12948,20062,7291,4166,44467,914,212,315,1441,45908
08-03-2014,2,13024,19923,7273,3990,44208,920,215,336,1471,45679
08-03-2014,3,13198,20013,7307,3663,44181,915,217,346,1478,45659
08-03-2014,4,13697,20028,7379,3385,44489,919,216,351,1486,45975
08-03-2014,5,13958,20480,7560,3259,45256,919,207,352,1478,46734
08-03-2014,6,14348,21083,7577,3095,46103,899,241,366,1506,47609
08-03-2014,7,15684,21800,7855,2935,48274,900,299,377,1576,49850
08-03-2014,8,16574,22774,8047,2929,50326,969,424,352,1745,52071
08-03-2014,9,17086,23217,8000,2992,51295,1080,451,324,1855,53150
08-03-2014,10,16736,22598,7938,3164,50435,1091,432,329,1852,52287
08-03-2014,11,15083,21859,7818,3467,48229,1057,430,303,1790,50019
08-03-2014,12,13900,20751,7663,3559,45873,1086,427,288,1801,47674
08-03-2014,13,13641,20202,7620,3497,44959,1068,406,273,1747,46706
08-03-2014,14,13521,20041,7569,3378,44507,1030,383,271,1684,46191
08-03-2014,15,13676,20207,7734,3421,45037,1021,384,257,1662,46699
08-03-2014,16,15477,21488,8044,3373,48382,1076,430,249,1755,50137
08-03-2014,17,17678,22350,8563,3269,51861,1062,518,252,1832,53693
08-03-2014,18,18462,22955,8779,3664,53861,1064,656,258,1978,55839
08-03-2014,19,17292,22886,8351,4156,52686,1066,633,252,1951,54637
08-03-2014,20,15925,22256,7892,4403,50477,944,565,250,1759,52236
08-03-2014,21,13941,20928,8001,4451,47321,881,293,212,1386,48707
08-03-2014,22,13323,20319,7821,4469,45933,847,240,210,1297,47230
08-03-2014,23,12294,19472,7390,4303,43459,790,194,204,1188,44647
09-03-2014,0,11310,18639,7401,4336,41687,762,177,200,1139,42826
09-03-2014,1,10724,18087,7171,4346,40327,765,181,201,1147,41474
09-03-2014,2,10516,17798,7082,4057,39454,753,185,203,1141,40595
09-03-2014,3,10261,17920,7015,3872,39068,767,187,193,1147,40215
09-03-2014,4,10028,17868,7023,3900,38819,778,190,193,1161,39980
09-03-2014,5,9992,17955,7123,3855,38924,825,228,207,1260,40184
09-03-2014,6,9754,17565,7153,3817,38291,852,259,267,1378,39669
09-03-2014,7,10097,17957,7210,3823,39086,857,344,272,1473,40559
09-03-2014,8,11305,18665,7411,4072,41454,966,424,286,1676,43130
09-03-2014,9,12045,19587,7499,4373,43505,941,481,295,1717,45222
09-03-2014,10,12109,20101,7605,4542,44358,932,493,295,1720,46078
09-03-2014,11,11967,20195,7596,4667,44424,951,429,321,1701,46125
09-03-2014,12,11451,19965,7440,4655,43509,926,403,331,1660,45169
09-03-2014,13,11323,19488,7366,4637,42815,916,380,321,1617,44432
09-03-2014,14,11117,19281,7407,4543,42348,900,353,330,1583,43931
09-03-2014,15,11222,19289,7421,4458,42390,905,350,339,1594,43984
09-03-2014,16,11796,19903,7691,4502,43893,942,387,325,1654,45547
09-03-2014,17,14345,21208,8143,4532,48229,1054,526,331,1911,50140
09-03-2014,18,16313,22708,8314,4496,51830,1085,709,361,2155,53985
09-03-2014,19,16038,22976,8169,4422,51606,1075,614,383,2072,53678
09-03-2014,20,15553,22474,7804,4098,49928,991,510,398,1899,51827
09-03-2014,21,14880,22298,7796,3897,48870,920,249,396,1565,50435
09-03-2014,22,14294,21623,7542,3698,47157,872,237,370,1479,48636
09-03-2014,23,13377,20409,7296,3408,44489,852,207,341,1400,45889
10-03-2014,0,11872,19524,7228,3052,41677,875,203,323,1401,43078
10-03-2014,1,10576,18691,7072,2824,39163,823,206,304,1333,40496
10-03-2014,2,10709,18354,7056,2824,38944,822,217,291,1330,40274
10-03-2014,3,10582,18214,6934,2986,38716,828,228,295,1351,40067
10-03-2014,4,10758,18238,7073,3274,39342,877,238,294,1409,40751
10-03-2014,5,13140,19824,7607,3482,44052,1177,476,299,1952,46004
10-03-2014,6,16791,22001,7823,3555,50172,1187,656,367,2210,52382
10-03-2014,7,19455,23283,8180,3504,54421,1334,772,445,2551,56972
10-03-2014,8,20021,23656,8304,3595,55576,1405,767,509,2681,58257
10-03-2014,9,19958,23512,8345,3559,55374,1429,788,416,2633,58007
10-03-2014,10,19737,23527,8203,3549,55018,1429,745,435,2609,57627
10-03-2014,11,19420,23463,8090,3258,54231,1443,712,386,2541,56772
10-03-2014,12,18427,23298,8049,3297,53071,1450,705,430,2585,55656
10-03-2014,13,18065,23260,7989,3361,52676,1454,705,383,2542,55218
10-03-2014,14,18116,23405,7969,3400,52890,1311,691,376,2378,55268
10-03-2014,15,17884,23285,7964,3593,52726,1074,688,352,2114,54840
10-03-2014,16,17722,23442,8058,3346,52568,1095,690,348,2133,54701
10-03-2014,17,18369,23383,8309,3558,53620,1351,716,407,2474,56094
10-03-2014,18,19151,23780,8412,3745,55088,1508,884,431,2823,57911
10-03-2014,19,19110,23741,8351,3728,54931,1335,721,455,2511,57442
10-03-2014,20,18461,23229,8070,3424,53186,1168,703,413,2284,55470
10-03-2014,21,17890,22426,7960,3069,51345,1111,422,327,1860,53205
10-03-2014,22,16682,21776,7612,2896,48965,1094,328,276,1698,50663
10-03-2014,23,15323,20784,7454,2599,46161,1017,308,258,1583,47744
11-03-2014,0,13409,19983,7332,2521,43247,1021,230,225,1476,44723
11-03-2014,1,13214,19668,7242,2659,42783,1057,198,207,1462,44245
11-03-2014,2,12456,18978,7145,2562,41141,1059,209,213,1481,42622
11-03-2014,3,12068,18688,7156,2421,40333,1062,320,205,1587,41920
11-03-2014,4,13215,19023,7235,2278,41752,1074,510,202,1786,43538
11-03-2014,5,15658,20453,7721,2345,46176,1244,595,230,2069,48245
11-03-2014,6,18477,22547,8123,2651,51800,1378,623,260,2261,54061
11-03-2014,7,20162,23768,8418,3014,55363,1481,759,409,2649,58012
11-03-2014,8,20582,23578,8450,3311,55921,1503,837,405,2745,58666
11-03-2014,9,20251,23263,8337,3216,55066,1507,,354,,
11-03-2014,10,19947,22982,8235,3054,54218,1505,762,338,2605,56823
11-03-2014,11,19183,22956,7920,2883,52943,1517,739,253,2509,55452
11-03-2014,12,18381,22648,7757,2731,51516,1500,718,276,2494,54010
11-03-2014,13,18285,22056,7800,2662,50804,1444,717,286,2447,53251
11-03-2014,14,18120,22148,7767,2509,50544,1442,716,290,2448,52992
11-03-2014,15,18250,22085,7845,2484,50664,1490,742,291,2523,53187
11-03-2014,16,18260,22207,8048,2652,51168,1414,684,349,2447,53615
11-03-2014,17,18822,22480,8298,2655,52258,1465,771,534,2770,55028
11-03-2014,18,19523,23385,8406,2888,54205,1468,827,312,2607,56812
11-03-2014,19,19465,23580,8206,3174,54425,1474,822,276,2572,56997
11-03-2014,20,18810,22946,8012,2933,52702,1204,754,266,2224,54926
11-03-2014,21,18349,22675,7937,2587,51547,1092,582,251,1925,53472
11-03-2014,22,17153,22149,7720,2441,49463,1035,393,235,1663,51126
11-03-2014,23,15830,21319,7566,2140,46857,997,423,246,1666,48523
12-03-2014,0,14510,20235,7560,2010,44317,966,391,180,1537,45854
12-03-2014,1,14153,19968,7462,2049,43632,939,391,178,1508,45140
12-03-2014,2,13865,19826,7392,2095,43178,940,412,175,1527,44705
12-03-2014,3,13843,20025,7432,2126,43427,938,431,172,1541,44968
12-03-2014,4,14643,20441,7520,2122,44726,961,549,223,1733,46459
12-03-2014,5,16112,21214,7918,2401,47645,1077,674,230,1981,49626
12-03-2014,6,17750,22978,8177,3021,51926,1273,815,296,2384,54310
12-03-2014,7,19595,24224,8373,3533,55726,1437,832,577,2846,58572
12-03-2014,8,19577,24414,8412,3732,56136,1480,962,442,2884,59020
12-03-2014,9,19286,24095,8322,3446,55149,1498,1056,349,2903,58052
12-03-2014,10,18885,23785,8145,3292,54109,1483,826,406,2715,56824
12-03-2014,11,18266,23531,7841,3246,52885,1470,807,317,2594,55479
12-03-2014,12,17859,23250,8004,3159,52271,1510,820,317,2647,54918
12-03-2014,13,17386,23181,7806,3249,51623,1497,822,304,2623,54246
12-03-2014,14,17074,22978,7770,3252,51075,1452,818,292,2562,53637
12-03-2014,15,17014,22884,7772,3244,50915,1321,800,292,2413,53328
12-03-2014,16,16885,22881,7901,3358,51023,1317,777,300,2394,53417
12-03-2014,17,17525,23153,8202,3327,52207,1502,901,431,2834,55041
12-03-2014,18,18287,23688,8339,3552,53866,1503,1034,330,2867,56733
12-03-2014,19,18437,23819,7998,3540,53794,1521,977,336,2834,56628
12-03-2014,20,18009,23471,7771,3194,52445,1235,800,347,2382,54827
12-03-2014,21,17735,22467,7639,2990,50831,1097,642,352,2091,52922
12-03-2014,22,16556,22131,7507,2681,48876,1037,575,269,1881,50757
12-03-2014,23,15112,21245,7378,2433,46168,1009,442,291,1742,47910
13-03-2014,0,14197,20350,7217,2283,44050,988,391,266,1645,45695
13-03-2014,1,13945,19773,7160,2271,43148,980,388,258,1626,44774
13-03-2014,2,13789,19652,7140,2311,42892,985,391,257,1633,44525
13-03-2014,3,14396,19851,7201,2337,43785,974,396,261,1631,45416
13-03-2014,4,15086,20195,7255,2422,44957,984,405,346,1735,46692
13-03-2014,5,16061,20891,7580,2586,47119,1300,532,339,2171,49290
13-03-2014,6,17739,22751,7915,2941,51346,1372,667,409,2448,53794
13-03-2014,7,19993,24041,8195,3458,55685,1358,804,495,2657,58342
13-03-2014,8,19963,24213,8292,3732,56199,1348,890,457,2695,58894
13-03-2014,9,19496,24003,8209,3574,55281,1355,865,462,2682,57963
13-03-2014,10,19083,23994,8082,3426,54586,1356,715,453,2524,57110
13-03-2014,11,18339,23883,7911,3409,53541,1362,681,405,2448,55989
13-03-2014,12,17876,23634,7718,3433,52661,1335,738,394,2467,55128
13-03-2014,13,17312,23649,7700,3480,52142,1244,704,414,2362,54504
13-03-2014,14,16986,23862,7668,3590,52106,1156,705,403,2264,54370
13-03-2014,15,16618,23897,7697,3484,51696,1257,690,454,2401,54097
13-03-2014,16,16382,23574,7822,3370,51147,1247,670,447,2364,53511
13-03-2014,17,17139,23803,8121,3541,52604,1285,757,488,2530,55134
13-03-2014,18,17950,24101,8334,3716,54102,1296,845,464,2605,56707
13-03-2014,19,18112,24425,8034,3751,54323,1336,772,352,2460,56783
13-03-2014,20,17427,24030,7777,3631,52866,1112,727,339,2178,55044
13-03-2014,21,16238,23245,7724,3657,50863,1028,451,292,1771,52634
13-03-2014,22,15077,22340,7545,3462,48425,1010,419,303,1732,50157
13-03-2014,23,13614,21402,7414,3286,45716,991,435,306,1732,47448
14-03-2014,0,12749,20243,7299,3160,43451,984,407,302,1693,45144
14-03-2014,1,12533,19634,7279,2985,42431,1013,406,320,1739,44170
14-03-2014,2,12603,19425,7322,2939,42290,999,406,320,1725,44015
14-03-2014,3,13158,19674,7386,2904,43122,995,412,285,1692,44814
14-03-2014,4,13846,20164,7491,2737,44238,1034,417,258,1709,45947
14-03-2014,5,15113,20967,7791,2722,46593,1218,509,338,2065,48658
14-03-2014,6,17356,22666,8161,2913,51097,1316,754,403,2473,53570
14-03-2014,7,19269,24194,8468,3388,55320,1367,880,444,2691,58011
14-03-2014,8,19642,24443,8579,3728,56392,1387,928,422,2737,59129
14-03-2014,9,19295,24156,8490,3592,55533,1365,979,411,2755,58288
14-03-2014,10,18780,24005,8373,3673,54831,1370,786,406,2562,57393
14-03-2014,11,18251,23626,8223,4050,54149,1382,687,398,2467,56616
14-03-2014,12,17355,23386,8014,4146,52900,1361,687,408,2456,55356
14-03-2014,13,16224,23736,8038,4457,52456,1357,690,395,2442,54898
14-03-2014,14,15903,23694,8004,4716,52316,1348,723,336,2407,54723
14-03-2014,15,15735,23467,8027,4905,52134,1326,731,274,2331,54465
14-03-2014,16,15529,23280,8160,5291,52258,1311,721,439,2471,54729
14-03-2014,17,15842,23823,8509,5702,53877,1286,752,474,2512,56389
14-03-2014,18,16350,23826,8629,6217,55022,1265,849,430,2544,57566
14-03-2014,19,15597,23744,8330,6288,53958,1247,836,376,2459,56417
14-03-2014,20,14407,22852,7995,6290,51544,1064,758,341,2163,53707
14-03-2014,21,13926,22024,7819,6177,49948,1100,568,289,1957,51905
14-03-2014,22,13291,21340,7628,6022,48281,1018,399,316,1733,50014
14-03-2014,23,12643,19980,7302,5662,45588,901,318,343,1562,47150
15-03-2014,0,12257,18511,7110,5349,43227,797,233,337,1367,44594
15-03-2014,1,11588,18048,6988,5093,41717,774,214,343,1331,43048
15-03-2014,2,11269,18190,6766,4820,41047,762,211,356,1329,42376
15-03-2014,3,11376,18411,6774,4625,41186,787,209,362,1358,42544
15-03-2014,4,11273,18953,6825,4689,41741,866,301,370,1537,43278
15-03-2014,5,11075,19120,6973,5018,42186,969,394,374,1737,43923
15-03-2014,6,11542,19312,6882,5168,42902,868,435,373,1676,44578
15-03-2014,7,12578,19834,7045,5286,44743,896,515,373,1784,46527
15-03-2014,8,13516,20865,7361,5497,47238,908,572,372,1852,49090
15-03-2014,9,13738,22411,7551,5711,49413,880,576,369,1825,51238
15-03-2014,10,13869,22736,7503,5846,49953,880,586,368,1834,51787
15-03-2014,11,13653,21958,7463,5882,48958,935,598,367,1900,50858
15-03-2014,12,13364,21192,7398,5724,47677,975,589,371,1935,49612
15-03-2014,13,13180,21044,7410,5579,47212,1003,573,387,1963,49175
15-03-2014,14,12933,20732,7607,5465,46737,962,592,390,1944,48681
15-03-2014,15,13035,20489,7589,5386,46497,961,577,381,1919,48416
15-03-2014,16,13322,21171,7828,5247,47568,997,591,365,1953,49521
15-03-2014,17,13888,22368,8344,5441,50040,1059,617,391,2067,52107
15-03-2014,18,15536,23076,8610,5873,53095,1075,672,391,2138,55233
15-03-2014,19,15779,22953,8217,5720,52670,1072,670,383,2125,54795
15-03-2014,20,14406,22582,7908,5495,50390,967,601,353,1921,52311
15-03-2014,21,13376,21522,7960,5058,47916,958,488,338,1784,49700
15-03-2014,22,12700,20689,7777,4839,46004,940,346,298,1584,47588
15-03-2014,23,12087,19514,7464,4389,43454,862,190,288,1340,44794
16-03-2014,0,11422,18514,7293,3544,40772,859,205,255,1319,42091
16-03-2014,1,11272,17853,7202,2800,39126,871,215,251,1337,40463
16-03-2014,2,11307,17563,7228,2894,38992,861,227,288,1376,40368
16-03-2014,3,11443,17507,7319,3068,39336,814,231,284,1329,40665
16-03-2014,4,11731,17556,7358,3282,39927,797,280,255,1332,41259
16-03-2014,5,11733,17578,7463,3515,40289,863,398,259,1520,41809
16-03-2014,6,11581,17449,7607,3629,40266,826,445,281,1552,41818
16-03-2014,7,11837,17669,7648,3933,41087,827,509,347,1683,42770
16-03-2014,8,12667,18622,7742,4892,43924,858,574,365,1797,45721
16-03-2014,9,13612,19455,7825,5297,46192,845,599,374,1818,48010
16-03-2014,10,13870,19889,7881,5386,47029,821,590,396,1807,48836
16-03-2014,11,13858,19864,7858,5409,46990,825,589,395,1809,48799
16-03-2014,12,13678,19958,7823,5153,46613,841,557,384,1782,48395
16-03-2014,13,13476,19790,7843,4789,45899,828,545,384,1757,47656
16-03-2014,14,13428,19908,7776,4467,45579,831,544,374,1749,47328
16-03-2014,15,13571,19842,7830,4434,45679,826,541,359,1726,47405
16-03-2014,16,13980,20010,8064,4914,46969,830,555,356,1741,48710
16-03-2014,17,14384,20617,8387,4994,48382,932,634,359,1925,50307
16-03-2014,18,15431,21316,8753,5235,50736,946,829,377,2152,52888
16-03-2014,19,16020,21540,8630,5540,51728,941,808,342,2091,53819
16-03-2014,20,14620,21341,8345,5583,49889,855,752,299,1906,51795
16-03-2014,21,13808,20799,8344,5375,48325,891,517,240,1648,49973
16-03-2014,22,13101,20303,8383,5325,47111,831,377,196,1404,48515
16-03-2014,23,12944,19429,8014,5238,45625,740,305,189,1234,46859
17-03-2014,0,12685,18896,7844,4999,44425,650,197,226,1073,45498
17-03-2014,1,12404,18814,7765,4500,43484,645,209,190,1044,44528
17-03-2014,2,12569,18902,7793,4551,43814,641,217,209,1067,44881
17-03-2014,3,12189,18955,8052,4653,43849,640,227,252,1119,44968
17-03-2014,4,12026,19015,8755,5057,44854,771,405,270,1446,46300
17-03-2014,5,12764,19742,9049,5157,46712,1240,652,269,2161,48873
17-03-2014,6,14624,22357,9342,5403,51726,1348,914,488,2750,54476
17-03-2014,7,17256,23816,9193,5761,56027,1351,1153,509,3013,59040
17-03-2014,8,17768,24006,9238,5885,56896,1381,1233,617,3231,60127
17-03-2014,9,17554,24026,9072,5922,56575,1396,1195,630,3221,59796
17-03-2014,10,16875,23449,8988,5969,55282,1388,976,582,2946,58228
17-03-2014,11,16629,22848,8861,5899,54237,1264,784,545,2593,56830
17-03-2014,12,16470,22669,8903,5771,53812,1196,821,558,2575,56387
17-03-2014,13,16492,22573,8802,5709,53577,1192,813,540,2545,56122
17-03-2014,14,16476,23047,8675,5496,53695,1179,796,512,2487,56182
17-03-2014,15,16747,23382,8629,5286,54044,1166,939,433,2538,56582
17-03-2014,16,17147,23288,8690,5083,54208,1149,921,556,2626,56834
17-03-2014,17,18053,23567,8871,4932,55423,1160,1011,604,2775,58198
17-03-2014,18,19019,23851,9030,4698,56598,1156,1082,529,2767,59365
17-03-2014,19,19499,23932,9142,4575,57149,1145,948,476,2569,59718
17-03-2014,20,18571,23775,8746,4576,55669,1141,748,471,2360,58029
17-03-2014,21,17425,23323,8739,4514,54001,1147,686,263,2096,56097
17-03-2014,22,16087,22551,8547,4319,51503,1113,498,259,1870,53373
17-03-2014,23,15160,21383,8088,4362,48994,1003,391,270,1664,50658
18-03-2014,0,14652,19520,7931,4238,46343,937,480,255,1672,48015
18-03-2014,1,14178,19422,7910,4117,45627,938,479,230,1647,47274
18-03-2014,2,13732,19393,7871,4098,45094,944,442,214,1600,46694
18-03-2014,3,13599,19184,8068,4019,44871,938,468,213,1619,46490
18-03-2014,4,14410,19335,8475,4017,46236,963,492,235,1690,47926
18-03-2014,5,15515,20493,8927,4278,49213,1181,592,232,2005,51218
18-03-2014,6,16985,22712,9255,4422,53376,1286,935,397,2618,55994
18-03-2014,7,19863,23571,9374,4688,57499,1288,1054,575,2917,60416
18-03-2014,8,20323,23640,9396,4781,58141,1331,1359,418,3108,61249
18-03-2014,9,19408,23594,9298,4681,56982,1316,1179,400,2895,59877
18-03-2014,10,18938,23512,9142,4783,56376,1317,1025,282,2624,59000
18-03-2014,11,18331,23377,8914,4927,55549,1310,926,275,2511,58060
18-03-2014,12,17929,23107,8920,4943,54900,1196,944,312,2452,57352
18-03-2014,13,18012,23093,8906,4990,55002,1182,962,312,2456,57458
18-03-2014,14,18101,23044,8779,4821,54745,1191,965,315,2471,57216
18-03-2014,15,18082,22970,8871,4642,54565,1263,965,338,2566,57131
18-03-2014,16,18351,22995,8843,4414,54603,1303,1091,266,2660,57263
18-03-2014,17,18833,23431,9088,4214,55567,1348,1123,308,2779,58346
18-03-2014,18,19721,23529,9080,4010,56342,1350,1150,341,2841,59183
18-03-2014,19,20015,23630,9130,3965,56741,1346,968,365,2679,59420
18-03-2014,20,19247,23185,8829,3613,54874,1317,847,375,2539,57413
18-03-2014,21,18269,22909,8583,3327,53088,1313,651,320,2284,55372
18-03-2014,22,16251,21976,8438,2928,49594,1098,566,316,1980,51574
18-03-2014,23,15045,20070,7965,2707,45788,961,529,298,1788,47576
19-03-2014,0,13429,18396,7831,2656,42312,935,487,277,1699,44011
19-03-2014,1,13192,17740,7785,2584,41301,902,486,249,1637,42938
19-03-2014,2,13189,17539,7740,2606,41072,914,483,230,1627,42699
19-03-2014,3,13525,17752,7830,2600,41706,954,484,208,1646,43352
19-03-2014,4,13594,18173,8114,2657,42537,1054,520,246,1820,44357
19-03-2014,5,13994,19028,8795,2988,44804,1270,604,290,2164,46968
19-03-2014,6,16726,21864,9274,3749,51613,1287,814,407,2508,54121
19-03-2014,7,19951,23245,9454,4547,57197,1298,1078,415,2791,59988
19-03-2014,8,20317,23708,9416,5231,58672,1312,1208,417,2937,61609
19-03-2014,9,19394,23998,9318,5537,58247,1310,1147,421,2878,61125
19-03-2014,10,19092,23995,9191,5656,57936,1311,943,416,2670,60606
19-03-2014,11,18086,23788,8912,5635,56422,1304,878,422,2604,59026
19-03-2014,12,17485,23484,8935,5835,55738,1299,870,418,2587,58325
19-03-2014,13,16771,23274,8877,5762,54684,1293,839,426,2558,57242
19-03-2014,14,16339,23330,8899,5771,54338,1280,817,432,2529,56867
19-03-2014,15,15518,23424,8929,5793,53664,1268,788,431,2487,56151
19-03-2014,16,15245,23419,9006,5783,53454,1251,895,498,2644,56098
19-03-2014,17,16544,24062,9333,5728,55665,1255,894,573,2722,58387
19-03-2014,18,17746,24411,9400,5735,57293,1266,849,531,2646,59939
19-03-2014,19,17792,24363,9277,5710,57141,1268,861,480,2609,59750
19-03-2014,20,17185,24001,8764,5570,55522,1243,811,393,2447,57969
19-03-2014,21,16038,23291,8553,5379,53260,1225,725,373,2323,55583
19-03-2014,22,14644,21984,8397,5282,50307,1030,654,373,2057,52364
19-03-2014,23,13430,20162,7954,5050,46597,870,544,373,1787,48384
20-03-2014,0,13813,18523,7777,4837,44947,804,484,372,1660,46607
20-03-2014,1,13564,17888,7755,4740,43947,785,482,371,1638,45585
20-03-2014,2,13236,17591,7723,4688,43239,790,451,367,1608,44847
20-03-2014,3,12976,17656,8166,4567,43365,936,496,399,1831,45196
20-03-2014,4,12856,17870,8554,4488,43769,1096,523,377,1996,45765
20-03-2014,5,15157,19182,8869,4546,47754,1209,599,519,2327,50081
20-03-2014,6,17414,21946,9223,4676,53259,1204,967,494,2665,55924
20-03-2014,7,19114,23488,9332,5074,57008,1204,1226,465,2895,59903
20-03-2014,8,19381,23904,9221,5450,57957,1188,1316,450,2954,60911
20-03-2014,9,19091,23699,9227,5570,57589,1176,1159,609,2944,60533
20-03-2014,10,18874,23766,9173,5782,57595,1177,1063,434,2674,60269
20-03-2014,11,17974,23663,8973,5788,56398,1185,886,414,2485,58883
20-03-2014,12,17348,23055,8868,6050,55321,1204,924,429,2557,57878
20-03-2014,13,17060,22884,8746,5935,54626,1212,778,409,2399,57025
20-03-2014,14,16761,22848,8679,5830,54117,1230,771,441,2442,56559
20-03-2014,15,16751,22790,8882,5730,54154,1262,839,456,2557,56711
20-03-2014,16,16644,22980,8927,5480,54032,1256,993,459,2708,56740
20-03-2014,17,17091,23486,9173,5354,55104,1351,1015,491,2857,57961
20-03-2014,18,17897,23627,9178,5291,55993,1379,885,509,2773,58766
20-03-2014,19,17864,23837,8896,5356,55953,1369,786,509,2664,58617
20-03-2014,20,16883,23517,8508,5322,54230,1281,716,419,2416,56646
20-03-2014,21,15684,22310,8985,5325,52305,1212,655,321,2188,54493
20-03-2014,22,14065,20470,8600,5407,48541,1049,570,335,1954,50495
20-03-2014,23,12938,19109,8211,5335,45593,1014,540,343,1897,47490
21-03-2014,0,12566,18169,7810,5045,43590,1027,438,347,1812,45402
21-03-2014,1,11792,18040,7539,4890,42260,1028,395,337,1760,44020
21-03-2014,2,11323,17741,7540,4736,41342,1033,394,341,1768,43110
21-03-2014,3,10812,17906,7992,4624,41333,1071,397,360,1828,43161
21-03-2014,4,11127,17871,8264,4299,41561,1282,399,365,2046,43607
21-03-2014,5,12358,18563,8731,4011,43662,1574,548,418,2540,46202
21-03-2014,6,14793,21853,8910,3969,49525,1603,707,481,2791,52316
21-03-2014,7,17745,23363,8693,3971,53771,1625,828,581,3034,56805
21-03-2014,8,18447,23385,8523,3949,54304,1596,1020,571,3187,57491
21-03-2014,9,18050,23201,8667,4001,53920,1574,825,547,2946,56866
21-03-2014,10,17762,22988,8719,3902,53372,1532,794,421,2747,56119
21-03-2014,11,16913,22929,8710,3736,52290,1416,747,373,2536,54826
21-03-2014,12,16121,22478,8486,3293,50377,1489,742,372,2603,52980
21-03-2014,13,15147,21726,8516,3173,48561,1512,730,345,2587,51148
21-03-2014,14,15619,21618,8453,2977,48668,1452,718,326,2496,51164
21-03-2014,15,16327,21672,8302,3086,49386,1425,676,338,2439,51825
21-03-2014,16,16427,22080,8330,3299,50137,1371,785,414,2570,52707
21-03-2014,17,17176,22015,8450,3406,51048,1512,924,407,2843,53891
21-03-2014,18,18244,22880,8484,3213,52822,1539,910,399,2848,55670
21-03-2014,19,18605,23111,8311,3468,53495,1426,752,401,2579,56074
21-03-2014,20,17355,22434,7964,3630,51383,1113,698,388,2199,53582
21-03-2014,21,16420,21786,7795,3525,49525,1111,480,238,1829,51354
21-03-2014,22,15926,20996,7465,3442,47828,971,347,219,1537,49365
21-03-2014,23,15081,20180,7068,3600,45930,877,296,193,1366,47296
22-03-2014,0,14414,18568,7003,3660,43643,901,311,202,1414,45057
22-03-2014,1,13710,18120,7054,3707,42591,860,220,231,1311,43902
22-03-2014,2,13602,17744,7110,3510,41966,920,224,209,1353,43319
22-03-2014,3,13562,17716,7133,3394,41804,1031,286,204,1521,43325
22-03-2014,4,13156,17811,7186,3380,41533,1030,377,190,1597,43130
22-03-2014,5,12798,17846,7304,3434,41383,1034,450,189,1673,43056
22-03-2014,6,13545,18390,7413,3529,42879,1012,528,218,1758,44637
22-03-2014,7,14093,19709,7652,3695,45149,1024,561,216,1801,46950
22-03-2014,8,14562,20740,7879,3926,47108,1059,671,293,2023,49131
22-03-2014,9,15112,20683,7881,4333,48009,1066,697,251,2014,50023
22-03-2014,10,15111,20631,7789,4799,48331,1065,707,225,1997,50328
22-03-2014,11,14469,20555,7756,5094,47874,1042,702,224,1968,49842
22-03-2014,12,14480,20198,7708,5044,47431,1025,692,213,1930,49361
22-03-2014,13,14301,20021,7620,4927,46870,1047,658,204,1909,48779
22-03-2014,14,14147,20181,7726,4692,46745,1041,633,198,1872,48617
22-03-2014,15,14359,20522,7946,4204,47030,1002,634,185,1821,48851
22-03-2014,16,14633,21319,8087,3786,47825,971,637,259,1867,49692
22-03-2014,17,15636,21773,8275,3691,49377,965,734,338,2037,51414
22-03-2014,18,16694,22733,8399,3321,51147,987,843,508,2338,53485
22-03-2014,19,17526,22829,8272,3132,51761,1027,784,373,2184,53945
22-03-2014,20,16604,22955,8041,2976,50574,1027,674,342,2043,52617
22-03-2014,21,16041,21980,7865,2765,48651,1030,601,235,1866,50517
22-03-2014,22,15669,20595,7722,2807,46794,1033,527,215,1775,48569
22-03-2014,23,15608,19265,7386,2658,44918,937,352,190,1479,46397
23-03-2014,0,12933,17712,7207,2437,40289,772,254,162,1188,41477
23-03-2014,1,11743,16627,7010,2303,37684,772,261,139,1172,38856
23-03-2014,2,11682,16422,6919,2453,37476,786,257,137,1180,38656
23-03-2014,3,11880,16361,6966,2481,37688,779,288,135,1202,38890
23-03-2014,4,12096,16457,7006,2594,38154,768,376,134,1278,39432
23-03-2014,5,11655,16626,6998,2600,37879,765,381,208,1354,39233
23-03-2014,6,11145,16549,7158,2675,37525,763,464,207,1434,38959
23-03-2014,7,11459,17301,7176,2839,38775,752,560,199,1511,40286
23-03-2014,8,12768,18472,7296,2863,41398,748,606,198,1552,42950
23-03-2014,9,15000,19791,7412,3100,45304,843,686,205,1734,47038
23-03-2014,10,16420,20607,7496,3388,47910,845,707,198,1750,49660
23-03-2014,11,16415,20759,7481,3498,48153,835,680,199,1714,49867
23-03-2014,12,15782,20879,7525,3491,47677,832,693,201,1726,49403
23-03-2014,13,15214,20762,7496,3351,46824,840,670,197,1707,48531
23-03-2014,14,14392,20773,7450,3204,45818,782,668,194,1644,47462
23-03-2014,15,14079,20671,7583,2856,45189,850,666,187,1703,46892
23-03-2014,16,14865,20574,7755,2705,45899,854,701,182,1737,47636
23-03-2014,17,16442,20978,7878,2711,48008,997,755,195,1947,49955
23-03-2014,18,18085,21470,8142,2919,50616,1151,946,201,2298,52914
23-03-2014,19,19216,22087,8098,2782,52183,1187,916,210,2313,54496
23-03-2014,20,18888,22085,7696,2635,51305,1015,858,189,2062,53367
23-03-2014,21,18541,21498,7464,2559,50062,904,578,185,1667,51729
23-03-2014,22,17624,20947,7275,2291,48139,897,584,131,1612,49751
23-03-2014,23,16474,20000,7268,2164,45906,869,483,130,1482,47388
24-03-2014,0,16422,18449,7154,2107,44133,825,255,134,1214,45347
24-03-2014,1,16056,18228,7116,2059,43459,804,248,137,1189,44648
24-03-2014,2,15996,18116,7074,2032,43218,789,232,147,1168,44386
24-03-2014,3,15975,18080,7089,2043,43188,784,240,151,1175,44363
24-03-2014,4,16559,18248,7162,2182,44152,804,440,154,1398,45550
24-03-2014,5,17725,19137,7634,2503,46997,1170,543,161,1874,48871
24-03-2014,6,19900,21128,8158,2808,51994,1229,951,225,2405,54399
24-03-2014,7,21933,22304,8481,2825,55544,1220,1043,313,2576,58120
24-03-2014,8,22568,22415,8515,2850,56349,1217,1094,393,2704,59053
24-03-2014,9,21840,22253,8378,2886,55358,1218,926,583,2727,58085
24-03-2014,10,21294,22079,8309,2951,54633,1220,881,403,2504,57137
24-03-2014,11,20884,21938,8002,2884,53708,1229,862,326,2417,56125
24-03-2014,12,20318,22062,7888,2923,53192,1292,881,350,2523,55715
24-03-2014,13,19699,22061,7765,2787,52312,1294,992,258,2544,54856
24-03-2014,14,19380,21875,7594,2725,51574,1296,979,239,2514,54088
24-03-2014,15,19109,21663,7660,2545,50977,1311,885,239,2435,53412
24-03-2014,16,18963,21512,7682,2362,50520,1281,1025,260,2566,53086
24-03-2014,17,19476,21213,8019,2490,51198,1285,1077,274,2636,53834
24-03-2014,18,20243,21463,8039,2581,52326,1277,1019,280,2576,54902
24-03-2014,19,20648,22197,7919,2585,53348,1296,972,260,2528,55876
24-03-2014,20,20408,22030,7677,2293,52408,1096,839,259,2194,54602
24-03-2014,21,19643,21858,7531,2163,51195,974,512,256,1742,52937
24-03-2014,22,18260,21350,7305,1897,48813,917,459,205,1581,50394
24-03-2014,23,17208,20037,7208,1767,46220,903,415,238,1556,47776
25-03-2014,0,16088,18336,7387,1706,43516,869,369,251,1489,45005
25-03-2014,1,15666,17844,7429,1675,42614,878,332,274,1484,44098
25-03-2014,2,15637,17742,7484,1680,42541,869,291,279,1439,43980
25-03-2014,3,16247,17845,7514,1783,43389,866,299,242,1407,44796
25-03-2014,4,16681,18261,7678,1986,44606,913,357,255,1525,46131
25-03-2014,5,17521,19173,7952,2215,46862,973,573,290,1836,48698
25-03-2014,6,19093,21597,8323,2384,51397,1155,823,353,2331,53728
25-03-2014,7,21143,22840,8403,2907,55293,1313,1022,360,2695,57988
25-03-2014,8,21618,22911,8483,2988,56001,1328,1110,365,2803,58804
25-03-2014,9,21019,22693,8180,3077,54969,1341,905,547,2793,57762
25-03-2014,10,20494,22288,8129,2912,53823,1325,893,419,2637,56460
25-03-2014,11,19876,22305,7948,2694,52824,1335,885,388,2608,55432
25-03-2014,12,19229,22507,7807,2710,52254,1345,913,409,2667,54921
25-03-2014,13,18497,22604,7685,3041,51827,1343,938,341,2622,54449
25-03-2014,14,18093,22715,7655,3222,51686,1218,940,313,2471,54157
25-03-2014,15,17434,22781,7692,3563,51470,1232,850,305,2387,53857
25-03-2014,16,17223,22709,7670,3696,51298,1227,1025,258,2510,53808
25-03-2014,17,17418,22910,7862,3905,52095,1408,1066,265,2739,54834
25-03-2014,18,17870,23050,8108,4059,53088,1497,1067,246,2810,55898
25-03-2014,19,18280,23250,8043,4091,53662,1451,1044,229,2724,56386
25-03-2014,20,17682,23036,7604,4115,52437,1167,966,183,2316,54753
25-03-2014,21,16675,22463,7482,4368,50988,1054,677,166,1897,52885
25-03-2014,22,15011,21732,7261,4680,48684,1043,572,161,1776,50460
25-03-2014,23,13741,20450,7128,4848,46166,1015,411,149,1575,47741
26-03-2014,0,12885,19247,6968,4731,43832,1013,264,146,1423,45255
26-03-2014,1,12770,18560,6949,4524,42803,981,253,143,1377,44180
26-03-2014,2,12943,18413,7004,4393,42755,973,252,140,1365,44120
26-03-2014,3,13659,18494,7118,4137,43408,1019,358,139,1516,44924
26-03-2014,4,14240,18960,7291,4132,44624,1044,511,146,1701,46325
26-03-2014,5,15164,19460,7865,4175,46664,1320,490,198,2008,48672
26-03-2014,6,17187,21362,8333,4073,50956,1382,954,207,2543,53499
26-03-2014,7,19665,22803,8480,4293,55243,1373,1044,407,2824,58067
26-03-2014,8,20427,23112,8450,4451,56441,1389,1086,403,2878,59319
26-03-2014,9,20051,23008,8351,4404,55814,1400,1112,400,2912,58726
26-03-2014,10,19725,23156,8338,4580,55799,1404,1062,337,2803,58602
26-03-2014,11,19811,22855,7993,4531,55190,1488,1057,207,2752,57942
26-03-2014,12,19651,22490,7889,4528,54559,1509,1054,206,2769,57328
26-03-2014,13,19389,22378,7805,4590,54162,1471,1030,210,2711,56873
26-03-2014,14,19184,22265,7709,4539,53697,1440,1022,209,2671,56368
26-03-2014,15,18908,22044,7742,4317,53011,1352,1031,205,2588,55599
26-03-2014,16,18995,22031,7768,4179,52974,1323,1159,202,2684,55658
26-03-2014,17,19262,22031,7943,4428,53665,1328,1086,380,2794,56459
26-03-2014,18,19777,22368,8331,4016,54492,1399,1104,354,2857,57349
26-03-2014,19,20646,22505,8238,3948,55337,1334,1177,241,2752,58089
26-03-2014,20,19911,22379,8008,3897,54197,1259,982,175,2416,56613
26-03-2014,21,19152,21472,7786,3620,52030,1066,537,187,1790,53820
26-03-2014,22,17717,20857,7614,3208,49396,967,444,212,1623,51019
26-03-2014,23,16112,20044,7418,3129,46704,905,396,231,1532,48236
27-03-2014,0,14580,17945,7298,3071,42893,910,439,212,1561,44454
27-03-2014,1,14353,17351,7216,2849,41769,885,478,212,1575,43344
27-03-2014,2,14299,17184,7284,2752,41518,893,478,207,1578,43096
27-03-2014,3,14613,17332,7276,3095,42315,905,476,183,1564,43879
27-03-2014,4,15039,17294,7478,3369,43180,949,498,183,1630,44810
27-03-2014,5,16265,18000,7932,3389,45588,1242,568,237,2047,47635
27-03-2014,6,19109,20165,8421,3404,51100,1376,664,260,2300,53400
27-03-2014,7,21402,21365,8559,3829,55155,1378,754,579,2711,57866
27-03-2014,8,21375,21482,8454,3747,55059,1381,1068,392,2841,57900
27-03-2014,9,20034,21280,8360,3474,53148,1383,1000,381,2764,55912
27-03-2014,10,19144,20824,8334,3361,51664,1381,850,202,2433,54097
27-03-2014,11,18935,20826,8186,3382,51331,1313,792,264,2369,53700
27-03-2014,12,17968,20863,7987,3354,50173,1328,774,280,2382,52555
27-03-2014,13,17932,20851,8020,3114,49917,1325,777,201,2303,52220
27-03-2014,14,18236,20789,7908,3020,49951,1318,786,196,2300,52251
27-03-2014,15,19202,20893,7774,2994,50862,1314,735,188,2237,53099
27-03-2014,16,19215,21043,7857,2977,51091,1333,703,306,2342,53433
27-03-2014,17,20144,21407,8154,3028,52732,1338,839,328,2505,55237
27-03-2014,18,20652,21587,8320,3349,53909,1302,1064,260,2626,56535
27-03-2014,19,21082,21740,8246,3622,54692,1300,998,247,2545,57237
27-03-2014,20,20331,21619,7779,3291,53019,1285,769,205,2259,55278
27-03-2014,21,19723,21033,7418,2987,51162,1185,678,179,2042,53204
27-03-2014,22,18407,19989,7191,2696,48283,1056,573,184,1813,50096
27-03-2014,23,16724,18700,7078,2647,45150,1026,510,172,1708,46858
28-03-2014,0,16269,17336,6985,2658,43248,913,619,188,1720,44968
28-03-2014,1,15983,16723,6976,2565,42249,893,607,198,1698,43947
28-03-2014,2,15416,16620,6916,2529,41482,880,611,204,1695,43177
28-03-2014,3,16049,16604,6948,2574,42175,864,605,209,1678,43853
28-03-2014,4,17072,17045,7177,2654,43948,907,644,234,1785,45733
28-03-2014,5,17740,18073,7496,2802,46111,1269,779,300,2348,48459
28-03-2014,6,19550,20058,8132,2909,50648,1303,911,370,2584,53232
28-03-2014,7,21494,21341,8392,3605,54833,1297,1081,507,2885,57718
28-03-2014,8,21726,21490,8483,3855,55555,1324,1180,439,2943,58498
28-03-2014,9,21043,21331,8395,3661,54431,1332,1167,439,2938,57369
28-03-2014,10,20087,21020,8137,3483,52727,1325,1146,336,2807,55534
28-03-2014,11,20051,20679,7893,3413,52036,1311,1104,277,2692,54728
28-03-2014,12,19394,20378,7755,3244,50771,1313,1093,272,2678,53449
28-03-2014,13,18777,20125,7633,3100,49633,1319,1045,251,2615,52248
28-03-2014,14,18197,19906,7495,3083,48682,1306,1063,245,2614,51296
28-03-2014,15,17717,19934,7448,3082,48181,1225,1059,234,2518,50699
28-03-2014,16,17470,19956,7628,3052,48106,1246,1053,239,2538,50644
28-03-2014,17,17572,20288,7925,3163,48948,1280,1031,247,2558,51506
28-03-2014,18,18338,20340,8017,3226,49923,1345,1084,336,2765,52688
28-03-2014,19,19008,20655,7805,3213,50681,1310,1131,202,2643,53324
28-03-2014,20,18099,20006,7390,3426,48921,1140,1028,178,2346,51267
28-03-2014,21,17385,19429,7422,3401,47635,1087,867,164,2118,49753
28-03-2014,22,16474,19287,7375,3450,46586,956,723,167,1846,48432
28-03-2014,23,16006,18190,7164,3414,44774,912,706,158,1776,46550
29-03-2014,0,15543,17067,7000,3263,42873,754,658,178,1590,44463
29-03-2014,1,15177,16734,6943,3091,41946,690,643,162,1495,43441
29-03-2014,2,14738,16622,6948,3002,41311,688,618,147,1453,42764
29-03-2014,3,15003,16637,6950,3031,41622,695,618,149,1462,43084
29-03-2014,4,15404,16719,7030,3026,42180,737,613,154,1504,43684
29-03-2014,5,15876,17129,7066,3047,43118,794,663,151,1608,44726
29-03-2014,6,16081,17451,7140,2951,43623,795,764,126,1685,45308
29-03-2014,7,16882,18487,7263,2877,45509,819,830,114,1763,47272
29-03-2014,8,17941,19581,7366,2803,47689,894,899,124,1917,49606
29-03-2014,9,17288,19955,7415,2962,47619,901,898,116,1915,49534
29-03-2014,10,15923,19553,7308,2936,45721,902,896,93,1891,47612
29-03-2014,11,15425,19233,7316,2878,44853,907,877,94,1878,46731
29-03-2014,12,13899,19011,7275,2760,42945,904,855,96,1855,44800
29-03-2014,13,13260,18411,7138,2553,41363,893,838,101,1832,43195
29-03-2014,14,13053,18000,6995,2236,40283,840,829,103,1772,42055
29-03-2014,15,13181,17903,7124,2200,40408,860,827,101,1788,42196
29-03-2014,16,15483,18413,7345,2452,43693,973,828,99,1900,45593
29-03-2014,17,16790,19130,7753,2577,46251,983,855,97,1935,48186
29-03-2014,18,17488,19439,8009,2549,47484,978,1128,98,2204,49688
29-03-2014,19,18439,19639,8020,2523,48621,1045,1008,123,2176,50797
29-03-2014,20,17730,19604,7490,2371,47196,966,922,101,1989,49185
29-03-2014,21,17242,18919,7162,2262,45586,946,821,103,1870,47456
29-03-2014,22,16351,18570,7100,2316,44338,885,717,93,1695,46033
29-03-2014,23,15963,17219,7043,2378,42602,840,717,70,1627,44229
30-03-2014,0,14762,16545,6949,2289,40544,809,529,64,1402,41946
30-03-2014,1,13400,16182,6933,1983,38500,793,480,62,1335,39835
30-03-2014,2,,,,,,688,,,,
30-03-2014,3,11989,15856,6801,1736,36381,775,483,62,1320,37701
30-03-2014,4,12232,15911,6870,1701,36714,769,484,66,1319,38033
30-03-2014,5,13073,16119,6968,1802,37963,769,512,71,1352,39315
30-03-2014,6,13130,16173,6989,1938,38229,769,547,112,1428,39657
30-03-2014,7,14123,16647,7081,1962,39813,795,606,95,1496,41309
30-03-2014,8,16016,17665,7282,2162,43125,885,703,94,1682,44807
30-03-2014,9,16401,18517,7340,2221,44480,911,734,83,1728,46208
30-03-2014,10,15174,18375,7334,2133,43015,958,747,78,1783,44798
30-03-2014,11,14742,18011,7284,2210,42247,974,749,78,1801,44048
30-03-2014,12,13829,18232,7174,2137,41372,974,717,79,1770,43142
30-03-2014,13,13590,18154,7102,2080,40927,947,707,82,1736,42663
30-03-2014,14,13259,18075,7075,1996,40407,957,659,85,1701,42108
30-03-2014,15,12944,18038,7089,1943,40014,922,666,79,1667,41681
30-03-2014,16,13067,18139,7290,1919,40415,959,670,65,1694,42109
30-03-2014,17,14481,18589,7486,1764,42321,957,699,66,1722,44043
30-03-2014,18,16354,19719,7714,2334,46120,958,835,103,1896,48016
30-03-2014,19,17780,19821,7848,2552,48001,993,1052,129,2174,50175
30-03-2014,20,18281,20782,7864,2640,49565,1030,859,104,1993,51558
30-03-2014,21,18029,20588,7535,2488,48641,1020,804,73,1897,50538
30-03-2014,22,17275,20105,7202,2179,46762,868,591,60,1519,48281
30-03-2014,23,16423,18980,7137,2176,44718,823,495,61,1379,46097
31-03-2014,0,15596,18063,7038,2022,42719,820,378,116,1314,44033
31-03-2014,1,15457,17401,7016,2044,41920,799,356,97,1252,43172
31-03-2014,2,14948,17213,6980,2052,41194,751,339,101,1191,42385
31-03-2014,3,14047,17188,7015,1921,40171,716,343,76,1135,41306
31-03-2014,4,14995,17062,7369,1925,41351,942,396,78,1416,42767
31-03-2014,5,17232,17975,7889,2305,45400,1374,604,147,2125,47525
31-03-2014,6,19080,19488,8228,2622,49418,1370,880,542,2792,52210
31-03-2014,7,20676,20663,8529,2877,52746,1356,983,748,3087,55833
31-03-2014,8,21332,21004,8710,3246,54291,1402,1043,738,3183,57474
31-03-2014,9,21063,21036,8673,3292,54065,1393,1043,717,3153,57218
31-03-2014,10,20833,20840,8566,3260,53500,1444,1187,449,3080,56580
31-03-2014,11,20279,20742,8494,3178,52693,1400,1002,465,2867,55560
31-03-2014,12,19224,20660,8407,3389,51681,1414,986,319,2719,54400
31-03-2014,13,19468,20112,8435,3259,51275,1461,958,307,2726,54001
31-03-2014,14,19135,19998,8204,3206,50545,1452,961,305,2718,53263
31-03-2014,15,18890,19993,8094,3037,50014,1382,909,327,2618,52632
31-03-2014,16,18434,19942,8049,2973,49399,1363,876,184,2423,51822
31-03-2014,17,19222,19749,7919,2809,49699,1348,857,434,2639,52338
31-03-2014,18,19606,20083,8125,2861,50675,1307,823,441,2571,53246
31-03-2014,19,20094,20291,8184,2788,51356,1367,872,475,2714,54070
31-03-2014,20,20087,20634,8185,2830,51736,1414,892,323,2629,54365
31-03-2014,21,19784,20312,7849,2738,50683,1418,779,247,2444,53127
31-03-2014,22,18890,19762,7388,2625,48665,1226,713,131,2070,50735
31-03-2014,23,17928,18723,7141,2451,46241,1018,566,78,1662,47903
01-04-2014,0,17608,17146,7191,2139,44086,1040,555,74,1669,45755
01-04-2014,1,17284,16413,7180,2102,42979,1005,465,91,1561,44540
01-04-2014,2,17113,16110,7203,2190,42616,988,468,88,1544,44160
01-04-2014,3,17153,15844,7219,2220,42436,1001,470,64,1535,43971
01-04-2014,4,17474,15959,7330,2190,42954,1074,522,58,1654,44608
01-04-2014,5,18936,17215,7871,2229,46251,1388,731,106,2225,48476
01-04-2014,6,20360,19315,8543,2723,50942,1390,803,274,2467,53409
01-04-2014,7,21403,20332,8701,3389,53825,1409,1070,694,3173,56998
01-04-2014,8,21701,20372,8829,3908,54811,1397,1222,688,3307,58118
01-04-2014,9,21541,20305,8799,4082,54728,1423,1155,689,3267,57995
01-04-2014,10,20862,19950,8797,4028,53638,1417,1145,290,2852,56490
01-04-2014,11,20377,19814,8666,4071,52929,1436,1043,290,2769,55698
01-04-2014,12,20411,19429,8467,3839,52147,1446,1023,291,2760,54907
01-04-2014,13,20236,19047,8422,3818,51523,1434,986,218,2638,54161
01-04-2014,14,19888,18865,8284,3685,50722,1475,982,199,2656,53378
01-04-2014,15,19948,18816,8135,3549,50448,1445,996,170,2611,53059
01-04-2014,16,19840,18850,8053,3578,50320,1430,953,156,2539,52859
01-04-2014,17,20041,19170,8169,3619,50998,1414,929,286,2629,53627
01-04-2014,18,19589,19440,8414,3791,51234,1413,990,133,2536,53770
01-04-2014,19,19938,19434,8552,3719,51644,1408,1029,132,2569,54213
01-04-2014,20,20608,19587,8355,3573,52122,1411,1063,143,2617,54739
01-04-2014,21,20109,19245,7939,3479,50772,1412,906,61,2379,53151
01-04-2014,22,19132,18338,7700,3314,48485,1274,710,58,2042,50527
01-04-2014,23,18172,17260,7447,3235,46113,1042,521,54,1617,47730
02-04-2014,0,17602,15612,7365,3063,43641,917,495,53,1465,45106
02-04-2014,1,17299,15142,7291,2934,42664,883,461,124,1468,44132
02-04-2014,2,16390,15120,7244,3059,41815,866,464,125,1455,43270
02-04-2014,3,15548,15140,7263,3106,41058,835,489,127,1451,42509
02-04-2014,4,16605,15362,7436,3103,42507,877,603,45,1525,44032
02-04-2014,5,17989,16627,8059,3185,45860,1141,836,87,2064,47924
02-04-2014,6,19804,18784,8712,3635,50938,1140,1053,110,2303,53241
02-04-2014,7,20809,19935,8870,4155,53769,1218,1180,271,2669,56438
02-04-2014,8,21081,20032,8793,4304,54210,1256,1317,248,2821,57031
02-04-2014,9,20816,19751,8731,4420,53717,1271,1217,282,2770,56487
02-04-2014,10,20849,19436,8756,4244,53286,1265,1181,284,2730,56016
02-04-2014,11,20405,19220,8589,4121,52335,1250,1176,308,2734,55069
02-04-2014,12,19672,18860,8415,4043,50991,1191,1174,195,2560,53551
02-04-2014,13,19094,18531,8180,4051,49857,1193,1143,116,2452,52309
02-04-2014,14,19056,18410,7943,4052,49462,1205,1090,117,2412,51874
02-04-2014,15,19184,18525,7822,3890,49420,1216,1062,118,2396,51816
02-04-2014,16,19390,18748,7920,3652,49710,1168,991,120,2279,51989
02-04-2014,17,19937,19402,8057,3391,50788,1246,1071,118,2435,53223
02-04-2014,18,19991,19917,8295,3387,51591,1238,1092,117,2447,54038
02-04-2014,19,20150,19881,8239,3246,51517,1253,1095,116,2464,53981
02-04-2014,20,20367,20065,8162,3291,51886,1273,1119,116,2508,54394
02-04-2014,21,19866,19768,7899,3169,50702,1288,872,121,2281,52983
02-04-2014,22,19336,18850,7638,2727,48550,1187,588,133,1908,50458
02-04-2014,23,18367,17896,7409,2496,46170,1080,522,77,1679,47849
03-04-2014,0,17837,16061,7245,2484,43628,1009,518,101,1628,45256
03-04-2014,1,17548,15558,7110,2412,42626,963,436,133,1532,44158
03-04-2014,2,17108,15221,7073,2457,41858,946,438,127,1511,43369
03-04-2014,3,16984,14976,7086,2440,41486,931,456,107,1494,42980
03-04-2014,4,17251,15411,7264,2594,42521,931,533,73,1537,44058
03-04-2014,5,18006,16542,7921,2922,45391,1093,857,78,2028,47419
03-04-2014,6,20194,18596,8568,3486,50843,1140,919,187,2246,53089
03-04-2014,7,21289,19558,8809,4127,53783,1214,1033,218,2465,56248
03-04-2014,8,21614,19443,8845,4090,53992,1219,1126,228,2573,56565
03-04-2014,9,21406,19410,8763,4156,53735,1214,1125,217,2556,56291
03-04-2014,10,20950,19208,8643,4237,53038,1214,1096,220,2530,55568
03-04-2014,11,20279,18971,8547,4281,52077,1206,1018,203,2427,54504
03-04-2014,12,19839,18354,8406,4209,50807,1203,1034,206,2443,53250
03-04-2014,13,19715,17923,8211,4166,50015,1197,1029,225,2451,52466
03-04-2014,14,19621,18067,8095,4095,49878,1198,1020,228,2446,52324
03-04-2014,15,19070,18237,7904,4018,49230,1200,975,192,2367,51597
03-04-2014,16,18993,18232,7907,3892,49025,1204,976,155,2335,51360
03-04-2014,17,19342,18679,8008,3720,49750,1207,950,145,2302,52052
03-04-2014,18,19159,18814,8168,3751,49892,1226,952,157,2335,52227
03-04-2014,19,19535,18713,8004,3477,49729,1223,1016,158,2397,52126
03-04-2014,20,19949,19471,7833,3718,50972,1216,1047,175,2438,53410
03-04-2014,21,19694,19359,7678,3482,50214,1194,881,131,2206,52420
03-04-2014,22,18390,18466,7505,3428,47789,1035,628,105,1768,49557
03-04-2014,23,17631,16969,7277,3256,45133,995,525,107,1627,46760
04-04-2014,0,16938,15101,7210,2977,42226,1088,442,105,1635,43861
04-04-2014,1,16369,14670,7130,2888,41058,1074,395,98,1567,42625
04-04-2014,2,16064,14672,7147,3117,41002,1058,370,101,1529,42531
04-04-2014,3,15355,14757,7110,3279,40500,1065,385,102,1552,42052
04-04-2014,4,16080,15173,7356,3391,41999,1070,419,87,1576,43575
04-04-2014,5,17238,16576,8123,3734,45671,1243,688,87,2018,47689
04-04-2014,6,19827,18467,8663,4246,51205,1244,902,251,2397,53602
04-04-2014,7,21648,19919,9031,5063,55661,1282,1004,273,2559,58220
04-04-2014,8,21574,20031,9005,5617,56228,1269,1100,494,2863,59091
04-04-2014,9,20628,19388,8987,5699,54703,1275,1141,327,2743,57446
04-04-2014,10,20082,19081,8879,5725,53769,1280,1146,324,2750,56519
04-04-2014,11,19184,18838,8774,5783,52580,1266,971,331,2568,55148
04-04-2014,12,18681,18397,8488,5764,51329,1271,974,325,2570,53899
04-04-2014,13,17969,18175,8167,5762,50072,1254,988,205,2447,52519
04-04-2014,14,17590,17876,8024,5626,49115,1246,975,187,2408,51523
04-04-2014,15,17136,17787,7885,5415,48223,1248,914,169,2331,50554
04-04-2014,16,16633,17757,7817,5216,47423,1245,915,88,2248,49671
04-04-2014,17,16917,18050,7788,5055,47810,1230,916,102,2248,50058
04-04-2014,18,16984,18384,7928,4875,48169,1240,920,109,2269,50438
04-04-2014,19,17488,18522,7880,4546,48438,1248,1007,131,2386,50824
04-04-2014,20,17954,18697,7586,4315,48552,1249,977,143,2369,50921
04-04-2014,21,17659,18285,7358,4257,47558,1188,898,106,2192,49750
04-04-2014,22,17093,17606,7109,4281,46088,1163,597,121,1881,47969
04-04-2014,23,16265,16544,6942,4097,43848,1060,519,126,1705,45553
05-04-2014,0,16200,15896,7014,3840,42949,832,455,118,1405,44354
05-04-2014,1,15892,15603,6990,3629,42116,831,413,108,1352,43468
05-04-2014,2,15732,15446,6982,3500,41661,828,368,98,1294,42955
05-04-2014,3,15839,15436,6982,3349,41605,835,379,97,1311,42916
05-04-2014,4,16198,15612,6983,3245,42039,840,428,96,1364,43403
05-04-2014,5,16558,15911,7110,3230,42811,846,459,87,1392,44203
05-04-2014,6,16646,16829,7230,3221,43924,884,586,83,1553,45477
05-04-2014,7,17485,17610,7257,3223,45574,936,737,72,1745,47319
05-04-2014,8,18681,18289,7304,3195,47469,984,836,52,1872,49341
05-04-2014,9,19627,19299,7323,3320,49569,999,877,47,1923,51492
05-04-2014,10,19618,19678,7304,3308,49908,1016,902,55,1973,51881
05-04-2014,11,19263,19410,7285,3314,49274,1029,864,57,1950,51224
05-04-2014,12,19130,18982,7160,3159,48432,1024,828,56,1908,50340
05-04-2014,13,18856,18931,7041,3018,47846,1015,806,54,1875,49721
05-04-2014,14,18637,18942,7051,2884,47513,977,772,53,1802,49315
05-04-2014,15,18678,18911,7072,2816,47477,967,753,53,1773,49250
05-04-2014,16,18616,19001,7218,2790,47625,942,747,54,1743,49368
05-04-2014,17,19150,19176,7463,2882,48672,982,743,57,1782,50454
05-04-2014,18,19758,19551,7528,2933,49769,987,800,63,1850,51619
05-04-2014,19,19811,19661,7619,2730,49820,972,819,80,1871,51691
05-04-2014,20,19708,19570,7496,2771,49546,974,826,110,1910,51456
05-04-2014,21,18812,19161,7336,2621,47930,1005,675,150,1830,49760
05-04-2014,22,18117,18529,7111,2355,46113,992,486,175,1653,47766
05-04-2014,23,17762,17190,6992,2309,44254,993,407,225,1625,45879
06-04-2014,0,17121,15907,6875,2251,42154,887,355,176,1418,43572
06-04-2014,1,16189,14921,6683,2205,39997,862,353,166,1381,41378
06-04-2014,2,14996,14533,6623,2256,38408,839,267,142,1248,39656
06-04-2014,3,13694,14419,6502,2301,36915,816,299,135,1250,38165
06-04-2014,4,14191,14340,6512,2329,37371,818,334,142,1294,38665
06-04-2014,5,14345,14298,6547,2393,37583,883,342,142,1367,38950
06-04-2014,6,14287,14496,6579,2440,37803,886,463,142,1491,39294
06-04-2014,7,14477,15173,6586,2469,38705,939,640,125,1704,40409
06-04-2014,8,16869,15710,6867,2581,42027,990,771,102,1863,43890
06-04-2014,9,18116,16631,7090,2801,44639,985,828,146,1959,46598
06-04-2014,10,18050,17322,7145,2936,45454,1033,869,165,2067,47521
06-04-2014,11,17975,17390,7162,3070,45597,1077,871,70,2018,47615
06-04-2014,12,16911,16825,7086,2972,43794,1073,845,68,1986,45780
06-04-2014,13,16595,16678,6991,2979,43245,1055,813,64,1932,45177
06-04-2014,14,16292,16648,6996,2911,42848,1038,818,63,1919,44767
06-04-2014,15,15845,16605,6984,2919,42354,1015,818,57,1890,44244
06-04-2014,16,15679,16815,7035,3040,42569,1023,815,57,1895,44464
06-04-2014,17,16377,17095,7148,2921,43541,1017,854,58,1929,45470
06-04-2014,18,17281,18258,7452,3253,46244,1026,892,51,1969,48213
06-04-2014,19,17965,18798,7590,3236,47589,1025,1105,52,2182,49771
06-04-2014,20,18454,19086,7473,3322,48335,1029,1112,77,2218,50553
06-04-2014,21,18126,18816,7479,3288,47708,1019,882,54,1955,49663
06-04-2014,22,17290,17727,7104,3454,45574,990,568,50,1608,47182
06-04-2014,23,16505,16367,6841,3428,43141,944,461,100,1505,44646
07-04-2014,0,15220,15279,6811,3295,40605,897,436,51,1384,41989
07-04-2014,1,13394,14828,6785,3237,38245,824,356,52,1232,39477
07-04-2014,2,12548,14827,6782,3142,37300,795,350,50,1195,38495
07-04-2014,3,12267,14795,6848,3012,36921,785,363,55,1203,38124
07-04-2014,4,13654,15129,7091,2802,38677,874,450,57,1381,40058
07-04-2014,5,15361,16312,7810,2854,42337,1105,617,56,1778,44115
07-04-2014,6,17618,18731,8432,3064,47845,1181,875,235,2291,50136
07-04-2014,7,19965,20224,8788,3287,52264,1161,1023,356,2540,54804
07-04-2014,8,20451,20442,8869,3465,53226,1163,1103,427,2693,55919
07-04-2014,9,20414,20653,8851,3369,53289,1172,,373,,
07-04-2014,10,20204,20865,8874,3536,53479,1187,1127,489,2803,56282
07-04-2014,11,20005,20783,8677,3399,52864,1176,1121,314,2611,55475
07-04-2014,12,18909,20551,8473,3338,51271,1181,1139,329,2649,53920
07-04-2014,13,18941,19806,8281,3268,50295,1183,1049,280,2512,52807
07-04-2014,14,18969,19958,8151,3216,50295,1187,996,273,2456,52751
07-04-2014,15,18662,20046,7959,3224,49891,1194,994,236,2424,52315
07-04-2014,16,18356,20007,7831,3215,49408,1194,940,196,2330,51738
07-04-2014,17,18490,20119,7779,3137,49525,1197,977,220,2394,51919
07-04-2014,18,18535,20132,7840,3048,49556,1177,1016,279,2472,52028
07-04-2014,19,18887,19926,7902,2865,49581,1198,1042,177,2417,51998
07-04-2014,20,19178,19569,7875,2781,49404,1204,1039,146,2389,51793
07-04-2014,21,18598,19187,7531,2932,48248,1189,840,112,2141,50389
07-04-2014,22,17358,18312,7141,2861,45671,1183,493,100,1776,47447
07-04-2014,23,16236,16470,6966,2761,42434,1118,542,82,1742,44176
08-04-2014,0,14833,15383,6876,2891,39982,949,486,72,1507,41489
08-04-2014,1,13217,14758,6877,2852,37703,843,474,66,1383,39086
08-04-2014,2,12100,14427,6824,3110,36461,841,474,58,1373,37834
08-04-2014,3,11816,14463,6823,3404,36508,834,467,54,1355,37863
08-04-2014,4,12435,14833,7011,3393,37674,843,479,54,1376,39050
08-04-2014,5,13754,16177,7628,3470,41027,1066,668,70,1804,42831
08-04-2014,6,16871,17687,8346,3649,46553,1062,813,224,2099,48652
08-04-2014,7,19313,19453,8616,3589,50971,1192,1005,398,2595,53566
08-04-2014,8,19717,20399,8635,3737,52488,1265,1012,518,2795,55283
08-04-2014,9,19400,20149,8624,3852,52026,1145,1070,421,2636,54662
08-04-2014,10,19500,20183,8508,4272,52465,1187,1172,334,2693,55158
08-04-2014,11,18703,20287,8215,4782,51987,1202,1090,367,2659,54646
08-04-2014,12,18471,19105,8176,5009,50762,1235,1030,308,2573,53335
08-04-2014,13,18336,18964,7843,5061,50205,1253,995,223,2471,52676
08-04-2014,14,17191,19083,7633,5243,49150,1255,957,232,2444,51594
08-04-2014,15,16805,18748,7498,4975,48027,1260,940,240,2440,50467
08-04-2014,16,16485,18713,7506,4741,47444,1275,910,246,2431,49875
08-04-2014,17,17336,19132,7434,4624,48526,1262,860,173,2295,50821
08-04-2014,18,17556,19878,7531,4556,49522,1257,904,315,2476,51998
08-04-2014,19,17880,19586,7659,4412,49537,1260,953,136,2349,51886
08-04-2014,20,18404,19237,7491,4338,49470,1274,926,132,2332,51802
08-04-2014,21,17679,18707,7174,4462,48022,1281,844,170,2295,50317
08-04-2014,22,16165,17889,6831,4605,45491,1095,564,133,1792,47283
08-04-2014,23,13451,16920,6736,4729,41837,929,535,184,1648,43485
09-04-2014,0,12312,15596,6781,4858,39547,886,470,124,1480,41027
09-04-2014,1,12078,15311,6799,4945,39133,851,453,127,1431,40564
09-04-2014,2,11837,15198,6783,4920,38738,857,453,150,1460,40198
09-04-2014,3,12208,15181,6812,4931,39132,856,451,151,1458,40590
09-04-2014,4,12899,15412,6978,4882,40170,919,506,141,1566,41736
09-04-2014,5,14502,16363,7641,4961,43468,1211,543,125,1879,45347
09-04-2014,6,16409,18424,8412,4984,48229,1233,782,125,2140,50369
09-04-2014,7,19166,19708,8713,5101,52687,1235,992,259,2486,55173
09-04-2014,8,19888,20074,8721,5261,53946,1268,1064,295,2627,56573
09-04-2014,9,19575,20144,8650,5393,53763,1288,1049,331,2668,56431
09-04-2014,10,19118,19696,8494,5369,52677,1312,1029,316,2657,55334
09-04-2014,11,18539,19652,8380,5464,52035,1335,1015,188,2538,54573
09-04-2014,12,17857,19471,8321,5355,51003,1309,1024,193,2526,53529
09-04-2014,13,17141,19553,7973,5299,49966,1344,980,88,2412,52378
09-04-2014,14,17208,19379,7900,5248,49734,1359,967,124,2450,52184
09-04-2014,15,17426,19583,7730,5111,49851,1313,911,114,2338,52189
09-04-2014,16,17874,19646,7680,4813,50014,1336,819,140,2295,52309
09-04-2014,17,18612,20100,7578,4529,50818,1291,896,109,2296,53114
09-04-2014,18,18692,20566,7714,4088,51059,1301,913,185,2399,53458
09-04-2014,19,18929,20528,7849,3722,51028,1303,916,96,2315,53343
09-04-2014,20,19377,20682,7492,3298,50848,1267,916,51,2234,53082
09-04-2014,21,19304,20215,7357,2996,49871,1284,718,83,2085,51956
09-04-2014,22,18393,19110,7078,2854,47436,1227,475,92,1794,49230
09-04-2014,23,17212,17983,7029,2558,44781,1115,532,132,1779,46560
10-04-2014,0,16852,16215,7076,2275,42419,1016,499,93,1608,44027
10-04-2014,1,16401,15741,7017,2203,41361,1013,495,99,1607,42968
10-04-2014,2,16204,15611,6918,2025,40757,927,500,91,1518,42275
10-04-2014,3,15494,15560,6947,1877,39880,909,511,95,1515,41395
10-04-2014,4,16251,15783,7180,1882,41095,1061,601,113,1775,42870
10-04-2014,5,17286,17358,7694,2019,44356,1159,698,126,1983,46339
10-04-2014,6,19528,19233,8496,2320,49578,1153,877,122,2152,51730
10-04-2014,7,21377,21046,8835,2772,54029,1132,1006,362,2500,56529
10-04-2014,8,21425,21344,8725,3475,54969,1097,1265,390,2752,57721
10-04-2014,9,21208,21403,8696,3766,55073,1137,1175,381,2693,57766
10-04-2014,10,21226,21233,8631,3784,54875,1134,977,399,2510,57385
10-04-2014,11,20955,21220,8563,3692,54430,1132,869,371,2372,56802
10-04-2014,12,20864,21252,8354,3427,53895,1094,921,383,2398,56293
10-04-2014,13,20562,21170,8227,3165,53124,1125,910,167,2202,55326
10-04-2014,14,20623,21078,8060,3009,52770,1138,854,158,2150,54920
10-04-2014,15,20368,21022,7880,2937,52206,1210,837,144,2191,54397
10-04-2014,16,20211,21047,7649,2989,51897,1189,803,101,2093,53990
10-04-2014,17,20267,21173,7763,3019,52222,1162,805,150,2117,54339
10-04-2014,18,20141,21139,7880,3093,52255,1152,865,150,2167,54422
10-04-2014,19,20325,21022,7969,2944,52261,1190,818,154,2162,54423
10-04-2014,20,20479,21217,7749,2900,52346,1221,858,139,2218,54564
10-04-2014,21,19835,21080,7527,2545,50987,1176,659,125,1960,52947
10-04-2014,22,18769,19939,7183,2233,48124,1152,573,131,1856,49980
10-04-2014,23,17754,18752,7028,2221,45757,1034,564,117,1715,47472
11-04-2014,0,16996,17009,6901,1996,42901,869,513,118,1500,44401
11-04-2014,1,16575,16388,6774,2119,41856,818,521,115,1454,43310
11-04-2014,2,16318,16211,6743,2083,41354,813,526,121,1460,42814
11-04-2014,3,16371,16145,6854,2087,41456,846,542,124,1512,42968
11-04-2014,4,16783,16631,7078,2154,42646,890,633,114,1637,44283
11-04-2014,5,17412,17686,7732,1998,44829,1073,653,114,1840,46669
11-04-2014,6,18759,19631,8334,2224,48949,1051,837,335,2223,51172
11-04-2014,7,20980,21165,8806,2800,53752,1069,976,391,2436,56188
11-04-2014,8,21187,21663,8755,3256,54862,1110,1296,309,2715,57577
11-04-2014,9,21127,21642,8664,3176,54609,1119,1377,237,2733,57342
11-04-2014,10,21063,21546,8660,3115,54385,1157,1168,221,2546,56931
11-04-2014,11,20758,21290,8586,2961,53595,1127,1162,218,2507,56102
11-04-2014,12,20101,21067,8490,2967,52627,1129,1141,233,2503,55130
11-04-2014,13,19584,20832,8307,2747,51469,1121,1088,79,2288,53757
11-04-2014,14,18635,20488,8334,2586,50043,1133,965,77,2175,52218
11-04-2014,15,18217,20318,8335,2587,49454,1137,907,88,2132,51586
11-04-2014,16,18058,19985,8294,2565,48904,1097,839,85,2021,50925
11-04-2014,17,17939,20102,8323,2566,48930,1071,793,79,1943,50873
11-04-2014,18,17957,20110,8276,2397,48739,1045,970,120,2135,50874
11-04-2014,19,18203,19904,7956,2133,48196,1065,908,82,2055,50251
11-04-2014,20,18426,19808,7702,2084,48020,1061,,105,,
11-04-2014,21,18182,19671,7370,2092,47315,1040,790,126,1956,49271
11-04-2014,22,17491,19354,7210,2300,46356,963,687,129,1779,48135
11-04-2014,23,16792,18828,6911,2133,44665,841,659,118,1618,46283
12-04-2014,0,16678,17280,6629,2137,42723,780,711,112,1603,44326
12-04-2014,1,16327,16839,6570,1991,41727,775,712,106,1593,43320
12-04-2014,2,16070,16490,6551,1888,40998,761,712,86,1559,42557
12-04-2014,3,15943,16298,6563,1889,40693,720,713,77,1510,42203
12-04-2014,4,16242,16379,6568,1845,41034,717,731,77,1525,42559
12-04-2014,5,16191,16634,6555,1963,41343,715,730,70,1515,42858
12-04-2014,6,16254,17423,6792,2104,42574,704,789,61,1554,44128
12-04-2014,7,16702,18351,6869,2172,44093,707,863,54,1624,45717
12-04-2014,8,17590,18711,7112,2755,46168,851,920,48,1819,47987
12-04-2014,9,18596,18859,7132,3028,47617,892,,43,,
12-04-2014,10,18762,18750,7166,3295,47972,860,941,43,1844,49816
12-04-2014,11,18012,18607,7145,3708,47472,825,942,47,1814,49286
12-04-2014,12,17439,17638,7086,4134,46297,766,938,51,1755,48052
12-04-2014,13,16106,17012,7043,4332,44494,729,928,53,1710,46204
12-04-2014,14,14618,16766,6910,4471,42766,716,917,55,1688,44454
12-04-2014,15,14260,17027,6818,4534,42639,742,888,49,1679,44318
12-04-2014,16,15404,17476,6958,4517,44355,808,892,47,1747,46102
12-04-2014,17,16990,18235,7215,4463,46903,885,890,44,1819,48722
12-04-2014,18,16894,18800,7250,4335,47280,919,901,43,1863,49143
12-04-2014,19,16926,18809,7130,4203,47071,946,1070,42,2058,49129
12-04-2014,20,17102,18957,7027,4207,47294,893,986,47,1926,49220
12-04-2014,21,17251,18488,6868,4003,46610,809,918,57,1784,48394
12-04-2014,22,16188,18172,6704,4241,45304,788,840,78,1706,47010
12-04-2014,23,15215,17264,6668,4174,43320,783,778,107,1668,44988
13-04-2014,0,13447,16095,6555,3850,39947,777,678,132,1587,41534
13-04-2014,1,12223,15433,6446,3744,37846,777,641,136,1554,39400
13-04-2014,2,11777,15102,6400,3806,37086,779,543,140,1462,38548
13-04-2014,3,11443,15011,6361,3742,36557,775,544,125,1444,38001
13-04-2014,4,11139,15053,6365,3754,36312,761,555,117,1433,37745
13-04-2014,5,11451,15078,6372,3786,36686,762,565,119,1446,38132
13-04-2014,6,11449,15126,6472,3854,36901,766,600,121,1487,38388
13-04-2014,7,12133,15383,6551,4048,38116,765,754,105,1624,39740
13-04-2014,8,12948,15716,6731,4487,39882,803,823,96,1722,41604
13-04-2014,9,13427,16179,6887,4917,41410,936,857,77,1870,43280
13-04-2014,10,13645,16555,7040,5144,42384,976,866,97,1939,44323
13-04-2014,11,13494,16794,7163,5394,42847,972,889,110,1971,44818
13-04-2014,12,13210,16827,7055,5455,42547,978,873,133,1984,44531
13-04-2014,13,12948,16651,6949,5370,41919,976,875,150,2001,43920
13-04-2014,14,12873,16516,6903,4500,40791,948,873,145,1966,42757
13-04-2014,15,12671,16419,6888,4643,40621,912,855,140,1907,42528
13-04-2014,16,12688,16402,6873,4552,40514,949,860,127,1936,42450
13-04-2014,17,13526,16722,6973,4900,42121,956,871,155,1982,44103
13-04-2014,18,13859,17405,6910,4980,43153,1029,967,150,2146,45299
13-04-2014,19,15212,18300,6993,4929,45435,1011,939,145,2095,47530
13-04-2014,20,16074,18529,7009,4787,46399,1009,1078,144,2231,48630
13-04-2014,21,16156,18342,6919,4767,46184,1004,895,166,2065,48249
13-04-2014,22,15751,17745,6739,4557,44791,803,801,177,1781,46572
13-04-2014,23,14336,17175,6631,4333,42475,753,709,170,1632,44107
14-04-2014,0,12084,15868,6508,4015,38475,801,669,178,1648,40123
14-04-2014,1,11026,15015,6478,3624,36142,810,584,173,1567,37709
14-04-2014,2,11794,14905,6296,3219,36214,804,555,180,1539,37753
14-04-2014,3,11445,14963,6288,3241,35937,822,647,182,1651,37588
14-04-2014,4,11881,15182,6431,3278,36772,850,702,187,1739,38511
14-04-2014,5,13675,15941,7041,3382,40041,1229,795,182,2206,42247
14-04-2014,6,16248,18128,7891,3929,46196,1358,989,158,2505,48701
14-04-2014,7,17323,19863,8135,4536,49857,1348,1238,357,2943,52800
14-04-2014,8,18319,20078,8190,5059,51646,1346,1265,382,2993,54639
14-04-2014,9,18087,19737,8308,5289,51422,1361,1364,379,3104,54526
14-04-2014,10,17660,19566,8206,5608,51039,1354,1425,357,3136,54175
14-04-2014,11,17078,19378,8140,5696,50292,1370,1422,326,3118,53410
14-04-2014,12,16791,18398,8029,5651,48870,1363,1395,304,3062,51932
14-04-2014,13,16424,17841,7852,5488,47606,1318,1227,301,2846,50452
14-04-2014,14,16190,17888,7692,5335,47106,1356,1213,270,2839,49945
14-04-2014,15,16026,17778,7559,5112,46476,1372,1161,291,2824,49300
14-04-2014,16,15745,17541,7610,4842,45737,1375,1072,288,2735,48472
14-04-2014,17,16024,17736,7350,4822,45933,1386,1175,120,2681,48614
14-04-2014,18,16258,18627,7387,4982,47254,1371,1198,111,2680,49934
14-04-2014,19,16283,19301,7164,4899,47646,1319,1240,111,2670,50316
14-04-2014,20,16515,19691,6908,4645,47758,1307,1280,111,2698,50456
14-04-2014,21,16415,19683,6803,4565,47465,1272,1082,98,2452,49917
14-04-2014,22,15673,18314,6698,4605,45289,1097,884,40,2021,47310
14-04-2014,23,14222,16863,6685,4372,42142,900,793,47,1740,43882
15-04-2014,0,12883,16027,6690,4199,39798,860,606,63,1529,41327
15-04-2014,1,12245,15802,6674,4107,38829,827,476,87,1390,40219
15-04-2014,2,12047,15746,6714,3992,38499,808,449,113,1370,39869
15-04-2014,3,12345,15815,6836,3816,38812,822,455,119,1396,40208
15-04-2014,4,13041,15926,6868,3614,39448,858,464,206,1528,40976
15-04-2014,5,14050,16833,7322,3541,41747,1144,827,216,2187,43934
15-04-2014,6,16003,19567,8061,3475,47108,1182,1072,273,2527,49635
15-04-2014,7,17698,21073,8447,3835,51053,1178,1099,421,2698,53751
15-04-2014,8,18246,21182,8563,4219,52211,1185,1235,393,2813,55024
15-04-2014,9,18073,20942,8477,4660,52152,1197,1289,391,2877,55029
15-04-2014,10,17994,20765,8342,4835,51935,1197,1313,346,2856,54791
15-04-2014,11,17801,20812,8337,4680,51632,1212,1433,132,2777,54409
15-04-2014,12,17377,20554,8207,4581,50719,1230,1451,137,2818,53537
15-04-2014,13,17244,20455,7782,4600,50083,1135,1363,153,2651,52734
15-04-2014,14,16937,20205,7634,4535,49309,1137,1221,145,2503,51812
15-04-2014,15,16523,20013,7431,4450,48416,1133,1065,251,2449,50865
15-04-2014,16,16513,19857,7335,4262,47968,1126,1006,297,2429,50397
15-04-2014,17,16650,20018,7402,4092,48161,1138,1117,307,2562,50723
15-04-2014,18,16855,19953,7474,3823,48105,1144,1094,276,2514,50619
15-04-2014,19,17270,20182,7382,3473,48307,1170,1028,252,2450,50757
15-04-2014,20,17763,20414,7320,3189,48685,1189,1058,257,2504,51189
15-04-2014,21,17799,20408,7325,3170,48704,1196,884,259,2339,51043
15-04-2014,22,17056,19762,7190,3120,47126,1158,682,228,2068,49194
15-04-2014,23,16437,18699,7110,2787,45034,1153,624,176,1953,46987
16-04-2014,0,15752,17191,7119,2619,42680,1148,412,178,1738,44418
16-04-2014,1,15526,16798,7065,2528,41918,1147,329,184,1660,43578
16-04-2014,2,15508,16553,7019,2430,41512,1145,328,176,1649,43161
16-04-2014,3,15600,16590,7080,2492,41761,1163,346,178,1687,43448
16-04-2014,4,16112,16788,7200,2417,42519,1278,434,183,1895,44414
16-04-2014,5,16853,17890,7559,2461,44763,1264,793,252,2309,47072
16-04-2014,6,17342,19826,8144,3004,48315,1243,1033,225,2501,50816
16-04-2014,7,18696,20729,8328,3194,50946,1246,1107,404,2757,53703
16-04-2014,8,19418,20904,8252,3255,51828,1292,1229,397,2918,54746
16-04-2014,9,19131,20925,8152,3142,51350,1299,1216,419,2934,54284
16-04-2014,10,19159,20868,7973,2894,50892,1306,1173,412,2891,53783
16-04-2014,11,18526,20711,8051,2758,50046,1309,1193,316,2818,52864
16-04-2014,12,17848,20593,7991,2723,49155,1306,1197,316,2819,51974
16-04-2014,13,17280,20423,7598,3122,48424,1135,1103,234,2472,50896
16-04-2014,14,16866,20426,7521,3150,47963,1291,1095,300,2686,50649
16-04-2014,15,16465,20343,7511,3156,47476,1238,1074,251,2563,50039
16-04-2014,16,16396,20306,7351,3269,47323,1237,1047,231,2515,49838
16-04-2014,17,16562,20577,7396,3330,47867,1226,1127,168,2521,50388
16-04-2014,18,16466,20613,7568,3365,48011,1222,1142,144,2508,50519
16-04-2014,19,16658,20667,7516,3263,48103,1215,1138,153,2506,50609
16-04-2014,20,16761,20780,7603,3334,48479,1231,1190,151,2572,51051
16-04-2014,21,16507,20814,7453,3486,48259,1245,1015,158,2418,50677
16-04-2014,22,15639,20148,7129,3260,46176,1058,742,148,1948,48124
16-04-2014,23,15173,18860,6892,2809,43734,1061,495,142,1698,45432
17-04-2014,0,14481,18006,6786,2297,41570,830,693,141,1664,43234
17-04-2014,1,14024,17215,6773,2307,40317,784,701,139,1624,41941
17-04-2014,2,13679,16990,6790,2404,39864,785,709,144,1638,41502
17-04-2014,3,13534,17025,6871,2610,40040,801,720,148,1669,41709
17-04-2014,4,13604,17205,6939,3061,40810,872,731,155,1758,42568
17-04-2014,5,13626,17734,7326,3552,42239,1221,864,167,2252,44491
17-04-2014,6,13802,19363,7774,3801,44740,1224,942,241,2407,47147
17-04-2014,7,14631,20261,8297,4162,47352,1199,1032,431,2662,50014
17-04-2014,8,15118,20573,8318,4425,48433,1227,1084,485,2796,51229
17-04-2014,9,15733,20350,8197,4776,49056,1244,1193,427,2864,51920
17-04-2014,10,15734,20739,8109,4848,49431,1274,1180,413,2867,52298
17-04-2014,11,15650,20340,8007,4958,48955,1304,1015,411,2730,51685
17-04-2014,12,15372,19669,7829,5093,47962,1315,1006,424,2745,50707
17-04-2014,13,15394,19426,7556,5132,47507,1316,988,220,2524,50031
17-04-2014,14,15186,19407,7430,5139,47162,1307,972,206,2485,49647
17-04-2014,15,15032,19083,7349,5057,46522,1199,953,211,2363,48885
17-04-2014,16,15170,19326,7227,4874,46597,1193,955,198,2346,48943
17-04-2014,17,15573,19732,7260,4664,47230,1176,965,236,2377,49607
17-04-2014,18,15326,20387,7338,4384,47436,1153,972,220,2345,49781
17-04-2014,19,15178,20092,7271,4085,46626,1145,983,230,2358,48984
17-04-2014,20,15241,20295,7277,3697,46509,1109,1009,245,2363,48872
17-04-2014,21,15477,19941,7129,3492,46038,1100,998,208,2306,48344
17-04-2014,22,15201,19296,6872,3033,44403,1050,830,249,2129,46532
17-04-2014,23,14972,18297,6608,2813,42691,884,758,277,1919,44610
18-04-2014,0,14228,16526,6563,2786,40102,764,454,245,1463,41565
18-04-2014,1,13916,15894,6488,2730,39029,744,412,234,1390,40419
18-04-2014,2,13992,15554,6495,2610,38651,724,385,218,1327,39978
18-04-2014,3,13487,15468,6442,2716,38114,704,391,213,1308,39422
18-04-2014,4,13643,15633,6461,2963,38701,698,481,237,1416,40117
18-04-2014,5,13810,16127,6527,2936,39400,696,620,275,1591,40991
18-04-2014,6,13917,17036,6764,2858,40576,688,774,271,1733,42309
18-04-2014,7,14684,18105,6853,2801,42446,675,900,386,1961,44407
18-04-2014,8,15369,19324,6901,2942,44536,733,1027,414,2174,46710
18-04-2014,9,15548,20000,6979,3315,45842,786,1032,418,2236,48078
18-04-2014,10,15228,19753,7078,3778,45837,803,1034,413,2250,48087
18-04-2014,11,15009,19538,7049,3926,45523,829,950,439,2218,47741
18-04-2014,12,14977,18932,7103,3888,44901,775,940,429,2144,47045
18-04-2014,13,14621,18902,6880,3906,44308,739,875,195,1809,46117
18-04-2014,14,14517,18475,6911,3972,43874,767,858,173,1798,45672
18-04-2014,15,14326,18063,6952,3891,43231,774,848,165,1787,45018
18-04-2014,16,14066,17959,6974,3968,42968,787,872,147,1806,44774
18-04-2014,17,14320,18323,7052,3729,43424,825,1013,190,2028,45452
18-04-2014,18,14463,18750,7302,3437,43953,913,690,181,1784,45737
18-04-2014,19,14466,18593,7386,3239,43683,919,729,179,1827,45510
18-04-2014,20,14679,18853,7408,2967,43907,916,808,212,1936,45843
18-04-2014,21,15140,18931,7500,2798,44370,907,741,162,1810,46180
18-04-2014,22,14915,18483,7172,2593,43163,892,403,171,1466,44629
18-04-2014,23,14526,17910,6848,2534,41819,813,390,153,1356,43175
19-04-2014,0,14270,16999,6626,2439,40335,777,410,95,1282,41617
19-04-2014,1,13891,16668,6607,2282,39450,762,403,93,1258,40708
19-04-2014,2,13749,16639,6651,2091,39130,774,405,88,1267,40397
19-04-2014,3,13789,16429,6671,1961,38850,748,415,90,1253,40103
19-04-2014,4,13919,16573,6670,1884,39045,795,440,90,1325,40370
19-04-2014,5,13907,16753,6643,1867,39171,783,489,88,1360,40531
19-04-2014,6,14186,16963,6748,1722,39621,837,581,109,1527,41148
19-04-2014,7,14687,17533,6863,1921,41005,909,640,124,1673,42678
19-04-2014,8,15367,18378,7016,2248,43009,911,696,129,1736,44745
19-04-2014,9,15819,18919,7119,2630,44488,913,721,129,1763,46251
19-04-2014,10,15800,19028,7059,2391,44278,914,734,136,1784,46062
19-04-2014,11,15446,18696,7027,2582,43751,909,733,129,1771,45522
19-04-2014,12,14920,17621,6825,2328,41694,901,704,123,1728,43422
19-04-2014,13,14333,16802,6663,2029,39826,886,702,108,1696,41522
19-04-2014,14,13435,16529,6689,1942,38596,889,684,103,1676,40272
19-04-2014,15,13091,16228,6780,1947,38045,908,684,100,1692,39737
19-04-2014,16,13085,16181,6942,2057,38266,913,675,96,1684,39950
19-04-2014,17,14077,16667,7037,2116,39898,910,676,87,1673,41571
19-04-2014,18,14298,17491,7152,2575,41515,914,708,89,1711,43226
19-04-2014,19,14479,17684,7080,2303,41545,910,745,85,1740,43285
19-04-2014,20,14717,17866,7053,2365,42002,902,792,148,1842,43844
19-04-2014,21,15126,18166,7216,2465,42974,912,678,155,1745,44719
19-04-2014,22,14794,17745,7108,2582,42230,906,548,151,1605,43835
19-04-2014,23,13929,16622,6885,2206,39643,905,525,175,1605,41248
20-04-2014,0,11552,15670,6629,2256,36107,745,286,154,1185,37292
20-04-2014,1,10589,15049,6534,2322,34495,662,225,138,1025,35520
20-04-2014,2,10589,14822,6530,2343,34283,683,193,137,1013,35296
20-04-2014,3,10612,14675,6508,2380,34175,693,196,141,1030,35205
20-04-2014,4,10530,14636,6493,2426,34085,667,207,148,1022,35107
20-04-2014,5,10364,14668,6475,2527,34034,704,198,158,1060,35094
20-04-2014,6,10261,14376,6471,2622,33730,683,268,157,1108,34838
20-04-2014,7,10521,14600,6410,2663,34195,767,404,118,1289,35484
20-04-2014,8,11752,14930,6411,2737,35831,811,555,87,1453,37284
20-04-2014,9,13066,15332,6383,2802,37582,901,573,119,1593,39175
20-04-2014,10,13317,15398,6460,2860,38036,899,562,129,1590,39626
20-04-2014,11,12998,15431,6374,3085,37890,864,483,110,1457,39347
20-04-2014,12,12526,15022,6341,3285,37173,844,455,105,1404,38577
20-04-2014,13,12351,14604,6253,3387,36595,822,427,99,1348,37943
20-04-2014,14,11962,14316,6303,3488,36069,781,420,101,1302,37371
20-04-2014,15,11998,14190,6292,3456,35936,781,418,87,1286,37222
20-04-2014,16,12061,14360,6350,3347,36118,774,423,88,1285,37403
20-04-2014,17,12208,14689,6391,3277,36564,834,449,95,1378,37942
20-04-2014,18,12501,15876,6406,3067,37852,886,454,90,1430,39282
20-04-2014,19,12764,16172,6435,2823,38193,987,500,99,1586,39779
20-04-2014,20,13687,16880,6767,2721,40055,1007,589,154,1750,41805
20-04-2014,21,14006,17258,6797,2733,40795,1054,528,173,1755,42550
20-04-2014,22,13377,16886,6798,2704,39766,1021,418,158,1597,41363
20-04-2014,23,12146,16521,6589,2633,37888,916,435,165,1516,39404
21-04-2014,0,11229,15607,6510,2574,35918,801,360,160,1321,37239
21-04-2014,1,10149,14949,6406,2624,34128,748,270,157,1175,35303
21-04-2014,2,10166,14681,6370,2654,33872,795,263,157,1215,35087
21-04-2014,3,10248,14506,6357,2734,33844,789,274,138,1201,35045
21-04-2014,4,10530,14552,6367,2933,34382,805,317,124,1246,35628
21-04-2014,5,10669,14728,6327,2935,34660,805,392,110,1307,35967
21-04-2014,6,10910,14813,6350,2921,34997,915,495,100,1510,36507
21-04-2014,7,11692,15319,6396,2949,36357,999,587,86,1672,38029
21-04-2014,8,12982,15803,6523,3091,38399,1090,639,102,1831,40230
21-04-2014,9,13864,16455,6776,3286,40383,1090,740,99,1929,42312
21-04-2014,10,13965,16296,6669,3387,40317,1083,741,110,1934,42251
21-04-2014,11,13819,16026,6598,3414,39857,1084,697,134,1915,41772
21-04-2014,12,13342,15947,6516,3463,39268,1091,654,134,1879,41147
21-04-2014,13,12530,15750,6426,3554,38260,1010,639,92,1741,40001
21-04-2014,14,12134,15614,6399,3544,37691,960,638,83,1681,39372
21-04-2014,15,11922,15494,6341,3367,37125,992,634,78,1704,38829
21-04-2014,16,11911,15548,6439,3186,37085,1017,600,73,1690,38775
21-04-2014,17,12599,16087,6474,2939,38099,1099,697,96,1892,39991
21-04-2014,18,13968,17477,6629,2783,40857,1124,695,104,1923,42780
21-04-2014,19,14068,17925,6810,2674,41477,1120,697,85,1902,43379
21-04-2014,20,14181,18192,6762,2804,41939,1126,785,145,2056,43995
21-04-2014,21,14382,18393,6758,2800,42333,1124,715,105,1944,44277
21-04-2014,22,13916,17751,6613,2779,41060,917,619,91,1627,42687
21-04-2014,23,12815,17257,6437,2747,39256,824,443,84,1351,40607
22-04-2014,0,11308,16500,6408,2595,36813,811,327,71,1209,38022
22-04-2014,1,10916,16080,6405,2439,35838,852,311,122,1285,37123
22-04-2014,2,10901,16028,6386,2436,35751,854,309,123,1286,37037
22-04-2014,3,10946,16071,6451,2616,36086,830,297,125,1252,37338
22-04-2014,4,11656,16132,6523,2785,37097,892,295,112,1299,38396
22-04-2014,5,12112,16683,6810,3028,38633,1213,433,110,1756,40389
22-04-2014,6,13508,18705,7211,3170,42596,1291,682,326,2299,44895
22-04-2014,7,15445,19967,7480,3266,46158,1278,882,390,2550,48708
22-04-2014,8,16115,20099,7564,3590,47369,1272,993,406,2671,50040
22-04-2014,9,15788,20210,7293,3693,46985,1317,1001,394,2712,49697
22-04-2014,10,15731,19992,7202,3734,46658,1311,878,438,2627,49285
22-04-2014,11,15399,19959,7263,3754,46375,1321,821,410,2552,48927
22-04-2014,12,15377,19420,7199,3820,45816,1334,801,418,2553,48369
22-04-2014,13,15070,19479,6982,3652,45181,1333,810,289,2432,47613
22-04-2014,14,14996,19122,6893,3585,44596,1255,811,285,2351,46947
22-04-2014,15,14774,19328,6827,3457,44387,1173,811,285,2269,46656
22-04-2014,16,14444,19265,6849,3281,43839,1155,763,286,2204,46043
22-04-2014,17,14414,19700,6820,3301,44235,1159,755,367,2281,46516
22-04-2014,18,14258,19658,6856,3272,44046,1166,736,355,2257,46303
22-04-2014,19,14364,19379,6865,3028,43637,1298,743,342,2383,46020
22-04-2014,20,14416,19659,6924,2938,43938,1288,798,337,2423,46361
22-04-2014,21,14765,19477,6930,2912,44083,1260,731,254,2245,46328
22-04-2014,22,14174,18779,6757,2676,42387,1127,484,209,1820,44207
22-04-2014,23,13229,17580,6725,2412,39946,1006,286,189,1481,41427
23-04-2014,0,11945,16391,6831,2409,37577,1013,336,202,1551,39128
23-04-2014,1,11629,16010,6853,2415,36908,932,303,206,1441,38349
23-04-2014,2,11544,15847,6841,2433,36663,925,302,201,1428,38091
23-04-2014,3,11541,15821,6869,2419,36651,968,317,192,1477,38128
23-04-2014,4,11811,16044,7014,2475,37346,966,417,188,1571,38917
23-04-2014,5,12548,16945,7191,2571,39255,1016,572,214,1802,41057
23-04-2014,6,14116,18882,7485,2747,43231,1148,703,331,2182,45413
23-04-2014,7,15721,20848,7603,3287,47459,1374,803,484,2661,50120
23-04-2014,8,16630,20704,7667,3624,48625,1382,1015,358,2755,51380
23-04-2014,9,16635,20305,7545,3467,47952,1355,859,587,2801,50753
23-04-2014,10,16179,20091,7507,3704,47482,1346,998,430,2774,50256
23-04-2014,11,16141,20224,7470,3642,47478,1161,917,463,2541,50019
23-04-2014,12,15673,20551,7363,3469,47056,1165,819,551,2535,49591
23-04-2014,13,15335,20465,7364,3641,46805,1157,804,225,2186,48991
23-04-2014,14,14926,20617,7368,3705,46616,1146,820,234,2200,48816
23-04-2014,15,15041,20595,7276,3576,46490,1147,746,255,2148,48638
23-04-2014,16,14815,20714,7243,3458,46230,1220,689,230,2139,48369
23-04-2014,17,14710,20443,7212,3657,46021,1314,767,310,2391,48412
23-04-2014,18,14634,20150,7290,3594,45668,1324,757,322,2403,48071
23-04-2014,19,14705,19835,7325,3511,45377,1268,700,282,2250,47627
23-04-2014,20,14963,19588,7388,3410,45348,1308,734,298,2340,47688
23-04-2014,21,15472,19662,7432,3479,46047,1306,623,321,2250,48297
23-04-2014,22,14764,18998,7305,3626,44693,1072,485,272,1829,46522
23-04-2014,23,14103,17322,7427,3440,42292,954,429,262,1645,43937
24-04-2014,0,13205,15967,7420,3446,40038,934,324,261,1519,41557
24-04-2014,1,12821,15301,7331,3411,38865,928,304,264,1496,40361
24-04-2014,2,12927,15096,7307,3304,38633,889,299,266,1454,40087
24-04-2014,3,13144,15243,7364,3237,38988,911,299,263,1473,40461
24-04-2014,4,13274,15865,7502,3200,39842,917,298,241,1456,41298
24-04-2014,5,13806,16917,7646,3195,41565,1061,561,273,1895,43460
24-04-2014,6,15179,19059,7801,3416,45455,1258,693,323,2274,47729
24-04-2014,7,17788,20527,7896,3717,49928,1279,804,459,2542,52470
24-04-2014,8,18583,20535,7887,3804,50808,1259,942,438,2639,53447
24-04-2014,9,18399,20136,7769,3825,50129,1255,845,548,2648,52777
24-04-2014,10,18054,20117,7627,3927,49725,1251,1080,309,2640,52365
24-04-2014,11,17660,20080,7656,3936,49334,1251,845,487,2583,51917
24-04-2014,12,17312,19676,7444,3741,48173,1255,894,430,2579,50752
24-04-2014,13,17113,19335,7353,3777,47578,1258,817,219,2294,49872
24-04-2014,14,17133,18913,7352,3861,47261,1268,803,209,2280,49541
24-04-2014,15,16699,19290,7372,3712,47074,1293,778,264,2335,49409
24-04-2014,16,16288,19203,7295,3655,46442,1294,757,206,2257,48699
24-04-2014,17,16079,19272,7223,3782,46355,1281,774,284,2339,48694
24-04-2014,18,16008,19124,7201,3589,45922,1269,756,293,2318,48240
24-04-2014,19,16161,18889,7342,3236,45628,1265,744,247,2256,47884
24-04-2014,20,16500,18854,7426,3023,45803,1284,799,246,2329,48132
24-04-2014,21,16519,19018,7443,3090,46070,1296,752,279,2327,48397
24-04-2014,22,15646,18361,7407,2915,44331,1309,406,419,2134,46465
24-04-2014,23,14652,17434,7416,2545,42046,1235,333,215,1783,43829
25-04-2014,0,14008,16229,7313,2160,39712,1050,359,233,1642,41354
25-04-2014,1,13908,15769,7229,2257,39161,968,350,220,1538,40699
25-04-2014,2,13860,15553,7208,2342,38964,965,352,222,1539,40503
25-04-2014,3,13821,15566,7197,2390,38974,978,349,214,1541,40515
25-04-2014,4,13829,15758,7170,2432,39190,1061,394,213,1668,40858
25-04-2014,5,14233,16524,7402,2612,40771,1266,591,227,2084,42855
25-04-2014,6,16483,18356,7773,2914,45527,1283,732,244,2259,47786
25-04-2014,7,18028,19630,8011,3227,48896,1305,978,337,2620,51516
25-04-2014,8,18720,19471,8125,3481,49797,1300,894,484,2678,52475
25-04-2014,9,18432,19295,7887,3481,49096,1303,832,587,2722,51818
25-04-2014,10,18066,19121,7702,3458,48348,1310,877,502,2689,51037
25-04-2014,11,17630,19028,7549,3497,47705,1363,797,489,2649,50354
25-04-2014,12,17172,18624,7397,3400,46593,1367,829,486,2682,49275
25-04-2014,13,16830,17842,7290,3450,45411,1373,806,322,2501,47912
25-04-2014,14,16612,17480,7131,3251,44474,1369,794,321,2484,46958
25-04-2014,15,16362,17541,7012,3172,44088,1323,785,318,2426,46514
25-04-2014,16,16076,17554,6921,3144,43695,1284,734,197,2215,45910
25-04-2014,17,15845,17808,6976,3102,43730,1329,751,257,2337,46067
25-04-2014,18,15586,17934,7226,3030,43777,1333,570,202,2105,45882
25-04-2014,19,15402,17971,7293,2779,43445,1315,462,214,1991,45436
25-04-2014,20,15318,17843,7161,2783,43105,1306,495,235,2036,45141
25-04-2014,21,15525,17844,7326,3018,43714,1343,374,263,1980,45694
25-04-2014,22,14828,16871,7115,3344,42157,1354,241,276,1871,44028
25-04-2014,23,14588,16044,6899,2966,40496,1115,275,188,1578,42074
26-04-2014,0,13693,15334,6745,2798,38569,1016,361,133,1510,40079
26-04-2014,1,13411,14881,6673,2628,37594,995,307,129,1431,39025
26-04-2014,2,13312,14708,6669,2524,37214,980,289,124,1393,38607
26-04-2014,3,13280,14782,6722,2398,37181,971,285,121,1377,38558
26-04-2014,4,13543,14861,6707,2304,37414,1007,267,113,1387,38801
26-04-2014,5,13486,15187,6830,2257,37759,990,236,113,1339,39098
26-04-2014,6,13677,15573,6974,2254,38479,1045,460,114,1619,40098
26-04-2014,7,14126,16370,7085,2316,39897,1059,542,102,1703,41600
26-04-2014,8,14540,17174,7273,2438,41426,1243,555,86,1884,43310
26-04-2014,9,14919,17877,7087,2622,42506,1269,614,69,1952,44458
26-04-2014,10,15005,17759,6874,2823,42461,1268,582,59,1909,44370
26-04-2014,11,14691,17310,6885,3065,41952,1270,576,67,1913,43865
26-04-2014,12,14526,16545,6828,3075,40974,1257,541,77,1875,42849
26-04-2014,13,14289,16034,6759,3035,40116,1267,561,111,1939,42055
26-04-2014,14,14146,16020,6692,2964,39822,1108,562,111,1781,41603
26-04-2014,15,14010,16018,6672,2815,39516,1030,546,113,1689,41205
26-04-2014,16,14003,16253,6802,2672,39731,1119,536,115,1770,41501
26-04-2014,17,14192,16498,6851,2795,40336,1234,458,76,1768,42104
26-04-2014,18,14248,16775,6795,2796,40613,1225,438,74,1737,42350
26-04-2014,19,14125,16755,6783,2658,40321,1226,487,67,1780,42101
26-04-2014,20,14143,16620,6801,2649,40210,1219,529,84,1832,42042
26-04-2014,21,14383,17031,6980,2586,40980,1262,427,75,1764,42744
26-04-2014,22,14177,16558,7037,2372,40145,1246,328,48,1622,41767
26-04-2014,23,13799,15948,6917,2317,38981,924,179,98,1201,40182
27-04-2014,0,13319,15226,6680,2289,37516,932,244,76,1252,38768
27-04-2014,1,12777,14375,6489,2205,35846,814,246,49,1109,36955
27-04-2014,2,12473,14080,6425,2134,35112,758,248,42,1048,36160
27-04-2014,3,12114,13706,6367,2042,34231,690,287,42,1019,35250
27-04-2014,4,12462,13674,6418,1999,34552,671,336,84,1091,35643
27-04-2014,5,12168,13681,6479,1905,34233,671,385,40,1096,35329
27-04-2014,6,11338,13867,6551,1863,33619,703,402,44,1149,34768
27-04-2014,7,12247,14192,6669,1918,35027,794,483,43,1320,36347
27-04-2014,8,13040,14703,6821,2039,36603,861,534,62,1457,38060
27-04-2014,9,14133,15917,6895,2174,39119,1020,591,65,1676,40795
27-04-2014,10,14204,16416,6868,2585,40073,1158,613,68,1839,41912
27-04-2014,11,14180,16562,6829,2747,40319,1165,593,61,1819,42138
27-04-2014,12,13866,16303,6809,2854,39832,1165,590,66,1821,41653
27-04-2014,13,13391,15379,6728,2712,38210,1007,560,66,1633,39843
27-04-2014,14,13171,14793,6687,2614,37264,886,545,70,1501,38765
27-04-2014,15,12789,14356,6697,2573,36416,873,547,84,1504,37920
27-04-2014,16,12780,14298,6744,2441,36263,890,565,80,1535,37798
27-04-2014,17,13571,15106,6796,2460,37934,918,594,77,1589,39523
27-04-2014,18,14040,16237,6875,2644,39796,1140,621,86,1847,41643
27-04-2014,19,14044,16754,6874,2438,40111,1195,665,76,1936,42047
27-04-2014,20,14026,17233,6934,2456,40650,1212,698,100,2010,42660
27-04-2014,21,14254,17874,6952,2509,41588,1211,632,89,1932,43520
27-04-2014,22,13809,17184,6826,2409,40228,1185,366,99,1650,41878
27-04-2014,23,13440,15815,6819,2084,38159,1072,266,95,1433,39592
28-04-2014,0,13190,15172,6718,1866,36947,1026,229,62,1317,38264
28-04-2014,1,13060,14986,6613,1749,36410,1055,205,48,1308,37718
28-04-2014,2,12959,14937,6551,1770,36216,1035,198,42,1275,37491
28-04-2014,3,12943,14933,6609,1902,36387,920,202,57,1179,37566
28-04-2014,4,12957,15195,6719,1876,36747,1026,260,37,1323,38070
28-04-2014,5,13357,16254,7105,2129,38844,1349,403,58,1810,40654
28-04-2014,6,15066,17739,7455,2575,42834,1350,584,44,1978,44812
28-04-2014,7,16161,18466,7650,3269,45545,1350,754,219,2323,47868
28-04-2014,8,16573,18667,7795,3478,46513,1355,909,229,2493,49006
28-04-2014,9,16291,18591,7862,3559,46306,1352,946,215,2513,48819
28-04-2014,10,16268,18495,7687,3552,46003,1356,871,225,2452,48455
28-04-2014,11,15796,18524,7639,3617,45576,1356,770,194,2320,47896
28-04-2014,12,15341,18764,7536,3508,45149,1355,771,181,2307,47456
28-04-2014,13,15122,18597,7357,3475,44551,1356,776,154,2286,46837
28-04-2014,14,15181,18395,7326,3372,44273,1356,780,175,2311,46584
28-04-2014,15,15074,18381,7184,3324,43965,1362,784,135,2281,46246
28-04-2014,16,14863,18696,7072,3254,43884,1364,747,107,2218,46102
28-04-2014,17,14568,18679,7027,3193,43467,1351,728,60,2139,45606
28-04-2014,18,14765,18592,7098,3143,43599,1364,705,100,2169,45768
28-04-2014,19,14895,18798,7065,2955,43712,1372,693,61,2126,45838
28-04-2014,20,14804,18989,7031,2864,43688,1387,724,104,2215,45903
28-04-2014,21,15008,18683,7016,2730,43438,1394,625,69,2088,45526
28-04-2014,22,14416,18098,6756,2579,41851,1389,440,70,1899,43750
28-04-2014,23,13474,16907,6732,2096,39208,1392,318,68,1778,40986
29-04-2014,0,12443,15834,6624,1913,36814,1112,496,52,1660,38474
29-04-2014,1,12307,15397,6655,1938,36298,974,515,41,1530,37828
29-04-2014,2,12190,15647,6677,2154,36669,977,499,38,1514,38183
29-04-2014,3,12222,14422,6709,1927,35279,975,498,39,1512,36791
29-04-2014,4,12351,15173,6621,1800,35945,1033,501,46,1580,37525
29-04-2014,5,12605,15813,6671,2236,37325,1279,565,89,1933,39258
29-04-2014,6,13808,17284,6923,2592,40607,1376,690,233,2299,42906
29-04-2014,7,16027,18676,7452,3125,45279,1375,833,263,2471,47750
29-04-2014,8,16778,19064,7656,3363,46863,1364,932,228,2524,49387
29-04-2014,9,16659,19101,7585,3434,46779,1360,935,259,2554,49333
29-04-2014,10,16293,19011,7488,3434,46226,1354,814,291,2459,48685
29-04-2014,11,16203,18949,7465,3494,46112,1352,752,232,2336,48448
29-04-2014,12,16287,18853,7457,3400,45997,1351,760,247,2358,48355
29-04-2014,13,16121,18857,7380,3414,45772,1451,756,85,2292,48064
29-04-2014,14,16095,18825,7321,3389,45630,1496,678,87,2261,47891
29-04-2014,15,15957,18867,7236,3236,45297,1386,781,87,2254,47551
29-04-2014,16,15659,18635,7249,2963,44506,1403,755,88,2246,46752
29-04-2014,17,15763,18486,7234,2822,44305,1413,751,142,2306,46611
29-04-2014,18,15617,18546,7252,2890,44305,1401,735,319,2455,46760
29-04-2014,19,15668,18379,7294,2744,44087,1382,741,181,2304,46391
29-04-2014,20,15822,18191,7425,2654,44092,1407,758,152,2317,46409
29-04-2014,21,16000,18151,7509,2533,44196,1400,733,124,2257,46453
29-04-2014,22,15132,17686,7475,2434,42728,1379,397,45,1821,44549
29-04-2014,23,14254,16607,7241,2346,40450,1371,366,44,1781,42231
30-04-2014,0,13660,15005,7230,2162,38058,1409,455,44,1908,39966
30-04-2014,1,13333,14544,7194,1991,37062,1399,372,44,1815,38877
30-04-2014,2,12887,14301,7211,1780,36178,1387,370,45,1802,37980
30-04-2014,3,12757,14192,7193,1648,35790,1390,381,45,1816,37606
30-04-2014,4,13068,14118,7345,1578,36109,1386,449,42,1877,37986
30-04-2014,5,14103,14771,7484,1798,38155,1364,522,111,1997,40152
30-04-2014,6,16177,16542,7912,2438,43068,1344,655,225,2224,45292
30-04-2014,7,17944,17883,8085,3077,46990,1337,824,224,2385,49375
30-04-2014,8,18049,17842,8208,3268,47368,1343,962,216,2521,49889
30-04-2014,9,18042,17479,8034,3128,46684,1396,916,225,2537,49221
30-04-2014,10,17914,17675,7890,3278,46757,1408,929,227,2564,49321
30-04-2014,11,17456,17643,7833,3376,46307,1369,747,233,2349,48656
30-04-2014,12,17213,17404,7755,3362,45734,1488,737,239,2464,48198
30-04-2014,13,17045,17296,7683,3315,45339,1520,729,75,2324,47663
30-04-2014,14,16856,16874,7518,3197,44445,1521,671,83,2275,46720
30-04-2014,15,16972,17963,7482,3100,45518,1390,692,81,2163,47681
30-04-2014,16,16689,16308,7537,3141,43673,1391,679,76,2146,45819
30-04-2014,17,16273,16676,7500,3285,43735,1413,675,128,2216,45951
30-04-2014,18,16496,16735,7528,3299,44057,1374,721,117,2212,46269
30-04-2014,19,16624,16628,7457,3295,44005,1368,762,66,2196,46201
30-04-2014,20,16434,16264,7438,3274,43410,1364,792,63,2219,45629
30-04-2014,21,16444,16139,7500,3181,43264,1341,657,73,2071,45335
30-04-2014,22,15997,15868,7394,3215,42473,1360,318,58,1736,44209
30-04-2014,23,14749,15397,7233,3120,40500,1369,245,56,1670,42170
01-05-2014,0,13327,14537,7206,3095,38166,1271,293,52,1616,39782
01-05-2014,1,12621,13727,7245,2837,36430,1062,221,49,1332,37762
01-05-2014,2,12384,13225,7093,2729,35430,891,214,44,1149,36579
01-05-2014,3,11944,13177,7054,2623,34800,851,217,55,1123,35923
01-05-2014,4,12137,13204,7158,2576,35076,862,301,61,1224,36300
01-05-2014,5,12361,13468,7193,2630,35653,860,328,94,1282,36935
01-05-2014,6,12556,13560,7117,2727,35961,857,384,84,1325,37286
01-05-2014,7,13048,14091,7180,3152,37470,1052,467,79,1598,39068
01-05-2014,8,13730,14540,7234,3431,38936,1272,560,85,1917,40853
01-05-2014,9,14276,15055,7279,3608,40217,1275,578,77,1930,42147
01-05-2014,10,14510,15163,7269,3746,40688,1290,567,96,1953,42641
01-05-2014,11,14623,15154,7277,3729,40782,1302,566,128,1996,42778
01-05-2014,12,14467,15086,7310,3463,40325,1300,575,137,2012,42337
01-05-2014,13,14265,14986,7311,3206,39769,1314,582,186,2082,41851
01-05-2014,14,13892,14722,7306,2890,38810,1353,573,206,2132,40942
01-05-2014,15,13759,14633,7268,2637,38297,1393,574,213,2180,40477
01-05-2014,16,13855,14554,7255,2563,38228,1401,546,211,2158,40386
01-05-2014,17,13951,14618,7278,2505,38352,1417,526,194,2137,40489
01-05-2014,18,14051,15096,7275,2483,38904,1418,578,174,2170,41074
01-05-2014,19,14454,15367,7341,2505,39667,1408,581,185,2174,41841
01-05-2014,20,14403,15632,7367,2431,39832,1379,602,242,2223,42055
01-05-2014,21,14931,15666,7444,2536,40577,1351,442,194,1987,42564
01-05-2014,22,14387,15450,7305,2456,39597,1349,271,94,1714,41311
01-05-2014,23,13690,14480,7249,2147,37565,1315,252,86,1653,39218
02-05-2014,0,13084,13578,7157,1994,35813,1163,520,77,1760,37573
02-05-2014,1,12720,13332,7117,1919,35089,1002,528,74,1604,36693
02-05-2014,2,12380,13122,7042,1953,34498,1088,523,76,1687,36185
02-05-2014,3,12341,13150,7095,1978,34563,1145,508,72,1725,36288
02-05-2014,4,12555,13143,7187,1969,34855,1252,497,75,1824,36679
02-05-2014,5,12920,13838,7265,1949,35970,1324,542,80,1946,37916
02-05-2014,6,14076,15874,7520,2247,39717,1334,606,73,2013,41730
02-05-2014,7,16078,16963,7829,2742,43612,1325,747,59,2131,45743
02-05-2014,8,16786,17515,7839,3012,45152,1345,766,77,2188,47340
02-05-2014,9,16870,17601,7885,3050,45405,1392,783,82,2257,47662
02-05-2014,10,16753,17902,7891,3134,45680,1383,775,104,2262,47942
02-05-2014,11,16648,18098,7883,3099,45730,1425,746,75,2246,47976
02-05-2014,12,15984,18165,7929,3164,45242,1446,747,84,2277,47519
02-05-2014,13,15370,17696,7858,3140,44064,1437,737,82,2256,46320
02-05-2014,14,14543,17297,7662,3156,42658,1427,669,95,2191,44849
02-05-2014,15,14131,17109,7480,3187,41906,1456,667,96,2219,44125
02-05-2014,16,13541,16559,7476,2754,40329,1427,658,101,2186,42515
02-05-2014,17,13811,16610,7558,2660,40639,1413,664,93,2170,42809
02-05-2014,18,14861,17263,7632,3006,42762,1406,668,84,2158,44920
02-05-2014,19,15447,17456,7803,2970,43678,1394,685,82,2161,45839
02-05-2014,20,15299,17368,7858,2808,43333,1404,738,78,2220,45553
02-05-2014,21,15596,17378,7941,2768,43684,1426,651,81,2158,45842
02-05-2014,22,15530,17145,7935,2670,43280,1437,512,82,2031,45311
02-05-2014,23,14178,16080,7705,2434,40395,1442,452,82,1976,42371
03-05-2014,0,13873,13971,7540,2019,37403,1218,272,248,1738,39141
03-05-2014,1,12977,13427,7447,2010,35861,1213,241,225,1679,37540
03-05-2014,2,12513,13400,7288,2053,35254,1182,239,200,1621,36875
03-05-2014,3,12558,13304,7247,2022,35132,1199,238,193,1630,36762
03-05-2014,4,12363,13313,7274,2068,35019,1194,251,196,1641,36660
03-05-2014,5,12223,13491,7294,1982,34990,1195,293,228,1716,36706
03-05-2014,6,12272,14236,7265,1971,35743,1155,404,205,1764,37507
03-05-2014,7,12950,14603,7377,2117,37049,1168,508,193,1869,38918
03-05-2014,8,14586,15253,7584,2433,39856,1160,580,228,1968,41824
03-05-2014,9,15403,15273,7574,2830,41080,1161,583,234,1978,43058
03-05-2014,10,15312,15147,7523,2958,40940,1131,586,227,1944,42884
03-05-2014,11,14606,15062,7447,3093,40208,1134,590,229,1953,42161
03-05-2014,12,14488,15097,7473,3149,40208,1131,590,223,1944,42152
03-05-2014,13,14008,15143,7424,3353,39928,1157,590,223,1970,41898
03-05-2014,14,13473,15245,7325,3617,39662,1176,580,232,1988,41650
03-05-2014,15,13099,15362,7259,3645,39366,1179,582,237,1998,41364
03-05-2014,16,12910,15558,7270,3711,39449,1164,572,228,1964,41413
03-05-2014,17,13424,15714,7376,4061,40576,1167,578,211,1956,42532
03-05-2014,18,14032,16088,7480,4241,41842,1171,556,228,1955,43797
03-05-2014,19,14802,15988,7586,4119,42496,1158,578,217,1953,44449
03-05-2014,20,14973,16019,7704,3883,42580,1147,568,214,1929,44509
03-05-2014,21,15275,15941,7755,3739,42709,1070,600,211,1881,44590
03-05-2014,22,14864,15883,7737,3793,42277,988,418,101,1507,43784
03-05-2014,23,13939,15229,7533,3555,40255,925,299,109,1333,41588
04-05-2014,0,12435,13577,7334,3091,36438,1028,336,69,1433,37871
04-05-2014,1,11993,13050,7269,2865,35176,889,338,80,1307,36483
04-05-2014,2,11872,12930,7265,2681,34750,847,267,96,1210,35960
04-05-2014,3,11950,12776,7244,2801,34773,808,263,116,1187,35960
04-05-2014,4,11961,12667,7217,2632,34477,851,249,126,1226,35703
04-05-2014,5,11823,12663,7178,2632,34297,897,244,143,1284,35581
04-05-2014,6,12184,12697,7222,2476,34578,905,429,111,1445,36023
04-05-2014,7,12524,13303,7242,2579,35648,921,442,122,1485,37133
04-05-2014,8,13387,13848,7262,2931,37428,941,503,104,1548,38976
04-05-2014,9,13881,14586,7289,2929,38684,946,558,99,1603,40287
04-05-2014,10,14423,14823,7348,2893,39488,957,583,96,1636,41124
04-05-2014,11,14463,14955,7461,2813,39694,964,591,127,1682,41376
04-05-2014,12,14446,15019,7576,2811,39853,977,589,141,1707,41560
04-05-2014,13,14216,14777,7571,2777,39342,985,548,167,1700,41042
04-05-2014,14,14098,14572,7510,2604,38784,986,535,180,1701,40485
04-05-2014,15,14061,14527,7470,2468,38528,986,528,168,1682,40210
04-05-2014,16,14083,14558,7538,2353,38531,984,559,165,1708,40239
04-05-2014,17,14390,14768,7607,2380,39147,988,558,155,1701,40848
04-05-2014,18,14416,15336,7682,2282,39716,981,540,146,1667,41383
04-05-2014,19,15050,15631,7771,2458,40910,971,585,119,1675,42585
04-05-2014,20,15465,15777,7840,2386,41469,962,657,128,1747,43216
04-05-2014,21,16126,15897,7944,2548,42515,973,617,101,1691,44206
04-05-2014,22,16134,16113,7945,2615,42807,983,402,100,1485,44292
04-05-2014,23,15268,15207,7810,2393,40678,1021,287,96,1404,42082
05-05-2014,0,14019,12969,7598,2287,36873,1037,375,100,1512,38385
05-05-2014,1,13774,12223,7455,2247,35700,1030,378,117,1525,37225
05-05-2014,2,13592,12312,7399,2352,35654,1015,348,111,1474,37128
05-05-2014,3,13585,12450,7475,2390,35900,1023,347,115,1485,37385
05-05-2014,4,14023,12562,7591,2459,36635,1000,344,124,1468,38103
05-05-2014,5,14711,13353,7832,2539,38435,1031,461,149,1641,40076
05-05-2014,6,16852,16412,8279,2863,44405,1114,524,272,1910,46315
05-05-2014,7,17978,17613,8372,3520,47482,1098,774,347,2219,49701
05-05-2014,8,17984,17505,8449,3641,47579,1092,835,443,2370,49949
05-05-2014,9,17672,17304,8437,3617,47029,1095,865,359,2319,49348
05-05-2014,10,17621,17011,8510,3673,46815,1121,789,419,2329,49144
05-05-2014,11,17475,17025,8506,3683,46691,1141,768,397,2306,48997
05-05-2014,12,17291,17103,8305,3645,46346,1154,760,387,2301,48647
05-05-2014,13,17125,16944,8328,3425,45822,1152,672,300,2124,47946
05-05-2014,14,17256,16614,8311,3300,45481,1150,670,272,2092,47573
05-05-2014,15,17052,16679,8231,3159,45122,1120,643,179,1942,47064
05-05-2014,16,16787,16506,8180,3102,44576,1120,637,153,1910,46486
05-05-2014,17,16777,16835,8214,3171,44996,1124,664,134,1922,46918
05-05-2014,18,16724,17262,8187,3171,45343,1122,707,189,2018,47361
05-05-2014,19,16690,17295,8174,3035,45194,1118,691,121,1930,47124
05-05-2014,20,16542,16989,8132,2993,44658,1104,649,125,1878,46536
05-05-2014,21,16619,16391,8133,2928,44071,1095,610,102,1807,45878
05-05-2014,22,16023,15679,8012,2869,42583,1081,313,97,1491,44074
05-05-2014,23,14538,14600,7718,2531,39388,1082,266,94,1442,40830
06-05-2014,0,14042,12584,7635,2429,36691,1032,261,89,1382,38073
06-05-2014,1,13695,12168,7508,2395,35767,1032,271,82,1385,37152
06-05-2014,2,13519,12213,7315,2384,35431,1004,277,78,1359,36790
06-05-2014,3,13467,12262,7367,2276,35372,1001,278,65,1344,36716
06-05-2014,4,13528,12301,7503,2455,35786,985,267,57,1309,37095
06-05-2014,5,14196,13031,7793,2817,37837,1022,316,183,1521,39358
06-05-2014,6,15621,15135,8226,3269,42251,1192,639,244,2075,44326
06-05-2014,7,17489,17266,8529,3910,47194,1202,844,379,2425,49619
06-05-2014,8,17431,17745,8623,4422,48222,1196,1047,297,2540,50762
06-05-2014,9,17303,17247,8527,4527,47603,1195,999,281,2475,50078
06-05-2014,10,17409,17051,8545,4837,47844,1155,805,406,2366,50210
06-05-2014,11,16756,17555,8525,5199,48036,1153,838,320,2311,50347
06-05-2014,12,16552,16852,8387,5195,46985,1148,838,328,2314,49299
06-05-2014,13,16682,16211,8178,5212,46282,1151,627,247,2025,48307
06-05-2014,14,16742,16267,8008,4979,45994,1206,567,246,2019,48013
06-05-2014,15,16882,16512,8031,4974,46399,1158,521,242,1921,48320
06-05-2014,16,16630,17324,8020,4853,46827,1117,518,238,1873,48700
06-05-2014,17,17318,17672,8081,4480,47550,1111,458,202,1771,49321
06-05-2014,18,17273,18287,8107,4190,47858,1135,656,235,2026,49884
06-05-2014,19,17068,18190,8139,3849,47246,1090,498,213,1801,49047
06-05-2014,20,16799,18226,8110,3681,46815,1086,582,236,1904,48719
06-05-2014,21,17106,18115,8130,3471,46822,1079,527,107,1713,48535
06-05-2014,22,16446,17533,8075,2893,44948,1072,463,70,1605,46553
06-05-2014,23,15195,16312,7838,2458,41804,1067,447,71,1585,43389
07-05-2014,0,13929,14057,7569,2023,37577,994,289,86,1369,38946
07-05-2014,1,13436,13624,7465,1854,36378,966,289,125,1380,37758
07-05-2014,2,12872,13453,7418,1869,35612,952,291,71,1314,36926
07-05-2014,3,12942,13431,7413,1873,35659,965,294,86,1345,37004
07-05-2014,4,13204,13464,7466,1877,36012,970,298,108,1376,37388
07-05-2014,5,14437,13727,7826,2013,38003,984,306,215,1505,39508
07-05-2014,6,16130,15858,8266,2305,42560,1047,582,322,1951,44511
07-05-2014,7,17812,18037,8658,3054,47562,1057,907,403,2367,49929
07-05-2014,8,18242,18129,8710,3552,48631,1022,924,545,2491,51122
07-05-2014,9,17988,18310,8725,3636,48659,1071,914,489,2474,51133
07-05-2014,10,17968,18281,8718,3746,48714,1154,914,437,2505,51219
07-05-2014,11,17794,18098,8621,3950,48463,1106,849,424,2379,50842
07-05-2014,12,17649,17671,8455,4150,47924,1077,916,520,2513,50437
07-05-2014,13,17633,17269,8491,4043,47435,1123,630,434,2187,49622
07-05-2014,14,17535,17026,8443,3979,46982,1123,606,400,2129,49111
07-05-2014,15,17390,16607,8334,4048,46380,1247,596,243,2086,48466
07-05-2014,16,17224,16487,8264,3847,45822,1154,566,221,1941,47763
07-05-2014,17,17208,16451,8285,3631,45575,1053,550,240,1843,47418
07-05-2014,18,17202,16744,8271,3487,45704,1062,749,272,2083,47787
07-05-2014,19,17384,16830,8441,3536,46192,1104,584,321,2009,48201
07-05-2014,20,17106,16850,8377,3552,45884,1123,561,287,1971,47855
07-05-2014,21,17097,16559,8299,3220,45173,1093,552,121,1766,46939
07-05-2014,22,16534,15852,8152,3052,43591,1053,492,71,1616,45207
07-05-2014,23,15038,14597,7824,2774,40233,1038,457,75,1570,41803
08-05-2014,0,14571,12246,7681,2584,37082,964,455,98,1517,38599
08-05-2014,1,14306,11699,7468,2419,35892,964,467,111,1542,37434
08-05-2014,2,14020,11674,7354,2435,35483,954,466,104,1524,37007
08-05-2014,3,13949,11603,7340,2481,35374,963,470,107,1540,36914
08-05-2014,4,14105,11675,7391,2614,35785,964,474,98,1536,37321
08-05-2014,5,14854,12250,7625,2804,37532,980,487,140,1607,39139
08-05-2014,6,16666,14337,8018,3001,42022,1028,753,282,2063,44085
08-05-2014,7,18029,16478,8507,3946,46960,1030,1042,327,2399,49359
08-05-2014,8,18190,16920,8665,4361,48137,1012,1021,521,2554,50691
08-05-2014,9,18226,16944,8630,4484,48283,1023,1094,341,2458,50741
08-05-2014,10,18240,16921,8614,4480,48256,1017,1055,342,2414,50670
08-05-2014,11,17836,16914,8549,4672,47971,1028,1014,304,2346,50317
08-05-2014,12,17722,16774,8478,4463,47438,1092,997,325,2414,49852
08-05-2014,13,17720,16526,8474,4496,47215,998,800,299,2097,49312
08-05-2014,14,17590,16352,8449,4474,46864,1002,760,293,2055,48919
08-05-2014,15,17341,16077,8448,4406,46272,985,797,293,2075,48347
08-05-2014,16,17261,16013,8338,4211,45824,958,752,275,1985,47809
08-05-2014,17,17623,16016,8381,3870,45889,943,697,263,1903,47792
08-05-2014,18,17649,16254,8498,3811,46212,942,754,240,1936,48148
08-05-2014,19,17627,16402,8472,3599,46100,945,595,265,1805,47905
08-05-2014,20,17424,16306,8440,3415,45585,953,605,277,1835,47420
08-05-2014,21,17095,15676,8412,3028,44211,963,552,245,1760,45971
08-05-2014,22,16621,14833,8152,2725,42331,969,419,126,1514,43845
08-05-2014,23,15512,13453,7872,2562,39400,948,388,113,1449,40849
09-05-2014,0,14620,12471,7561,2276,36928,1044,271,70,1385,38313
09-05-2014,1,14297,12091,7258,2165,35811,1035,382,64,1481,37292
09-05-2014,2,14001,11784,7174,2139,35099,1030,380,62,1472,36571
09-05-2014,3,14164,11675,7185,2009,35033,1030,367,72,1469,36502
09-05-2014,4,14513,11745,7291,2142,35691,1038,452,89,1579,37270
09-05-2014,5,15268,12225,7592,2320,37407,1044,406,141,1591,38998
09-05-2014,6,16540,14793,8053,2513,41899,1042,490,266,1798,43697
09-05-2014,7,17889,16583,8642,3157,46271,1054,552,267,1873,48144
09-05-2014,8,18198,16950,8775,3685,47609,1061,594,281,1936,49545
09-05-2014,9,17768,17078,8777,3796,47420,1063,593,292,1948,49368
09-05-2014,10,17818,16891,8639,3842,47190,1073,570,302,1945,49135
09-05-2014,11,17943,16898,8558,3622,47021,1076,553,291,1920,48941
09-05-2014,12,17720,16590,8452,3743,46504,1111,578,326,2015,48519
09-05-2014,13,17441,16382,8397,3612,45833,1071,586,341,1998,47831
09-05-2014,14,17038,15950,8337,3553,44877,1088,572,175,1835,46712
09-05-2014,15,16773,15572,8278,3562,44187,1078,562,150,1790,45977
09-05-2014,16,16704,15314,8193,3554,43765,1031,531,135,1697,45462
09-05-2014,17,16829,15587,8205,3636,44257,972,545,132,1649,45906
09-05-2014,18,16407,15278,8125,3480,43292,900,524,103,1527,44819
09-05-2014,19,16099,15096,8033,3277,42505,909,509,94,1512,44017
09-05-2014,20,15842,14261,7861,3166,41129,916,469,167,1552,42681
09-05-2014,21,16290,13622,7827,3034,40773,907,454,90,1451,42224
09-05-2014,22,15859,13469,7650,2859,39839,917,433,78,1428,41267
09-05-2014,23,15097,12750,7282,2759,37887,912,427,54,1393,39280
10-05-2014,0,14461,11387,6949,2097,34893,910,256,55,1221,36114
10-05-2014,1,14154,11279,6688,2006,34127,913,244,54,1211,35338
10-05-2014,2,13925,11201,6543,1791,33460,884,243,64,1191,34651
10-05-2014,3,13691,11064,6417,1798,32972,842,243,61,1146,34118
10-05-2014,4,13454,11030,6418,1730,32632,831,251,73,1155,33787
10-05-2014,5,13171,11021,6454,1764,32411,819,314,72,1205,33616
10-05-2014,6,13095,11366,6597,1889,32947,836,428,57,1321,34268
10-05-2014,7,14160,12688,6761,2184,35792,873,530,50,1453,37245
10-05-2014,8,14865,13345,7000,2539,37751,877,571,48,1496,39247
10-05-2014,9,15726,13650,7143,2721,39240,879,579,106,1564,40804
10-05-2014,10,16046,13755,7131,2943,39875,874,594,106,1574,41449
10-05-2014,11,16085,13673,7126,2760,39644,865,595,110,1570,41214
10-05-2014,12,15611,13742,7032,2824,39209,856,595,109,1560,40769
10-05-2014,13,15120,13610,6994,2726,38451,850,578,145,1573,40024
10-05-2014,14,14775,13429,6977,2640,37822,853,557,132,1542,39364
10-05-2014,15,14572,13273,6946,2592,37383,872,558,121,1551,38934
10-05-2014,16,14654,13277,7020,2562,37512,852,546,115,1513,39025
10-05-2014,17,14856,13424,7133,2891,38303,865,542,94,1501,39804
10-05-2014,18,15230,13674,7389,3059,39352,870,541,82,1493,40845
10-05-2014,19,15144,13692,7422,3234,39492,882,540,91,1513,41005
10-05-2014,20,14684,13429,7231,3091,38435,888,525,109,1522,39957
10-05-2014,21,14694,12987,7256,2958,37896,877,523,84,1484,39380
10-05-2014,22,14727,12213,7145,2760,36845,866,376,100,1342,38187
10-05-2014,23,13621,11582,6983,2705,34891,898,268,109,1275,36166
11-05-2014,0,12411,10989,6791,2522,32712,815,251,75,1141,33853
11-05-2014,1,11642,10737,6558,2314,31251,808,252,87,1147,32398
11-05-2014,2,11086,10760,6363,2127,30336,801,255,83,1139,31475
11-05-2014,3,11070,10738,6376,2083,30268,787,256,75,1118,31386
11-05-2014,4,10632,10689,6352,2092,29764,804,263,73,1140,30904
11-05-2014,5,10396,10766,6343,1950,29453,878,333,74,1285,30738
11-05-2014,6,10692,11026,6382,1912,30011,871,384,65,1320,31331
11-05-2014,7,11448,11623,6640,2131,31841,891,462,59,1412,33253
11-05-2014,8,12870,12127,6826,2382,34207,904,518,76,1498,35705
11-05-2014,9,14310,12515,7035,2579,36440,911,518,87,1516,37956
11-05-2014,10,14777,12985,7095,2786,37643,913,567,89,1569,39212
11-05-2014,11,14789,13177,7076,3224,38266,902,547,111,1560,39826
11-05-2014,12,14593,13012,7020,3472,38097,898,522,122,1542,39639
11-05-2014,13,14437,12640,7001,3562,37641,902,494,129,1525,39166
11-05-2014,14,14461,12653,6913,3379,37404,907,504,137,1548,38952
11-05-2014,15,14507,12755,6573,3277,37112,900,499,130,1529,38641
11-05-2014,16,14833,13209,6340,3260,37643,906,491,100,1497,39140
11-05-2014,17,15189,13533,6296,3332,38350,897,505,84,1486,39836
11-05-2014,18,15296,13901,6276,3026,38499,895,534,88,1517,40016
11-05-2014,19,15162,14178,6335,2939,38615,935,525,130,1590,40205
11-05-2014,20,15443,13746,6322,2988,38499,963,550,139,1652,40151
11-05-2014,21,15397,13910,6483,2986,38775,953,548,134,1635,40410
11-05-2014,22,14935,13430,6298,2800,37463,935,473,103,1511,38974
11-05-2014,23,13747,13027,6000,2516,35290,968,257,103,1328,36618
12-05-2014,0,12812,11708,5754,2086,32362,1079,249,75,1403,33765
12-05-2014,1,12691,11298,5650,1920,31559,1072,245,71,1388,32947
12-05-2014,2,12409,11092,5544,1881,30925,1087,244,78,1409,32334
12-05-2014,3,12372,11030,5583,1853,30840,1077,335,100,1512,32352
12-05-2014,4,12749,11062,5829,1955,31596,1093,341,141,1575,33171
12-05-2014,5,13877,11421,6394,2273,33967,1113,432,175,1720,35687
12-05-2014,6,15975,13410,7064,2709,39160,1193,555,272,2020,41180
12-05-2014,7,17644,15260,7621,3188,43714,1203,652,388,2243,45957
12-05-2014,8,17813,16184,7828,3530,45356,1203,729,420,2352,47708
12-05-2014,9,17625,16353,7896,3427,45301,1192,708,427,2327,47628
12-05-2014,10,17567,16181,7812,3619,45180,1171,707,633,2511,47691
12-05-2014,11,17294,16060,7793,3512,44659,1146,677,429,2252,46911
12-05-2014,12,17100,16357,7900,3563,44920,1132,662,426,2220,47140
12-05-2014,13,16692,16408,7782,3666,44548,1118,618,435,2171,46719
12-05-2014,14,16902,16247,7762,3365,44276,1096,603,398,2097,46373
12-05-2014,15,16913,16222,7739,3491,44364,1080,611,309,2000,46364
12-05-2014,16,16998,15893,7605,3694,44191,1079,589,229,1897,46088
12-05-2014,17,16827,15644,7549,3822,43843,1068,586,230,1884,45727
12-05-2014,18,16783,15562,7437,4045,43828,1068,589,313,1970,45798
12-05-2014,19,16798,15310,7445,4081,43635,1067,603,228,1898,45533
12-05-2014,20,16639,15201,7352,3967,43160,1090,645,212,1947,45107
12-05-2014,21,16591,14906,7321,3878,42695,1078,510,195,1783,44478
12-05-2014,22,16246,14185,7177,3700,41307,1042,365,198,1605,42912
12-05-2014,23,15001,13282,6945,3269,38497,1047,315,197,1559,40056
13-05-2014,0,14400,11705,6567,2981,35654,1034,320,192,1546,37200
13-05-2014,1,13917,11554,6270,3256,34997,1073,399,194,1666,36663
13-05-2014,2,13581,11590,6199,3289,34660,1114,398,193,1705,36365
13-05-2014,3,13507,11663,6190,3025,34385,1123,410,193,1726,36111
13-05-2014,4,13614,11830,6316,3259,35021,1130,419,192,1741,36762
13-05-2014,5,14396,12386,6698,3201,36680,1123,499,191,1813,38493
13-05-2014,6,16052,13714,7329,3693,40788,1152,610,277,2039,42827
13-05-2014,7,17692,16235,7833,4082,45844,1146,689,377,2212,48056
13-05-2014,8,17560,16846,8109,4538,47052,1157,792,393,2342,49394
13-05-2014,9,17286,16893,8004,4667,46850,1168,791,387,2346,49196
13-05-2014,10,17206,16691,7939,4741,46577,1167,760,395,2322,48899
13-05-2014,11,17234,16672,7906,4615,46428,1182,728,419,2329,48757
13-05-2014,12,17136,16884,7884,4669,46574,1188,742,427,2357,48931
13-05-2014,13,16878,16606,7629,4697,45810,1201,728,259,2188,47998
13-05-2014,14,16940,15963,7585,4902,45390,1216,715,253,2184,47574
13-05-2014,15,16974,15820,7621,4762,45177,1172,677,276,2125,47302
13-05-2014,16,16611,15729,7606,4704,44649,1151,642,288,2081,46730
13-05-2014,17,16477,15264,7566,4913,44221,1143,632,276,2051,46272
13-05-2014,18,16720,15308,7559,4718,44306,1128,627,391,2146,46452
13-05-2014,19,16479,15431,7540,4536,43984,1144,448,311,1903,45887
13-05-2014,20,16342,15204,7511,4322,43378,1145,447,238,1830,45208
13-05-2014,21,16408,15135,7467,4310,43319,1142,402,242,1786,45105
13-05-2014,22,16110,14820,7363,3935,42228,1135,333,250,1718,43946
13-05-2014,23,14972,13446,7021,3780,39220,1125,329,253,1707,40927
14-05-2014,0,14266,12567,6616,3220,36669,1144,316,251,1711,38380
14-05-2014,1,14104,12134,6412,3204,35853,1127,295,259,1681,37534
14-05-2014,2,13787,11966,6363,3247,35365,1078,416,250,1744,37109
14-05-2014,3,13162,11637,6407,3247,34453,1065,561,244,1870,36323
14-05-2014,4,13460,11568,6550,3308,34887,1030,589,248,1867,36754
14-05-2014,5,14897,12211,7036,3278,37423,1118,559,232,1909,39332
14-05-2014,6,16570,14344,7700,3428,42042,1122,646,222,1990,44032
14-05-2014,7,18290,16419,8247,3937,46892,1156,804,347,2307,49199
14-05-2014,8,18476,16773,8259,4469,47978,1167,832,390,2389,50367
14-05-2014,9,18225,16831,8350,4131,47537,1156,844,449,2449,49986
14-05-2014,10,17937,16819,8359,4020,47136,1152,883,475,2510,49646
14-05-2014,11,17850,16827,8336,3814,46828,1154,877,436,2467,49295
14-05-2014,12,17940,16621,8347,3703,46610,1193,860,418,2471,49081
14-05-2014,13,17763,16361,8155,3830,46108,1195,791,435,2421,48529
14-05-2014,14,17639,16172,8101,3612,45525,1202,786,364,2352,47877
14-05-2014,15,17685,15746,8016,3477,44924,1187,784,339,2310,47234
14-05-2014,16,17621,15601,7812,3238,44274,1197,748,259,2204,46478
14-05-2014,17,16590,14849,7668,3485,42593,1185,762,196,2143,44736
14-05-2014,18,17364,15073,7804,3639,43881,1164,722,235,2121,46002
14-05-2014,19,17031,15176,7708,3571,43488,1167,708,190,2065,45553
14-05-2014,20,16966,14950,7601,3386,42905,1171,660,189,2020,44925
14-05-2014,21,17357,14488,7539,3277,42662,1171,565,216,1952,44614
14-05-2014,22,17003,14277,7682,3175,42139,1164,325,191,1680,43819
14-05-2014,23,15527,13187,7254,2938,38904,1153,348,188,1689,40593
15-05-2014,0,14379,12100,7017,2702,36200,1079,266,187,1532,37732
15-05-2014,1,14252,11842,6822,2549,35462,1049,238,190,1477,36939
15-05-2014,2,13929,11993,6705,2300,34927,1108,236,203,1547,36474
15-05-2014,3,13703,12018,6716,2151,34588,1131,234,223,1588,36176
15-05-2014,4,13944,11863,6898,2257,34961,1106,399,244,1749,36710
15-05-2014,5,14605,12708,7238,2284,36836,1097,593,252,1942,38778
15-05-2014,6,16858,14440,7868,2564,41731,1153,690,215,2058,43789
15-05-2014,7,18422,15925,8160,3107,45615,1146,797,248,2191,47806
15-05-2014,8,18467,16214,8195,3463,46338,1152,839,304,2295,48633
15-05-2014,9,18450,16025,8222,3156,45852,1158,855,313,2326,48178
15-05-2014,10,18621,16370,8200,3220,46412,1159,831,300,2290,48702
15-05-2014,11,17844,16349,8084,3383,45661,1152,905,301,2358,48019
15-05-2014,12,18031,15993,8090,3241,45354,1138,1000,307,2445,47799
15-05-2014,13,17854,15721,8109,3251,44935,1153,838,104,2095,47030
15-05-2014,14,17714,15553,8015,3048,44331,1059,761,98,1918,46249
15-05-2014,15,17469,14938,7984,3011,43403,1023,750,110,1883,45286
15-05-2014,16,17439,14560,7920,2923,42843,1075,752,105,1932,44775
15-05-2014,17,17507,14645,7878,2856,42887,1102,665,98,1865,44752
15-05-2014,18,17594,14644,7974,2904,43115,1116,602,302,2020,45135
15-05-2014,19,17608,15160,8008,2906,43683,1109,597,135,1841,45524
15-05-2014,20,17485,15014,7986,2729,43213,1107,570,146,1823,45036
15-05-2014,21,17221,14754,7739,2651,42365,1074,506,186,1766,44131
15-05-2014,22,16567,14633,7500,2655,41354,1082,425,135,1642,42996
15-05-2014,23,14924,13578,7195,2371,38069,1079,269,131,1479,39548
16-05-2014,0,12998,12768,6750,1697,34212,1082,257,148,1487,35699
16-05-2014,1,12488,12529,6630,1569,33217,1075,248,147,1470,34687
16-05-2014,2,12437,12420,6558,1546,32960,1011,243,145,1399,34359
16-05-2014,3,12302,12384,6470,1543,32699,1017,245,144,1406,34105
16-05-2014,4,12419,12330,6586,1584,32919,1019,314,144,1477,34396
16-05-2014,5,13518,12733,7048,1727,35028,1153,475,126,1754,36782
16-05-2014,6,16086,13814,7615,2605,40121,1137,659,114,1910,42031
16-05-2014,7,18292,15815,7944,3054,45106,1197,788,260,2245,47351
16-05-2014,8,18553,16415,7995,3100,46061,1187,807,306,2300,48361
16-05-2014,9,18407,16348,7992,2966,45714,1186,816,297,2299,48013
16-05-2014,10,17820,16869,7869,2966,45525,1180,774,401,2355,47880
16-05-2014,11,17682,16693,7857,2952,45186,1173,768,304,2245,47431
16-05-2014,12,17637,16036,7864,2911,44448,1169,796,304,2269,46717
16-05-2014,13,17297,15346,7596,2780,43019,1181,776,99,2056,45075
16-05-2014,14,17274,14867,7479,2369,41990,1095,766,175,2036,44026
16-05-2014,15,16882,14847,7225,2233,41188,1044,761,132,1937,43125
16-05-2014,16,16332,14573,7209,2437,40551,1042,724,101,1867,42418
16-05-2014,17,15753,14316,7103,2540,39713,1039,703,87,1829,41542
16-05-2014,18,16011,14092,7250,2400,39754,1113,667,213,1993,41747
16-05-2014,19,16388,14077,7166,2374,40006,1168,662,62,1892,41898
16-05-2014,20,16222,14355,7175,2252,40003,1168,667,71,1906,41909
16-05-2014,21,16121,13998,7152,1992,39265,1153,668,82,1903,41168
16-05-2014,22,16083,13226,7176,1950,38435,1093,582,91,1766,40201
16-05-2014,23,14874,12558,6933,1696,36060,1031,335,96,1462,37522
17-05-2014,0,13620,11711,6365,1495,33192,924,513,104,1541,34733
17-05-2014,1,13019,11344,6233,1256,31853,923,510,105,1538,33391
17-05-2014,2,12668,11389,6125,1408,31591,917,498,120,1535,33126
17-05-2014,3,12410,11456,5921,1273,31061,883,496,128,1507,32568
17-05-2014,4,12495,11464,5933,1257,31149,853,497,121,1471,32620
17-05-2014,5,12583,11494,6011,1269,31357,857,516,125,1498,32855
17-05-2014,6,12833,11641,5826,1248,31549,854,554,105,1513,33062
17-05-2014,7,13847,12754,6020,1305,33926,849,600,89,1538,35464
17-05-2014,8,14661,13778,6256,1488,36184,852,682,103,1637,37821
17-05-2014,9,15148,14085,6318,1591,37142,853,763,125,1741,38883
17-05-2014,10,15125,14283,6316,1952,37676,851,709,141,1701,39377
17-05-2014,11,14719,13819,6197,1853,36588,839,693,141,1673,38261
17-05-2014,12,14507,13360,6088,1811,35766,850,683,137,1670,37436
17-05-2014,13,14098,13052,5992,1766,34908,857,676,131,1664,36572
17-05-2014,14,13476,13063,5993,1699,34230,857,673,124,1654,35884
17-05-2014,15,13323,13070,6019,1614,34026,859,651,131,1641,35667
17-05-2014,16,13401,12987,6101,1519,34007,884,648,138,1670,35677
17-05-2014,17,13649,13143,6167,1414,34374,906,629,134,1669,36043
17-05-2014,18,14529,13500,6146,1342,35518,888,622,111,1621,37139
17-05-2014,19,14753,13598,6141,1347,35840,876,648,101,1625,37465
17-05-2014,20,14556,13537,6122,1305,35520,857,651,112,1620,37140
17-05-2014,21,14775,13034,6255,1215,35279,870,642,120,1632,36911
17-05-2014,22,14475,13427,6119,1332,35351,874,621,122,1617,36968
17-05-2014,23,13552,12282,5937,1255,33026,888,538,123,1549,34575
18-05-2014,0,12690,11740,5740,975,31145,808,417,111,1336,32481
18-05-2014,1,12099,11388,5625,918,30029,792,405,112,1309,31338
18-05-2014,2,11836,11344,5622,914,29716,764,405,117,1286,31002
18-05-2014,3,11649,11294,5633,932,29508,708,330,100,1138,30646
18-05-2014,4,11317,11301,5658,960,29237,684,317,112,1113,30350
18-05-2014,5,11201,11207,5621,967,28997,690,363,119,1172,30169
18-05-2014,6,11347,10956,5542,1013,28858,773,512,73,1358,30216
18-05-2014,7,12207,11204,5556,1137,30104,789,559,77,1425,31529
18-05-2014,8,13193,12175,5687,1313,32368,804,634,96,1534,33902
18-05-2014,9,13868,13016,5807,1548,34238,843,740,102,1685,35923
18-05-2014,10,14346,13336,5860,1680,35223,859,752,114,1725,36948
18-05-2014,11,14374,13456,5865,1756,35451,879,746,98,1723,37174
18-05-2014,12,14137,13498,5659,1703,34998,873,790,96,1759,36757
18-05-2014,13,13995,13584,5607,1576,34763,869,776,100,1745,36508
18-05-2014,14,13882,13506,5587,1527,34502,872,730,108,1710,36212
18-05-2014,15,13970,13455,5601,1581,34608,867,732,98,1697,36305
18-05-2014,16,13991,13607,5716,1754,35070,857,732,95,1684,36754
18-05-2014,17,14059,13806,5784,1854,35504,868,794,93,1755,37259
18-05-2014,18,14392,14033,5924,1813,36162,879,830,89,1798,37960
18-05-2014,19,14828,14274,6027,1714,36842,887,893,96,1876,38718
18-05-2014,20,15203,14494,6100,1703,37500,884,787,112,1783,39283
18-05-2014,21,15181,14334,6086,1573,37173,885,757,101,1743,38916
18-05-2014,22,15017,13939,6031,1519,36506,861,648,54,1563,38069
18-05-2014,23,13508,12992,5818,1294,33613,860,556,36,1452,35065
19-05-2014,0,12775,12201,5667,1178,31822,1030,250,35,1315,33137
19-05-2014,1,12196,12090,5476,1225,30986,1085,170,35,1290,32276
19-05-2014,2,12054,11844,5496,1252,30646,1140,151,35,1326,31972
19-05-2014,3,12273,11655,5478,1179,30585,1206,172,36,1414,31999
19-05-2014,4,12172,11703,5577,1340,30792,1215,196,38,1449,32241
19-05-2014,5,12732,12918,5838,1595,33084,1231,536,215,1982,35066
19-05-2014,6,15514,15077,6493,2142,39226,1220,683,264,2167,41393
19-05-2014,7,16459,16780,6806,2476,42520,1298,787,498,2583,45103
19-05-2014,8,16342,16980,6921,2716,42960,1401,886,582,2869,45829
19-05-2014,9,16180,16908,6938,2913,42940,1415,968,541,2924,45864
19-05-2014,10,16137,16828,6911,3129,43005,1445,960,497,2902,45907
19-05-2014,11,15976,16907,6853,3247,42984,1443,920,573,2936,45920
19-05-2014,12,16077,16750,6841,3283,42951,1485,866,582,2933,45884
19-05-2014,13,15951,16627,6747,3263,42588,1496,824,313,2633,45221
19-05-2014,14,15919,16340,6627,3171,42059,1503,828,307,2638,44697
19-05-2014,15,15788,16118,6596,2897,41400,1506,838,295,2639,44039
19-05-2014,16,15798,15957,6426,2696,40877,1512,789,288,2589,43466
19-05-2014,17,16038,16121,6572,2642,41373,1491,784,287,2562,43935
19-05-2014,18,16057,16280,6627,2793,41758,1512,776,279,2567,44325
19-05-2014,19,15878,16131,6554,2713,41276,1545,786,264,2595,43871
19-05-2014,20,15532,15583,6540,2373,40030,1522,756,250,2528,42558
19-05-2014,21,15650,15092,6505,2154,39402,1551,729,100,2380,41782
19-05-2014,22,15301,14528,6496,2031,38357,1517,395,105,2017,40374
19-05-2014,23,13763,13781,6182,1671,35397,1523,218,102,1843,37240
20-05-2014,0,12988,12592,5829,1724,33134,1417,207,56,1680,34814
20-05-2014,1,12435,12102,5639,1730,31907,1424,213,60,1697,33604
20-05-2014,2,12281,12081,5585,1445,31392,1366,279,54,1699,33091
20-05-2014,3,12228,12086,5556,1626,31498,1316,322,46,1684,33182
20-05-2014,4,12203,12257,5619,1650,31728,1350,286,42,1678,33406
20-05-2014,5,12844,12876,5884,1691,33297,1423,600,87,2110,35407
20-05-2014,6,15037,14882,6454,2078,38450,1484,717,278,2479,40929
20-05-2014,7,16190,16308,6936,2615,42050,1464,814,284,2562,44612
20-05-2014,8,16246,16368,6981,3406,43002,1429,975,284,2688,45690
20-05-2014,9,16279,16493,6950,3103,42825,1446,844,309,2599,45424
20-05-2014,10,16151,16286,6913,3318,42669,1459,842,285,2586,45255
20-05-2014,11,16126,16178,6825,3451,42581,1463,841,288,2592,45173
20-05-2014,12,16319,15907,6904,3339,42470,1466,885,291,2642,45112
20-05-2014,13,16121,15717,6907,3354,42098,1470,859,241,2570,44668
20-05-2014,14,15856,15594,6845,3173,41468,1468,779,283,2530,43998
20-05-2014,15,15600,15570,6827,3079,41075,1565,767,279,2611,43686
20-05-2014,16,15945,15750,6867,2833,41395,1570,779,196,2545,43940
20-05-2014,17,15948,16072,6846,2890,41758,1555,791,185,2531,44289
20-05-2014,18,15644,16287,6816,3073,41820,1559,772,264,2595,44415
20-05-2014,19,15608,15799,6721,2960,41087,1583,776,101,2460,43547
20-05-2014,20,15527,15568,6648,2839,40581,1578,718,147,2443,43024
20-05-2014,21,15423,15162,6543,2648,39776,1573,662,155,2390,42166
20-05-2014,22,15345,14365,6456,2576,38742,1619,337,88,2044,40786
20-05-2014,23,14583,13194,6218,2464,36459,1549,229,54,1832,38291
21-05-2014,0,13452,12413,5801,2289,33954,1436,206,38,1680,35634
21-05-2014,1,13053,12140,5527,2107,32828,1416,207,39,1662,34490
21-05-2014,2,12475,12180,5429,1984,32068,1403,208,40,1651,33719
21-05-2014,3,12178,12196,5399,1932,31707,1407,217,40,1664,33371
21-05-2014,4,12150,12185,5495,2017,31848,1408,238,66,1712,33560
21-05-2014,5,12588,12284,5671,2208,32751,1423,433,142,1998,34749
21-05-2014,6,14644,13597,6182,2693,37117,1482,629,215,2326,39443
21-05-2014,7,15704,14904,6456,2933,39998,1489,801,216,2506,42504
21-05-2014,8,16112,14940,6690,3174,40918,1492,959,266,2717,43635
21-05-2014,9,16212,14774,6639,3393,41018,1481,,270,,
21-05-2014,10,16323,15451,6602,3754,42129,1493,848,239,2580,44709
21-05-2014,11,15931,15604,6578,3700,41815,1488,854,260,2602,44417
21-05-2014,12,15548,15590,6604,3440,41182,1603,934,389,2926,44108
21-05-2014,13,15117,15689,6585,3380,40770,1610,760,234,2604,43374
21-05-2014,14,15114,15567,6540,3442,40663,1621,711,266,2598,43261
21-05-2014,15,15240,15513,6471,3255,40479,1622,706,261,2589,43068
21-05-2014,16,15081,15224,6368,3001,39674,1534,667,261,2462,42136
21-05-2014,17,15431,15370,6474,2782,40057,1505,654,486,2645,42702
21-05-2014,18,15184,15686,6495,2935,40300,1493,700,389,2582,42882
21-05-2014,19,15310,15630,6527,2765,40232,1488,620,252,2360,42592
21-05-2014,20,15057,15215,6352,2725,39351,1486,615,218,2319,41670
21-05-2014,21,14980,14639,6228,2513,38360,1485,495,210,2190,40550
21-05-2014,22,14812,14241,6056,2533,37641,1494,387,88,1969,39610
21-05-2014,23,13155,13824,5593,2341,34913,1497,262,91,1850,36763
22-05-2014,0,11822,13256,5371,2297,32746,1443,214,73,1730,34476
22-05-2014,1,11304,12859,5190,2495,31848,1117,212,63,1392,33240
22-05-2014,2,11113,12665,5180,2626,31584,1010,212,74,1296,32880
22-05-2014,3,10860,12614,5175,2751,31401,908,217,83,1208,32609
22-05-2014,4,10717,12723,5284,2972,31696,1005,239,86,1330,33026
22-05-2014,5,10876,13420,5481,3236,33013,1444,417,129,1990,35003
22-05-2014,6,12958,14580,6274,3243,37055,1490,614,279,2383,39438
22-05-2014,7,16320,16323,6578,3937,43159,1485,798,287,2570,45729
22-05-2014,8,16771,16933,6681,4286,44672,1481,948,267,2696,47368
22-05-2014,9,16366,16903,6597,4388,44255,1485,868,475,2828,47083
22-05-2014,10,16371,16778,6613,4295,44058,1487,875,290,2652,46710
22-05-2014,11,16151,16832,6613,4280,43877,1485,879,298,2662,46539
22-05-2014,12,15913,16617,6560,4190,43279,1482,887,325,2694,45973
22-05-2014,13,16008,16539,6321,3981,42850,1474,824,334,2632,45482
22-05-2014,14,15964,16757,6335,3740,42796,1463,787,341,2591,45387
22-05-2014,15,16095,17091,6277,3536,42999,1467,784,306,2557,45556
22-05-2014,16,15932,17692,6263,3214,43102,1471,720,251,2442,45544
22-05-2014,17,15775,17559,6331,3084,42748,1465,726,293,2484,45232
22-05-2014,18,15790,17519,6313,2778,42400,1456,680,300,2436,44836
22-05-2014,19,15811,17222,6234,2535,41802,1443,618,179,2240,44042
22-05-2014,20,15256,17389,6081,2523,41248,1445,611,148,2204,43452
22-05-2014,21,15316,16431,6016,2299,40060,1436,453,172,2061,42121
22-05-2014,22,15178,15210,6008,2213,38611,1449,357,190,1996,40607
22-05-2014,23,13760,14590,5846,1990,36186,1456,258,189,1903,38089
23-05-2014,0,12962,13302,5479,1964,33708,1402,236,140,1778,35486
23-05-2014,1,12667,12931,5310,1975,32884,1398,232,134,1764,34648
23-05-2014,2,12245,12738,5306,2017,32307,1390,234,116,1740,34047
23-05-2014,3,12196,12566,5217,1784,31763,1190,237,111,1538,33301
23-05-2014,4,12074,12462,5292,1785,31614,1416,253,116,1785,33399
23-05-2014,5,12363,13180,5661,1683,32887,1405,504,159,2068,34955
23-05-2014,6,14612,15379,6299,2422,38712,1440,606,308,2354,41066
23-05-2014,7,16206,16607,6550,3186,42549,1404,798,312,2514,45063
23-05-2014,8,16209,16836,6686,3230,42961,1432,933,431,2796,45757
23-05-2014,9,16497,16955,6696,3169,43316,1613,880,480,2973,46289
23-05-2014,10,16574,17217,6636,3091,43518,1620,853,494,2967,46485
23-05-2014,11,16350,17232,6662,3103,43346,1494,846,422,2762,46108
23-05-2014,12,16641,17435,6614,3111,43802,1514,865,414,2793,46595
23-05-2014,13,16119,17540,6395,2917,42971,1549,865,241,2655,45626
23-05-2014,14,16127,16856,6273,2408,41664,1534,753,247,2534,44198
23-05-2014,15,16059,17177,6212,2404,41852,1496,710,235,2441,44293
23-05-2014,16,15722,17076,6162,2160,41121,1474,699,232,2405,43526
23-05-2014,17,15844,16709,6000,1822,40376,1459,714,211,2384,42760
23-05-2014,18,15771,16535,6180,1965,40451,1480,662,373,2515,42966
23-05-2014,19,15959,15993,6129,2320,40401,1460,639,166,2265,42666
23-05-2014,20,15419,15531,5978,2201,39128,1457,620,171,2248,41376
23-05-2014,21,15271,15082,5810,1966,38130,1479,595,185,2259,40389
23-05-2014,22,15157,14776,5724,2023,37681,1505,484,192,2181,39862
23-05-2014,23,14286,14154,5534,1799,35773,1521,263,204,1988,37761
24-05-2014,0,13576,13039,5261,1889,33765,1294,211,159,1664,35429
24-05-2014,1,13141,12534,5234,1803,32710,1272,216,165,1653,34363
24-05-2014,2,12513,12425,5196,1937,32072,1281,190,163,1634,33706
24-05-2014,3,12300,12244,5169,1870,31583,1269,187,157,1613,33196
24-05-2014,4,12194,12094,5132,1784,31204,1267,195,155,1617,32821
24-05-2014,5,12182,12124,5088,1574,30968,1237,363,143,1743,32711
24-05-2014,6,12420,12483,5051,1590,31545,1217,488,121,1826,33371
24-05-2014,7,13593,13649,5107,1723,34073,1202,586,103,1891,35964
24-05-2014,8,14037,14836,5250,2090,36213,1190,660,119,1969,38182
24-05-2014,9,15077,15192,5455,2265,37989,1192,668,155,2015,40004
24-05-2014,10,15163,15531,5534,2299,38528,1202,667,164,2033,40561
24-05-2014,11,15122,15421,5475,2306,38324,1213,675,154,2042,40366
24-05-2014,12,14812,15086,5409,2277,37583,1225,671,173,2069,39652
24-05-2014,13,14456,14331,5305,2198,36291,1214,625,160,1999,38290
24-05-2014,14,14100,14247,5269,2036,35651,1201,620,158,1979,37630
24-05-2014,15,13651,14226,5282,1862,35021,1212,617,143,1972,36993
24-05-2014,16,13786,14383,5327,1630,35126,1204,614,113,1931,37057
24-05-2014,17,13944,14565,5406,1667,35582,1207,621,134,1962,37544
24-05-2014,18,14320,14752,5365,1745,36183,1207,618,113,1938,38121
24-05-2014,19,14917,14977,5416,1757,37068,1200,621,113,1934,39002
24-05-2014,20,14697,14769,5362,1838,36665,1204,628,128,1960,38625
24-05-2014,21,14381,14611,5314,1496,35802,1204,577,96,1877,37679
24-05-2014,22,14462,14058,5325,1409,35254,1249,547,121,1917,37171
24-05-2014,23,13830,13259,5178,1349,33616,1227,225,64,1516,35132
25-05-2014,0,12398,12594,5040,1383,31415,1047,187,75,1309,32724
25-05-2014,1,12041,12238,4970,1063,30312,834,181,105,1120,31432
25-05-2014,2,12244,12078,4979,1054,30356,773,184,75,1032,31388
25-05-2014,3,11915,11737,4928,1000,29581,768,185,42,995,30576
25-05-2014,4,11623,11493,4920,1008,29044,810,192,82,1084,30128
25-05-2014,5,11354,11591,4904,1017,28867,772,197,67,1036,29903
25-05-2014,6,11511,11618,5013,1039,29181,768,272,48,1088,30269
25-05-2014,7,12128,12213,5194,1110,30644,959,535,62,1556,32200
25-05-2014,8,12575,13164,5340,1278,32357,1119,630,63,1812,34169
25-05-2014,9,13523,13821,5436,1520,34301,1116,677,60,1853,36154
25-05-2014,10,13908,14190,5592,1660,35349,1126,674,64,1864,37213
25-05-2014,11,13832,14349,5705,1809,35694,1142,674,81,1897,37591
25-05-2014,12,13763,14220,5707,1832,35522,1163,677,83,1923,37445
25-05-2014,13,13662,14146,5663,1809,35280,1162,670,87,1919,37199
25-05-2014,14,13430,14181,5600,1720,34929,1132,670,96,1898,36827
25-05-2014,15,13282,14139,5659,1815,34895,1114,669,101,1884,36779
25-05-2014,16,13465,14298,5659,1725,35148,1118,676,94,1888,37036
25-05-2014,17,13981,14447,5713,1581,35721,1105,653,92,1850,37571
25-05-2014,18,14295,14509,5729,1457,35990,1121,660,84,1865,37855
25-05-2014,19,15247,14838,5726,1554,37365,1123,666,84,1873,39238
25-05-2014,20,15529,14852,5611,1453,37445,1124,670,79,1873,39318
25-05-2014,21,15619,14819,5689,1528,37655,1149,429,84,1662,39317
25-05-2014,22,15315,14592,5656,1439,37003,1141,347,58,1546,38549
25-05-2014,23,13862,14023,5508,1380,34773,1149,228,56,1433,36206
26-05-2014,0,12614,13016,5454,1285,32369,1318,189,44,1551,33920
26-05-2014,1,12322,12690,5413,1070,31495,1082,190,36,1308,32803
26-05-2014,2,12240,12773,5393,936,31340,924,193,33,1150,32490
26-05-2014,3,12083,12772,5396,883,31137,857,207,34,1098,32235
26-05-2014,4,11752,12768,5493,911,30925,907,223,34,1164,32089
26-05-2014,5,12038,13368,5897,1131,32434,1381,326,151,1858,34292
26-05-2014,6,14591,14152,6424,1582,36750,1468,408,199,2075,38825
26-05-2014,7,16167,15415,6824,2127,40534,1464,622,313,2399,42933
26-05-2014,8,16820,15811,6933,2328,41892,1470,707,414,2591,44483
26-05-2014,9,16686,15802,6972,2429,41889,1481,729,471,2681,44570
26-05-2014,10,16748,15864,7010,2558,42179,1489,701,419,2609,44788
26-05-2014,11,16698,15928,7080,2679,42386,1482,693,481,2656,45042
26-05-2014,12,16630,16104,7105,2664,42504,1480,702,406,2588,45092
26-05-2014,13,16647,15864,7069,2611,42191,1490,713,326,2529,44720
26-05-2014,14,16407,15527,6966,2573,41475,1521,553,256,2330,43805
26-05-2014,15,16430,15396,6957,2725,41508,1567,537,234,2338,43846
26-05-2014,16,16318,15091,6820,2721,40952,1588,504,186,2278,43230
26-05-2014,17,16136,14845,6828,2681,40490,1581,510,214,2305,42795
26-05-2014,18,16076,14925,6805,2664,40469,1573,482,425,2480,42949
26-05-2014,19,15997,14830,6734,2544,40105,1577,266,412,2255,42360
26-05-2014,20,15701,14240,6602,2326,38871,1612,267,342,2221,41092
26-05-2014,21,15635,13704,6476,2151,37966,1607,306,143,2056,40022
26-05-2014,22,15541,13565,6298,2083,37488,1645,265,137,2047,39535
26-05-2014,23,14413,13186,6080,1882,35559,1509,200,134,1843,37402
27-05-2014,0,12811,12670,5917,1781,33180,1445,197,137,1779,34959
27-05-2014,1,12358,12468,5847,1667,32339,1296,198,131,1625,33964
27-05-2014,2,11938,12672,5818,1738,32166,1136,201,129,1466,33632
27-05-2014,3,11794,12693,5841,1920,32247,1140,212,126,1478,33725
27-05-2014,4,11593,12702,5884,2157,32336,1169,232,121,1522,33858
27-05-2014,5,11938,13108,6423,2511,33982,1399,496,106,2001,35983
27-05-2014,6,14452,13944,6825,3158,38378,1485,652,124,2261,40639
27-05-2014,7,15869,14866,7091,3716,41543,1493,745,282,2520,44063
27-05-2014,8,16211,15379,7282,4208,43080,1511,780,307,2598,45678
27-05-2014,9,16677,15684,7302,4356,44019,1529,744,389,2662,46681
27-05-2014,10,16537,15600,7453,4430,44022,1543,714,377,2634,46656
27-05-2014,11,16330,16009,7524,4472,44336,1534,719,338,2591,46927
27-05-2014,12,16493,15808,7541,4407,44249,1519,733,346,2598,46847
27-05-2014,13,16152,15669,7388,4329,43538,1523,589,75,2187,45725
27-05-2014,14,15895,15146,7383,4489,42913,1534,602,77,2213,45126
27-05-2014,15,15789,14738,7253,4379,42160,1569,582,92,2243,44403
27-05-2014,16,15841,14601,7020,4408,41870,1579,499,96,2174,44044
27-05-2014,17,15681,14981,6896,4339,41897,1518,507,120,2145,44042
27-05-2014,18,15211,14997,6867,4350,41426,1569,576,315,2460,43886
27-05-2014,19,15168,14862,6640,4194,40864,1560,483,140,2183,43047
27-05-2014,20,14827,14785,6539,3909,40061,1552,284,127,1963,42024
27-05-2014,21,14800,14657,6383,3662,39501,1557,262,89,1908,41409
27-05-2014,22,14317,14509,6319,3725,38869,1494,223,105,1822,40691
27-05-2014,23,12852,14312,6231,3726,37121,1481,233,114,1828,38949
28-05-2014,0,11698,13675,6101,3759,35233,1083,269,129,1481,36714
28-05-2014,1,10965,13360,6057,3762,34143,981,214,126,1321,35464
28-05-2014,2,10717,13369,6025,3833,33945,982,211,122,1315,35260
28-05-2014,3,10712,13469,5997,3841,34020,978,255,135,1368,35388
28-05-2014,4,10814,13624,6088,3819,34345,1004,322,141,1467,35812
28-05-2014,5,11868,13996,6453,3796,36113,1310,441,155,1906,38019
28-05-2014,6,14151,14701,6984,4124,39961,1576,617,159,2352,42313
28-05-2014,7,16170,15914,7322,4337,43743,1578,700,365,2643,46386
28-05-2014,8,16533,16628,7436,4313,44910,1582,727,341,2650,47560
28-05-2014,9,16531,16899,7412,4358,45201,1699,729,345,2773,47974
28-05-2014,10,16610,16984,7425,4451,45470,1714,722,323,2759,48229
28-05-2014,11,16318,16973,7394,4500,45185,1605,677,296,2578,47763
28-05-2014,12,16182,16853,7359,4440,44834,1591,717,281,2589,47423
28-05-2014,13,16166,16637,7184,4427,44412,1607,512,279,2398,46810
28-05-2014,14,16457,16139,7197,4288,44083,1532,524,253,2309,46392
28-05-2014,15,16229,15969,7214,4194,43606,1559,524,201,2284,45890
28-05-2014,16,16068,15670,7172,3982,42892,1547,513,163,2223,45115
28-05-2014,17,16049,15410,7141,3933,42534,1585,498,108,2191,44725
28-05-2014,18,16042,15335,7175,3959,42511,1611,578,146,2335,44846
28-05-2014,19,15763,15217,7131,3729,41841,1610,435,129,2174,44015
28-05-2014,20,15589,14971,7132,3352,41045,1618,449,126,2193,43238
28-05-2014,21,15339,14380,7037,3017,39773,1558,358,113,2029,41802
28-05-2014,22,14973,14136,6915,2968,38992,1563,256,60,1879,40871
28-05-2014,23,14076,13681,6601,2990,37349,1542,230,61,1833,39182
29-05-2014,0,12871,12656,6457,3121,35105,1397,209,57,1663,36768
29-05-2014,1,12698,12424,6535,2662,34318,1316,207,54,1577,35895
29-05-2014,2,12593,12331,6488,2547,33958,1231,208,54,1493,35451
29-05-2014,3,12457,12297,6417,2456,33627,1140,224,57,1421,35048
29-05-2014,4,12100,12352,6494,2229,33174,1130,256,59,1445,34619
29-05-2014,5,12076,12310,6552,2002,32940,1071,380,116,1567,34507
29-05-2014,6,12414,12557,6604,1944,33519,1158,466,226,1850,35369
29-05-2014,7,13097,13028,6664,2153,34941,1374,630,375,2379,37320
29-05-2014,8,14001,13097,6649,2253,35999,1407,662,432,2501,38500
29-05-2014,9,14616,13273,6735,2279,36903,1429,662,393,2484,39387
29-05-2014,10,14817,13443,6799,2380,37440,1369,662,355,2386,39826
29-05-2014,11,15187,13509,6832,2438,37966,1349,671,341,2361,40327
29-05-2014,12,15389,13740,6852,2452,38432,1337,671,429,2437,40869
29-05-2014,13,14919,13803,6852,2449,38023,1360,490,275,2125,40148
29-05-2014,14,14690,13748,6810,2462,37710,1367,474,269,2110,39820
29-05-2014,15,14384,13471,6754,2193,36802,1430,466,271,2167,38969
29-05-2014,16,14620,13365,6780,2116,36882,1303,423,285,2011,38893
29-05-2014,17,14652,13297,6790,2197,36935,1306,587,257,2150,39085
29-05-2014,18,14885,13403,6725,2249,37261,1363,585,136,2084,39345
29-05-2014,19,14950,13296,6814,2225,37285,1345,569,88,2002,39287
29-05-2014,20,15150,13074,6884,2346,37453,1298,371,88,1757,39210
29-05-2014,21,14979,13138,6915,2273,37305,1290,288,88,1666,38971
29-05-2014,22,14820,13061,6897,2189,36968,1287,261,93,1641,38609
29-05-2014,23,13864,13077,6773,1994,35710,1286,219,43,1548,37258
30-05-2014,0,13226,12597,6634,1717,34175,1272,200,45,1517,35692
30-05-2014,1,12754,12463,6541,1666,33425,1262,217,41,1520,34945
30-05-2014,2,12373,12502,6531,1619,33026,1253,215,41,1509,34535
30-05-2014,3,12252,12517,6470,1608,32850,1250,228,45,1523,34373
30-05-2014,4,12070,12582,6486,1657,32795,1255,330,45,1630,34425
30-05-2014,5,12340,12941,6593,1864,33738,1266,354,95,1715,35453
30-05-2014,6,14205,13547,6931,2037,36720,1315,463,264,2042,38762
30-05-2014,7,15609,14412,7268,2665,39955,1328,702,364,2394,42349
30-05-2014,8,16209,14936,7351,3013,41510,1465,707,424,2596,44106
30-05-2014,9,16484,15094,7425,3255,42257,1445,700,379,2524,44781
30-05-2014,10,16519,15103,7426,3478,42526,1430,687,328,2445,44971
30-05-2014,11,16405,15261,7421,3632,42720,1373,648,296,2317,45037
30-05-2014,12,16113,15007,7343,3777,42238,1353,598,475,2426,44664
30-05-2014,13,15984,14297,7214,3775,41270,1347,421,286,2054,43324
30-05-2014,14,15617,13922,7072,3704,40316,1309,449,266,2024,42340
30-05-2014,15,15566,13861,7018,3507,39951,1356,421,257,2034,41985
30-05-2014,16,15313,13822,6903,3462,39500,1354,394,264,2012,41512
30-05-2014,17,15472,13734,7022,3372,39601,1403,446,248,2097,41698
30-05-2014,18,15833,14195,7108,3336,40473,1381,443,252,2076,42549
30-05-2014,19,15668,13839,7031,3458,39996,1325,312,198,1835,41831
30-05-2014,20,15229,13496,6957,3373,39054,1308,358,122,1788,40842
30-05-2014,21,14774,13101,6821,3192,37886,1310,260,66,1636,39522
30-05-2014,22,14352,12917,6840,3036,37146,1316,232,74,1622,38768
30-05-2014,23,13657,12607,6657,3138,36058,1324,194,62,1580,37638
31-05-2014,0,12611,11839,6578,3019,34047,1118,182,35,1335,35382
31-05-2014,1,11886,11454,6337,2765,32442,990,181,35,1206,33648
31-05-2014,2,11701,11272,6252,2680,31905,851,181,40,1072,32977
31-05-2014,3,11581,11243,6247,2684,31756,814,182,51,1047,32803
31-05-2014,4,11428,11198,6199,2701,31527,820,193,50,1063,32590
31-05-2014,5,11291,11254,6200,2596,31340,862,205,51,1118,32458
31-05-2014,6,11399,11493,6322,2660,31874,872,296,51,1219,33093
31-05-2014,7,11774,11987,6443,2713,32917,1016,441,42,1499,34416
31-05-2014,8,12818,12548,6539,2823,34727,1175,502,43,1720,36447
31-05-2014,9,13721,12858,6536,2897,36012,1193,505,43,1741,37753
31-05-2014,10,14257,12995,6536,3097,36884,1203,516,45,1764,38648
31-05-2014,11,14531,12980,6573,2988,37073,1196,521,49,1766,38839
31-05-2014,12,14379,12990,6559,2933,36862,1185,435,54,1674,38536
31-05-2014,13,14135,12889,6541,2894,36459,1221,446,58,1725,38184
31-05-2014,14,13482,12981,6497,2879,35839,1255,440,69,1764,37603
31-05-2014,15,13510,12972,6492,2858,35832,1285,436,65,1786,37618
31-05-2014,16,13655,12938,6526,2888,36008,1217,428,69,1714,37722
31-05-2014,17,13746,12930,6522,3026,36224,1238,473,58,1769,37993
31-05-2014,18,13676,12923,6539,2847,35987,1131,487,55,1673,37660
31-05-2014,19,13812,12927,6575,2756,36071,1148,497,54,1699,37770
31-05-2014,20,14316,12879,6567,2544,36306,1109,489,56,1654,37960
31-05-2014,21,13770,12943,6578,2336,35627,1128,391,58,1577,37204
31-05-2014,22,14162,13051,6668,2216,36099,1161,290,57,1508,37607
31-05-2014,23,13525,12820,6564,2052,34960,1156,191,59,1406,36366
01-06-2014,0,12053,12189,6318,1738,32298,876,178,61,1115,33413
01-06-2014,1,12030,11738,6194,1556,31518,796,177,66,1039,32557
01-06-2014,2,11970,11571,6165,1401,31107,777,176,73,1026,32133
01-06-2014,3,11773,11584,6133,1286,30776,776,178,73,1027,31803
01-06-2014,4,11598,11638,6199,1225,30658,767,188,77,1032,31690
01-06-2014,5,11649,11707,6220,1172,30746,768,203,70,1041,31787
01-06-2014,6,11177,11643,6219,1165,30204,767,292,45,1104,31308
01-06-2014,7,11734,11782,6259,1159,30933,766,382,55,1203,32136
01-06-2014,8,12579,12252,6615,1173,32620,992,475,50,1517,34137
01-06-2014,9,13829,12653,6731,1439,34653,1103,506,69,1678,36331
01-06-2014,10,14388,12853,6752,1570,35564,1103,512,80,1695,37259
01-06-2014,11,14613,12760,6730,1634,35737,1104,516,95,1715,37452
01-06-2014,12,14501,12674,6671,1640,35487,1101,450,104,1655,37142
01-06-2014,13,14406,12630,6591,1655,35283,1111,434,101,1646,36929
01-06-2014,14,14401,12639,6349,1662,35051,1137,422,107,1666,36717
01-06-2014,15,14483,12550,6068,1655,34754,1140,385,108,1633,36387
01-06-2014,16,14659,12703,5925,1647,34934,1120,390,117,1627,36561
01-06-2014,17,14892,12904,5933,1668,35397,1109,390,121,1620,37017
01-06-2014,18,15010,12987,5945,1710,35652,1122,504,114,1740,37392
01-06-2014,19,15051,13086,5991,1640,35769,1131,511,125,1767,37536
01-06-2014,20,15158,12993,5985,1558,35695,1139,498,124,1761,37456
01-06-2014,21,15002,12899,5970,1503,35374,1118,495,83,1696,37070
01-06-2014,22,14773,12750,5942,1423,34888,1141,400,92,1633,36521
01-06-2014,23,14244,12517,5759,1270,33791,1243,207,111,1561,35352
02-06-2014,0,13187,11921,5567,1131,31806,1411,192,106,1709,33515
02-06-2014,1,12594,11609,5510,1129,30843,1378,206,95,1679,32522
02-06-2014,2,12383,11501,5537,1174,30597,1377,214,100,1691,32288
02-06-2014,3,12407,11417,5545,1087,30457,1382,304,97,1783,32240
02-06-2014,4,12382,11485,5554,1115,30535,1384,342,124,1850,32385
02-06-2014,5,12860,12019,5722,1300,31901,1399,457,289,2145,34046
02-06-2014,6,15042,13267,6145,1904,36360,1459,596,459,2514,38874
02-06-2014,7,16558,15337,6519,2240,40655,1458,690,483,2631,43286
02-06-2014,8,16479,15565,6486,2479,41009,1480,710,896,3086,44095
02-06-2014,9,16671,15432,6507,2631,41241,1543,737,534,2814,44055
02-06-2014,10,16689,15509,6669,2692,41559,1533,671,581,2785,44344
02-06-2014,11,16604,15544,6788,2744,41681,1496,548,629,2673,44354
02-06-2014,12,16420,15521,6755,2701,41397,1584,569,644,2797,44194
02-06-2014,13,16105,15868,6718,2661,41353,1632,518,672,2822,44175
02-06-2014,14,16162,15667,6521,2570,40921,1620,422,519,2561,43482
02-06-2014,15,15851,15361,6456,2520,40187,1559,414,534,2507,42694
02-06-2014,16,15689,14978,6385,2298,39351,1525,398,527,2450,41801
02-06-2014,17,15616,15021,6470,2260,39366,1583,425,482,2490,41856
02-06-2014,18,15419,15618,6535,2224,39797,1445,470,333,2248,42045
02-06-2014,19,15467,15572,6517,2214,39769,1439,484,380,2303,42072
02-06-2014,20,15477,15171,6553,1998,39198,1474,494,312,2280,41478
02-06-2014,21,15409,14717,6437,1984,38547,1452,397,311,2160,40707
02-06-2014,22,14861,14174,6422,1924,37380,1476,301,310,2087,39467
02-06-2014,23,14369,13635,6237,1865,36105,1479,213,301,1993,38098
03-06-2014,0,13216,12241,6073,1756,33287,1444,194,174,1812,35099
03-06-2014,1,12775,11902,5994,1692,32363,1470,196,187,1853,34216
03-06-2014,2,12339,11946,5911,1716,31911,1442,208,169,1819,33730
03-06-2014,3,12022,11903,5845,1643,31412,1424,224,169,1817,33229
03-06-2014,4,12094,11777,5831,1510,31213,1428,258,174,1860,33073
03-06-2014,5,12526,12415,6142,1561,32644,1432,285,213,1930,34574
03-06-2014,6,14591,14137,6649,1931,37306,1465,440,283,2188,39494
03-06-2014,7,16319,15895,7062,2190,41467,1448,565,407,2420,43887
03-06-2014,8,16143,16204,7109,2736,42193,1545,643,384,2572,44765
03-06-2014,9,16024,16127,7060,2577,41788,1446,678,382,2506,44294
03-06-2014,10,16023,16148,7105,2515,41791,1430,668,382,2480,44271
03-06-2014,11,16001,16242,7065,2810,42118,1422,677,372,2471,44589
03-06-2014,12,16095,16050,7044,2786,41977,1394,680,373,2447,44424
03-06-2014,13,15824,15877,6953,2827,41481,1374,662,369,2405,43886
03-06-2014,14,15955,15781,6950,2597,41283,1403,532,333,2268,43551
03-06-2014,15,16019,15719,6867,2393,40997,1364,601,310,2275,43272
03-06-2014,16,16085,15813,6847,2298,41043,1400,501,324,2225,43268
03-06-2014,17,15637,15853,6874,2317,40681,1408,495,378,2281,42962
03-06-2014,18,15554,15912,6967,2259,40691,1378,440,342,2160,42851
03-06-2014,19,15566,15913,7009,2166,40655,1365,443,384,2192,42847
03-06-2014,20,15301,15632,6894,2035,39862,1386,433,309,2128,41990
03-06-2014,21,15211,14905,6869,1931,38917,1390,371,309,2070,40987
03-06-2014,22,14509,14544,6755,1851,37659,1358,269,311,1938,39597
03-06-2014,23,13767,13451,6356,1838,35412,1392,225,309,1926,37338
04-06-2014,0,12716,12220,6026,1456,32417,1284,203,311,1798,34215
04-06-2014,1,12400,11625,5894,1264,31184,1244,188,329,1761,32945
04-06-2014,2,12239,11374,5862,1289,30765,1266,256,318,1840,32605
04-06-2014,3,12049,11285,5806,1306,30446,1266,292,318,1876,32322
04-06-2014,4,12051,11184,5807,1392,30434,1275,254,320,1849,32283
04-06-2014,5,12256,12212,6043,1542,32053,1365,393,318,2076,34129
04-06-2014,6,14006,13731,6623,1812,36172,1454,444,388,2286,38458
04-06-2014,7,15240,15893,7003,2136,40272,1481,567,533,2581,42853
04-06-2014,8,15856,16496,7115,2422,41889,1480,617,539,2636,44525
04-06-2014,9,15647,16480,7140,2599,41864,1484,619,572,2675,44539
04-06-2014,10,15791,16411,7107,2734,42044,1472,455,802,2729,44773
04-06-2014,11,15610,16404,7080,2821,41916,1494,613,612,2719,44635
04-06-2014,12,15512,16028,7034,2802,41376,1433,511,859,2803,44179
04-06-2014,13,15526,15923,7042,2805,41295,1437,468,855,2760,44055
04-06-2014,14,15347,15813,6895,2831,40886,1487,395,763,2645,43531
04-06-2014,15,15245,15744,6852,2882,40722,1477,479,628,2584,43306
04-06-2014,16,15361,15337,6863,2883,40444,1488,445,624,2557,43001
04-06-2014,17,15173,14937,6847,3074,40031,1482,275,476,2233,42264
04-06-2014,18,15225,14960,6773,3221,40177,1482,413,342,2237,42414
04-06-2014,19,15019,14929,6801,3229,39978,1420,420,369,2209,42187
04-06-2014,20,15014,14325,6686,3056,39081,1469,392,362,2223,41304
04-06-2014,21,14917,13987,6505,2745,38155,1505,313,325,2143,40298
04-06-2014,22,14186,13647,6393,2765,36991,1557,261,317,2135,39126
04-06-2014,23,13134,13015,6057,2412,34618,1505,246,247,1998,36616
05-06-2014,0,12818,11953,5802,2290,32863,1468,224,267,1959,34822
05-06-2014,1,12116,11337,5689,2223,31367,1437,210,316,1963,33330
05-06-2014,2,11686,11130,5633,2095,30544,1395,211,294,1900,32444
05-06-2014,3,11699,11075,5614,2035,30424,1120,214,132,1466,31890
05-06-2014,4,11804,11176,5544,2035,30559,1097,240,75,1412,31971
05-06-2014,5,11814,11953,5651,1915,31332,1277,295,248,1820,33152
05-06-2014,6,13428,13564,6339,2185,35517,1302,342,360,2004,37521
05-06-2014,7,15533,14795,6843,2769,39941,1286,458,443,2187,42128
05-06-2014,8,15945,15407,6964,2850,41166,1309,638,463,2410,43576
05-06-2014,9,15960,15391,7030,2859,41240,1319,,539,,
05-06-2014,10,16138,15394,7035,2823,41389,1332,488,706,2526,43915
05-06-2014,11,16217,15303,7040,2938,41496,1335,599,542,2476,43972
05-06-2014,12,16068,15522,6974,3172,41737,1328,679,522,2529,44266
05-06-2014,13,16000,15072,6878,3135,41085,1285,648,544,2477,43562
05-06-2014,14,15921,14694,6746,2930,40290,1284,538,476,2298,42588
05-06-2014,15,15775,14430,6590,2867,39662,1269,538,471,2278,41940
05-06-2014,16,15566,13971,6408,2773,38720,1229,577,362,2168,40888
05-06-2014,17,15534,13655,6184,2755,38128,1263,506,374,2143,40271
05-06-2014,18,15460,14375,6346,2726,38906,1282,449,346,2077,40983
05-06-2014,19,15480,14442,6437,2612,38969,1295,420,365,2080,41049
05-06-2014,20,15053,14241,6257,2448,37999,1295,404,354,2053,40052
05-06-2014,21,14852,13954,6163,2155,37126,1297,320,419,2036,39162
05-06-2014,22,14369,14001,6132,2174,36675,1301,290,334,1925,38600
05-06-2014,23,13542,13145,5806,2257,34750,1276,224,338,1838,36588
06-06-2014,0,12586,12106,5608,2174,32473,1186,190,378,1754,34227
06-06-2014,1,12135,11648,5556,2123,31463,1181,182,435,1798,33261
06-06-2014,2,11956,11383,5527,2070,30938,1180,183,433,1796,32734
06-06-2014,3,11976,11328,5507,2111,30922,1152,194,425,1771,32693
06-06-2014,4,11926,11316,5494,2048,30782,1198,216,421,1835,32617
06-06-2014,5,12031,11792,5789,2183,31794,1282,258,414,1954,33748
06-06-2014,6,13947,13044,6375,2362,35728,1384,403,414,2201,37929
06-06-2014,7,15926,13452,6811,2806,38994,1401,591,523,2515,41509
06-06-2014,8,16326,13989,6925,3132,40371,1389,679,612,2680,43051
06-06-2014,9,15759,13849,6984,3435,40029,1398,699,602,2699,42728
06-06-2014,10,15909,13574,7052,3590,40124,1390,702,626,2718,42842
06-06-2014,11,15740,13561,6999,3320,39621,1400,650,610,2660,42281
06-06-2014,12,15603,13374,7040,3378,39393,1399,643,614,2656,42049
06-06-2014,13,15335,13642,6895,3254,39128,1394,650,620,2664,41792
06-06-2014,14,15064,13913,6764,3213,38954,1337,632,479,2448,41402
06-06-2014,15,14765,14036,6654,3047,38503,1241,668,529,2438,40941
06-06-2014,16,14821,13985,6545,2771,38123,1247,523,731,2501,40624
06-06-2014,17,15190,14468,6278,2627,38565,1301,458,652,2411,40976
06-06-2014,18,15778,14642,6158,2636,39214,1326,463,420,2209,41423
06-06-2014,19,15394,14986,6168,2800,39349,1350,421,413,2184,41533
06-06-2014,20,15162,14566,6153,2612,38492,1311,410,413,2134,40626
06-06-2014,21,14968,14273,5887,2344,37473,1327,373,412,2112,39585
06-06-2014,22,14490,13991,5678,2252,36411,1315,330,409,2054,38465
06-06-2014,23,13751,13329,5393,1735,34208,1304,323,407,2034,36242
07-06-2014,0,12847,12324,5132,1495,31798,929,415,299,1643,33441
07-06-2014,1,12299,11668,4992,1308,30266,855,388,300,1543,31809
07-06-2014,2,12058,11380,4988,1259,29687,890,354,348,1592,31279
07-06-2014,3,12089,11287,4974,1219,29569,869,339,299,1507,31076
07-06-2014,4,12054,11173,4975,1198,29402,952,317,299,1568,30970
07-06-2014,5,11877,11496,4980,1143,29495,947,327,299,1573,31068
07-06-2014,6,12147,12141,5223,1158,30669,931,290,321,1542,32211
07-06-2014,7,12716,12737,5508,1308,32269,978,376,311,1665,33934
07-06-2014,8,13063,13426,5576,1470,33536,985,469,322,1776,35312
07-06-2014,9,13478,13705,5585,1578,34346,984,487,337,1808,36154
07-06-2014,10,13837,13802,5666,1612,34917,979,519,343,1841,36758
07-06-2014,11,14276,13864,5666,1588,35391,973,511,335,1819,37210
07-06-2014,12,14161,13896,5695,1550,35303,969,440,328,1737,37040
07-06-2014,13,13930,13727,5664,1424,34745,973,486,332,1791,36536
07-06-2014,14,13441,13727,5696,1408,34272,961,469,333,1763,36035
07-06-2014,15,13020,13453,5698,1450,33622,963,467,335,1765,35387
07-06-2014,16,13155,13512,5731,1409,33806,956,465,336,1757,35563
07-06-2014,17,13454,13673,5724,1443,34294,969,466,354,1789,36083
07-06-2014,18,14922,14370,5740,1610,36644,953,493,348,1794,38438
07-06-2014,19,15065,14451,5652,1629,36797,948,498,347,1793,38590
07-06-2014,20,14881,14399,5616,1553,36449,955,476,364,1795,38244
07-06-2014,21,14581,14319,5544,1493,35938,955,446,398,1799,37737
07-06-2014,22,14341,14081,5548,1500,35470,959,314,379,1652,37122
07-06-2014,23,13795,13634,5447,1428,34303,1009,304,369,1682,35985
08-06-2014,0,12677,12039,5099,1290,31107,1015,295,351,1661,32768
08-06-2014,1,12066,11400,4816,1054,29337,995,296,366,1657,30994
08-06-2014,2,11891,11173,4730,1084,28878,950,291,377,1618,30496
08-06-2014,3,11680,11061,4634,1101,28475,822,289,344,1455,29930
08-06-2014,4,11345,11025,4571,1150,28093,807,291,376,1474,29567
08-06-2014,5,11235,10994,4658,1176,28064,914,291,327,1532,29596
08-06-2014,6,10838,11071,4744,1259,27912,1015,291,302,1608,29520
08-06-2014,7,11013,11596,4923,1481,29014,1061,386,297,1744,30758
08-06-2014,8,11731,12062,5036,1533,30363,1048,469,359,1876,32239
08-06-2014,9,12474,12861,5280,1506,32122,1056,489,308,1853,33975
08-06-2014,10,12881,13281,5387,1483,33033,1062,490,319,1871,34904
08-06-2014,11,13036,13351,5413,1695,33495,1067,478,364,1909,35404
08-06-2014,12,12663,13506,5407,1821,33398,1073,473,336,1882,35280
08-06-2014,13,12686,13489,5394,1765,33334,1066,473,357,1896,35230
08-06-2014,14,12768,13326,5382,1604,33080,1076,473,343,1892,34972
08-06-2014,15,12867,13289,5284,1459,32898,1156,471,354,1981,34879
08-06-2014,16,13127,13195,5322,1334,32980,1149,472,341,1962,34942
08-06-2014,17,13333,13576,5381,1369,33660,1185,478,349,2012,35672
08-06-2014,18,13806,14088,5473,1553,34920,1144,475,353,1972,36892
08-06-2014,19,14531,14831,5568,1686,36616,1143,475,356,1974,38590
08-06-2014,20,14521,14647,5513,1642,36322,1140,470,373,1983,38305
08-06-2014,21,14508,14484,5547,1572,36111,1124,470,336,1930,38041
08-06-2014,22,14282,14253,5552,1595,35683,1152,302,325,1779,37462
08-06-2014,23,13426,13555,5240,1493,33714,1169,300,303,1772,35486
09-06-2014,0,12851,12072,4972,1384,31280,1348,291,300,1939,33219
09-06-2014,1,11942,11296,4833,1196,29268,1346,294,301,1941,31209
09-06-2014,2,11167,10794,4978,1234,28173,1017,299,303,1619,29792
09-06-2014,3,10817,10692,5024,1227,27761,837,304,308,1449,29210
09-06-2014,4,10972,10703,5053,1205,27932,912,398,310,1620,29552
09-06-2014,5,10972,11057,5316,1185,28531,1369,491,308,2168,30699
09-06-2014,6,12146,12491,5919,1225,31780,1455,556,437,2448,34228
09-06-2014,7,13515,13701,6516,1307,35040,1431,623,542,2596,37636
09-06-2014,8,14053,14557,6664,1557,36831,1512,698,549,2759,39590
09-06-2014,9,14313,14819,6712,1824,37668,1533,697,557,2787,40455
09-06-2014,10,14752,15147,6704,1882,38484,1576,695,550,2821,41305
09-06-2014,11,14854,15310,6713,1875,38751,1456,606,727,2789,41540
09-06-2014,12,14805,15239,6863,1848,38754,1449,604,787,2840,41594
09-06-2014,13,14643,14941,6931,1827,38340,1448,608,768,2824,41164
09-06-2014,14,14628,14552,6407,1756,37344,1482,609,595,2686,40030
09-06-2014,15,14740,14571,6287,1702,37299,1538,593,548,2679,39978
09-06-2014,16,14655,14334,6206,1708,36902,1569,560,548,2677,39579
09-06-2014,17,14720,14389,6014,1842,36965,1559,519,582,2660,39625
09-06-2014,18,14842,15022,6080,1874,37818,1550,493,565,2608,40426
09-06-2014,19,14902,15451,6252,1858,38464,1532,481,528,2541,41005
09-06-2014,20,14911,15305,6418,1851,38486,1431,479,405,2315,40801
09-06-2014,21,14691,15237,6460,1900,38288,1446,398,428,2272,40560
09-06-2014,22,14419,14843,6426,2084,37773,1422,340,354,2116,39889
09-06-2014,23,13404,13514,6215,1756,34890,1408,345,327,2080,36970
10-06-2014,0,12946,12503,5824,1611,32884,1441,292,362,2095,34979
10-06-2014,1,12335,11956,5420,1596,31309,1046,291,315,1652,32961
10-06-2014,2,12095,11586,5398,1589,30668,910,294,311,1515,32183
10-06-2014,3,12089,11609,5417,1579,30696,895,291,311,1497,32193
10-06-2014,4,11057,11552,5400,1945,29954,885,289,311,1485,31439
10-06-2014,5,11493,11933,5597,2202,31225,1001,384,302,1687,32912
10-06-2014,6,13943,13349,6402,2509,36203,1418,551,341,2310,38513
10-06-2014,7,16380,15311,6931,2791,41413,1447,719,489,2655,44068
10-06-2014,8,16469,15575,7138,3548,42730,1504,698,562,2764,45494
10-06-2014,9,16694,15208,7145,3318,42366,1503,673,560,2736,45102
10-06-2014,10,16690,15373,7159,3232,42453,1492,712,570,2774,45227
10-06-2014,11,16746,15413,7090,3433,42684,1550,738,562,2850,45534
10-06-2014,12,16514,15453,7014,3597,42578,1519,697,602,2818,45396
10-06-2014,13,16344,15363,6880,3428,42017,1571,826,595,2992,45009
10-06-2014,14,16399,15165,7026,3166,41754,1593,594,611,2798,44552
10-06-2014,15,16320,15133,7004,2987,41446,1598,565,622,2785,44231
10-06-2014,16,16121,14843,6971,2816,40752,1591,563,613,2767,43519
10-06-2014,17,15854,15094,6870,2629,40448,1579,528,595,2702,43150
10-06-2014,18,15704,15010,6946,2473,40134,1576,583,561,2720,42854
10-06-2014,19,15737,14959,7100,2382,40178,1564,514,521,2599,42777
10-06-2014,20,15722,14791,6915,2329,39758,1525,520,430,2475,42233
10-06-2014,21,15586,14495,6779,2170,39031,1487,434,459,2380,41411
10-06-2014,22,15291,14050,6705,2153,38199,1536,306,383,2225,40424
10-06-2014,23,14376,13590,6559,2133,36656,1469,318,347,2134,38790
11-06-2014,0,13558,12540,6128,1886,34112,1443,294,339,2076,36188
11-06-2014,1,13157,12269,6047,1761,33236,1453,293,333,2079,35315
11-06-2014,2,12819,12255,5973,1573,32621,1430,291,331,2052,34673
11-06-2014,3,12525,12192,5752,1453,31921,1423,292,323,2038,33959
11-06-2014,4,12244,12164,5799,1476,31684,1416,294,317,2027,33711
11-06-2014,5,12529,13060,6118,1320,33027,1367,384,306,2057,35084
11-06-2014,6,14584,14510,6581,1638,37314,1460,487,364,2311,39625
11-06-2014,7,15642,15536,6946,2002,40127,1521,624,479,2624,42751
11-06-2014,8,16076,15304,7051,2254,40685,1533,686,578,2797,43482
11-06-2014,9,16195,15366,7080,2275,40918,1530,,570,,
11-06-2014,10,16284,15858,7281,2409,41830,1537,718,562,2817,44647
11-06-2014,11,16033,15912,7240,2495,41680,1557,701,551,2809,44489
11-06-2014,12,16042,15644,7164,2321,41172,1555,827,552,2934,44106
11-06-2014,13,16244,15670,7059,2334,41306,1556,716,571,2843,44149
11-06-2014,14,16106,15629,6974,2335,41044,1533,623,574,2730,43774
11-06-2014,15,16056,15625,6867,2442,40990,1559,615,554,2728,43718
11-06-2014,16,16045,15831,6902,2687,41465,1546,540,578,2664,44129
11-06-2014,17,15810,15799,6991,2791,41391,1546,488,604,2638,44029
11-06-2014,18,15600,15516,6946,2799,40862,1545,458,579,2582,43444
11-06-2014,19,15596,14907,6904,2809,40216,1528,440,487,2455,42671
11-06-2014,20,15668,14982,6721,2821,40192,1527,405,464,2396,42588
11-06-2014,21,15390,14800,6425,2699,39313,1523,378,421,2322,41635
11-06-2014,22,15077,14583,6279,2578,38517,1466,296,363,2125,40642
11-06-2014,23,14501,13731,6229,2651,37112,1388,286,298,1972,39084
12-06-2014,0,13542,12543,5980,2389,34455,1389,286,294,1969,36424
12-06-2014,1,13153,12353,5862,2216,33583,1410,287,302,1999,35582
12-06-2014,2,12609,12313,5749,2235,32906,1371,286,313,1970,34876
12-06-2014,3,12388,12315,5706,2232,32642,1233,287,353,1873,34515
12-06-2014,4,12205,12460,5791,2223,32681,1245,288,318,1851,34532
12-06-2014,5,12527,13068,6036,2213,33845,1349,288,329,1966,35811
12-06-2014,6,14758,14164,6441,2499,37861,1470,300,472,2242,40103
12-06-2014,7,15534,15910,6878,3086,41410,1499,395,479,2373,43783
12-06-2014,8,15912,15561,6839,3041,41353,1530,672,465,2667,44020
12-06-2014,9,15923,15566,6747,2948,41185,1546,689,484,2719,43904
12-06-2014,10,16467,15705,6835,3013,42020,1559,689,477,2725,44745
12-06-2014,11,16437,15578,6854,3212,42083,1562,682,465,2709,44792
12-06-2014,12,16389,15689,6836,3240,42154,1565,659,527,2751,44905
12-06-2014,13,16610,16023,6850,3360,42844,1621,658,493,2772,45616
12-06-2014,14,16443,16017,6862,3594,42916,1596,647,429,2672,45588
12-06-2014,15,16243,15997,6792,3720,42751,1609,595,436,2640,45391
12-06-2014,16,16104,15891,6723,3634,42353,1595,504,460,2559,44912
12-06-2014,17,15968,16040,6697,3567,42271,1600,402,414,2416,44687
12-06-2014,18,15799,15919,6697,3450,41865,1594,332,386,2312,44177
12-06-2014,19,15773,15346,6590,3305,41014,1583,309,366,2258,43272
12-06-2014,20,15883,14935,6380,3145,40343,1584,288,353,2225,42568
12-06-2014,21,15853,14954,6403,3202,40412,1560,297,351,2208,42620
12-06-2014,22,15630,14527,6367,3110,39634,1523,292,403,2218,41852
12-06-2014,23,14879,14298,6067,3019,38262,1493,329,343,2165,40427
13-06-2014,0,13409,13094,5783,2917,35205,1500,181,339,2020,37225
13-06-2014,1,12991,13045,5709,2977,34720,1229,128,339,1696,36416
13-06-2014,2,12550,12893,5669,3102,34213,1060,119,343,1522,35735
13-06-2014,3,12132,12759,5632,3195,33718,988,114,347,1449,35167
13-06-2014,4,12030,12895,5632,3251,33808,982,118,367,1467,35275
13-06-2014,5,12194,13420,5910,3173,34698,1192,129,369,1690,36388
13-06-2014,6,14272,14553,6337,3349,38510,1525,221,438,2184,40694
13-06-2014,7,16129,15748,6739,3983,42598,1559,326,477,2362,44960
13-06-2014,8,16613,16362,6883,4358,44215,1540,489,531,2560,46775
13-06-2014,9,16599,16076,6862,4495,44032,1546,500,543,2589,46621
13-06-2014,10,16636,15823,6918,4524,43902,1544,494,562,2600,46502
13-06-2014,11,16412,15671,6703,4424,43210,1541,468,589,2598,45808
13-06-2014,12,16140,15333,6665,4346,42484,1544,497,595,2636,45120
13-06-2014,13,16008,15191,6718,4242,42159,1547,485,589,2621,44780
13-06-2014,14,15738,15081,6585,4072,41478,1539,458,595,2592,44070
13-06-2014,15,15346,14966,6638,3991,40942,1546,442,585,2573,43515
13-06-2014,16,14942,14941,6381,3735,40001,1557,409,501,2467,42468
13-06-2014,17,15020,14972,6392,3628,40012,1554,365,402,2321,42333
13-06-2014,18,15335,14860,6496,3421,40111,1545,364,394,2303,42414
13-06-2014,19,15233,14845,6502,3321,39902,1577,360,369,2306,42208
13-06-2014,20,15126,14523,6366,2835,38850,1570,309,379,2258,41108
13-06-2014,21,15007,14396,6298,2569,38269,1569,154,525,2248,40517
13-06-2014,22,14729,14136,6290,2459,37614,1494,152,436,2082,39696
13-06-2014,23,14451,13743,6130,2239,36562,1487,167,369,2023,38585
14-06-2014,0,13524,12638,5986,2195,34344,1103,141,376,1620,35964
14-06-2014,1,13187,12168,5844,1905,33105,989,137,363,1489,34594
14-06-2014,2,12810,11974,5712,1739,32237,895,138,369,1402,33639
14-06-2014,3,12356,11944,5570,1759,31628,888,136,374,1398,33026
14-06-2014,4,12188,11942,5548,1743,31422,894,135,370,1399,32821
14-06-2014,5,12157,12054,5564,1675,31452,899,137,377,1413,32865
14-06-2014,6,12553,12307,5597,1591,32047,913,239,376,1528,33575
14-06-2014,7,13117,13090,5793,1636,33638,1042,343,372,1757,35395
14-06-2014,8,13926,13936,6115,1856,35833,1237,382,380,1999,37832
14-06-2014,9,14483,14348,6315,2007,37151,1248,485,388,2121,39272
14-06-2014,10,14525,14339,6271,2076,37213,1248,455,411,2114,39327
14-06-2014,11,14456,14274,6323,2079,37133,1248,448,374,2070,39203
14-06-2014,12,14277,13920,6241,1927,36363,1239,447,392,2078,38441
14-06-2014,13,14094,13756,6109,2018,35978,1247,409,345,2001,37979
14-06-2014,14,13649,13579,6032,2057,35317,1228,408,339,1975,37292
14-06-2014,15,13493,13388,6027,2054,34963,1229,393,355,1977,36940
14-06-2014,16,13558,13343,6020,1981,34902,1251,403,378,2032,36934
14-06-2014,17,13536,13421,6124,1915,34996,1252,380,391,2023,37019
14-06-2014,18,13693,13465,6273,1995,35426,1246,374,397,2017,37443
14-06-2014,19,14050,13246,6260,1893,35447,1236,356,376,1968,37415
14-06-2014,20,14106,13266,6296,1705,35374,1231,301,352,1884,37258
14-06-2014,21,14122,13085,6279,1473,34958,1207,284,345,1836,36794
14-06-2014,22,13993,12975,6331,1424,34723,1161,203,343,1707,36430
14-06-2014,23,13947,12861,6161,1486,34456,1139,137,340,1616,36072
15-06-2014,0,12931,11715,5874,1321,31841,1032,119,340,1491,33332
15-06-2014,1,12439,10806,5736,1164,30145,919,115,335,1369,31514
15-06-2014,2,12184,10792,5606,954,29537,872,115,356,1343,30880
15-06-2014,3,12018,10598,5511,935,29064,858,113,316,1287,30351
15-06-2014,4,11781,10415,5468,916,28580,828,112,312,1252,29832
15-06-2014,5,11485,10451,5459,954,28349,802,113,353,1268,29617
15-06-2014,6,11791,10507,5545,1040,28883,799,198,337,1334,30217
15-06-2014,7,12166,11102,5729,1102,30099,846,294,302,1442,31541
15-06-2014,8,12856,11718,5930,1257,31761,978,340,302,1620,33381
15-06-2014,9,13511,12395,6056,1388,33350,1083,364,321,1768,35118
15-06-2014,10,14021,12835,6182,1544,34583,1076,367,355,1798,36381
15-06-2014,11,14281,13028,6171,1627,35108,1073,368,350,1791,36899
15-06-2014,12,14126,13158,6085,1608,34978,1070,359,339,1768,36746
15-06-2014,13,14013,13118,6048,1552,34732,1071,356,348,1775,36507
15-06-2014,14,13778,12906,6042,1537,34262,1069,315,345,1729,35991
15-06-2014,15,13693,12879,6044,1528,34145,1061,305,355,1721,35866
15-06-2014,16,13642,12941,6015,1469,34067,1058,305,358,1721,35788
15-06-2014,17,13673,13356,6160,1518,34705,1053,316,351,1720,36425
15-06-2014,18,13605,13712,6200,1519,35036,1073,352,343,1768,36804
15-06-2014,19,13948,13929,6351,1616,35845,1074,368,327,1769,37614
15-06-2014,20,14056,13806,6440,1648,35949,1078,280,376,1734,37683
15-06-2014,21,14430,13779,6414,1605,36228,1082,246,375,1703,37931
15-06-2014,22,14218,13917,6366,1615,36115,1086,238,324,1648,37763
15-06-2014,23,13429,13401,6053,1564,34448,1133,124,322,1579,36027
16-06-2014,0,13126,12328,5947,1701,33102,1276,105,309,1690,34792
16-06-2014,1,12582,11807,5835,1659,31884,1226,122,302,1650,33534
16-06-2014,2,12244,11608,5614,1694,31160,1153,125,297,1575,32735
16-06-2014,3,12007,11587,5480,1643,30716,1041,124,293,1458,32174
16-06-2014,4,11912,11716,5535,1639,30802,1076,151,333,1560,32362
16-06-2014,5,12464,12576,5803,1606,32450,1372,237,323,1932,34382
16-06-2014,6,15018,14527,6333,2123,38003,1467,423,337,2227,40230
16-06-2014,7,16221,15641,6679,2377,40919,1495,518,500,2513,43432
16-06-2014,8,16567,15796,6864,2521,41749,1518,594,530,2642,44391
16-06-2014,9,16676,15668,6925,2405,41675,1522,618,557,2697,44372
16-06-2014,10,16319,15835,7008,2782,41944,1528,768,334,2630,44574
16-06-2014,11,16540,15988,6976,2963,42466,1547,764,301,2612,45078
16-06-2014,12,16744,16195,6949,3102,42989,1548,826,318,2692,45681
16-06-2014,13,16808,16304,6864,3215,43191,1580,635,511,2726,45917
16-06-2014,14,16800,16193,6744,3057,42794,1618,480,335,2433,45227
16-06-2014,15,16675,16141,6771,3125,42712,1632,508,333,2473,45185
16-06-2014,16,16438,15758,6753,2952,41902,1633,463,331,2427,44329
16-06-2014,17,16143,15635,6812,2917,41507,1616,470,330,2416,43923
16-06-2014,18,16022,15383,6778,2689,40872,1632,544,248,2424,43296
16-06-2014,19,15957,15449,6694,2706,40804,1623,532,244,2399,43203
16-06-2014,20,15887,15123,6682,2396,40087,1658,511,298,2467,42554
16-06-2014,21,15702,14984,6634,2239,39558,1637,333,212,2182,41740
16-06-2014,22,15063,14757,6614,2188,38621,1618,324,159,2101,40722
16-06-2014,23,14522,14131,6457,2167,37278,1635,316,148,2099,39377
17-06-2014,0,13807,13318,6302,1983,35411,1497,303,160,1960,37371
17-06-2014,1,13385,12970,6238,1951,34545,1482,302,172,1956,36501
17-06-2014,2,12926,12857,6097,1772,33653,1465,303,174,1942,35595
17-06-2014,3,12823,12633,6071,1634,33161,1434,303,187,1924,35085
17-06-2014,4,12797,12414,6158,1440,32807,1434,303,179,1916,34723
17-06-2014,5,13230,12996,6296,1419,33942,1528,304,180,2012,35954
17-06-2014,6,15499,14311,6755,1669,38234,1732,388,246,2366,40600
17-06-2014,7,16390,15749,7190,1973,41303,1728,698,310,2736,44039
17-06-2014,8,16884,15601,7364,2206,42055,1723,773,314,2810,44865
17-06-2014,9,17124,15398,7330,2282,42135,1718,739,322,2779,44914
17-06-2014,10,17160,15445,7333,2373,42311,1729,786,389,2904,45215
17-06-2014,11,16959,15431,7264,2477,42131,1729,764,403,2896,45027
17-06-2014,12,16959,15513,7101,2571,42145,1716,759,388,2863,45008
17-06-2014,13,16984,15599,7053,2923,42559,1728,762,402,2892,45451
17-06-2014,14,16879,15669,7069,3325,42943,1725,656,289,2670,45613
17-06-2014,15,16730,15517,7165,3051,42462,1723,651,216,2590,45052
17-06-2014,16,16715,14923,6995,2560,41195,1711,485,356,2552,43747
17-06-2014,17,16682,15126,6997,2483,41289,1724,457,368,2549,43838
17-06-2014,18,16489,15438,7058,2737,41722,1706,452,294,2452,44174
17-06-2014,19,16467,15120,7002,2807,41396,1690,441,299,2430,43826
17-06-2014,20,16285,14792,6942,2579,40597,1690,382,259,2331,42928
17-06-2014,21,16199,14314,6867,2432,39812,1684,333,177,2194,42006
17-06-2014,22,15841,14216,6658,2131,38848,1651,313,182,2146,40994
17-06-2014,23,15028,13643,6354,2266,37293,1639,291,154,2084,39377
18-06-2014,0,13963,12731,6207,1967,34868,1532,288,170,1990,36858
18-06-2014,1,13487,12352,6092,1811,33742,1519,288,167,1974,35716
18-06-2014,2,13231,12342,6014,1768,33354,1510,286,160,1956,35310
18-06-2014,3,13019,12431,5884,1681,33016,1509,285,209,2003,35019
18-06-2014,4,12726,12559,5877,1695,32858,1517,285,167,1969,34827
18-06-2014,5,12970,13190,6095,1735,33990,1557,296,178,2031,36021
18-06-2014,6,15180,14481,6490,2033,38184,1691,469,252,2412,40596
18-06-2014,7,16113,15686,6887,2429,41116,1684,631,382,2697,43813
18-06-2014,8,16609,15330,7014,2577,41532,1684,670,483,2837,44369
18-06-2014,9,16966,15469,7068,2490,41992,1698,,541,,
18-06-2014,10,16880,15729,6996,2583,42189,1684,686,531,2901,45090
18-06-2014,11,16637,15485,6932,2895,41950,1682,687,496,2865,44815
18-06-2014,12,16593,15322,6752,2809,41475,1717,689,550,2956,44431
18-06-2014,13,16817,15401,6689,2684,41591,1709,690,515,2914,44505
18-06-2014,14,16893,15211,6676,2705,41485,1723,596,454,2773,44258
18-06-2014,15,16826,14931,6662,2789,41208,1712,586,406,2704,43912
18-06-2014,16,16352,14909,6512,2768,40542,1692,471,424,2587,43129
18-06-2014,17,16473,14978,6610,2714,40777,1730,450,389,2569,43346
18-06-2014,18,16624,15246,6699,3141,41710,1708,451,369,2528,44238
18-06-2014,19,16269,15443,6579,3210,41502,1709,456,346,2511,44013
18-06-2014,20,16210,14720,6393,3240,40563,1697,470,316,2483,43046
18-06-2014,21,15753,14278,6292,3043,39366,1686,418,202,2306,41672
18-06-2014,22,15648,13816,6293,3009,38766,1672,306,187,2165,40931
18-06-2014,23,15034,13170,6012,3047,37264,1638,286,188,2112,39376
19-06-2014,0,14068,11575,5897,3207,34748,1619,286,148,2053,36801
19-06-2014,1,12925,10843,5657,3306,32731,1609,287,156,2052,34783
19-06-2014,2,12285,10475,5625,3442,31827,1579,288,153,2020,33847
19-06-2014,3,11805,10425,5526,3593,31348,1350,287,197,1834,33182
19-06-2014,4,10968,10508,5501,3661,30638,1237,285,164,1686,32324
19-06-2014,5,11230,11413,5564,3770,31977,1438,291,214,1943,33920
19-06-2014,6,13312,12755,5870,3989,35927,1544,495,254,2293,38220
19-06-2014,7,15750,13967,6271,4351,40338,1539,578,366,2483,42821
19-06-2014,8,16395,14627,6431,4533,41986,1550,670,370,2590,44576
19-06-2014,9,16038,15045,6509,4699,42291,1561,693,388,2642,44933
19-06-2014,10,16042,15202,6457,4732,42431,1528,699,409,2636,45067
19-06-2014,11,15605,15428,6414,4856,42305,1523,687,422,2632,44937
19-06-2014,12,15268,15161,6147,4992,41569,1524,706,431,2661,44230
19-06-2014,13,14810,14876,5920,5101,40705,1519,766,423,2708,43413
19-06-2014,14,14176,14659,5874,4883,39593,1518,607,398,2523,42116
19-06-2014,15,13722,14286,5754,4864,38628,1534,536,394,2464,41092
19-06-2014,16,13648,14220,5740,4774,38383,1527,581,399,2507,40890
19-06-2014,17,14520,14185,5772,4580,39058,1539,585,409,2533,41591
19-06-2014,18,15052,14438,5931,4272,39692,1556,588,362,2506,42198
19-06-2014,19,15177,14660,5971,3901,39709,1556,588,273,2417,42126
19-06-2014,20,14821,14560,5957,3513,38852,1507,548,263,2318,41170
19-06-2014,21,14624,14335,5828,3304,38091,1509,537,245,2291,40382
19-06-2014,22,14195,13883,5717,3311,37107,1500,313,239,2052,39159
19-06-2014,23,13841,13255,5549,3325,35970,1362,294,242,1898,37868
20-06-2014,0,12993,11862,5525,3243,33622,1131,289,230,1650,35272
20-06-2014,1,11846,11119,5311,3174,31450,948,287,227,1462,32912
20-06-2014,2,10407,11072,5310,3096,29883,892,294,215,1401,31284
20-06-2014,3,9547,10978,5248,3007,28780,843,292,200,1335,30115
20-06-2014,4,9859,10993,5238,2753,28843,850,292,184,1326,30169
20-06-2014,5,11900,11773,5481,2664,31818,953,292,172,1417,33235
20-06-2014,6,13291,12765,5584,2623,34264,1133,429,200,1762,36026
20-06-2014,7,14928,13671,5990,2849,37438,1327,615,280,2222,39660
20-06-2014,8,15868,14687,6189,2902,39645,1350,663,351,2364,42009
20-06-2014,9,16368,15344,6244,2780,40736,1353,692,403,2448,43184
20-06-2014,10,16429,15494,6279,2852,41054,1357,702,426,2485,43539
20-06-2014,11,16173,15461,6277,2961,40872,1358,706,404,2468,43340
20-06-2014,12,15614,15436,6244,2959,40252,1369,621,476,2466,42718
20-06-2014,13,15102,14762,6287,3153,39303,1369,606,473,2448,41751
20-06-2014,14,14699,13974,6226,3296,38195,1301,443,380,2124,40319
20-06-2014,15,14525,13945,5994,3389,37852,1191,449,302,1942,39794
20-06-2014,16,14472,13627,5901,3573,37573,1314,469,307,2090,39663
20-06-2014,17,14913,13521,5806,3639,37879,1414,467,260,2141,40020
20-06-2014,18,14716,13224,5921,3528,37391,1426,451,214,2091,39482
20-06-2014,19,14442,13260,5945,3380,37028,1425,440,208,2073,39101
20-06-2014,20,13937,13444,5882,3194,36457,1423,402,210,2035,38492
20-06-2014,21,13907,13296,5883,3057,36142,1438,367,255,2060,38202
20-06-2014,22,14074,13076,5916,3207,36275,1410,309,190,1909,38184
20-06-2014,23,13906,12690,5759,3147,35504,1288,130,153,1571,37075
21-06-2014,0,13401,12025,5629,3177,34233,1169,118,66,1353,35586
21-06-2014,1,13013,11620,5454,3176,33262,999,117,48,1164,34426
21-06-2014,2,12290,11610,5226,3112,32238,877,116,41,1034,33272
21-06-2014,3,11507,11390,5259,3088,31244,849,117,43,1009,32253
21-06-2014,4,11188,11218,5196,2915,30516,867,119,45,1031,31547
21-06-2014,5,10760,11263,5128,3016,30167,893,119,49,1061,31228
21-06-2014,6,11341,11204,5303,3118,30966,897,133,218,1248,32214
21-06-2014,7,12272,11656,5503,3481,32914,889,323,247,1459,34373
21-06-2014,8,12938,12068,5898,3720,34625,1031,282,437,1750,36375
21-06-2014,9,13540,13022,6057,3847,36467,1241,454,272,1967,38434
21-06-2014,10,13551,13194,5985,3889,36619,1234,460,288,1982,38601
21-06-2014,11,13303,13132,5954,3940,36328,1261,438,270,1969,38297
21-06-2014,12,13240,12801,5943,4141,36125,1171,437,268,1876,38001
21-06-2014,13,12714,12613,5815,4371,35514,1004,441,266,1711,37225
21-06-2014,14,12293,12629,5739,4157,34818,959,432,228,1619,36437
21-06-2014,15,12310,12712,5712,4131,34865,962,369,271,1602,36467
21-06-2014,16,12307,12868,5720,4051,34948,921,356,260,1537,36485
21-06-2014,17,13375,13286,5938,3844,36445,945,346,262,1553,37998
21-06-2014,18,13541,13794,6209,3562,37106,1129,353,247,1729,38835
21-06-2014,19,13763,13835,6253,3273,37124,1187,296,265,1748,38872
21-06-2014,20,13726,13806,6177,3051,36760,1122,233,267,1622,38382
21-06-2014,21,13783,13829,6107,2787,36507,1152,221,267,1640,38147
21-06-2014,22,13936,13705,6057,2734,36432,1183,172,160,1515,37947
21-06-2014,23,13687,13463,5817,2820,35786,1173,128,75,1376,37162
22-06-2014,0,13350,12518,5677,2947,34493,1003,121,55,1179,35672
22-06-2014,1,12775,11554,5394,2851,32574,870,122,79,1071,33645
22-06-2014,2,11422,10936,5271,2926,30555,777,123,67,967,31522
22-06-2014,3,9949,10833,5244,2863,28890,724,123,58,905,29795
22-06-2014,4,9446,10740,5187,2857,28230,706,132,55,893,29123
22-06-2014,5,9046,10680,5170,2944,27840,708,138,60,906,28746
22-06-2014,6,8710,10732,5208,3056,27706,702,137,69,908,28614
22-06-2014,7,8914,11044,5314,3358,28631,704,139,110,953,29584
22-06-2014,8,9774,11651,5404,3592,30422,771,136,139,1046,31468
22-06-2014,9,11297,12043,5463,3636,32441,798,,170,,
22-06-2014,10,12549,12342,5750,3625,34267,949,171,167,1287,35554
22-06-2014,11,12999,12541,5732,3661,34931,968,218,164,1350,36281
22-06-2014,12,12579,12613,5615,3795,34602,952,225,154,1331,35933
22-06-2014,13,12371,12506,5638,3735,34250,959,202,161,1322,35572
22-06-2014,14,11785,12518,5531,3694,33527,960,211,164,1335,34862
22-06-2014,15,11665,12473,5532,3747,33416,963,211,171,1345,34761
22-06-2014,16,11915,12725,5567,3897,34105,1005,225,150,1380,35485
22-06-2014,17,12670,13078,5655,3956,35360,1049,224,133,1406,36766
22-06-2014,18,13392,13114,5782,3897,36186,1042,195,108,1345,37531
22-06-2014,19,14032,13780,5880,3848,37538,1153,199,83,1435,38973
22-06-2014,20,14286,13942,6039,3811,38080,1161,168,246,1575,39655
22-06-2014,21,14204,13843,6108,3638,37793,1166,168,112,1446,39239
22-06-2014,22,14182,13792,6110,3631,37717,1165,193,130,1488,39205
22-06-2014,23,13828,13299,5976,3645,36750,1079,157,159,1395,38145
23-06-2014,0,13143,12205,5778,3504,34386,1069,121,92,1282,35668
23-06-2014,1,12897,11541,5620,3324,33175,955,123,117,1195,34370
23-06-2014,2,12682,11492,5415,3242,32829,797,123,80,1000,33829
23-06-2014,3,11507,11658,5358,3224,31748,767,122,66,955,32703
23-06-2014,4,11298,11556,5356,3227,31439,783,119,56,958,32397
23-06-2014,5,12465,12561,5617,3250,33893,953,122,49,1124,35017
23-06-2014,6,14699,14430,6106,3459,38693,1231,133,179,1543,40236
23-06-2014,7,16537,16370,6320,3924,43151,1265,233,290,1788,44939
23-06-2014,8,16834,16972,6586,4338,44730,1276,268,461,2005,46735
23-06-2014,9,16586,16880,6523,4301,44292,1275,,497,,
23-06-2014,10,16353,16709,6563,4182,43808,1274,400,336,2010,45818
23-06-2014,11,16528,16570,6666,4034,43798,1275,373,353,2001,45799
23-06-2014,12,16357,16733,6530,3847,43468,1274,415,365,2054,45522
23-06-2014,13,16516,16566,6518,3912,43511,1261,320,381,1962,45473
23-06-2014,14,16303,16576,6458,3856,43193,1265,217,350,1832,45025
23-06-2014,15,16165,16300,6462,3667,42596,1267,198,331,1796,44392
23-06-2014,16,16189,16154,6516,3415,42274,1257,191,305,1753,44027
23-06-2014,17,16230,16627,6606,3232,42694,1270,193,281,1744,44438
23-06-2014,18,16151,16691,6505,2963,42311,1262,159,254,1675,43986
23-06-2014,19,16151,16402,6465,2659,41678,1241,156,249,1646,43324
23-06-2014,20,16037,16281,6395,2392,41105,1252,159,151,1562,42667
23-06-2014,21,15792,15854,6405,2226,40278,1244,179,71,1494,41772
23-06-2014,22,15394,15457,6382,2182,39415,1241,165,100,1506,40921
23-06-2014,23,15170,14813,6245,2112,38340,1256,148,99,1503,39843
24-06-2014,0,13875,13724,5993,2082,35675,1170,126,104,1400,37075
24-06-2014,1,13526,12925,5933,1686,34070,1187,137,119,1443,35513
24-06-2014,2,13260,12777,5872,1595,33505,1192,146,121,1459,34964
24-06-2014,3,13072,12648,5799,1502,33021,1191,141,117,1449,34470
24-06-2014,4,12974,12715,5837,1363,32887,1188,141,106,1435,34322
24-06-2014,5,13230,13433,6029,1465,34156,1190,142,85,1417,35573
24-06-2014,6,15040,15252,6370,1692,38354,1191,127,72,1390,39744
24-06-2014,7,16115,16286,6650,2055,41106,1229,137,205,1571,42677
24-06-2014,8,16713,16677,6902,2282,42573,1223,234,276,1733,44306
24-06-2014,9,16492,16629,6873,2258,42252,1300,236,298,1834,44086
24-06-2014,10,16454,17040,7013,2238,42745,1331,234,339,1904,44649
24-06-2014,11,16336,17109,7014,2300,42758,1332,245,357,1934,44692
24-06-2014,12,16085,17227,6992,2324,42629,1337,248,386,1971,44600
24-06-2014,13,16212,16864,6909,2273,42260,1320,257,389,1966,44226
24-06-2014,14,16405,16598,6829,2190,42022,1306,256,283,1845,43867
24-06-2014,15,16313,16298,6713,2190,41513,1299,262,265,1826,43339
24-06-2014,16,16352,16286,6773,2082,41493,1308,284,282,1874,43367
24-06-2014,17,16164,16283,6772,2125,41344,1318,206,314,1838,43182
24-06-2014,18,16028,16203,6778,2024,41033,1325,197,264,1786,42819
24-06-2014,19,15966,16272,6782,1892,40912,1302,202,252,1756,42668
24-06-2014,20,15890,16263,6699,1819,40672,1295,211,245,1751,42423
24-06-2014,21,15807,15729,6778,1722,40037,1307,214,238,1759,41796
24-06-2014,22,15507,15425,6746,1689,39367,1312,192,110,1614,40981
24-06-2014,23,15155,14879,6455,1674,38161,1316,130,67,1513,39674
25-06-2014,0,14035,13167,6078,1365,34645,1418,117,81,1616,36261
25-06-2014,1,13615,12065,5964,1267,32910,1396,118,59,1573,34483
25-06-2014,2,13509,11769,5862,1242,32384,1391,119,56,1566,33950
25-06-2014,3,13223,11776,5716,1119,31834,1403,118,49,1570,33404
25-06-2014,4,13107,11815,5681,1140,31742,1428,118,46,1592,33334
25-06-2014,5,13509,12326,5936,1402,33174,1432,119,108,1659,34833
25-06-2014,6,15198,14508,6454,1713,37873,1433,224,237,1894,39767
25-06-2014,7,16422,16433,6790,1995,41641,1427,535,239,2201,43842
25-06-2014,8,16708,16811,6861,2253,42633,1424,737,237,2398,45031
25-06-2014,9,16544,16929,6874,2388,42736,1424,769,237,2430,45166
25-06-2014,10,16730,16906,6926,2470,43032,1432,758,240,2430,45462
25-06-2014,11,16595,17024,6839,2491,42948,1445,745,241,2431,45379
25-06-2014,12,16627,16942,6801,2379,42750,1458,752,243,2453,45203
25-06-2014,13,16624,16896,6690,2430,42642,1460,721,250,2431,45073
25-06-2014,14,16675,16771,6683,2363,42492,1462,619,254,2335,44827
25-06-2014,15,16488,16523,6663,2386,42061,1456,552,259,2267,44328
25-06-2014,16,16269,16313,6525,2311,41420,1442,496,258,2196,43616
25-06-2014,17,16091,16548,6572,2120,41330,1445,473,261,2179,43509
25-06-2014,18,16110,16753,6603,2039,41505,1425,412,261,2098,43603
25-06-2014,19,15869,16654,6623,2029,41176,1423,370,256,2049,43225
25-06-2014,20,15796,16206,6512,1848,40362,1437,307,291,2035,42397
25-06-2014,21,15711,15876,6469,1679,39735,1439,373,123,1935,41670
25-06-2014,22,15492,15706,6518,1659,39375,1440,276,129,1845,41220
25-06-2014,23,15046,14654,6279,1595,37572,1427,128,77,1632,39204
26-06-2014,0,14391,12852,5858,1434,34534,1321,123,79,1523,36057
26-06-2014,1,13735,12093,5645,1319,32791,1298,124,113,1535,34326
26-06-2014,2,13494,12069,5550,1400,32514,1289,123,92,1504,34018
26-06-2014,3,13083,11801,5494,1415,31793,1267,134,89,1490,33283
26-06-2014,4,12957,11643,5566,1370,31536,1262,147,83,1492,33028
26-06-2014,5,13636,12321,5819,1391,33169,1267,172,74,1513,34682
26-06-2014,6,15049,14411,6494,1911,37866,1264,262,151,1677,39543
26-06-2014,7,16061,16279,6876,2333,41548,1269,503,210,1982,43530
26-06-2014,8,16333,16833,6932,2660,42758,1268,736,211,2215,44973
26-06-2014,9,16502,16528,7034,2745,42809,1272,749,207,2228,45037
26-06-2014,10,16687,16703,7109,2751,43251,1271,709,222,2202,45453
26-06-2014,11,16604,16794,7067,2751,43218,1271,676,210,2157,45375
26-06-2014,12,16506,16732,7045,2681,42963,1276,697,219,2192,45155
26-06-2014,13,16481,16676,6951,2628,42738,1281,680,204,2165,44903
26-06-2014,14,16601,16603,6920,2709,42833,1238,520,93,1851,44684
26-06-2014,15,16323,16606,6819,2681,42429,1197,518,110,1825,44254
26-06-2014,16,16172,16637,6712,2549,42070,1243,405,112,1760,43830
26-06-2014,17,16165,16818,6714,2476,42172,1269,394,107,1770,43942
26-06-2014,18,16247,16879,6795,2347,42268,1274,308,96,1678,43946
26-06-2014,19,16108,16892,6766,2232,41998,1265,305,86,1656,43654
26-06-2014,20,15867,16554,6678,2130,41230,1263,326,81,1670,42900
26-06-2014,21,15571,15881,6610,2073,40136,1263,317,87,1667,41803
26-06-2014,22,15325,15359,6596,1981,39261,1269,303,63,1635,40896
26-06-2014,23,15228,14728,6181,1973,38110,1268,311,62,1641,39751
27-06-2014,0,14663,13457,5809,1902,35830,1181,315,60,1556,37386
27-06-2014,1,14059,12562,5570,1835,34027,1179,317,55,1551,35578
27-06-2014,2,13651,12261,5522,1649,33085,1167,320,51,1538,34623
27-06-2014,3,13283,12276,5455,1539,32552,1172,317,48,1537,34089
27-06-2014,4,13337,12227,5578,1487,32628,1194,305,46,1545,34173
27-06-2014,5,13516,12804,5907,1682,33909,1252,306,49,1607,35516
27-06-2014,6,15092,14909,6591,1916,38508,1262,313,153,1728,40236
27-06-2014,7,16149,17057,6995,2298,42498,1255,484,231,1970,44468
27-06-2014,8,16476,17472,7048,2421,43418,1251,652,231,2134,45552
27-06-2014,9,16664,17259,7028,2447,43400,1256,551,394,2201,45601
27-06-2014,10,16831,17240,7089,2495,43658,1352,544,238,2134,45792
27-06-2014,11,16688,17372,7069,2676,43804,1355,534,237,2126,45930
27-06-2014,12,16906,17457,7019,2686,44068,1357,562,238,2157,46225
27-06-2014,13,16781,17424,6833,2666,43706,1352,504,251,2107,45813
27-06-2014,14,16479,17248,6691,2621,43039,1352,466,234,2052,45091
27-06-2014,15,16087,17167,6662,2547,42464,1322,512,134,1968,44432
27-06-2014,16,15914,17112,6564,2447,42037,1260,476,61,1797,43834
27-06-2014,17,15770,17215,6454,2499,41938,1313,315,53,1681,43619
27-06-2014,18,15671,17055,6388,2524,41638,1331,214,47,1592,43230
27-06-2014,19,15464,16799,6344,2499,41108,1324,243,42,1609,42717
27-06-2014,20,15244,16479,6159,2221,40104,1329,150,43,1522,41626
27-06-2014,21,15137,15967,6099,2241,39443,1316,128,51,1495,40938
27-06-2014,22,14966,15349,6225,2363,38905,1317,125,50,1492,40397
27-06-2014,23,14708,14702,5898,2183,37490,1271,119,51,1441,38931
28-06-2014,0,14671,13558,5555,2218,36003,952,120,36,1108,37111
28-06-2014,1,14076,12888,5346,2057,34367,953,120,34,1107,35474
28-06-2014,2,13648,12511,5282,1988,33428,954,120,35,1109,34537
28-06-2014,3,13110,12313,5300,1892,32615,950,121,39,1110,33725
28-06-2014,4,12753,12090,5252,1899,31993,953,121,47,1121,33114
28-06-2014,5,12689,12129,5256,1837,31911,956,134,71,1161,33072
28-06-2014,6,13049,12921,5418,1821,33210,958,155,108,1221,34431
28-06-2014,7,13794,14007,5741,1724,35266,958,264,92,1314,36580
28-06-2014,8,14518,14890,6092,1876,37378,955,467,95,1517,38895
28-06-2014,9,14760,15672,6143,2267,38842,955,224,79,1258,40100
28-06-2014,10,15103,15931,6128,2318,39480,957,232,89,1278,40758
28-06-2014,11,15033,15965,6109,2337,39442,962,234,89,1285,40727
28-06-2014,12,15277,15844,6087,2293,39501,965,242,88,1295,40796
28-06-2014,13,14809,15485,5974,2253,38520,962,339,96,1397,39917
28-06-2014,14,14398,15000,5960,2044,37403,966,223,97,1286,38689
28-06-2014,15,14187,14919,5939,1946,36990,967,206,125,1298,38288
28-06-2014,16,14824,15137,6055,1990,38007,965,229,118,1312,39319
28-06-2014,17,15429,15781,6112,2315,39636,970,229,115,1314,40950
28-06-2014,18,15488,16391,6257,2359,40497,971,230,96,1297,41794
28-06-2014,19,15163,16304,6208,2109,39784,972,228,113,1313,41097
28-06-2014,20,14744,15817,5960,1874,38395,956,206,155,1317,39712
28-06-2014,21,14728,15485,5832,1713,37758,948,167,172,1287,39045
28-06-2014,22,14742,15375,5820,1741,37678,964,145,149,1258,38936
28-06-2014,23,14398,15028,5435,1704,36566,986,140,126,1252,37818
29-06-2014,0,13367,12675,5239,1268,32549,985,141,114,1240,33789
29-06-2014,1,12588,11821,5125,1110,30646,979,137,126,1242,31888
29-06-2014,2,12121,11433,5077,1098,29727,982,133,88,1203,30930
29-06-2014,3,11667,11182,5036,1136,29021,913,131,89,1133,30154
29-06-2014,4,11284,11152,5014,1086,28535,931,130,85,1146,29681
29-06-2014,5,11132,11037,5002,1122,28294,936,129,69,1134,29428
29-06-2014,6,11149,11121,5036,1210,28515,900,133,59,1092,29607
29-06-2014,7,11811,11520,5153,1268,29753,1008,160,98,1266,31019
29-06-2014,8,12907,12229,5351,1430,31917,985,337,99,1421,33338
29-06-2014,9,13908,12922,5490,1610,33929,1020,365,71,1456,35385
29-06-2014,10,14782,13561,5613,1721,35677,1045,322,97,1464,37141
29-06-2014,11,15166,14208,5733,2102,37210,1041,369,73,1483,38693
29-06-2014,12,14863,14647,5676,2055,37241,1033,361,85,1479,38720
29-06-2014,13,14217,14122,5708,2143,36190,1036,308,90,1434,37624
29-06-2014,14,14118,13749,5662,2205,35732,1037,305,83,1425,37157
29-06-2014,15,13972,13493,5678,2208,35349,1024,341,67,1432,36781
29-06-2014,16,14102,13517,5837,2283,35739,1001,315,89,1405,37144
29-06-2014,17,14435,14078,5962,2401,36875,992,307,97,1396,38271
29-06-2014,18,14431,14626,6085,2462,37602,983,286,107,1376,38978
29-06-2014,19,14872,14664,6054,2535,38124,981,257,98,1336,39460
29-06-2014,20,14904,14941,5889,2487,38220,976,257,78,1311,39531
29-06-2014,21,14953,15360,5940,2282,38534,973,191,71,1235,39769
29-06-2014,22,14741,15354,5888,2300,38283,991,161,49,1201,39484
29-06-2014,23,14098,14283,5748,2104,36231,1007,126,40,1173,37404
30-06-2014,0,12870,12719,5514,1807,32910,1059,118,42,1219,34129
30-06-2014,1,12336,12175,5230,1687,31428,1054,118,64,1236,32664
30-06-2014,2,12153,12018,5130,1571,30872,1054,118,43,1215,32087
30-06-2014,3,12015,11945,5156,1504,30620,1000,118,32,1150,31770
30-06-2014,4,11940,12011,5298,1478,30726,1042,119,30,1191,31917
30-06-2014,5,12620,12475,5802,1624,32521,1137,151,232,1520,34041
30-06-2014,6,14411,15392,6637,2143,38584,1137,249,375,1761,40345
30-06-2014,7,15735,16928,6929,2377,41969,1129,620,429,2178,44147
30-06-2014,8,16409,17814,7091,2606,43920,1113,696,239,2048,45968
30-06-2014,9,16556,18134,7216,2714,44618,1143,816,394,2353,46971
30-06-2014,10,16745,18280,7158,2804,44988,1147,806,426,2379,47367
30-06-2014,11,16700,18332,7276,2846,45155,1202,736,344,2282,47437
30-06-2014,12,16281,18281,7310,2907,44778,1250,755,407,2412,47190
30-06-2014,13,16097,18025,7181,2927,44231,1269,719,411,2399,46630
30-06-2014,14,15466,17641,7080,2913,43101,1276,599,449,2324,45425
30-06-2014,15,15683,16359,7010,2873,41926,1284,567,415,2266,44192
30-06-2014,16,16066,16520,6962,2806,42355,1299,472,419,2190,44545
30-06-2014,17,15947,16838,6848,2831,42464,1303,394,454,2151,44615
30-06-2014,18,15722,17211,6742,2740,42416,1343,381,409,2133,44549
30-06-2014,19,15649,16963,6610,2793,42016,1328,391,375,2094,44110
30-06-2014,20,15429,16587,6285,2688,40991,1321,,391,,
30-06-2014,21,15396,15984,6266,2468,40114,1318,186,309,1813,41927
30-06-2014,22,15370,15735,6122,2489,39718,1299,179,291,1769,41487
30-06-2014,23,14827,14489,5784,2213,37314,1278,160,291,1729,39043
01-07-2014,0,13499,12549,5530,1940,33518,1259,120,294,1673,35191
01-07-2014,1,12333,12180,5555,1751,31821,1343,119,291,1753,33574
01-07-2014,2,12244,12168,5587,1594,31594,1271,119,290,1680,33274
01-07-2014,3,12024,12120,5597,1542,31282,1326,119,290,1735,33017
01-07-2014,4,11909,12097,5709,1549,31265,1334,119,291,1744,33009
01-07-2014,5,12375,12377,6003,1570,32325,1384,125,292,1801,34126
01-07-2014,6,14608,14417,6585,1999,37608,1377,301,290,1968,39576
01-07-2014,7,15676,16807,7035,2172,41691,1374,359,470,2203,43894
01-07-2014,8,16248,17072,7256,2400,42977,1366,594,479,2439,45416
01-07-2014,9,16379,17242,7301,2421,43344,1357,,479,,
01-07-2014,10,16545,17093,7331,2487,43457,1363,687,461,2511,45968
01-07-2014,11,16602,17114,7342,2648,43706,1300,649,513,2462,46168
01-07-2014,12,17330,16562,7223,2506,43621,1302,669,543,2514,46135
01-07-2014,13,17304,15921,7134,2383,42742,1304,612,548,2464,45206
01-07-2014,14,17316,15629,7068,2411,42425,1290,494,566,2350,44775
01-07-2014,15,17245,15580,6933,2332,42091,1298,384,416,2098,44189
01-07-2014,16,17066,15330,6788,2328,41512,1299,377,350,2026,43538
01-07-2014,17,16772,15717,6686,2321,41497,1310,378,342,2030,43527
01-07-2014,18,16694,16602,6693,2283,42274,1311,376,325,2012,44286
01-07-2014,19,16634,16195,6519,2069,41416,1310,356,362,2028,43444
01-07-2014,20,16538,15725,6270,2067,40600,1274,351,350,1975,42575
01-07-2014,21,16569,14985,6263,2038,39854,1227,340,347,1914,41768
01-07-2014,22,16193,14994,6177,1957,39321,1253,330,345,1928,41249
01-07-2014,23,15477,14351,5793,1946,37566,1316,299,350,1965,39531
02-07-2014,0,14545,12987,5534,1645,34712,1318,302,343,1963,36675
02-07-2014,1,13798,12488,5546,1504,33337,1319,302,320,1941,35278
02-07-2014,2,13041,12349,5537,1566,32494,1323,302,314,1939,34433
02-07-2014,3,12481,12336,5515,1441,31773,1331,302,299,1932,33705
02-07-2014,4,12641,12313,5531,1408,31893,1327,299,307,1933,33826
02-07-2014,5,13579,12479,5771,1383,33212,1328,303,350,1981,35193
02-07-2014,6,15164,14171,6144,1972,37452,1325,492,340,2157,39609
02-07-2014,7,16525,15758,6620,2454,41358,1322,615,431,2368,43726
02-07-2014,8,16888,16678,6860,2642,43070,1334,733,491,2558,45628
02-07-2014,9,17205,16684,6962,2693,43545,1341,749,496,2586,46131
02-07-2014,10,17154,17071,6967,2795,43987,1354,756,515,2625,46612
02-07-2014,11,17097,17103,7007,3064,44271,1352,756,500,2608,46879
02-07-2014,12,17099,16857,6994,3047,43999,1372,695,512,2579,46578
02-07-2014,13,17146,16905,6881,3095,44027,1366,634,500,2500,46527
02-07-2014,14,17154,16788,6751,3228,43921,1369,563,475,2407,46328
02-07-2014,15,16693,16609,6550,3312,43164,1364,430,466,2260,45424
02-07-2014,16,16615,15806,6572,3400,42393,1327,407,441,2175,44568
02-07-2014,17,16470,15776,6483,3394,42124,1322,344,433,2099,44223
02-07-2014,18,16459,15505,6445,3302,41712,1330,335,423,2088,43800
02-07-2014,19,16326,15149,6558,3201,41233,1318,329,355,2002,43235
02-07-2014,20,15924,15117,6333,2911,40287,1246,315,353,1914,42201
02-07-2014,21,15766,15030,6215,2782,39793,1246,315,320,1881,41674
02-07-2014,22,15288,14805,6146,2636,38875,1237,309,322,1868,40743
02-07-2014,23,14440,14584,5676,2447,37146,1255,304,328,1887,39033
03-07-2014,0,13727,13905,5565,2449,35646,1216,304,295,1815,37461
03-07-2014,1,12686,13676,5554,2393,34309,1213,303,311,1827,36136
03-07-2014,2,12324,13573,5561,2375,33833,1222,302,300,1824,35657
03-07-2014,3,11502,13542,5538,2493,33076,1142,303,274,1719,34795
03-07-2014,4,11279,13637,5579,2673,33169,1116,306,285,1707,34876
03-07-2014,5,12520,13743,5682,2668,34612,1299,305,310,1914,36526
03-07-2014,6,14551,14590,6013,2892,38046,1392,544,319,2255,40301
03-07-2014,7,15821,15975,6393,3237,41426,1430,649,330,2409,43835
03-07-2014,8,16434,16577,6734,3484,43228,1461,724,341,2526,45754
03-07-2014,9,16568,16870,6789,3520,43748,1506,766,338,2610,46358
03-07-2014,10,16758,16996,6798,3718,44270,1494,770,353,2617,46887
03-07-2014,11,16766,17035,6732,3964,44498,1499,764,339,2602,47100
03-07-2014,12,16265,16725,6647,4079,43716,1502,777,353,2632,46348
03-07-2014,13,16005,16517,6467,4093,43082,1504,935,357,2796,45878
03-07-2014,14,15935,16055,6352,3990,42333,1516,850,362,2728,45061
03-07-2014,15,16162,16002,6276,3802,42241,1521,665,363,2549,44790
03-07-2014,16,15850,16317,6226,3747,42140,1530,581,353,2464,44604
03-07-2014,17,15983,16440,6172,3684,42281,1490,489,376,2355,44636
03-07-2014,18,15832,16310,6149,3560,41850,1457,421,395,2273,44123
03-07-2014,19,15724,16360,6130,3211,41426,1441,400,303,2144,43570
03-07-2014,20,15516,16024,6030,3005,40575,1457,363,317,2137,42712
03-07-2014,21,14784,15627,6796,2702,39909,1355,360,275,1990,41899
03-07-2014,22,14510,14952,6671,2649,38782,1399,323,347,2069,40851
03-07-2014,23,14025,14638,6392,2398,37454,1383,320,397,2100,39554
04-07-2014,0,13287,13975,6199,2336,35798,1322,324,365,2011,37809
04-07-2014,1,12720,13563,5902,2144,34330,1305,323,375,2003,36333
04-07-2014,2,12536,13369,5929,1774,33610,1312,319,507,2138,35748
04-07-2014,3,12032,13340,5982,1774,33130,1294,319,410,2023,35153
04-07-2014,4,11945,13330,6024,1756,33055,1240,370,382,1992,35047
04-07-2014,5,12696,13536,6332,1693,34255,1322,407,359,2088,36343
04-07-2014,6,14216,14552,6809,2136,37714,1433,608,359,2400,40114
04-07-2014,7,15423,15687,7055,2542,40708,1438,880,342,2660,43368
04-07-2014,8,16047,16365,7236,2819,42468,1440,942,331,2713,45181
04-07-2014,9,16270,16412,7390,2910,42983,1443,944,326,2713,45696
04-07-2014,10,16490,16799,7421,3024,43734,1450,859,326,2635,46369
04-07-2014,11,16303,16863,7441,3156,43764,1439,862,327,2628,46392
04-07-2014,12,16154,16802,7351,3171,43477,1434,685,469,2588,46065
04-07-2014,13,15905,15724,7206,2988,41823,1438,681,473,2592,44415
04-07-2014,14,15616,15514,7047,3083,41261,1454,659,473,2586,43847
04-07-2014,15,15452,15291,7073,2704,40518,1463,666,314,2443,42961
04-07-2014,16,15549,14987,7016,2805,40358,1456,532,349,2337,42695
04-07-2014,17,15491,15424,6860,2710,40485,1432,483,372,2287,42772
04-07-2014,18,15042,15525,6734,2750,40051,1424,457,366,2247,42298
04-07-2014,19,14846,15160,6767,2610,39383,1354,403,293,2050,41433
04-07-2014,20,14507,14688,6603,2343,38141,1328,402,295,2025,40166
04-07-2014,21,14513,14069,6397,2445,37424,1346,339,305,1990,39414
04-07-2014,22,14124,13596,6344,2342,36407,1359,300,323,1982,38389
04-07-2014,23,13348,13367,6059,2020,34794,1353,300,340,1993,36787
05-07-2014,0,13103,12662,5880,2053,33700,1230,307,342,1879,35579
05-07-2014,1,12248,12454,5690,2074,32466,1208,306,345,1859,34325
05-07-2014,2,11933,12428,5606,2043,32012,1197,305,335,1837,33849
05-07-2014,3,11741,12258,5587,1901,31486,1202,308,330,1840,33326
05-07-2014,4,11551,12220,5563,1669,31003,1177,307,326,1810,32813
05-07-2014,5,11275,12296,5702,1573,30846,1190,308,317,1815,32661
05-07-2014,6,11829,12382,5345,1682,31238,1205,489,325,2019,33257
05-07-2014,7,13204,12772,5422,1935,33333,1194,602,446,2242,35575
05-07-2014,8,14018,13520,5790,2323,35649,1186,832,481,2499,38148
05-07-2014,9,14596,13940,6031,2569,37136,1182,974,333,2489,39625
05-07-2014,10,14876,14419,6118,2617,38030,1186,1000,326,2512,40542
05-07-2014,11,14548,14321,6360,2544,37775,1187,1000,321,2508,40283
05-07-2014,12,14192,13613,6433,2397,36635,1204,835,309,2348,38983
05-07-2014,13,13150,13593,5959,2202,34904,1197,795,322,2314,37218
05-07-2014,14,11952,13766,5952,2229,33898,1198,764,308,2270,36168
05-07-2014,15,11999,13640,6247,2210,34095,1197,479,302,1978,36073
05-07-2014,16,12535,13671,6276,2347,34829,1197,402,306,1905,36734
05-07-2014,17,13558,13671,6248,2581,36057,1195,397,469,2061,38118
05-07-2014,18,14073,13762,6282,2687,36805,1182,410,465,2057,38862
05-07-2014,19,14060,13722,6174,2612,36569,1176,465,304,1945,38514
05-07-2014,20,13986,13463,6013,2268,35731,1179,437,311,1927,37658
05-07-2014,21,13817,13619,6062,1900,35397,1195,394,322,1911,37308
05-07-2014,22,13777,13356,5952,1771,34858,1201,315,338,1854,36712
05-07-2014,23,13196,13019,5608,1697,33520,1202,286,346,1834,35354
06-07-2014,0,12214,12699,5367,1556,31836,1171,149,347,1667,33503
06-07-2014,1,10696,12365,5356,1456,29873,1100,192,348,1640,31513
06-07-2014,2,10226,12044,5398,1356,29023,1112,147,344,1603,30626
06-07-2014,3,9906,11864,5338,1261,28369,1043,138,345,1526,29895
06-07-2014,4,9504,11787,5317,1131,27738,1028,130,346,1504,29242
06-07-2014,5,8885,11648,5295,1016,26845,1084,139,341,1564,28409
06-07-2014,6,9071,11493,5333,1028,26924,1024,223,327,1574,28498
06-07-2014,7,10772,11359,5371,1076,28578,965,308,305,1578,30156
06-07-2014,8,11368,11655,5366,1087,29476,1094,366,295,1755,31231
06-07-2014,9,13262,12212,5498,1186,32159,1090,460,297,1847,34006
06-07-2014,10,13694,12438,5512,1304,32948,1105,442,421,1968,34916
06-07-2014,11,13674,12477,5513,1442,33108,1052,408,433,1893,35001
06-07-2014,12,13484,12649,5498,1613,33243,1017,408,491,1916,35159
06-07-2014,13,13231,12773,5506,1789,33300,1012,350,480,1842,35142
06-07-2014,14,13014,12761,5408,1910,33092,1009,316,472,1797,34889
06-07-2014,15,12870,12523,5428,1996,32817,1109,315,471,1895,34712
06-07-2014,16,12959,12564,5437,2016,32978,1139,351,471,1961,34939
06-07-2014,17,13435,12615,5432,2091,33575,1131,429,410,1970,35545
06-07-2014,18,14316,13249,5530,2205,35301,1135,405,460,2000,37301
06-07-2014,19,14611,13716,5566,2142,36036,1141,325,441,1907,37943
06-07-2014,20,14664,13434,5589,2188,35876,1142,362,376,1880,37756
06-07-2014,21,14654,13330,5476,2366,35827,1070,284,478,1832,37659
06-07-2014,22,14186,12956,5455,2718,35314,978,204,481,1663,36977
06-07-2014,23,13309,12215,5347,2805,33676,995,253,363,1611,35287
07-07-2014,0,12596,11499,5315,2631,32042,991,119,343,1453,33495
07-07-2014,1,11278,11331,5278,2541,30427,982,110,344,1436,31863
07-07-2014,2,11100,11297,5275,2381,30054,972,106,337,1415,31469
07-07-2014,3,11252,11302,5244,2436,30233,955,106,325,1386,31619
07-07-2014,4,11102,11308,5328,2214,29952,988,108,314,1410,31362
07-07-2014,5,12385,11324,5478,2046,31233,1122,168,314,1604,32837
07-07-2014,6,14128,13358,6060,2312,35859,1121,371,306,1798,37657
07-07-2014,7,15288,14978,6483,2495,39245,1117,506,632,2255,41500
07-07-2014,8,16086,15764,6642,2582,41074,1111,601,803,2515,43589
07-07-2014,9,16336,16376,6740,2829,42280,1116,560,835,2511,44791
07-07-2014,10,16301,16911,6903,2904,43020,1120,537,854,2511,45531
07-07-2014,11,16467,16959,6860,2967,43255,1119,491,832,2442,45697
07-07-2014,12,16354,16953,6883,2904,43094,1120,475,1016,2611,45705
07-07-2014,13,16369,16858,6789,2833,42849,1125,503,840,2468,45317
07-07-2014,14,16257,16931,6708,2651,42546,1129,471,836,2436,44982
07-07-2014,15,16089,17113,6617,2495,42313,1129,333,884,2346,44659
07-07-2014,16,15803,17093,6457,2412,41764,1124,484,697,2305,44069
07-07-2014,17,15907,16379,6355,2307,40949,1130,410,699,2239,43188
07-07-2014,18,15827,15726,6358,2234,40145,1134,340,658,2132,42277
07-07-2014,19,15749,15459,6322,2071,39601,1138,383,481,2002,41603
07-07-2014,20,15372,15437,6124,1970,38903,1151,388,470,2009,40912
07-07-2014,21,15085,14881,5992,1899,37858,1134,350,523,2007,39865
07-07-2014,22,14848,14437,5900,1828,37014,1120,289,393,1802,38816
07-07-2014,23,14389,13765,5487,1693,35334,1152,289,332,1773,37107
08-07-2014,0,13617,12320,5346,1584,32866,1065,304,330,1699,34565
08-07-2014,1,13183,11750,5343,1639,31916,1041,303,338,1682,33598
08-07-2014,2,12977,11655,5289,1571,31495,1043,302,330,1675,33170
08-07-2014,3,12615,11565,5252,1516,30947,1001,301,330,1632,32579
08-07-2014,4,12453,11709,5237,1572,30971,1021,297,356,1674,32645
08-07-2014,5,12721,12205,5474,1766,32168,1035,296,352,1683,33851
08-07-2014,6,13804,13748,5930,1932,35414,1043,541,339,1923,37337
08-07-2014,7,14550,15438,6349,2135,38472,1087,642,566,2295,40767
08-07-2014,8,15110,16375,6603,2518,40608,1088,713,613,2414,43022
08-07-2014,9,15334,17031,6795,2707,41866,1175,753,601,2529,44395
08-07-2014,10,15350,17322,6875,2936,42484,1101,758,611,2470,44954
08-07-2014,11,15553,17155,6879,2964,42550,1126,734,604,2464,45014
08-07-2014,12,15684,16964,6959,2702,42309,1118,763,613,2494,44803
08-07-2014,13,15417,16968,6866,2809,42060,1112,725,610,2447,44507
08-07-2014,14,15276,16626,6812,2996,41712,1130,679,606,2415,44127
08-07-2014,15,14976,16257,6695,2919,40847,1140,594,596,2330,43177
08-07-2014,16,14885,16022,6593,2985,40484,1149,483,605,2237,42721
08-07-2014,17,14821,15972,6452,2963,40208,1165,397,606,2168,42376
08-07-2014,18,14612,15440,6392,2801,39244,1169,366,568,2103,41347
08-07-2014,19,14367,15212,6273,2853,38706,1158,362,452,1972,40678
08-07-2014,20,14158,15186,5998,2817,38158,1161,362,456,1979,40137
08-07-2014,21,13864,15162,5975,2707,37707,1171,316,473,1960,39667
08-07-2014,22,13719,14461,5810,2651,36641,1166,306,373,1845,38486
08-07-2014,23,13818,13787,5427,2630,35662,1146,308,377,1831,37493
09-07-2014,0,12586,13436,5117,2641,33780,1118,307,375,1800,35580
09-07-2014,1,11696,12954,4990,2507,32147,1047,304,375,1726,33873
09-07-2014,2,10543,12504,4992,2749,30787,1012,300,370,1682,32469
09-07-2014,3,9795,12413,5011,2780,29998,1001,298,380,1679,31677
09-07-2014,4,9694,12538,5001,2659,29893,1075,299,372,1746,31639
09-07-2014,5,10936,12536,5275,2623,31371,1300,301,351,1952,33323
09-07-2014,6,12800,13682,5753,2609,34844,1308,389,318,2015,36859
09-07-2014,7,14256,14764,6196,2928,38145,1315,559,591,2465,40610
09-07-2014,8,14829,15723,6251,3429,40232,1303,724,716,2743,42975
09-07-2014,9,15082,16084,6428,3906,41500,1298,778,720,2796,44296
09-07-2014,10,15108,16061,6461,4158,41787,1315,732,730,2777,44564
09-07-2014,11,14943,15643,6394,4279,41260,1340,711,603,2654,43914
09-07-2014,12,14861,15196,6395,4229,40680,1346,750,610,2706,43386
09-07-2014,13,14685,14947,6326,4465,40423,1347,650,631,2628,43051
09-07-2014,14,14674,14774,6245,4437,40130,1347,625,631,2603,42733
09-07-2014,15,14589,14933,6243,4460,40224,1334,596,624,2554,42778
09-07-2014,16,14559,14941,6113,4079,39691,1332,450,765,2547,42238
09-07-2014,17,14525,14889,6067,3978,39460,1278,497,660,2435,41895
09-07-2014,18,14570,14556,6063,3741,38930,1231,546,484,2261,41191
09-07-2014,19,14702,14348,5963,3313,38325,1260,489,465,2214,40539
09-07-2014,20,14518,14404,5717,2920,37557,1293,448,456,2197,39754
09-07-2014,21,14378,14134,5653,2664,36828,1326,405,439,2170,38998
09-07-2014,22,14120,13926,5504,2770,36321,1339,380,375,2094,38415
09-07-2014,23,13691,13527,5319,2953,35490,1344,356,374,2074,37564
10-07-2014,0,12033,12787,5212,2898,32930,1177,394,381,1952,34882
10-07-2014,1,10506,12523,5139,2604,30773,1041,402,382,1825,32598
10-07-2014,2,9971,12465,5101,2550,30086,982,403,374,1759,31845
10-07-2014,3,9959,12436,5108,2489,29992,939,403,364,1706,31698
10-07-2014,4,10407,12405,5079,2513,30404,971,402,367,1740,32144
10-07-2014,5,11953,12496,5160,2450,32059,1260,373,352,1985,34044
10-07-2014,6,13417,13550,5401,2770,35136,1361,514,330,2205,37341
10-07-2014,7,14585,15227,5888,3139,38840,1274,638,462,2374,41214
10-07-2014,8,15001,16182,6298,3421,40905,1328,695,560,2583,43488
10-07-2014,9,15359,16499,6424,3465,41745,1354,,541,,
10-07-2014,10,15568,16979,6393,3372,42313,1343,765,582,2690,45003
10-07-2014,11,15664,16938,6367,3324,42293,1348,756,549,2653,44946
10-07-2014,12,15554,16908,6364,3353,42181,1381,746,575,2702,44883
10-07-2014,13,15165,16454,6307,3378,41304,1345,665,612,2622,43926
10-07-2014,14,15264,15925,6237,3289,40715,1353,537,608,2498,43213
10-07-2014,15,15194,15898,6066,3271,40428,1308,575,563,2446,42874
10-07-2014,16,14995,15786,5965,3223,39968,1327,423,605,2355,42323
10-07-2014,17,14741,16132,5908,3000,39782,1329,417,566,2312,42094
10-07-2014,18,14553,15838,5836,2819,39047,1327,417,488,2232,41279
10-07-2014,19,14625,15684,5761,2673,38743,1354,414,463,2231,40974
10-07-2014,20,14593,15365,5574,2653,38184,1182,353,566,2101,40285
10-07-2014,21,14480,14753,5478,2387,37096,1169,302,542,2013,39109
10-07-2014,22,14326,14118,5531,2308,36285,1165,324,384,1873,38158
10-07-2014,23,13647,12841,5275,2115,33879,1160,306,378,1844,35723
11-07-2014,0,13137,12289,5113,1899,32438,1087,331,376,1794,34232
11-07-2014,1,11792,12168,5100,1810,30872,1083,352,382,1817,32689
11-07-2014,2,10783,12028,5072,1756,29640,976,397,359,1732,31372
11-07-2014,3,10426,11888,5089,1759,29163,981,398,363,1742,30905
11-07-2014,4,10583,11834,5114,1637,29167,1010,364,353,1727,30894
11-07-2014,5,12029,12173,5450,1741,31393,1027,353,343,1723,33116
11-07-2014,6,13424,13738,5903,2153,35219,1011,482,331,1824,37043
11-07-2014,7,14138,15272,6125,2412,37948,1005,600,552,2157,40105
11-07-2014,8,14795,16000,6237,2471,39504,1019,723,599,2341,41845
11-07-2014,9,15054,16390,6288,2569,40300,1075,759,605,2439,42739
11-07-2014,10,15202,16571,6256,2780,40809,1095,694,604,2393,43202
11-07-2014,11,15314,16316,6334,2855,40820,1106,661,548,2315,43135
11-07-2014,12,15265,16019,6315,3013,40613,1122,790,598,2510,43123
11-07-2014,13,15201,15533,6319,3023,40075,1136,714,596,2446,42521
11-07-2014,14,14877,15057,6235,2902,39071,1145,569,590,2304,41375
11-07-2014,15,14691,14668,6148,2675,38183,1136,478,573,2187,40370
11-07-2014,16,14477,14609,6035,2410,37531,1122,449,476,2047,39578
11-07-2014,17,14902,14857,5868,2165,37793,1107,485,470,2062,39855
11-07-2014,18,14860,15351,5778,2158,38147,1101,461,456,2018,40165
11-07-2014,19,14697,15187,5703,2180,37768,1059,428,451,1938,39706
11-07-2014,20,14701,14675,5510,2001,36887,1073,356,463,1892,38779
11-07-2014,21,14466,14547,5475,1841,36331,1083,309,434,1826,38157
11-07-2014,22,14217,14284,5541,1895,35939,1078,302,341,1721,37660
11-07-2014,23,13904,13189,5265,1832,34190,1080,300,339,1719,35909
12-07-2014,0,13573,12398,5067,1847,32886,1027,298,358,1683,34569
12-07-2014,1,12836,12104,5012,1528,31481,1018,300,355,1673,33154
12-07-2014,2,12005,11962,5011,1264,30243,1013,302,356,1671,31914
12-07-2014,3,11950,11895,5030,1219,30094,985,300,396,1681,31775
12-07-2014,4,11687,11844,5039,1214,29783,977,301,387,1665,31448
12-07-2014,5,11469,11803,5111,1201,29584,995,299,357,1651,31235
12-07-2014,6,12175,11883,5158,1248,30464,989,295,344,1628,32092
12-07-2014,7,13003,12541,5327,1435,32309,986,302,380,1668,33977
12-07-2014,8,13983,13841,5539,1784,35148,982,375,427,1784,36932
12-07-2014,9,14753,14273,5423,2017,36467,1011,307,606,1924,38391
12-07-2014,10,14945,14520,5498,2156,37119,1059,308,599,1966,39085
12-07-2014,11,14882,14612,5462,2111,37067,1099,332,430,1861,38928
12-07-2014,12,14278,13378,5526,1968,35148,1105,337,447,1889,37037
12-07-2014,13,13430,12907,5445,1637,33419,1119,304,435,1858,35277
12-07-2014,14,13043,12814,5392,1476,32725,1108,284,442,1834,34559
12-07-2014,15,12860,12689,5383,1492,32425,1104,303,456,1863,34288
12-07-2014,16,13415,12639,5466,1637,33158,1083,293,436,1812,34970
12-07-2014,17,14184,13564,5544,1848,35140,1071,299,439,1809,36949
12-07-2014,18,14849,14261,5523,1852,36486,1053,300,437,1790,38276
12-07-2014,19,14774,14581,5447,2076,36878,1044,291,435,1770,38648
12-07-2014,20,14531,14282,5305,2019,36137,1039,288,429,1756,37893
12-07-2014,21,14470,14113,5305,1969,35857,1047,290,440,1777,37634
12-07-2014,22,14457,14031,5221,1861,35572,1045,293,417,1755,37327
12-07-2014,23,14085,13618,5091,1573,34368,1039,299,363,1701,36069
13-07-2014,0,12745,12781,5017,1391,31934,1074,134,352,1560,33494
13-07-2014,1,11384,12235,4907,1118,29644,1047,118,338,1503,31147
13-07-2014,2,10657,12158,4919,1059,28793,992,118,341,1451,30244
13-07-2014,3,9769,12157,4936,1088,27950,980,119,368,1467,29417
13-07-2014,4,9314,12172,4924,1108,27517,950,123,362,1435,28952
13-07-2014,5,9127,12152,4923,1192,27393,891,132,373,1396,28789
13-07-2014,6,9147,12172,4913,1236,27469,913,137,338,1388,28857
13-07-2014,7,9463,12371,4950,1333,28117,980,143,345,1468,29585
13-07-2014,8,10923,12847,5075,1446,30292,1051,153,393,1597,31889
13-07-2014,9,13065,13292,5128,1584,33069,1096,217,399,1712,34781
13-07-2014,10,13507,12597,5282,1586,32973,1116,141,563,1820,34793
13-07-2014,11,13164,13124,5336,1766,33390,1151,138,538,1827,35217
13-07-2014,12,13086,13074,5332,1448,32939,1136,370,375,1881,34820
13-07-2014,13,13349,13088,5325,1506,33268,1145,485,377,2007,35275
13-07-2014,14,13210,12855,5319,1792,33176,1125,256,388,1769,34945
13-07-2014,15,13181,12959,5321,1746,33205,1126,245,373,1744,34949
13-07-2014,16,13124,13116,5348,1778,33365,1122,243,375,1740,35105
13-07-2014,17,13241,13244,5328,1902,33716,1064,249,367,1680,35396
13-07-2014,18,14025,13470,5386,2111,34991,1025,351,359,1735,36726
13-07-2014,19,14452,14302,5386,2338,36479,1090,259,360,1709,38188
13-07-2014,20,14656,14593,5307,2497,37055,1124,195,361,1680,38735
13-07-2014,21,13979,14146,5475,2559,36159,1114,182,359,1655,37814
13-07-2014,22,14155,13899,5524,2609,36186,1107,121,317,1545,37731
13-07-2014,23,13212,13038,5269,2746,34264,1137,110,296,1543,35807
14-07-2014,0,11575,12200,4993,2617,31386,1195,149,309,1653,33039
14-07-2014,1,10078,11885,4890,2653,29508,1093,149,367,1609,31117
14-07-2014,2,9258,11929,4898,2708,28792,1002,112,337,1451,30243
14-07-2014,3,8896,11862,4868,2782,28410,997,207,406,1610,30020
14-07-2014,4,8776,11845,4891,2763,28276,1038,210,355,1603,29879
14-07-2014,5,9973,12235,5082,2826,30115,1248,124,346,1718,31833
14-07-2014,6,12944,13258,5529,3020,34751,1278,359,460,2097,36848
14-07-2014,7,14485,14329,5916,3298,38028,1278,474,542,2294,40322
14-07-2014,8,15455,14794,6271,3538,40057,1252,630,575,2457,42514
14-07-2014,9,15823,15193,6418,3653,41087,1255,651,580,2486,43573
14-07-2014,10,16040,15311,6506,3755,41611,1266,624,603,2493,44104
14-07-2014,11,16120,15344,6552,3764,41779,1269,562,615,2446,44225
14-07-2014,12,16143,15151,6532,3589,41415,1271,633,619,2523,43938
14-07-2014,13,15976,14385,6357,3463,40180,1239,545,610,2394,42574
14-07-2014,14,15591,13948,6288,3249,39076,1228,566,599,2393,41469
14-07-2014,15,15154,13896,6216,3012,38277,1237,494,606,2337,40614
14-07-2014,16,15075,14158,6072,2931,38236,1242,436,600,2278,40514
14-07-2014,17,15643,15369,5957,3042,40011,1248,385,589,2222,42233
14-07-2014,18,15407,15777,5988,2959,40132,1249,301,584,2134,42266
14-07-2014,19,15300,15618,5946,2844,39707,1245,294,581,2120,41827
14-07-2014,20,15135,15215,5635,2603,38589,1255,295,538,2088,40677
14-07-2014,21,15061,14877,5590,2354,37882,1277,297,527,2101,39983
14-07-2014,22,15015,14546,5649,2375,37586,1293,295,388,1976,39562
14-07-2014,23,14618,13526,5309,2284,35736,1287,293,315,1895,37631
15-07-2014,0,13423,12336,5088,2230,33077,1262,293,339,1894,34971
15-07-2014,1,12783,12065,4965,2286,32099,1237,293,382,1912,34011
15-07-2014,2,12138,12006,4864,2071,31078,1226,293,337,1856,32934
15-07-2014,3,11644,12020,4903,2107,30674,1207,294,302,1803,32477
15-07-2014,4,11685,11999,4885,2062,30631,1209,300,304,1813,32444
15-07-2014,5,12370,12124,5116,1923,31534,1266,303,314,1883,33417
15-07-2014,6,13304,13260,5620,2010,34195,1312,305,459,2076,36271
15-07-2014,7,14299,14342,6172,2325,37139,1297,412,545,2254,39393
15-07-2014,8,14780,15055,6357,2581,38773,1304,594,586,2484,41257
15-07-2014,9,15279,15168,6448,2765,39661,1316,627,598,2541,42202
15-07-2014,10,15384,15647,6392,2885,40308,1323,657,617,2597,42905
15-07-2014,11,15425,15804,6436,2939,40604,1339,692,601,2632,43236
15-07-2014,12,15297,15207,6440,3308,40252,1337,648,606,2591,42843
15-07-2014,13,15125,15075,6352,3282,39833,1331,590,606,2527,42360
15-07-2014,14,14821,15005,6351,3292,39468,1327,627,613,2567,42035
15-07-2014,15,14739,14858,6329,3193,39119,1321,407,605,2333,41452
15-07-2014,16,14704,14892,6218,3081,38897,1312,408,593,2313,41210
15-07-2014,17,15121,15337,6105,3167,39729,1295,385,583,2263,41992
15-07-2014,18,14624,15403,5993,3045,39065,1286,442,523,2251,41316
15-07-2014,19,14634,15240,5916,2921,38712,1285,445,513,2243,40955
15-07-2014,20,14445,14972,5745,2730,37892,1288,431,509,2228,40120
15-07-2014,21,14210,14742,5754,2737,37441,1299,318,507,2124,39565
15-07-2014,22,14379,14157,5564,2694,36794,1305,297,385,1987,38781
15-07-2014,23,13968,13765,5213,2621,35568,1294,293,329,1916,37484
16-07-2014,0,12880,13079,5078,2134,33171,1265,292,295,1852,35023
16-07-2014,1,12238,12889,4957,1797,31882,1263,293,297,1853,33735
16-07-2014,2,11967,12637,4954,1837,31395,1268,293,302,1863,33258
16-07-2014,3,11619,12679,4941,1824,31064,1262,291,312,1865,32929
16-07-2014,4,11547,12650,4960,1728,30885,1281,294,310,1885,32770
16-07-2014,5,12145,12712,5183,1652,31692,1376,297,312,1985,33677
16-07-2014,6,13402,13292,5615,2174,34483,1415,302,325,2042,36525
16-07-2014,7,14497,14268,6004,2505,37275,1420,451,544,2415,39690
16-07-2014,8,14906,14794,6214,2742,38654,1428,559,561,2548,41202
16-07-2014,9,15222,15274,6311,2734,39541,1434,,530,,
16-07-2014,10,15448,15714,6315,2805,40283,1439,673,539,2651,42934
16-07-2014,11,15501,15758,6381,2866,40508,1436,672,503,2611,43119
16-07-2014,12,15531,15942,6331,2897,40701,1432,647,565,2644,43345
16-07-2014,13,15388,15975,6242,2889,40494,1433,679,550,2662,43156
16-07-2014,14,15297,15853,6280,2882,40312,1451,611,581,2643,42955
16-07-2014,15,15560,15410,6200,2788,39959,1460,464,570,2494,42453
16-07-2014,16,15734,15578,6052,2652,40015,1432,438,544,2414,42429
16-07-2014,17,15727,15388,5887,2596,39598,1420,434,563,2417,42015
16-07-2014,18,15656,15027,5789,2473,38946,1402,454,518,2374,41320
16-07-2014,19,15469,14842,5718,2362,38392,1392,416,510,2318,40710
16-07-2014,20,15230,14644,5556,2191,37621,1396,321,484,2201,39822
16-07-2014,21,15134,14373,5501,2073,37082,1395,306,424,2125,39207
16-07-2014,22,15068,14229,5394,2130,36822,1394,294,383,2071,38893
16-07-2014,23,14582,14166,5095,1890,35733,1391,289,325,2005,37738
17-07-2014,0,13917,13235,4953,1790,33897,1293,289,295,1877,35774
17-07-2014,1,13371,12754,4875,1584,32583,1181,288,295,1764,34347
17-07-2014,2,12978,12416,4889,1470,31752,1186,289,293,1768,33520
17-07-2014,3,12702,12359,4920,1379,31361,1184,289,293,1766,33127
17-07-2014,4,12553,12380,4898,1429,31259,1192,288,290,1770,33029
17-07-2014,5,13006,12555,5090,1717,32369,1196,288,287,1771,34140
17-07-2014,6,13882,13644,5458,1940,34923,1225,404,330,1959,36882
17-07-2014,7,14464,14289,5860,2202,36815,1223,510,531,2264,39079
17-07-2014,8,15042,14718,6102,2284,38147,1221,568,568,2357,40504
17-07-2014,9,15337,15297,6198,2376,39208,1220,584,577,2381,41589
17-07-2014,10,15552,15599,6294,2475,39920,1185,588,580,2353,42273
17-07-2014,11,15571,15895,6366,2513,40345,1124,682,568,2374,42719
17-07-2014,12,15558,16009,6362,2499,40429,1118,718,571,2407,42836
17-07-2014,13,15438,16056,6291,2502,40287,1120,670,573,2363,42650
17-07-2014,14,15381,15854,6227,2454,39917,1119,582,590,2291,42208
17-07-2014,15,15496,15554,6199,2424,39673,1122,576,585,2283,41956
17-07-2014,16,15818,15408,6155,2347,39728,1121,462,584,2167,41895
17-07-2014,17,15787,15357,6089,2235,39469,1125,398,580,2103,41572
17-07-2014,18,15742,15262,6003,2252,39257,1124,371,580,2075,41332
17-07-2014,19,15522,15139,5945,2234,38841,1103,398,520,2021,40862
17-07-2014,20,15186,14688,5853,2042,37771,1050,433,508,1991,39762
17-07-2014,21,14977,14370,5861,1890,37098,1051,387,496,1934,39032
17-07-2014,22,15076,14064,5723,1832,36695,1049,299,385,1733,38428
17-07-2014,23,14779,13589,5378,1650,35396,1008,285,377,1670,37066
18-07-2014,0,14084,12563,5061,1571,33278,1045,285,309,1639,34917
18-07-2014,1,13466,12173,4990,1377,32006,1035,285,290,1610,33616
18-07-2014,2,13399,12111,4989,1218,31717,1029,285,293,1607,33324
18-07-2014,3,13341,12019,4952,1229,31540,1020,286,294,1600,33140
18-07-2014,4,13266,11981,4961,1237,31446,1032,286,295,1613,33059
18-07-2014,5,13290,12181,5248,1328,32048,1082,291,289,1662,33710
18-07-2014,6,13915,13270,5775,1724,34686,1110,192,452,1754,36440
18-07-2014,7,14878,14356,6150,1919,37303,1128,293,534,1955,39258
18-07-2014,8,15173,15258,6382,2030,38842,1124,503,568,2195,41037
18-07-2014,9,15627,15599,6464,2169,39860,1116,529,567,2212,42072
18-07-2014,10,16218,15936,6511,2197,40862,1105,546,561,2212,43074
18-07-2014,11,16385,15968,6528,2258,41139,1096,503,553,2152,43291
18-07-2014,12,16294,15910,6469,2277,40949,1097,594,551,2242,43191
18-07-2014,13,16050,15998,6378,2209,40635,1107,520,554,2181,42816
18-07-2014,14,15991,15896,6354,2232,40474,1155,359,557,2071,42545
18-07-2014,15,15537,15800,6266,2225,39828,1165,216,560,1941,41769
18-07-2014,16,15329,15564,6188,2215,39296,1182,223,560,1965,41261
18-07-2014,17,15348,15360,6024,2153,38885,1219,197,555,1971,40856
18-07-2014,18,15224,15095,5923,2120,38362,1218,193,551,1962,40324
18-07-2014,19,15154,14833,5872,2047,37906,1206,175,551,1932,39838
18-07-2014,20,14972,14462,5634,1988,37056,1206,203,572,1981,39037
18-07-2014,21,14803,14177,5611,1904,36495,1211,113,573,1897,38392
18-07-2014,22,14748,13879,5634,1911,36172,1207,108,390,1705,37877
18-07-2014,23,14633,13452,5226,1683,34994,1210,106,323,1639,36633
19-07-2014,0,13707,12473,4986,1471,32639,1055,106,303,1464,34103
19-07-2014,1,12958,11722,4847,1303,30830,1045,133,355,1533,32363
19-07-2014,2,12591,11655,4862,1322,30432,1049,106,302,1457,31889
19-07-2014,3,12217,11654,4865,1359,30095,1045,106,300,1451,31546
19-07-2014,4,11961,11636,4813,1334,29744,1054,106,314,1474,31218
19-07-2014,5,11642,11663,4867,1379,29551,1049,109,294,1452,31003
19-07-2014,6,12299,11741,4920,1505,30465,1050,116,315,1481,31946
19-07-2014,7,12871,12205,5131,1660,31866,1046,156,362,1564,33430
19-07-2014,8,13514,12739,5428,1682,33361,1049,242,404,1695,35056
19-07-2014,9,13852,12830,5632,1898,34213,1044,297,420,1761,35974
19-07-2014,10,13863,12776,5638,2122,34398,1040,314,421,1775,36173
19-07-2014,11,13567,12693,5647,2157,34063,1043,339,500,1882,35945
19-07-2014,12,12683,12512,5656,2019,32870,1061,344,563,1968,34838
19-07-2014,13,12137,12301,5619,2067,32124,1113,345,557,2015,34139
19-07-2014,14,11952,12200,5537,2125,31815,1123,332,546,2001,33816
19-07-2014,15,12303,12101,5538,2224,32167,1121,284,550,1955,34122
19-07-2014,16,12571,12205,5622,2336,32734,1126,296,554,1976,34710
19-07-2014,17,13351,12731,5628,2387,34096,1128,152,573,1853,35949
19-07-2014,18,14297,13400,5620,2581,35897,1125,168,575,1868,37765
19-07-2014,19,14306,13844,5518,2445,36114,1112,165,564,1841,37955
19-07-2014,20,14096,13741,5421,2318,35577,1109,165,527,1801,37378
19-07-2014,21,13893,13347,5458,2165,34864,1113,166,461,1740,36604
19-07-2014,22,13971,13248,5597,2248,35063,1117,118,415,1650,36713
19-07-2014,23,13141,12335,5189,2227,32894,1097,111,361,1569,34463
20-07-2014,0,10625,11871,4920,2018,29434,934,108,325,1367,30801
20-07-2014,1,9257,11784,4799,1982,27822,927,107,328,1362,29184
20-07-2014,2,8364,11564,4779,1946,26653,924,107,338,1369,28022
20-07-2014,3,8022,11462,4840,1890,26215,923,107,334,1364,27579
20-07-2014,4,7832,11597,4853,1843,26125,923,109,339,1371,27496
20-07-2014,5,7550,11598,4825,1918,25893,923,108,330,1361,27254
20-07-2014,6,7559,11520,4948,1938,25965,927,112,304,1343,27308
20-07-2014,7,8600,11544,4957,2017,27117,922,160,335,1417,28534
20-07-2014,8,9315,11757,5075,2229,28378,933,225,389,1547,29925
20-07-2014,9,10761,11818,5246,2636,30462,922,226,431,1579,32041
20-07-2014,10,11091,11941,5477,2997,31507,930,238,603,1771,33278
20-07-2014,11,11072,12075,5442,3258,31848,942,244,597,1783,33631
20-07-2014,12,11013,12120,5483,3416,32031,943,244,602,1789,33820
20-07-2014,13,10813,12064,5441,3530,31847,943,245,587,1775,33622
20-07-2014,14,10663,12185,5338,3533,31718,946,233,576,1755,33473
20-07-2014,15,10715,12214,5425,3534,31888,950,268,556,1774,33662
20-07-2014,16,10896,12455,5457,3663,32472,956,171,618,1745,34217
20-07-2014,17,12204,12932,5439,3758,34333,954,170,604,1728,36061
20-07-2014,18,13427,13387,5375,3589,35778,952,172,623,1747,37525
20-07-2014,19,13869,13956,5373,3515,36714,958,187,601,1746,38460
20-07-2014,20,13703,13280,5369,3061,35413,975,141,598,1714,37127
20-07-2014,21,13508,13120,5525,2760,34912,988,284,566,1838,36750
20-07-2014,22,13597,13021,5630,2791,35040,982,120,402,1504,36544
20-07-2014,23,11755,12520,5139,2776,32190,979,112,341,1432,33622
21-07-2014,0,10015,11654,4999,2613,29281,1128,114,313,1555,30836
21-07-2014,1,9815,11487,4719,2390,28411,1104,115,311,1530,29941
21-07-2014,2,9507,11841,4703,2324,28374,1089,114,308,1511,29885
21-07-2014,3,9624,11997,4754,2368,28741,1081,112,310,1503,30244
21-07-2014,4,9252,12009,4829,2361,28450,1152,113,320,1585,30035
21-07-2014,5,9931,12233,5047,2311,29521,1321,118,324,1763,31284
21-07-2014,6,12781,13161,5565,2257,33766,1311,211,325,1847,35613
21-07-2014,7,13813,13727,6170,2388,36098,1327,434,511,2272,38370
21-07-2014,8,14707,14536,6205,2739,38188,1354,593,567,2514,40702
21-07-2014,9,15090,14837,6394,3009,39331,1375,564,565,2504,41835
21-07-2014,10,15063,15004,6441,3296,39803,1412,636,559,2607,42410
21-07-2014,11,15065,14941,6451,3328,39784,1426,672,554,2652,42436
21-07-2014,12,14908,14879,6430,3207,39425,1428,731,577,2736,42161
21-07-2014,13,14932,14619,6346,3207,39105,1413,625,568,2606,41711
21-07-2014,14,14980,14308,6320,3164,38774,1429,541,575,2545,41319
21-07-2014,15,14866,14417,6163,3035,38481,1428,509,556,2493,40974
21-07-2014,16,14533,14416,5952,2822,37722,1411,454,545,2410,40132
21-07-2014,17,14676,14190,5881,2664,37412,1420,420,547,2387,39799
21-07-2014,18,14673,14028,5802,2519,37023,1410,364,532,2306,39329
21-07-2014,19,14435,14198,5680,2245,36558,1400,356,500,2256,38814
21-07-2014,20,14209,14023,5519,2010,35762,1402,308,496,2206,37968
21-07-2014,21,14074,13677,5488,1828,35068,1414,299,445,2158,37226
21-07-2014,22,14149,13353,5435,1894,34831,1325,299,444,2068,36899
21-07-2014,23,12640,12805,5169,1811,32425,1325,300,370,1995,34420
22-07-2014,0,12877,11738,4818,1761,31195,1318,301,345,1964,33159
22-07-2014,1,10653,11531,4713,1810,28707,1306,300,359,1965,30672
22-07-2014,2,10231,11487,4723,1697,28140,1304,298,356,1958,30098
22-07-2014,3,9703,11487,4737,1689,27616,1302,298,347,1947,29563
22-07-2014,4,10419,11582,4778,1697,28477,1311,299,349,1959,30436
22-07-2014,5,11132,11914,4822,1550,29418,1386,297,369,2052,31470
22-07-2014,6,12914,12654,5280,1581,32429,1371,462,372,2205,34634
22-07-2014,7,14516,13619,5858,1773,35765,1358,563,397,2318,38083
22-07-2014,8,15087,14649,6089,2076,37900,1374,631,571,2576,40476
22-07-2014,9,15286,15373,6276,2442,39378,1388,624,587,2599,41977
22-07-2014,10,15680,15299,6316,2578,39873,1399,626,597,2622,42495
22-07-2014,11,15532,15191,6345,2696,39765,1403,660,587,2650,42415
22-07-2014,12,15525,14906,6449,2687,39566,1406,692,592,2690,42256
22-07-2014,13,15648,14722,6194,2879,39444,1406,605,593,2604,42048
22-07-2014,14,15145,14438,6265,2940,38789,1397,455,594,2446,41235
22-07-2014,15,14915,14184,6244,2990,38333,1409,449,584,2442,40775
22-07-2014,16,15097,14121,6116,2621,37956,1399,538,475,2412,40368
22-07-2014,17,15074,14311,5999,2432,37816,1374,547,459,2380,40196
22-07-2014,18,14739,14538,5820,2239,37336,1375,491,505,2371,39707
22-07-2014,19,14645,14360,5769,2131,36907,1380,418,451,2249,39156
22-07-2014,20,14585,13982,5725,1954,36246,1401,328,422,2151,38397
22-07-2014,21,14482,13711,5626,1836,35654,1423,300,475,2198,37852
22-07-2014,22,14521,13546,5509,1804,35381,1343,302,476,2121,37502
22-07-2014,23,14017,12962,5243,1774,33995,1334,324,415,2073,36068
23-07-2014,0,12450,12017,4802,1421,30688,1247,321,388,1956,32644
23-07-2014,1,10737,11624,4758,1341,28460,1191,314,379,1884,30344
23-07-2014,2,10234,11469,4733,1291,27727,1199,318,404,1921,29648
23-07-2014,3,9984,11583,4720,1239,27526,1201,318,376,1895,29421
23-07-2014,4,10375,11686,4739,1277,28077,1202,328,353,1883,29960
23-07-2014,5,11525,11986,4882,1325,29717,1354,333,402,2089,31806
23-07-2014,6,13115,12959,5383,1521,32978,1354,427,425,2206,35184
23-07-2014,7,14367,13904,5915,1669,35856,1342,511,578,2431,38287
23-07-2014,8,14980,15144,6191,1914,38229,1343,600,602,2545,40774
23-07-2014,9,15319,15529,6406,2289,39544,1359,590,594,2543,42087
23-07-2014,10,15587,15642,6473,2561,40265,1373,566,607,2546,42811
23-07-2014,11,15381,15606,6600,2709,40296,1381,570,596,2547,42843
23-07-2014,12,15225,15274,6620,2757,39877,1386,671,602,2659,42536
23-07-2014,13,15184,14936,6613,2726,39457,1392,577,588,2557,42014
23-07-2014,14,15313,14413,6487,2446,38659,1387,543,598,2528,41187
23-07-2014,15,14910,14055,6409,2329,37702,1385,489,598,2472,40174
23-07-2014,16,15051,13784,6300,2174,37311,1385,475,533,2393,39704
23-07-2014,17,15196,14306,6054,2105,37662,1376,378,562,2316,39978
23-07-2014,18,14042,15409,6030,2433,37913,1374,377,509,2260,40173
23-07-2014,19,13815,15434,5947,2402,37598,1375,331,507,2213,39811
23-07-2014,20,13739,14962,5756,2168,36625,1391,297,539,2227,38852
23-07-2014,21,13717,14558,5617,2026,35919,1412,285,605,2302,38221
23-07-2014,22,13748,14256,5646,1976,35626,1363,284,342,1989,37615
23-07-2014,23,12816,13724,5099,1794,33433,1335,284,330,1949,35382
24-07-2014,0,10777,12490,4722,1683,29673,1288,285,290,1863,31536
24-07-2014,1,10595,11775,4672,1493,28536,1277,284,293,1854,30390
24-07-2014,2,9911,11927,4674,1551,28064,1278,283,276,1837,29901
24-07-2014,3,9325,11829,4660,1389,27202,1227,282,280,1789,28991
24-07-2014,4,9521,11756,4644,1295,27215,1278,285,272,1835,29050
24-07-2014,5,10436,12008,4813,1292,28550,1368,284,301,1953,30503
24-07-2014,6,11791,13426,5522,1479,32217,1393,429,311,2133,34350
24-07-2014,7,12943,15287,6047,1664,35942,1389,483,486,2358,38300
24-07-2014,8,13218,16416,6310,2136,38081,1381,708,485,2574,40655
24-07-2014,9,13298,17345,6508,2305,39456,1381,684,471,2536,41992
24-07-2014,10,13450,17317,6585,2497,39849,1383,650,485,2518,42367
24-07-2014,11,13326,17224,6623,2782,39957,1383,666,490,2539,42496
24-07-2014,12,13368,16367,6688,2919,39343,1384,810,473,2667,42010
24-07-2014,13,13712,15945,6628,2652,38938,1392,673,474,2539,41477
24-07-2014,14,13736,15701,6504,2658,38598,1393,595,490,2478,41076
24-07-2014,15,13671,15434,6468,2649,38222,1401,547,488,2436,40658
24-07-2014,16,13581,15408,6359,2566,37916,1402,506,488,2396,40312
24-07-2014,17,13553,15563,6157,2567,37841,1399,469,488,2356,40197
24-07-2014,18,13466,15456,6072,2505,37499,1395,405,485,2285,39784
24-07-2014,19,13436,15211,5967,2320,36935,1401,375,464,2240,39175
24-07-2014,20,13106,14845,5791,2180,35921,1412,322,474,2208,38129
24-07-2014,21,13070,14404,5783,2102,35358,1413,318,408,2139,37497
24-07-2014,22,13579,13742,5665,2026,35011,1356,314,321,1991,37002
24-07-2014,23,13534,12930,5169,1751,33384,1329,304,361,1994,35378
25-07-2014,0,12131,11946,4810,1531,30420,1242,303,312,1857,32277
25-07-2014,1,10485,11797,4805,1456,28544,1191,302,302,1795,30339
25-07-2014,2,9993,11658,4755,1497,27903,1187,306,294,1787,29690
25-07-2014,3,9939,11631,4759,1535,27865,1187,309,292,1788,29653
25-07-2014,4,9813,11749,4753,1439,27753,1217,311,289,1817,29570
25-07-2014,5,10565,11964,4978,1492,29000,1252,315,314,1881,30881
25-07-2014,6,12916,12830,5677,1743,33165,1222,322,426,1970,35135
25-07-2014,7,13964,14189,6154,2116,36424,1214,511,472,2197,38621
25-07-2014,8,14820,14931,6456,2526,38732,1208,712,465,2385,41117
25-07-2014,9,15140,15102,6764,2700,39706,1203,731,464,2398,42104
25-07-2014,10,15511,15454,6767,2970,40703,1209,690,472,2371,43074
25-07-2014,11,15315,15513,6767,2976,40571,1207,673,490,2370,42941
25-07-2014,12,15073,15237,6748,2898,39957,1217,797,489,2503,42460
25-07-2014,13,15064,14866,6638,2937,39506,1266,641,488,2395,41901
25-07-2014,14,14904,14674,6577,2908,39063,1208,570,489,2267,41330
25-07-2014,15,14640,14597,6510,2902,38649,1205,449,424,2078,40727
25-07-2014,16,14740,14351,6365,2819,38275,1203,420,409,2032,40307
25-07-2014,17,14922,14166,6173,2921,38181,1201,326,402,1929,40110
25-07-2014,18,14990,14152,6039,2936,38118,1195,324,398,1917,40035
25-07-2014,19,14875,13890,6009,2727,37502,1192,324,396,1912,39414
25-07-2014,20,14825,13793,5782,2440,36840,1190,311,403,1904,38744
25-07-2014,21,14538,13719,5716,2315,36287,1184,312,433,1929,38216
25-07-2014,22,14690,13745,5582,2443,36461,1180,313,354,1847,38308
25-07-2014,23,13834,13384,5029,2201,34449,1261,287,344,1892,36341
26-07-2014,0,13410,12773,4776,2129,33088,894,134,368,1396,34484
26-07-2014,1,12106,11844,4689,1910,30549,860,131,290,1281,31830
26-07-2014,2,11492,11754,4662,1924,29832,859,135,288,1282,31114
26-07-2014,3,10747,11666,4621,1887,28922,860,132,286,1278,30200
26-07-2014,4,10734,11536,4651,1772,28693,861,130,281,1272,29965
26-07-2014,5,10548,11507,4706,1644,28404,851,134,311,1296,29700
26-07-2014,6,12261,11568,4851,1625,30306,851,135,312,1298,31604
26-07-2014,7,12986,11882,5085,1721,31673,919,152,341,1412,33085
26-07-2014,8,14112,12766,5430,1812,34122,929,267,466,1662,35784
26-07-2014,9,14625,13544,5737,1948,35852,938,310,479,1727,37579
26-07-2014,10,14177,13478,5790,2083,35529,980,305,496,1781,37310
26-07-2014,11,13735,12764,5824,2240,34565,997,256,499,1752,36317
26-07-2014,12,13289,12614,5828,2027,33759,983,249,496,1728,35487
26-07-2014,13,12935,12184,5819,1917,32855,991,256,557,1804,34659
26-07-2014,14,12734,12127,5786,1721,32367,1079,236,643,1958,34325
26-07-2014,15,12629,12290,5824,1616,32357,1095,352,473,1920,34277
26-07-2014,16,13379,12672,5745,1650,33445,1082,311,411,1804,35249
26-07-2014,17,14551,13569,5765,1815,35702,1047,317,295,1659,37361
26-07-2014,18,14540,13915,5757,1921,36133,1070,331,296,1697,37830
26-07-2014,19,14336,14343,5642,1850,36171,994,337,300,1631,37802
26-07-2014,20,14226,14167,5475,1858,35727,995,370,302,1667,37394
26-07-2014,21,14461,13677,5639,1694,35471,990,237,318,1545,37016
26-07-2014,22,14354,14074,5552,1657,35637,980,124,328,1432,37069
26-07-2014,23,13830,13379,5108,1608,33925,1000,115,310,1425,35350
27-07-2014,0,12248,11342,4885,1245,29722,949,113,289,1351,31073
27-07-2014,1,11156,10362,4735,1150,27404,932,112,286,1330,28734
27-07-2014,2,10651,10233,4636,1123,26643,935,115,303,1353,27996
27-07-2014,3,10267,10264,4625,1177,26334,940,112,300,1352,27686
27-07-2014,4,9611,10271,4610,1182,25673,950,110,289,1349,27022
27-07-2014,5,9373,10207,4631,1096,25306,955,124,319,1398,26704
27-07-2014,6,9392,10305,4685,1098,25479,947,123,318,1388,26867
27-07-2014,7,10138,10290,4697,1136,26263,931,159,299,1389,27652
27-07-2014,8,11726,10678,4912,1239,28557,934,209,353,1496,30053
27-07-2014,9,12932,11077,5229,1398,30638,953,,380,,
27-07-2014,10,13482,11585,5351,1505,31923,968,315,397,1680,33603
27-07-2014,11,13520,11719,5418,1731,32388,979,305,417,1701,34089
27-07-2014,12,13405,12039,5391,1760,32595,981,303,410,1694,34289
27-07-2014,13,13363,11822,5406,1648,32239,976,303,389,1668,33907
27-07-2014,14,13311,11330,5390,1668,31699,967,304,356,1627,33326
27-07-2014,15,13097,11467,5377,1521,31461,946,323,354,1623,33084
27-07-2014,16,13172,11715,5397,1431,31715,955,313,397,1665,33380
27-07-2014,17,13019,12153,5362,1419,31954,985,311,431,1727,33681
27-07-2014,18,13521,12774,5259,1381,32936,965,310,470,1745,34681
27-07-2014,19,13996,13279,5335,1292,33902,965,315,479,1759,35661
27-07-2014,20,13941,13467,5344,1399,34151,966,321,475,1762,35913
27-07-2014,21,14378,13597,5533,1404,34913,973,318,386,1677,36590
27-07-2014,22,14246,13965,5419,1379,35008,973,307,328,1608,36616
27-07-2014,23,13353,12492,5110,1199,32156,1012,297,336,1645,33801
28-07-2014,0,12722,11033,4853,1117,29725,1342,295,289,1926,31651
28-07-2014,1,11098,10691,4756,1124,27669,1382,299,287,1968,29637
28-07-2014,2,10707,10513,4692,1165,27077,1388,296,297,1981,29058
28-07-2014,3,10477,10453,4695,1120,26744,1393,293,292,1978,28722
28-07-2014,4,10561,10513,4720,1020,26814,1412,293,302,2007,28821
28-07-2014,5,11571,10632,4888,1114,28206,1421,293,335,2049,30255
28-07-2014,6,14011,13271,5287,1683,34252,1411,298,450,2159,36411
28-07-2014,7,14800,14679,5765,1744,36990,1392,428,497,2317,39307
28-07-2014,8,15304,15522,6159,2126,39112,1377,666,535,2578,41690
28-07-2014,9,15449,15819,6394,2536,40197,1370,698,560,2628,42825
28-07-2014,10,15655,16154,6477,2503,40788,1365,656,663,2684,43472
28-07-2014,11,15709,16215,6482,2287,40693,1365,653,662,2680,43373
28-07-2014,12,15628,15888,6458,2308,40282,1366,762,588,2716,42998
28-07-2014,13,15668,15870,6426,2378,40342,1367,681,586,2634,42976
28-07-2014,14,15377,15367,6320,2430,39494,1348,610,573,2531,42025
28-07-2014,15,15286,15033,6086,2312,38717,1377,518,573,2468,41185
28-07-2014,16,15178,14993,5854,2211,38237,1431,513,570,2514,40751
28-07-2014,17,15073,15092,5763,2232,38159,1441,463,574,2478,40637
28-07-2014,18,15087,14831,5599,2212,37731,1434,422,563,2419,40150
28-07-2014,19,14884,14718,5585,2202,37389,1396,393,563,2352,39741
28-07-2014,20,14828,14340,5369,2000,36539,1431,357,574,2362,38901
28-07-2014,21,14934,13947,5319,1835,36035,1459,326,500,2285,38320
28-07-2014,22,14697,13184,5316,1628,34824,1466,312,375,2153,36977
28-07-2014,23,13101,11533,5075,1576,31285,1460,289,323,2072,33357
29-07-2014,0,11443,10886,4864,1431,28625,1457,106,302,1865,30490
29-07-2014,1,10492,10570,4816,1332,27210,1436,103,313,1852,29062
29-07-2014,2,10272,10649,4781,1200,26900,1422,102,312,1836,28736
29-07-2014,3,9998,10656,4750,1171,26575,1442,102,310,1854,28429
29-07-2014,4,9905,10721,4745,1190,26562,1433,104,307,1844,28406
29-07-2014,5,10580,11009,4878,1199,27666,1430,107,306,1843,29509
29-07-2014,6,13651,11688,5326,1468,32132,1459,128,475,2062,34194
29-07-2014,7,14901,14426,5937,1644,36907,1453,415,564,2432,39339
29-07-2014,8,15371,15566,6108,1911,38956,1452,669,576,2697,41653
29-07-2014,9,15709,15976,6329,2089,40103,1452,677,575,2704,42807
29-07-2014,10,15780,16480,6325,2188,40773,1454,709,578,2741,43514
29-07-2014,11,15627,16351,6429,2260,40667,1446,745,582,2773,43440
29-07-2014,12,15692,16210,6330,2079,40311,1455,804,588,2847,43158
29-07-2014,13,15477,15983,6309,2051,39820,1457,691,589,2737,42557
29-07-2014,14,15663,15830,6182,2234,39908,1457,619,593,2669,42577
29-07-2014,15,15379,15456,5950,2304,39089,1453,579,591,2623,41712
29-07-2014,16,15079,15254,5796,2289,38419,1463,538,582,2583,41002
29-07-2014,17,15245,15416,5669,2217,38547,1449,477,587,2513,41060
29-07-2014,18,14954,14965,5556,2140,37615,1458,424,582,2464,40079
29-07-2014,19,15275,14637,5478,2102,37493,1462,363,588,2413,39906
29-07-2014,20,15304,14241,5284,1862,36690,1444,337,596,2377,39067
29-07-2014,21,14974,13654,5290,1799,35718,1437,237,623,2297,38015
29-07-2014,22,14221,12581,5316,1714,33833,1441,108,434,1983,35816
29-07-2014,23,13035,11304,4990,1574,30903,1435,106,372,1913,32816
30-07-2014,0,11622,11047,4807,1496,28972,1170,106,326,1602,30574
30-07-2014,1,10820,10925,4726,1375,27845,1141,109,316,1566,29411
30-07-2014,2,10483,10802,4738,1284,27306,1142,108,326,1576,28882
30-07-2014,3,10317,10702,4753,1211,26982,1145,111,331,1587,28569
30-07-2014,4,10247,10674,4762,1123,26806,1146,115,340,1601,28407
30-07-2014,5,10835,10878,5038,1121,27871,1178,133,353,1664,29535
30-07-2014,6,13666,11792,5518,1435,32411,1252,157,390,1799,34210
30-07-2014,7,14780,14091,6029,1847,36746,1320,359,510,2189,38935
30-07-2014,8,15386,15384,6261,2184,39215,1328,519,529,2376,41591
30-07-2014,9,15586,15832,6343,1986,39747,1365,641,518,2524,42271
30-07-2014,10,15793,16090,6534,2176,40595,1336,666,521,2523,43118
30-07-2014,11,15967,16503,6522,2403,41395,1333,643,525,2501,43896
30-07-2014,12,15934,16383,6498,2581,41396,1336,692,588,2616,44012
30-07-2014,13,15733,16152,6317,2721,40923,1424,664,535,2623,43546
30-07-2014,14,15567,15462,6247,2608,39883,1441,617,515,2573,42456
30-07-2014,15,15229,14700,6162,2579,38668,1387,580,503,2470,41138
30-07-2014,16,14877,14449,6033,2622,37980,1334,504,504,2342,40322
30-07-2014,17,14944,14519,5855,2548,37864,1335,497,486,2318,40182
30-07-2014,18,15087,14519,5706,2636,37948,1323,495,471,2289,40237
30-07-2014,19,15243,14412,5641,2671,37968,1326,492,443,2261,40229
30-07-2014,20,15085,13831,5458,2578,36952,1332,441,447,2220,39172
30-07-2014,21,15090,13236,5417,2452,36195,1345,380,462,2187,38382
30-07-2014,22,14810,12417,5404,2321,34952,1297,295,373,1965,36917
30-07-2014,23,12570,11637,5096,2185,31490,1326,292,393,2011,33501
31-07-2014,0,10570,11216,4859,2127,28772,1341,295,373,2009,30781
31-07-2014,1,9745,11029,4736,2131,27641,1331,298,370,1999,29640
31-07-2014,2,9298,10980,4662,2005,26945,1334,300,365,1999,28944
31-07-2014,3,9242,10876,4679,1918,26715,1325,298,359,1982,28697
31-07-2014,4,9335,10908,4685,1917,26847,1338,295,345,1978,28825
31-07-2014,5,10547,11090,4822,1962,28421,1404,294,341,2039,30460
31-07-2014,6,13253,12300,5341,2087,32980,1389,300,395,2084,35064
31-07-2014,7,14416,13987,5943,2568,36913,1372,439,596,2407,39320
31-07-2014,8,15265,14455,6214,2918,38852,1360,577,602,2539,41391
31-07-2014,9,15449,14732,6194,3114,39489,1450,631,590,2671,42160
31-07-2014,10,15636,14852,6337,3275,40102,1493,636,591,2720,42822
31-07-2014,11,15665,14956,6474,3438,40533,1416,637,603,2656,43189
31-07-2014,12,15407,14662,6347,3426,39842,1371,682,622,2675,42517
31-07-2014,13,15196,14049,6284,3322,38852,1325,668,608,2601,41453
31-07-2014,14,15003,14093,6109,3234,38439,1342,530,614,2486,40925
31-07-2014,15,14583,13966,5924,3106,37580,1369,480,617,2466,40046
31-07-2014,16,14335,13913,5813,2957,37018,1381,480,578,2439,39457
31-07-2014,17,14958,14138,5684,2962,37743,1373,478,484,2335,40078
31-07-2014,18,15379,14575,5584,2880,38420,1376,476,470,2322,40742
31-07-2014,19,15367,14354,5600,2711,38032,1378,474,469,2321,40353
31-07-2014,20,15255,14037,5400,2357,37050,1358,473,431,2262,39312
31-07-2014,21,15221,13687,5473,2473,36855,1362,304,524,2190,39045
31-07-2014,22,15334,13037,5310,2463,36144,1362,288,351,2001,38145
31-07-2014,23,13685,11955,4908,2122,32670,1374,289,311,1974,34644
01-08-2014,0,11717,11171,4797,2046,29732,1339,288,300,1927,31659
01-08-2014,1,10351,10920,4699,1901,27871,1342,285,293,1920,29791
01-08-2014,2,9915,10810,4681,1841,27247,1334,285,291,1910,29157
01-08-2014,3,9609,10739,4668,1709,26723,1333,284,288,1905,28628
01-08-2014,4,9660,10671,4712,1657,26700,1349,287,285,1921,28621
01-08-2014,5,10912,10860,4992,1748,28512,1352,291,283,1926,30438
01-08-2014,6,13773,12080,5561,1940,33355,1326,292,473,2091,35446
01-08-2014,7,15016,13717,6167,2052,36952,1319,361,567,2247,39199
01-08-2014,8,15655,14853,6526,2344,39378,1322,621,568,2511,41889
01-08-2014,9,15510,14915,6617,2412,39454,1336,650,569,2555,42009
01-08-2014,10,15128,14219,6503,2491,38342,1354,677,571,2602,40944
01-08-2014,11,15269,13755,6386,2433,37843,1365,654,573,2592,40435
01-08-2014,12,15138,13374,6348,2422,37283,1333,697,575,2605,39888
01-08-2014,13,14980,13221,6262,2367,36830,1353,652,574,2579,39409
01-08-2014,14,14714,13348,6044,2356,36462,1352,347,575,2274,38736
01-08-2014,15,14389,13381,5923,2395,36088,1334,294,560,2188,38276
01-08-2014,16,14389,13420,5771,2356,35937,1325,403,572,2300,38237
01-08-2014,17,15352,13803,5714,2457,37328,1335,512,575,2422,39750
01-08-2014,18,15496,14331,5693,2428,37950,1337,440,574,2351,40301
01-08-2014,19,15332,14368,5557,2200,37457,1316,300,512,2128,39585
01-08-2014,20,14980,14440,5346,2060,36825,1310,288,512,2110,38935
01-08-2014,21,14815,13966,5356,2161,36297,1309,289,510,2108,38405
01-08-2014,22,14275,12610,5325,2278,34488,1307,286,337,1930,36418
01-08-2014,23,13078,11464,5046,2231,31819,1296,285,317,1898,33717
02-08-2014,0,11837,10509,4744,2187,29276,958,283,296,1537,30813
02-08-2014,1,10643,10416,4634,2274,27966,953,285,297,1535,29501
02-08-2014,2,10148,10317,4613,2339,27418,949,283,298,1530,28948
02-08-2014,3,9957,10311,4632,2319,27219,945,284,296,1525,28744
02-08-2014,4,9462,10269,4602,2274,26609,944,283,304,1531,28140
02-08-2014,5,9418,10128,4630,2242,26418,942,284,322,1548,27966
02-08-2014,6,9506,10026,4999,2250,26782,934,292,392,1618,28400
02-08-2014,7,11617,10320,5387,2324,29648,944,292,452,1688,31336
02-08-2014,8,12962,10761,5770,2369,31863,928,292,552,1772,33635
02-08-2014,9,13692,11459,5997,2481,33631,929,343,522,1794,35425
02-08-2014,10,13888,11607,5959,2656,34110,935,389,519,1843,35953
02-08-2014,11,13772,11675,5916,2992,34356,938,384,540,1862,36218
02-08-2014,12,13145,11666,5898,3265,33975,940,293,541,1774,35749
02-08-2014,13,12693,11495,5828,3622,33638,941,293,542,1776,35414
02-08-2014,14,12253,11338,5858,3743,33193,938,297,428,1663,34856
02-08-2014,15,12045,11411,5839,3757,33050,943,296,427,1666,34716
02-08-2014,16,12130,11515,5699,3722,33066,946,296,424,1666,34732
02-08-2014,17,12091,11696,5662,3929,33379,946,295,507,1748,35127
02-08-2014,18,12315,12055,5436,3969,33775,939,294,501,1734,35509
02-08-2014,19,12509,12296,5485,3751,34041,942,292,407,1641,35682
02-08-2014,20,12324,12483,5469,3458,33735,974,261,444,1679,35414
02-08-2014,21,11907,12431,5514,3132,32986,983,270,461,1714,34700
02-08-2014,22,12271,12061,5591,2953,32876,983,261,405,1649,34525
02-08-2014,23,11237,11210,5129,2796,30372,996,162,389,1547,31919
03-08-2014,0,10046,10969,4716,2517,28249,977,115,375,1467,29716
03-08-2014,1,9725,10788,4598,2148,27258,963,116,390,1469,28727
03-08-2014,2,9476,10713,4581,1909,26679,947,114,371,1432,28111
03-08-2014,3,9278,10603,4591,1665,26137,944,114,358,1416,27553
03-08-2014,4,9019,10592,4578,1579,25768,949,116,352,1417,27185
03-08-2014,5,8991,10527,4620,1498,25637,931,114,347,1392,27029
03-08-2014,6,9083,10463,4709,1469,25725,911,113,369,1393,27118
03-08-2014,7,9752,10691,4920,1439,26804,879,113,410,1402,28206
03-08-2014,8,11072,10905,5165,1495,28636,882,124,515,1521,30157
03-08-2014,9,13245,11253,5423,1547,31468,909,196,535,1640,33108
03-08-2014,10,13813,11507,5638,1456,32415,908,225,567,1700,34115
03-08-2014,11,14008,11751,5682,1504,32945,902,234,488,1624,34569
03-08-2014,12,13938,11907,5715,1598,33159,898,226,468,1592,34751
03-08-2014,13,13799,12189,5705,1602,33295,898,192,558,1648,34943
03-08-2014,14,13728,12006,5680,1778,33192,896,201,534,1631,34823
03-08-2014,15,13797,12119,5590,1817,33324,891,193,439,1523,34847
03-08-2014,16,13940,12234,5404,2083,33662,896,201,432,1529,35191
03-08-2014,17,14171,12430,5465,2166,34233,889,161,570,1620,35853
03-08-2014,18,14308,12407,5522,2008,34244,886,121,551,1558,35802
03-08-2014,19,14188,12517,5571,1889,34165,898,166,565,1629,35794
03-08-2014,20,14312,12604,5565,1843,34324,911,120,475,1506,35830
03-08-2014,21,14543,12705,5663,1853,34764,929,127,466,1522,36286
03-08-2014,22,14376,12405,5564,1815,34160,934,227,456,1617,35777
03-08-2014,23,12690,11585,5199,1418,30892,935,135,407,1477,32369
04-08-2014,0,10905,11128,4815,1389,28238,1202,127,365,1694,29932
04-08-2014,1,10206,10961,4723,1543,27434,1228,127,347,1702,29136
04-08-2014,2,9835,10846,4733,1469,26883,1219,147,329,1695,28578
04-08-2014,3,9662,10739,4751,1479,26631,1235,146,346,1727,28358
04-08-2014,4,9700,10954,4811,1438,26904,1233,228,352,1813,28717
04-08-2014,5,10304,11173,5282,1390,28149,1255,286,346,1887,30036
04-08-2014,6,11939,12934,5832,1813,32519,1289,435,396,2120,34639
04-08-2014,7,13471,15441,6370,2150,37432,1327,477,624,2428,39860
04-08-2014,8,13980,16908,6828,2438,40154,1324,611,598,2533,42687
04-08-2014,9,14025,16565,6998,2588,40175,1337,758,604,2699,42874
04-08-2014,10,14492,16788,7180,2562,41023,1340,781,602,2723,43746
04-08-2014,11,14687,16773,7168,2714,41341,1332,764,629,2725,44066
04-08-2014,12,14590,16665,7264,2888,41407,1325,774,639,2738,44145
04-08-2014,13,14243,16370,7097,2980,40690,1313,775,639,2727,43417
04-08-2014,14,14124,16024,6616,3004,39766,1394,604,639,2637,42403
04-08-2014,15,13913,15890,6385,3045,39233,1404,506,623,2533,41766
04-08-2014,16,13560,15552,6309,2977,38397,1359,461,632,2452,40849
04-08-2014,17,13625,15561,6387,2992,38565,1343,437,617,2397,40962
04-08-2014,18,13287,15536,6211,2773,37807,1329,399,604,2332,40139
04-08-2014,19,13557,15272,6024,2287,37139,1337,396,610,2343,39482
04-08-2014,20,13583,15212,5839,2429,37064,1359,353,591,2303,39367
04-08-2014,21,13720,14905,5762,2495,36883,1373,349,577,2299,39182
04-08-2014,22,13498,14001,5666,2368,35533,1341,305,402,2048,37581
04-08-2014,23,12941,12465,5261,1857,32525,1303,305,368,1976,34501
05-08-2014,0,11769,11386,4943,1630,29729,1070,308,351,1729,31458
05-08-2014,1,11278,11109,4867,1563,28819,1034,309,327,1670,30489
05-08-2014,2,11003,11013,4901,1627,28544,1039,309,304,1652,30196
05-08-2014,3,10965,10956,4905,1706,28531,1038,317,296,1651,30182
05-08-2014,4,10855,11032,4923,1660,28470,1049,324,292,1665,30135
05-08-2014,5,11195,11331,5253,1602,29382,1136,347,294,1777,31159
05-08-2014,6,12641,12295,5900,1892,32727,1184,407,490,2081,34808
05-08-2014,7,13829,14856,6461,2272,37420,1164,662,604,2430,39850
05-08-2014,8,14858,16004,6989,2580,40431,1281,786,628,2695,43126
05-08-2014,9,14758,16143,6865,2678,40446,1342,782,608,2732,43178
05-08-2014,10,14963,15932,7025,2767,40687,1279,879,591,2749,43436
05-08-2014,11,14962,16010,6918,2830,40721,1259,879,570,2708,43429
05-08-2014,12,14949,15905,6855,2894,40603,1221,864,625,2710,43313
05-08-2014,13,14916,16039,6773,2884,40612,1222,684,761,2667,43279
05-08-2014,14,14752,15612,6586,2888,39839,1217,559,587,2363,42202
05-08-2014,15,14796,15130,6393,2882,39200,1185,553,574,2312,41512
05-08-2014,16,14513,14868,6260,2934,38577,1190,574,580,2344,40921
05-08-2014,17,14393,14821,6137,2891,38242,1165,573,595,2333,40575
05-08-2014,18,14508,15192,6049,2760,38508,1155,546,585,2286,40794
05-08-2014,19,13980,15668,5937,2703,38290,1163,414,569,2146,40436
05-08-2014,20,13709,14693,5688,2554,36643,1181,370,596,2147,38790
05-08-2014,21,14102,13727,5679,2451,35959,1195,324,582,2101,38060
05-08-2014,22,13645,13316,5575,2442,34980,1219,322,457,1998,36978
05-08-2014,23,12955,11750,5197,2312,32215,1202,321,326,1849,34064
06-08-2014,0,12011,10914,4912,1877,29714,1060,313,292,1665,31379
06-08-2014,1,11608,10600,4765,1873,28846,1028,313,285,1626,30472
06-08-2014,2,11001,10436,4779,1910,28126,1011,306,284,1601,29727
06-08-2014,3,10817,10283,4819,1840,27759,1015,306,285,1606,29365
06-08-2014,4,10554,10341,4837,1797,27528,1053,311,329,1693,29221
06-08-2014,5,10898,10796,5258,1821,28774,1139,342,386,1867,30641
06-08-2014,6,12406,11952,5869,2145,32371,1154,473,422,2049,34420
06-08-2014,7,13446,14130,6246,2657,36480,1154,789,557,2500,38980
06-08-2014,8,14258,15254,6719,2852,39083,1148,869,601,2618,41701
06-08-2014,9,14750,15588,6758,3032,40126,1223,893,700,2816,42942
06-08-2014,10,14773,15761,6915,3186,40636,1169,832,774,2775,43411
06-08-2014,11,14847,15793,6894,3236,40770,1183,799,489,2471,43241
06-08-2014,12,14755,15686,6821,3237,40500,1180,745,672,2597,43097
06-08-2014,13,14661,15616,6788,3230,40296,1166,722,641,2529,42825
06-08-2014,14,14628,15356,6623,3195,39802,1156,652,337,2145,41947
06-08-2014,15,14519,15102,6518,3046,39187,1146,595,288,2029,41216
06-08-2014,16,14298,14922,6323,3089,38632,1138,577,289,2004,40636
06-08-2014,17,14356,14842,6261,2893,38351,1166,574,432,2172,40523
06-08-2014,18,14161,15143,6207,2684,38194,1195,581,421,2197,40391
06-08-2014,19,14231,15013,5877,2528,37649,1236,501,284,2021,39670
06-08-2014,20,14084,14475,5649,2399,36607,1240,502,322,2064,38671
06-08-2014,21,14029,13992,5483,2374,35877,1246,429,304,1979,37856
06-08-2014,22,13652,13614,5451,2407,35125,1177,318,271,1766,36891
06-08-2014,23,12999,12011,5111,2352,32474,1132,310,273,1715,34189
07-08-2014,0,12229,10787,4945,2284,30245,1058,306,274,1638,31883
07-08-2014,1,11384,10630,4870,2248,29132,1025,304,260,1589,30721
07-08-2014,2,10902,10434,4843,2227,28408,1019,305,260,1584,29992
07-08-2014,3,11077,10278,4848,2177,28379,1010,321,260,1591,29970
07-08-2014,4,11098,10354,4913,2172,28538,1017,338,262,1617,30155
07-08-2014,5,11171,10787,5347,2156,29462,1070,389,274,1733,31195
07-08-2014,6,12837,11982,5919,2419,33158,1084,541,273,1898,35056
07-08-2014,7,13824,13808,6315,2797,36744,1144,833,267,2244,38988
07-08-2014,8,14602,15138,6629,2917,39285,1191,923,347,2461,41746
07-08-2014,9,14935,15400,6785,2971,40091,1139,931,398,2468,42559
07-08-2014,10,15105,15562,6910,3077,40655,1145,933,433,2511,43166
07-08-2014,11,15029,15692,6926,3059,40708,1152,860,465,2477,43185
07-08-2014,12,15097,15528,7012,2960,40597,1155,789,549,2493,43090
07-08-2014,13,15048,15393,7000,2890,40330,1188,726,558,2472,42802
07-08-2014,14,14951,15229,6889,2790,39859,1153,664,283,2100,41959
07-08-2014,15,14904,15048,6671,2651,39273,1167,642,276,2085,41358
07-08-2014,16,14853,15056,6397,2530,38835,1192,648,284,2124,40959
07-08-2014,17,14870,15050,6354,2435,38708,1174,638,390,2202,40910
07-08-2014,18,14697,14931,6196,2420,38245,1177,616,389,2182,40427
07-08-2014,19,14630,14738,5932,2150,37449,1189,419,285,1893,39342
07-08-2014,20,14426,14358,5728,2004,36516,1136,449,289,1874,38390
07-08-2014,21,14356,14128,5651,2054,36190,1082,372,301,1755,37945
07-08-2014,22,14312,13682,5394,2051,35439,1148,349,297,1794,37233
07-08-2014,23,13778,11940,5091,2084,32894,1162,361,301,1824,34718
08-08-2014,0,12607,10896,4991,1888,30382,1024,359,253,1636,32018
08-08-2014,1,12023,10603,4891,1938,29456,992,359,203,1554,31010
08-08-2014,2,11808,10565,4890,1883,29146,948,359,194,1501,30647
08-08-2014,3,11645,10503,4873,1955,28976,926,359,195,1480,30456
08-08-2014,4,11311,10586,4893,2043,28832,925,361,200,1486,30318
08-08-2014,5,11658,11073,5154,1835,29720,1037,366,237,1640,31360
08-08-2014,6,12440,13004,6099,1976,33519,1127,479,283,1889,35408
08-08-2014,7,13737,14793,6688,2227,37445,1142,735,438,2315,39760
08-08-2014,8,14478,15738,6990,2511,39718,1192,839,448,2479,42197
08-08-2014,9,14489,16005,7199,2738,40432,1229,913,451,2593,43025
08-08-2014,10,14692,16114,7207,2869,40882,1151,923,451,2525,43407
08-08-2014,11,14769,16239,7213,2976,41198,1151,928,445,2524,43722
08-08-2014,12,14917,15971,7151,2896,40936,1134,844,494,2472,43408
08-08-2014,13,14963,15715,6871,2881,40430,1103,796,475,2374,42804
08-08-2014,14,14623,15461,6395,2885,39364,1122,735,292,2149,41513
08-08-2014,15,14352,14662,6173,2831,38018,1122,657,306,2085,40103
08-08-2014,16,14201,14434,6120,2714,37470,1071,604,308,1983,39453
08-08-2014,17,14000,14530,6218,2633,37380,1054,618,461,2133,39513
08-08-2014,18,13899,14602,6121,2509,37131,1053,610,453,2116,39247
08-08-2014,19,13750,14609,6077,2447,36883,1041,431,306,1778,38661
08-08-2014,20,13388,14177,5590,2303,35458,1046,372,305,1723,37181
08-08-2014,21,13501,13570,5555,2243,34870,1037,372,302,1711,36581
08-08-2014,22,13164,13153,5393,2236,33947,1055,367,309,1731,35678
08-08-2014,23,12613,11772,4940,2323,31648,1040,349,309,1698,33346
09-08-2014,0,11904,10679,4679,2201,29464,971,341,301,1613,31077
09-08-2014,1,10970,10215,4560,2062,27807,944,340,278,1562,29369
09-08-2014,2,10052,10050,4564,2315,26981,947,340,270,1557,28538
09-08-2014,3,9613,9951,4513,2576,26652,948,341,269,1558,28210
09-08-2014,4,8876,9931,4490,2859,26156,958,343,265,1566,27722
09-08-2014,5,8644,9909,4467,2991,26011,932,343,278,1553,27564
09-08-2014,6,8848,9981,4506,3083,26417,937,346,284,1567,27984
09-08-2014,7,10231,10316,4648,3491,28686,1038,346,278,1662,30348
09-08-2014,8,11374,10946,4918,3913,31151,1050,348,276,1674,32825
09-08-2014,9,11910,11664,5133,4290,32998,1049,349,275,1673,34671
09-08-2014,10,12190,11928,5169,4550,33835,1045,351,357,1753,35588
09-08-2014,11,12355,11958,5114,4440,33867,1047,353,364,1764,35631
09-08-2014,12,11811,12095,5176,4238,33322,1046,350,349,1745,35067
09-08-2014,13,11521,12206,5090,4319,33135,1045,349,317,1711,34846
09-08-2014,14,11471,12191,5052,4353,33066,1045,351,328,1724,34790
09-08-2014,15,11697,11981,5153,4669,33499,1049,352,308,1709,35208
09-08-2014,16,11637,12140,5198,4773,33747,1047,351,282,1680,35427
09-08-2014,17,11657,12313,5123,4879,33972,1045,351,271,1667,35639
09-08-2014,18,12079,12311,5070,4821,34281,1041,350,259,1650,35931
09-08-2014,19,12397,12490,5007,4449,34343,1041,348,256,1645,35988
09-08-2014,20,12608,12431,4943,3921,33902,1038,348,257,1643,35545
09-08-2014,21,12891,12804,5172,3555,34423,1031,349,273,1653,36076
09-08-2014,22,12706,12910,5082,3254,33952,1024,345,270,1639,35591
09-08-2014,23,11793,11879,4776,2827,31275,961,344,269,1574,32849
10-08-2014,0,10713,11212,4559,2293,28777,850,344,269,1463,30240
10-08-2014,1,10282,10925,4520,2260,27987,793,346,259,1398,29385
10-08-2014,2,9861,10770,4493,2507,27630,793,347,254,1394,29024
10-08-2014,3,9660,10726,4418,2240,27045,833,346,253,1432,28477
10-08-2014,4,9097,10635,4415,1968,26115,829,348,267,1444,27559
10-08-2014,5,8856,10557,4397,1859,25669,801,345,276,1422,27091
10-08-2014,6,8782,10531,4384,2011,25710,817,342,301,1460,27170
10-08-2014,7,9969,10539,4570,2262,27340,938,346,289,1573,28913
10-08-2014,8,11435,10818,4881,2515,29648,992,349,276,1617,31265
10-08-2014,9,12752,11635,5130,2853,32371,974,348,272,1594,33965
10-08-2014,10,13024,11865,5298,3074,33259,953,347,272,1572,34831
10-08-2014,11,13004,12017,5450,3343,33813,966,345,275,1586,35399
10-08-2014,12,12673,12149,5370,3698,33891,1012,344,281,1637,35528
10-08-2014,13,12006,12102,5328,3806,33240,1026,344,284,1654,34894
10-08-2014,14,11734,12001,5327,4215,33277,1033,346,285,1664,34941
10-08-2014,15,11587,11972,5354,4434,33346,1027,345,286,1658,35004
10-08-2014,16,11445,11952,5403,4565,33365,1024,345,285,1654,35019
10-08-2014,17,11685,12074,5398,4554,33712,1029,344,279,1652,35364
10-08-2014,18,11698,12357,5382,4503,33938,1015,343,274,1632,35570
10-08-2014,19,11681,12429,5495,4551,34158,995,344,270,1609,35767
10-08-2014,20,11844,12194,5418,4486,33944,990,344,269,1603,35547
10-08-2014,21,11886,12192,5758,4545,34381,984,344,268,1596,35977
10-08-2014,22,10830,11922,5424,4425,32601,973,342,267,1582,34183
10-08-2014,23,10086,11307,5075,4077,30545,912,339,267,1518,32063
11-08-2014,0,9210,11046,4918,3807,28980,1008,339,259,1606,30586
11-08-2014,1,8394,10917,4823,3789,27922,1020,340,242,1602,29524
11-08-2014,2,8365,10900,4839,3685,27790,929,340,247,1516,29306
11-08-2014,3,8487,10914,4849,3510,27760,877,341,271,1489,29249
11-08-2014,4,8448,10981,4869,3610,27909,847,345,299,1491,29400
11-08-2014,5,9342,11318,5099,3555,29315,1048,355,356,1759,31074
11-08-2014,6,11765,12242,5716,3596,33320,1175,450,415,2040,35360
11-08-2014,7,14159,14055,6356,3862,38432,1231,549,656,2436,40868
11-08-2014,8,15012,15292,6693,4379,41376,1235,807,657,2699,44075
11-08-2014,9,14320,15430,6818,4950,41520,1243,872,642,2757,44277
11-08-2014,10,13896,15597,6854,5222,41569,1257,873,613,2743,44312
11-08-2014,11,13607,15445,6864,5270,41186,1266,841,629,2736,43922
11-08-2014,12,13662,15299,6924,5342,41228,1264,763,783,2810,44038
11-08-2014,13,13686,15376,6851,5378,41293,1268,803,626,2697,43990
11-08-2014,14,13479,15459,6450,5269,40657,1291,611,521,2423,43080
11-08-2014,15,13448,15319,6162,5137,40065,1276,676,543,2495,42560
11-08-2014,16,13363,14947,6009,5004,39324,1272,644,519,2435,41759
11-08-2014,17,13879,15259,5999,5079,40217,1280,636,580,2496,42713
11-08-2014,18,14446,15422,5950,4720,40539,1284,586,566,2436,42975
11-08-2014,19,14393,15947,5708,4371,40421,1281,392,478,2151,42572
11-08-2014,20,14393,15853,5542,3812,39601,1264,361,436,2061,41662
11-08-2014,21,14652,15967,5543,3317,39477,1249,358,297,1904,41381
11-08-2014,22,14086,14294,5418,3356,37155,1151,353,301,1805,38960
11-08-2014,23,11859,12286,5306,3354,32804,1136,343,290,1769,34573
12-08-2014,0,11062,10913,5192,2977,30145,1146,345,289,1780,31925
12-08-2014,1,9933,10814,5091,2941,28779,1023,343,271,1637,30416
12-08-2014,2,9429,10786,5137,2921,28273,997,345,278,1620,29893
12-08-2014,3,9329,10823,5185,2939,28276,991,345,279,1615,29891
12-08-2014,4,9727,10795,5257,2877,28656,1032,345,279,1656,30312
12-08-2014,5,10464,11085,5593,3062,30204,1048,348,305,1701,31905
12-08-2014,6,12636,13163,5819,3599,35217,1246,357,351,1954,37171
12-08-2014,7,14582,15170,6395,3670,39816,1367,749,489,2605,42421
12-08-2014,8,15007,15911,6785,3900,41603,1362,826,527,2715,44318
12-08-2014,9,15182,15591,6928,3983,41684,1374,871,484,2729,44413
12-08-2014,10,15347,15208,6933,4077,41566,1385,861,486,2732,44298
12-08-2014,11,15213,15158,6947,4263,41581,1401,816,484,2701,44282
12-08-2014,12,14364,14985,6838,4117,40304,1384,828,521,2733,43037
12-08-2014,13,13953,14631,6594,4472,39650,1450,792,524,2766,42416
12-08-2014,14,13885,14877,6297,4256,39313,1437,600,486,2523,41836
12-08-2014,15,13642,14943,6182,4008,38775,1446,547,472,2465,41240
12-08-2014,16,14056,14768,6071,3863,38760,1441,392,458,2291,41051
12-08-2014,17,14667,14612,5977,3920,39175,1442,535,451,2428,41603
12-08-2014,18,14929,14923,5936,3653,39442,1434,541,444,2419,41861
12-08-2014,19,15118,14991,5878,3448,39435,1426,363,354,2143,41578
12-08-2014,20,15093,14741,5835,3157,38826,1427,357,400,2184,41010
12-08-2014,21,14960,15182,5890,3072,39105,1393,360,350,2103,41208
12-08-2014,22,14475,13989,5593,2871,36930,1305,361,320,1986,38916
12-08-2014,23,13313,12068,5351,2580,33313,1220,359,278,1857,35170
13-08-2014,0,11391,11202,5191,2411,30195,1125,349,277,1751,31946
13-08-2014,1,10196,11052,5163,2517,28927,1125,349,263,1737,30664
13-08-2014,2,9493,10865,5159,2571,28089,1098,345,273,1716,29805
13-08-2014,3,9493,10723,5194,2529,27938,1085,345,282,1712,29650
13-08-2014,4,9786,10699,5240,2468,28194,1025,346,294,1665,29859
13-08-2014,5,11381,11134,5402,2440,30356,1058,351,318,1727,32083
13-08-2014,6,13322,12866,5905,2922,35015,1235,357,308,1900,36915
13-08-2014,7,14892,15232,6580,3160,39865,1279,486,497,2262,42127
13-08-2014,8,15219,16101,6827,3460,41608,1325,796,501,2622,44230
13-08-2014,9,15357,15894,6794,3777,41823,1313,816,504,2633,44456
13-08-2014,10,15691,15784,6824,3888,42186,1323,823,503,2649,44835
13-08-2014,11,15786,15936,6813,4204,42739,1332,821,501,2654,45393
13-08-2014,12,15557,16111,6822,4186,42678,1354,830,549,2733,45411
13-08-2014,13,15686,15981,6656,3944,42268,1360,768,513,2641,44909
13-08-2014,14,15795,15915,6473,3736,41921,1377,436,466,2279,44200
13-08-2014,15,15419,15895,6437,3808,41561,1404,370,453,2227,43788
13-08-2014,16,15375,15748,6377,3556,41057,1339,367,417,2123,43180
13-08-2014,17,15442,16142,6428,3486,41497,1292,589,421,2302,43799
13-08-2014,18,15243,16110,6390,3242,40985,1279,561,428,2268,43253
13-08-2014,19,15167,15777,6266,3063,40272,1313,390,268,1971,42243
13-08-2014,20,15014,15044,6172,2803,39033,1317,349,307,1973,41006
13-08-2014,21,15087,14792,6124,2692,38693,1308,355,349,2012,40705
13-08-2014,22,14590,13334,5886,2439,36250,1157,359,357,1873,38123
13-08-2014,23,13296,11902,5778,2138,33114,1153,361,361,1875,34989
14-08-2014,0,12036,10928,5702,2048,30715,1010,363,333,1706,32421
14-08-2014,1,10868,10600,5650,2077,29194,944,364,302,1610,30804
14-08-2014,2,10457,10436,5608,2193,28694,960,358,278,1596,30290
14-08-2014,3,10355,10451,5579,2468,28851,957,345,264,1566,30417
14-08-2014,4,10175,10796,5604,2606,29182,981,346,275,1602,30784
14-08-2014,5,11351,11123,5717,2679,30870,1143,353,316,1812,32682
14-08-2014,6,12872,12527,6010,2803,34214,1267,368,452,2087,36301
14-08-2014,7,14275,14566,6415,3003,38259,1342,527,505,2374,40633
14-08-2014,8,14886,15678,6604,3182,40351,1347,804,504,2655,43006
14-08-2014,9,14910,15326,6682,3501,40418,1353,870,497,2720,43138
14-08-2014,10,15207,15281,6689,3973,41150,1287,889,503,2679,43829
14-08-2014,11,15191,15413,6795,4103,41503,1325,817,516,2658,44161
14-08-2014,12,14966,15261,6780,4143,41150,1353,814,533,2700,43850
14-08-2014,13,14850,15140,6753,4086,40830,1331,702,562,2595,43425
14-08-2014,14,14754,14887,6594,4096,40331,1291,365,497,2153,42484
14-08-2014,15,14622,14681,6523,3934,39761,1273,354,513,2140,41901
14-08-2014,16,14809,14516,6469,3834,39628,1272,362,449,2083,41711
14-08-2014,17,14977,14688,6384,3617,39666,1274,420,682,2376,42042
14-08-2014,18,14859,15497,6285,3424,40066,1265,544,489,2298,42364
14-08-2014,19,14860,15693,6199,2981,39733,1251,368,355,1974,41707
14-08-2014,20,14702,16053,6114,2637,39508,1247,346,306,1899,41407
14-08-2014,21,14689,15921,6081,2662,39353,1245,345,411,2001,41354
14-08-2014,22,14189,14380,5782,2553,36904,1255,342,320,1917,38821
14-08-2014,23,13441,12123,5519,2338,33420,1205,339,304,1848,35268
15-08-2014,0,12128,10883,5444,2139,30593,998,340,274,1612,32205
15-08-2014,1,11494,10532,5444,2034,29504,943,341,242,1526,31030
15-08-2014,2,11271,10457,5447,1950,29126,897,342,235,1474,30600
15-08-2014,3,11267,10469,5414,1944,29096,909,344,231,1484,30580
15-08-2014,4,11356,10515,5447,1948,29266,949,343,245,1537,30803
15-08-2014,5,11824,11190,5602,1984,30601,1012,346,290,1648,32249
15-08-2014,6,13072,12718,6049,2193,34031,1235,351,281,1867,35898
15-08-2014,7,14800,14529,6492,2295,38115,1232,370,461,2063,40178
15-08-2014,8,15540,15333,6701,2409,39983,1221,561,460,2242,42225
15-08-2014,9,15665,15626,6801,2544,40637,1224,684,464,2372,43009
15-08-2014,10,15678,15823,6914,2682,41097,1227,682,479,2388,43485
15-08-2014,11,15633,15764,7056,2807,41261,1230,579,491,2300,43561
15-08-2014,12,15307,15439,6868,2791,40405,1242,489,668,2399,42804
15-08-2014,13,15220,15098,6651,2780,39747,1233,634,504,2371,42118
15-08-2014,14,15156,14462,6457,2861,38935,1238,440,447,2125,41060
15-08-2014,15,15404,13701,6399,2865,38370,1247,405,412,2064,40434
15-08-2014,16,15664,13074,6142,2875,37754,1232,401,387,2020,39774
15-08-2014,17,15817,12878,6078,3025,37798,1234,430,466,2130,39928
15-08-2014,18,15714,12800,6020,2968,37501,1227,423,464,2114,39615
15-08-2014,19,15729,13152,6175,2920,37975,1159,421,353,1933,39908
15-08-2014,20,15678,13374,6053,2747,37852,1166,380,366,1912,39764
15-08-2014,21,15516,13040,5986,2888,37430,1157,363,363,1883,39313
15-08-2014,22,14728,11740,5633,3009,35110,1083,351,281,1715,36825
15-08-2014,23,13823,10355,5504,2937,32617,969,346,287,1602,34219
16-08-2014,0,12326,9554,5496,2773,30148,899,345,273,1517,31665
16-08-2014,1,11040,9454,5417,2992,28904,905,346,257,1508,30412
16-08-2014,2,10385,9399,5446,3053,28285,890,346,257,1493,29778
16-08-2014,3,10147,9317,5510,3128,28103,892,346,246,1484,29587
16-08-2014,4,10068,9285,5491,3107,27952,895,347,241,1483,29435
16-08-2014,5,9950,9258,5526,3271,28004,878,344,251,1473,29477
16-08-2014,6,10635,9409,5549,3104,28698,913,345,285,1543,30241
16-08-2014,7,12716,10068,5658,3406,31847,957,347,265,1569,33416
16-08-2014,8,13694,11107,5657,3802,34261,989,350,268,1607,35868
16-08-2014,9,14301,11422,5828,4071,35621,997,348,279,1624,37245
16-08-2014,10,14160,11754,5876,4365,36155,1001,349,283,1633,37788
16-08-2014,11,13916,11692,5777,4536,35923,996,352,295,1643,37566
16-08-2014,12,13693,11562,5647,4593,35494,999,348,281,1628,37122
16-08-2014,13,13412,11445,5681,4546,35084,997,348,274,1619,36703
16-08-2014,14,12964,11222,5724,4229,34139,996,355,275,1626,35765
16-08-2014,15,13026,11048,5596,4414,34084,992,354,286,1632,35716
16-08-2014,16,12956,11177,5657,4405,34195,990,352,296,1638,35833
16-08-2014,17,13289,11317,5680,4413,34699,986,353,297,1636,36335
16-08-2014,18,14007,11245,5673,4291,35215,964,349,290,1603,36818
16-08-2014,19,14052,11138,5740,3815,34746,961,348,289,1598,36344
16-08-2014,20,14555,11078,5637,3464,34735,965,346,292,1603,36338
16-08-2014,21,14685,11167,5796,3347,34996,971,347,319,1637,36633
16-08-2014,22,13438,11010,5827,2987,33263,960,347,311,1618,34881
16-08-2014,23,12308,10249,5296,3094,30948,949,344,432,1725,32673
17-08-2014,0,11691,9718,4999,2950,29358,786,350,324,1460,30818
17-08-2014,1,10652,9534,4878,3020,28083,762,349,289,1400,29483
17-08-2014,2,9491,9409,4811,3191,26903,749,348,288,1385,28288
17-08-2014,3,9365,9458,4764,3272,26860,756,350,282,1388,28248
17-08-2014,4,9189,9450,4743,3318,26700,770,351,273,1394,28094
17-08-2014,5,9452,9475,4801,3410,27138,814,349,275,1438,28576
17-08-2014,6,9756,9650,4854,3529,27788,763,349,308,1420,29208
17-08-2014,7,10135,9928,5052,3567,28682,803,348,320,1471,30153
17-08-2014,8,11313,10473,5395,3546,30727,699,351,329,1379,32106
17-08-2014,9,12156,11314,5681,3683,32835,719,359,335,1413,34248
17-08-2014,10,13255,11743,5857,3559,34415,744,365,320,1429,35844
17-08-2014,11,13759,11988,5874,3869,35490,757,367,303,1427,36917
17-08-2014,12,13588,12261,5859,3666,35376,764,366,321,1451,36827
17-08-2014,13,13203,12327,5880,3578,34989,744,369,331,1444,36433
17-08-2014,14,13083,12423,5826,3586,34919,736,367,317,1420,36339
17-08-2014,15,13155,12246,5841,3554,34797,757,360,344,1461,36258
17-08-2014,16,13167,12244,5715,3701,34827,769,366,470,1605,36432
17-08-2014,17,13471,12525,5700,4058,35754,837,362,439,1638,37392
17-08-2014,18,13580,12501,5864,3908,35854,841,368,340,1549,37403
17-08-2014,19,13497,12281,5926,3845,35549,843,369,318,1530,37079
17-08-2014,20,13681,12097,5950,3715,35443,854,429,316,1599,37042
17-08-2014,21,13807,12093,5773,3493,35165,837,548,331,1716,36881
17-08-2014,22,13363,11530,5399,3464,33756,846,359,355,1560,35316
17-08-2014,23,12139,10729,5072,3520,31462,769,358,352,1479,32941
18-08-2014,0,10616,10121,4919,3311,28966,899,363,357,1619,30585
18-08-2014,1,9675,9951,4919,3286,27831,1046,360,372,1778,29609
18-08-2014,2,9439,9880,4856,3154,27328,1063,359,389,1811,29139
18-08-2014,3,9384,9892,4872,3105,27254,1058,364,391,1813,29067
18-08-2014,4,9499,9961,5016,3120,27597,1072,369,385,1826,29423
18-08-2014,5,10738,10290,5390,3199,29618,1110,372,396,1878,31496
18-08-2014,6,13226,11459,6130,3189,34004,1229,386,388,2003,36007
18-08-2014,7,15447,14395,6714,3477,40031,1325,507,468,2300,42331
18-08-2014,8,15951,15194,7046,3696,41886,1291,612,566,2469,44355
18-08-2014,9,16009,14006,7141,3642,40797,1375,656,579,2610,43407
18-08-2014,10,15611,14574,7188,3610,40982,1391,666,641,2698,43680
18-08-2014,11,15396,14676,7228,3664,40965,1392,653,646,2691,43656
18-08-2014,12,15165,14655,7179,3651,40651,1380,645,643,2668,43319
18-08-2014,13,15054,14718,7044,3860,40677,1395,645,646,2686,43363
18-08-2014,14,14805,14591,6679,4081,40156,1401,566,529,2496,42652
18-08-2014,15,14619,14320,6457,4500,39896,1372,510,544,2426,42322
18-08-2014,16,13985,14331,6277,4532,39124,1356,464,473,2293,41417
18-08-2014,17,14035,14113,6663,4536,39347,1340,433,602,2375,41722
18-08-2014,18,14063,13767,6101,4618,38550,1337,413,608,2358,40908
18-08-2014,19,14344,13329,6010,4757,38439,1315,375,502,2192,40631
18-08-2014,20,14756,12966,5874,4992,38588,1293,362,565,2220,40808
18-08-2014,21,14829,12691,5813,5033,38365,1296,367,419,2082,40447
18-08-2014,22,13747,11846,5361,4730,35684,1209,361,367,1937,37621
18-08-2014,23,11968,10568,5105,4344,31987,1178,361,380,1919,33906
19-08-2014,0,10862,10066,5093,4242,30261,1145,358,401,1904,32165
19-08-2014,1,9892,10026,5108,4287,29312,1159,355,406,1920,31232
19-08-2014,2,9338,10017,5027,4245,28626,1166,363,419,1948,30574
19-08-2014,3,9193,10125,4996,4232,28546,1155,364,452,1971,30517
19-08-2014,4,9476,10120,5047,4091,28735,1146,378,463,1987,30722
19-08-2014,5,10783,10305,5321,4278,30687,1190,374,473,2037,32724
19-08-2014,6,12916,11873,5881,4614,35284,1314,378,464,2156,37440
19-08-2014,7,14357,13800,6606,4791,39555,1399,473,537,2409,41964
19-08-2014,8,14948,14813,6836,5165,41762,1417,495,614,2526,44288
19-08-2014,9,14582,14513,6858,5460,41413,1419,512,607,2538,43951
19-08-2014,10,14479,14612,6899,5523,41514,1435,523,650,2608,44122
19-08-2014,11,14371,14777,6923,5664,41737,1446,524,662,2632,44369
19-08-2014,12,14056,14862,6951,5614,41482,1446,574,637,2657,44139
19-08-2014,13,13475,14982,6880,5404,40741,1455,557,632,2644,43385
19-08-2014,14,13202,15122,6592,5244,40160,1424,568,526,2518,42678
19-08-2014,15,13101,14912,6490,4959,39460,1385,546,505,2436,41896
19-08-2014,16,13163,14453,6306,4939,38862,1355,453,545,2353,41215
19-08-2014,17,14706,14010,6205,4634,39556,1273,411,577,2261,41817
19-08-2014,18,15627,13902,6231,4164,39924,1250,401,553,2204,42128
19-08-2014,19,15636,13955,6273,4013,39878,1228,382,487,2097,41975
19-08-2014,20,15540,13783,6147,4023,39494,1228,376,494,2098,41592
19-08-2014,21,15728,13839,6013,3891,39472,1243,367,433,2043,41515
19-08-2014,22,14420,12460,5661,4011,36553,1138,365,335,1838,38391
19-08-2014,23,12385,11300,5357,3737,32779,1131,360,361,1852,34631
20-08-2014,0,10931,10502,5327,3818,30578,1084,360,376,1820,32398
20-08-2014,1,10135,10351,5249,3813,29548,1065,365,392,1822,31370
20-08-2014,2,10109,10279,5221,3677,29287,1064,360,383,1807,31094
20-08-2014,3,9917,10277,5217,3686,29096,1102,359,391,1852,30948
20-08-2014,4,10125,10274,5229,3724,29352,1114,367,408,1889,31241
20-08-2014,5,10838,10964,5477,3826,31105,1116,368,413,1897,33002
20-08-2014,6,11947,12863,5989,4047,34846,1274,371,424,2069,36915
20-08-2014,7,13816,14400,6674,4533,39424,1284,472,530,2286,41710
20-08-2014,8,14403,15515,6773,4608,41299,1290,631,663,2584,43883
20-08-2014,9,14412,15642,6826,4945,41824,1293,754,639,2686,44510
20-08-2014,10,14316,15526,6859,5231,41932,1311,657,673,2641,44573
20-08-2014,11,14092,15400,6819,5265,41576,1339,655,627,2621,44197
20-08-2014,12,14028,15463,6749,5217,41459,1336,651,640,2627,44086
20-08-2014,13,13703,15524,6693,5352,41272,1337,618,663,2618,43890
20-08-2014,14,13555,15419,6568,5306,40850,1334,558,534,2426,43276
20-08-2014,15,13431,15411,6477,5307,40626,1357,483,533,2373,42999
20-08-2014,16,13306,15112,6398,5208,40024,1368,422,572,2362,42386
20-08-2014,17,13563,15586,6351,5015,40515,1321,352,700,2373,42888
20-08-2014,18,13697,16014,6450,4870,41031,1339,399,613,2351,43382
20-08-2014,19,13764,16146,6517,4441,40870,1335,373,550,2258,43128
20-08-2014,20,13987,15966,6502,4046,40502,1330,371,592,2293,42795
20-08-2014,21,14270,15505,6313,3808,39897,1347,276,537,2160,42057
20-08-2014,22,13686,14263,5895,3683,37527,1332,220,455,2007,39534
20-08-2014,23,12489,12135,5489,3535,33650,1191,202,414,1807,35457
21-08-2014,0,10915,11347,5344,3392,30997,1175,193,411,1779,32776
21-08-2014,1,10242,11002,5363,3297,29905,1197,189,413,1799,31704
21-08-2014,2,10336,10912,5286,3163,29697,1166,185,390,1741,31438
21-08-2014,3,10301,11019,5317,3087,29725,1150,182,391,1723,31448
21-08-2014,4,10428,11207,5414,3110,30160,1144,181,366,1691,31851
21-08-2014,5,11319,12004,5564,3271,32158,1158,219,353,1730,33888
21-08-2014,6,13333,13868,6178,3182,36561,1293,470,348,2111,38672
21-08-2014,7,14686,16096,6832,3421,41036,1315,536,444,2295,43331
21-08-2014,8,14774,17235,7041,3606,42656,1320,591,535,2446,45102
21-08-2014,9,14558,16714,7029,3693,41994,1351,574,715,2640,44634
21-08-2014,10,14913,16415,7072,3773,42172,1361,619,631,2611,44783
21-08-2014,11,14977,16038,7055,3848,41918,1355,625,648,2628,44546
21-08-2014,12,14938,15950,7000,3766,41653,1309,631,669,2609,44262
21-08-2014,13,14895,15821,6906,3839,41461,1313,590,664,2567,44028
21-08-2014,14,14931,15673,6689,3763,41056,1289,493,593,2375,43431
21-08-2014,15,14639,15446,6572,3818,40476,1287,432,654,2373,42849
21-08-2014,16,14677,15206,6397,3726,40007,1252,408,563,2223,42230
21-08-2014,17,14731,15261,6357,3527,39875,1236,371,677,2284,42159
21-08-2014,18,15352,15652,6447,3396,40848,1205,366,654,2225,43073
21-08-2014,19,15168,15852,6605,3059,40683,1194,367,496,2057,42740
21-08-2014,20,14967,15863,6629,2791,40250,1197,391,519,2107,42357
21-08-2014,21,15076,15740,6536,2705,40057,1221,308,447,1976,42033
21-08-2014,22,14358,14087,6245,2821,37511,1226,182,343,1751,39262
21-08-2014,23,13689,11891,5807,2488,33876,1103,283,347,1733,35609
22-08-2014,0,12322,10941,5553,2367,31182,1078,170,340,1588,32770
22-08-2014,1,10908,10565,5449,2543,29464,1083,166,348,1597,31061
22-08-2014,2,10335,10436,5481,2360,28614,1057,167,346,1570,30184
22-08-2014,3,10121,10481,5449,2495,28546,1045,171,361,1577,30123
22-08-2014,4,10268,10652,5533,2587,29039,1067,172,353,1592,30631
22-08-2014,5,11539,11509,5760,2501,31309,1108,194,341,1643,32952
22-08-2014,6,13396,13372,6416,3114,36299,1288,404,436,2128,38427
22-08-2014,7,15100,15827,7130,3325,41384,1321,443,472,2236,43620
22-08-2014,8,15627,16634,7476,3438,43176,1336,548,536,2420,45596
22-08-2014,9,15359,16293,7326,3640,42618,1347,562,513,2422,45040
22-08-2014,10,15436,15955,7284,3681,42356,1371,645,602,2618,44974
22-08-2014,11,15244,15880,7180,3819,42125,1392,636,614,2642,44767
22-08-2014,12,14871,15698,7038,3878,41487,1395,666,619,2680,44167
22-08-2014,13,14397,15125,6789,3688,39999,1412,648,611,2671,42670
22-08-2014,14,14385,14562,6541,3480,38968,1410,561,511,2482,41450
22-08-2014,15,14284,14039,6375,3508,38206,1385,495,496,2376,40582
22-08-2014,16,14526,13838,6275,3689,38327,1374,477,440,2291,40618
22-08-2014,17,15270,13568,6273,3761,38872,1353,397,600,2350,41222
22-08-2014,18,15560,13920,6227,3693,39400,1322,374,575,2271,41671
22-08-2014,19,15604,14485,6164,3432,39685,1308,370,435,2113,41798
22-08-2014,20,15527,14516,6072,3313,39428,1303,344,470,2117,41545
22-08-2014,21,15321,14097,6009,3378,38806,1280,348,424,2052,40858
22-08-2014,22,14897,12938,5799,3176,36810,1278,342,340,1960,38770
22-08-2014,23,13769,11570,5622,2962,33924,1143,223,349,1715,35639
23-08-2014,0,12308,10646,5400,2606,30960,893,176,327,1396,32356
23-08-2014,1,11274,10266,5195,2736,29471,857,173,333,1363,30834
23-08-2014,2,10905,10127,5134,2838,29004,853,171,344,1368,30372
23-08-2014,3,10787,10038,5173,2787,28785,850,172,352,1374,30159
23-08-2014,4,10849,10070,5235,2870,29023,862,172,333,1367,30390
23-08-2014,5,11153,10123,5297,2907,29480,908,181,339,1428,30908
23-08-2014,6,11489,10580,5404,2764,30237,901,259,339,1499,31736
23-08-2014,7,12648,11262,5587,3011,32508,892,272,333,1497,34005
23-08-2014,8,13569,12301,5837,3179,34887,888,431,327,1646,36533
23-08-2014,9,14131,13056,6005,3410,36603,904,,336,,
23-08-2014,10,14328,13658,6056,3659,37700,914,452,343,1709,39409
23-08-2014,11,13934,13587,6257,3769,37546,911,382,345,1638,39184
23-08-2014,12,13837,13137,6262,3826,37062,925,379,341,1645,38707
23-08-2014,13,13857,13053,6215,3939,37065,904,377,332,1613,38678
23-08-2014,14,13224,12952,6078,4004,36256,887,387,368,1642,37898
23-08-2014,15,13298,12716,6143,3920,36075,884,386,341,1611,37686
23-08-2014,16,13523,12886,6223,3728,36362,908,373,330,1611,37973
23-08-2014,17,13998,13025,6147,3676,36846,964,372,303,1639,38485
23-08-2014,18,14975,13132,6161,3576,37845,989,315,333,1637,39482
23-08-2014,19,14984,13270,6143,3341,37738,985,342,317,1644,39382
23-08-2014,20,14795,13400,6271,3288,37752,979,360,333,1672,39424
23-08-2014,21,14717,12927,6200,3297,37142,989,287,301,1577,38719
23-08-2014,22,14335,12331,6036,3219,35922,972,239,285,1496,37418
23-08-2014,23,13663,11240,5698,3103,33704,950,220,289,1459,35163
24-08-2014,0,11744,10448,5425,2954,30571,859,168,294,1321,31892
24-08-2014,1,10790,10232,5220,2902,29143,829,167,291,1287,30430
24-08-2014,2,10345,10180,5147,3016,28688,833,169,289,1291,29979
24-08-2014,3,10146,10148,5149,3072,28515,841,169,290,1300,29815
24-08-2014,4,9951,10106,5142,3152,28352,868,171,291,1330,29682
24-08-2014,5,9677,10135,5137,3187,28136,960,173,290,1423,29559
24-08-2014,6,9953,10247,5280,3247,28727,907,171,291,1369,30096
24-08-2014,7,10473,10611,5400,3229,29713,914,168,341,1423,31136
24-08-2014,8,11335,11351,5585,3529,31801,1071,170,459,1700,33501
24-08-2014,9,12431,11613,5705,3946,33696,1104,170,457,1731,35427
24-08-2014,10,13338,11973,5778,4471,35562,1156,174,459,1789,37351
24-08-2014,11,13217,12131,5853,4673,35874,1163,171,460,1794,37668
24-08-2014,12,12870,12205,5979,4560,35615,1118,172,464,1754,37369
24-08-2014,13,12878,12069,5828,4473,35247,1084,171,477,1732,36979
24-08-2014,14,12924,11933,5890,4496,35242,1113,168,480,1761,37003
24-08-2014,15,12813,11987,5931,4487,35220,1113,167,479,1759,36979
24-08-2014,16,12922,11995,5969,4775,35662,1124,166,489,1779,37441
24-08-2014,17,13333,12188,5993,5029,36543,1118,166,493,1777,38320
24-08-2014,18,13540,12432,6128,4854,36954,1122,166,505,1793,38747
24-08-2014,19,14172,12784,6262,4536,37754,1117,183,512,1812,39566
24-08-2014,20,14602,13360,6233,4133,38328,1125,209,486,1820,40148
24-08-2014,21,15053,13510,6380,3809,38754,1128,164,469,1761,40515
24-08-2014,22,14597,12717,5921,3555,36789,1134,164,319,1617,38406
24-08-2014,23,13428,11670,5480,3284,33862,1106,164,321,1591,35453
25-08-2014,0,11166,11033,5321,2911,30431,1047,161,324,1532,31963
25-08-2014,1,10641,10535,5281,2895,29351,1029,161,326,1516,30867
25-08-2014,2,10435,10476,5306,2911,29129,1027,161,322,1510,30639
25-08-2014,3,10431,10465,5342,2931,29169,1036,163,320,1519,30688
25-08-2014,4,10717,10610,5357,2929,29612,1050,165,317,1532,31144
25-08-2014,5,11756,11284,5707,2977,31724,1070,173,328,1571,33295
25-08-2014,6,14222,13476,6448,3669,37815,1195,294,447,1936,39751
25-08-2014,7,15455,16181,7100,3792,42529,1232,434,504,2170,44699
25-08-2014,8,15817,16845,7321,3938,43921,1265,552,529,2346,46267
25-08-2014,9,15967,16525,7308,4063,43864,1203,616,519,2338,46202
25-08-2014,10,16189,16455,7314,4295,44252,1205,655,614,2474,46726
25-08-2014,11,15980,16589,7450,4372,44391,1197,647,572,2416,46807
25-08-2014,12,15617,16268,7386,4252,43523,1218,628,646,2492,46015
25-08-2014,13,15612,15848,7250,4208,42919,1236,592,609,2437,45356
25-08-2014,14,15644,15523,7036,4207,42409,1249,562,457,2268,44677
25-08-2014,15,15706,15495,6961,3880,42043,1247,476,513,2236,44279
25-08-2014,16,15418,15704,6981,3651,41754,1252,445,471,2168,43922
25-08-2014,17,15301,16152,7000,3543,41996,1258,442,557,2257,44253
25-08-2014,18,15156,16231,7000,3433,41821,1257,397,534,2188,44009
25-08-2014,19,15242,16469,7091,3206,42007,1247,373,506,2126,44133
25-08-2014,20,15340,16491,7104,3025,41959,1252,370,597,2219,44178
25-08-2014,21,15170,15922,6981,2923,40996,1239,362,415,2016,43012
25-08-2014,22,14397,13568,6561,2770,37296,1205,298,401,1904,39200
25-08-2014,23,13796,12086,6018,2412,34312,1087,183,405,1675,35987
26-08-2014,0,12239,11101,5662,1947,30949,999,176,395,1570,32519
26-08-2014,1,11899,10483,5515,1853,29749,996,174,373,1543,31292
26-08-2014,2,11674,10394,5467,1796,29332,998,172,361,1531,30863
26-08-2014,3,11713,10448,5440,1734,29335,992,173,358,1523,30858
26-08-2014,4,11989,10719,5488,1618,29816,993,174,347,1514,31330
26-08-2014,5,12834,11538,5826,1938,32135,1033,174,332,1539,33674
26-08-2014,6,14158,13836,6315,2143,36451,1186,327,441,1954,38405
26-08-2014,7,15498,15883,7149,2467,40997,1258,457,507,2222,43219
26-08-2014,8,15712,16774,7495,2856,42837,1255,519,555,2329,45166
26-08-2014,9,15502,16916,7525,2984,42927,1284,492,526,2302,45229
26-08-2014,10,15414,16888,7587,3081,42971,1297,489,527,2313,45284
26-08-2014,11,15175,16770,7452,3120,42516,1305,494,536,2335,44851
26-08-2014,12,15345,17062,7426,3042,42876,1304,413,617,2334,45210
26-08-2014,13,15263,16692,7450,3050,42455,1276,391,725,2392,44847
26-08-2014,14,15021,16656,7336,3110,42122,1301,409,582,2292,44414
26-08-2014,15,14796,16409,7279,3076,41560,1279,425,547,2251,43811
26-08-2014,16,14760,16309,7251,3036,41357,1226,361,576,2163,43520
26-08-2014,17,14810,16300,7175,2951,41236,1197,330,527,2054,43290
26-08-2014,18,14709,15891,7375,2813,40789,1201,377,517,2095,42884
26-08-2014,19,15014,15938,7338,2560,40849,1299,359,490,2148,42997
26-08-2014,20,14975,16416,7267,2394,41053,1290,361,573,2224,43277
26-08-2014,21,14876,15967,7248,2338,40430,1291,329,502,2122,42552
26-08-2014,22,13994,14462,6561,2279,37298,1227,217,366,1810,39108
26-08-2014,23,12696,12761,6041,1949,33447,1015,329,369,1713,35160
27-08-2014,0,11604,12336,5841,1493,31274,1077,183,375,1635,32909
27-08-2014,1,10313,12140,5624,1479,29555,1094,171,381,1646,31201
27-08-2014,2,9593,12105,5568,1502,28770,1104,175,375,1654,30424
27-08-2014,3,9570,12078,5536,1462,28645,1112,174,395,1681,30326
27-08-2014,4,10208,12236,5557,1542,29543,1119,170,384,1673,31216
27-08-2014,5,11604,12536,5698,1691,31528,1128,174,354,1656,33184
27-08-2014,6,13464,14391,6252,2190,36298,1267,200,519,1986,38284
27-08-2014,7,15152,16485,7043,2502,41183,1295,221,653,2169,43352
27-08-2014,8,15510,17739,7179,2743,43171,1277,376,761,2414,45585
27-08-2014,9,15667,17673,7266,2846,43452,1287,426,655,2368,45820
27-08-2014,10,15639,17588,7253,2941,43421,1293,401,664,2358,45779
27-08-2014,11,15476,17460,7242,2995,43173,1312,400,635,2347,45520
27-08-2014,12,15155,17048,7252,3011,42466,1310,397,692,2399,44865
27-08-2014,13,15254,16451,7053,3042,41800,1297,338,743,2378,44178
27-08-2014,14,15217,15928,6927,2968,41041,1313,301,742,2356,43397
27-08-2014,15,15007,15497,6798,3030,40332,1301,308,673,2282,42614
27-08-2014,16,14891,15360,6689,2917,39857,1284,218,693,2195,42052
27-08-2014,17,14904,15045,6670,3127,39746,1282,243,640,2165,41911
27-08-2014,18,15217,15137,6932,2957,40243,1280,261,620,2161,42404
27-08-2014,19,15717,15503,7101,2764,41087,1287,226,650,2163,43250
27-08-2014,20,15692,15317,6972,2630,40612,1325,287,618,2230,42842
27-08-2014,21,15738,15100,6830,2545,40215,1323,205,514,2042,42257
27-08-2014,22,15146,13828,6251,2459,37682,1270,194,398,1862,39544
27-08-2014,23,13092,12863,5878,1992,33825,1164,189,374,1727,35552
28-08-2014,0,10564,12307,5739,1979,30590,1121,193,383,1697,32287
28-08-2014,1,9420,11931,5640,2026,29018,1096,195,384,1675,30693
28-08-2014,2,9165,11667,5596,2081,28511,1099,190,382,1671,30182
28-08-2014,3,9160,11601,5568,1931,28261,1105,188,386,1679,29940
28-08-2014,4,9664,11618,5655,1922,28860,1120,190,384,1694,30554
28-08-2014,5,11428,12145,5847,2192,31612,1132,200,363,1695,33307
28-08-2014,6,13737,14190,6410,2461,36798,1284,312,459,2055,38853
28-08-2014,7,15393,16282,7271,2597,41543,1288,463,569,2320,43863
28-08-2014,8,15547,17180,7434,2829,42991,1276,505,596,2377,45368
28-08-2014,9,15581,16552,7369,2844,42345,1358,,556,,
28-08-2014,10,15632,16133,7308,2934,42005,1360,509,617,2486,44491
28-08-2014,11,15647,16171,7244,3012,42074,1327,406,635,2368,44442
28-08-2014,12,15241,15830,7244,2938,41253,1328,485,626,2439,43692
28-08-2014,13,15351,15682,7116,2946,41096,1305,391,638,2334,43430
28-08-2014,14,15214,15356,6757,2919,40246,1302,365,617,2284,42530
28-08-2014,15,15275,15216,6624,2873,39988,1258,373,588,2219,42207
28-08-2014,16,15273,15011,6592,2760,39636,1247,293,595,2135,41771
28-08-2014,17,15407,15314,6878,2707,40306,1243,290,574,2107,42413
28-08-2014,18,15531,15653,7045,2617,40847,1233,284,549,2066,42913
28-08-2014,19,15919,15573,7017,2551,41060,1290,295,549,2134,43194
28-08-2014,20,16236,15693,6914,2539,41380,1272,411,520,2203,43583
28-08-2014,21,15949,15065,6889,2777,40679,1290,272,505,2067,42746
28-08-2014,22,15112,13094,6362,2698,37265,1259,180,340,1779,39044
28-08-2014,23,13231,11608,5863,2375,33077,1096,178,317,1591,34668
29-08-2014,0,11112,10947,5563,2324,29948,1139,177,328,1644,31592
29-08-2014,1,10118,10618,5389,2371,28496,1137,175,340,1652,30148
29-08-2014,2,9738,10579,5361,2300,27978,1120,175,342,1637,29615
29-08-2014,3,9919,10547,5332,2268,28067,1120,173,338,1631,29698
29-08-2014,4,10436,10659,5338,2331,28764,1129,174,336,1639,30403
29-08-2014,5,11802,11197,5645,2388,31032,1155,278,335,1768,32800
29-08-2014,6,13767,12741,6355,2594,35458,1271,447,329,2047,37505
29-08-2014,7,16168,15409,7083,2947,41608,1324,454,412,2190,43798
29-08-2014,8,16529,16579,7318,2953,43380,1294,554,489,2337,45717
29-08-2014,9,16508,16187,7464,3043,43203,1184,560,514,2258,45461
29-08-2014,10,16727,15836,7404,3094,43060,1174,537,499,2210,45270
29-08-2014,11,16719,15749,7395,3065,42929,1191,464,536,2191,45120
29-08-2014,12,16502,15372,7322,2926,42123,1191,430,583,2204,44327
29-08-2014,13,16379,15098,7274,2767,41517,1192,411,627,2230,43747
29-08-2014,14,16107,14365,6885,2818,40174,1202,372,602,2176,42350
29-08-2014,15,15685,13715,6681,2703,38784,1192,366,544,2102,40886
29-08-2014,16,15315,13410,6654,2838,38218,1186,363,471,2020,40238
29-08-2014,17,15383,13874,6664,2842,38761,1185,381,444,2010,40771
29-08-2014,18,15536,14607,6709,2818,39669,1189,366,412,1967,41636
29-08-2014,19,15498,14697,6400,2700,39296,1191,348,479,2018,41314
29-08-2014,20,15613,14722,6244,2591,39170,1191,294,487,1972,41142
29-08-2014,21,15119,14006,6090,2517,37733,1174,238,442,1854,39587
29-08-2014,22,14636,12552,5894,2386,35467,1137,168,315,1620,37087
29-08-2014,23,13168,11659,5772,2154,32752,1126,167,292,1585,34337
30-08-2014,0,11830,10549,5449,1781,29609,922,166,288,1376,30985
30-08-2014,1,11173,10237,5421,1787,28617,921,166,286,1373,29990
30-08-2014,2,10818,10086,5366,1774,28044,939,166,285,1390,29434
30-08-2014,3,10606,10059,5418,1869,27953,934,166,286,1386,29339
30-08-2014,4,10597,10040,5458,1931,28027,921,166,287,1374,29401
30-08-2014,5,10587,10089,5473,2024,28173,934,167,289,1390,29563
30-08-2014,6,11199,10339,5478,1897,28914,943,247,293,1483,30397
30-08-2014,7,12534,10917,5742,1923,31116,929,341,299,1569,32685
30-08-2014,8,13721,11657,5982,2108,33468,923,360,301,1584,35052
30-08-2014,9,14270,12407,6060,2317,35055,931,,297,,
30-08-2014,10,14508,12765,5986,2533,35794,999,360,291,1650,37444
30-08-2014,11,14349,12738,6023,2616,35726,1005,350,291,1646,37372
30-08-2014,12,14161,12638,5998,2613,35410,947,343,292,1582,36992
30-08-2014,13,13828,12558,5927,2876,35189,934,343,290,1567,36756
30-08-2014,14,13631,12345,5940,2885,34801,936,343,288,1567,36368
30-08-2014,15,13670,12216,5993,2765,34644,953,344,290,1587,36231
30-08-2014,16,13880,12249,5986,2792,34908,1001,343,291,1635,36543
30-08-2014,17,14379,12443,5981,2696,35498,1006,343,305,1654,37152
30-08-2014,18,14644,12506,6052,2430,35633,989,345,316,1650,37283
30-08-2014,19,14921,12357,6049,2316,35642,992,329,320,1641,37283
30-08-2014,20,15115,12639,6117,2349,36220,1005,313,345,1663,37883
30-08-2014,21,14633,12100,6035,2101,34870,1002,207,338,1547,36417
30-08-2014,22,13905,11679,5945,1908,33437,952,170,325,1447,34884
30-08-2014,23,12893,11163,5717,1587,31361,948,168,314,1430,32791
31-08-2014,0,12269,10699,5460,1539,29968,770,167,307,1244,31212
31-08-2014,1,11593,10473,5430,1556,29053,762,166,301,1229,30282
31-08-2014,2,11189,10405,5433,1608,28635,758,167,274,1199,29834
31-08-2014,3,10949,10414,5412,1557,28333,767,167,285,1219,29552
31-08-2014,4,10728,10431,5385,1479,28024,775,168,273,1216,29240
31-08-2014,5,10559,10487,5409,1510,27966,801,180,298,1279,29245
31-08-2014,6,10962,10496,5486,1523,28465,787,264,308,1359,29824
31-08-2014,7,11597,10762,5572,1593,29524,771,346,306,1423,30947
31-08-2014,8,12576,11225,5807,1844,31451,774,448,301,1523,32974
31-08-2014,9,14022,11769,5893,1949,33634,770,452,302,1524,35158
31-08-2014,10,14407,12196,5906,2348,34857,823,422,308,1553,36410
31-08-2014,11,14556,12617,5983,2427,35582,836,414,317,1567,37149
31-08-2014,12,14434,12690,5841,2479,35444,833,373,321,1527,36971
31-08-2014,13,14481,12666,5834,2440,35420,822,364,315,1501,36921
31-08-2014,14,14265,12713,5743,2529,35249,829,351,310,1490,36739
31-08-2014,15,13840,12845,5774,2643,35102,835,347,308,1490,36592
31-08-2014,16,13849,12856,5803,2656,35165,830,348,311,1489,36654
31-08-2014,17,14395,12990,5905,2849,36140,847,348,335,1530,37670
31-08-2014,18,14584,13184,5906,2910,36583,861,349,347,1557,38140
31-08-2014,19,14795,13512,6092,2918,37317,862,420,388,1670,38987
31-08-2014,20,15189,13823,6204,2917,38134,862,435,428,1725,39859
31-08-2014,21,14738,13309,5966,2831,36844,867,353,374,1594,38438
31-08-2014,22,14143,12333,5755,2623,34853,794,193,355,1342,36195
31-08-2014,23,12488,11467,5555,2407,31916,810,183,356,1349,33265
01-09-2014,0,10785,11281,5434,2204,29704,955,177,340,1472,31176
01-09-2014,1,10159,10869,5378,2061,28466,957,177,338,1472,29938
01-09-2014,2,10308,10812,5182,1956,28258,980,175,347,1502,29760
01-09-2014,3,10610,10755,5202,1976,28544,966,176,344,1486,30030
01-09-2014,4,11207,10792,5408,2000,29408,950,175,342,1467,30875
01-09-2014,5,12810,11615,5974,2160,32559,977,212,331,1520,34079
01-09-2014,6,14077,13439,6921,2499,36938,1169,459,321,1949,38887
01-09-2014,7,15638,15992,7331,2666,41628,1256,489,495,2240,43868
01-09-2014,8,16117,16790,7507,2753,43166,1261,601,546,2408,45574
01-09-2014,9,16223,17097,7482,2940,43743,1269,627,562,2458,46201
01-09-2014,10,16549,16957,7471,2867,43844,1278,629,482,2389,46233
01-09-2014,11,16244,17080,7390,2842,43556,1273,601,480,2354,45910
01-09-2014,12,15681,16943,7243,2905,42773,1272,583,368,2223,44996
01-09-2014,13,15646,16802,7087,2893,42429,1270,519,435,2224,44653
01-09-2014,14,15803,16392,7037,2897,42129,1285,500,412,2197,44326
01-09-2014,15,15681,15911,6928,2761,41282,1276,443,464,2183,43465
01-09-2014,16,15750,15768,6868,2702,41087,1264,437,400,2101,43188
01-09-2014,17,15909,16250,6977,2639,41776,1255,432,459,2146,43922
01-09-2014,18,15739,16587,7048,2525,41898,1237,485,520,2242,44140
01-09-2014,19,16395,16792,7107,2392,42685,1270,489,420,2179,44864
01-09-2014,20,16925,16398,7137,2288,42747,1270,483,441,2194,44941
01-09-2014,21,16627,15314,6746,2284,40971,1224,370,334,1928,42899
01-09-2014,22,15375,13415,6186,2066,37044,1196,276,342,1814,38858
01-09-2014,23,14265,12180,5811,1749,34006,1058,172,339,1569,35575
02-09-2014,0,12683,11138,5578,1737,31135,1052,172,328,1552,32687
02-09-2014,1,11391,10813,5507,1977,29688,1047,186,320,1553,31241
02-09-2014,2,11113,10596,5549,1959,29218,1040,189,324,1553,30771
02-09-2014,3,11203,10547,5599,1897,29246,1033,187,324,1544,30790
02-09-2014,4,11799,10645,5645,1826,29913,1036,185,324,1545,31458
02-09-2014,5,13245,11633,5993,1886,32755,1129,201,321,1651,34406
02-09-2014,6,14827,13495,6840,1972,37134,1217,382,493,2092,39226
02-09-2014,7,15997,16300,7407,2121,41825,1259,460,526,2245,44070
02-09-2014,8,16290,17036,7480,2441,43248,1259,467,695,2421,45669
02-09-2014,9,16306,17078,7545,2628,43557,1266,496,688,2450,46007
02-09-2014,10,16219,16993,7476,2635,43324,1266,460,595,2321,45645
02-09-2014,11,16119,17117,7422,2753,43411,1264,371,583,2218,45629
02-09-2014,12,15688,16742,7201,2889,42520,1264,368,508,2140,44660
02-09-2014,13,15770,16099,7091,2789,41751,1257,370,508,2135,43886
02-09-2014,14,15783,16003,7037,2635,41456,1263,338,507,2108,43564
02-09-2014,15,15640,16057,7016,2562,41274,1224,335,506,2065,43339
02-09-2014,16,15519,15837,6927,2466,40750,1202,256,499,1957,42707
02-09-2014,17,15344,16147,6929,2458,40880,1246,256,550,2052,42932
02-09-2014,18,15581,16261,7011,2332,41183,1255,311,609,2175,43358
02-09-2014,19,16400,16172,7037,2231,41840,1249,329,499,2077,43917
02-09-2014,20,16841,15855,7042,2111,41849,1243,332,542,2117,43966
02-09-2014,21,16253,14982,6486,2084,39805,1211,270,440,1921,41726
02-09-2014,22,14934,13252,6127,1786,36099,1073,171,305,1549,37648
02-09-2014,23,13790,11886,5985,1545,33207,1073,168,303,1544,34751
03-09-2014,0,11980,11391,5715,1397,30482,1048,168,301,1517,31999
03-09-2014,1,11098,11012,5589,1380,29081,970,183,303,1456,30537
03-09-2014,2,10864,10785,5510,1520,28680,948,183,303,1434,30114
03-09-2014,3,10880,10860,5493,1596,28829,953,183,302,1438,30267
03-09-2014,4,11541,10931,5585,1546,29604,1027,185,295,1507,31111
03-09-2014,5,12963,11846,6116,1569,32495,1154,201,318,1673,34168
03-09-2014,6,14423,13636,6763,2057,36879,1366,333,471,2170,39049
03-09-2014,7,15816,16375,7140,2175,41507,1402,440,506,2348,43855
03-09-2014,8,16369,17078,7320,2347,43115,1377,482,681,2540,45655
03-09-2014,9,16297,17185,7265,2527,43274,1360,460,624,2444,45718
03-09-2014,10,15863,17248,7394,2689,43195,1374,444,624,2442,45637
03-09-2014,11,15823,17298,7380,2877,43376,1383,433,569,2385,45761
03-09-2014,12,15485,16580,7097,2792,41954,1365,409,497,2271,44225
03-09-2014,13,15213,16153,6963,2688,41017,1360,375,501,2236,43253
03-09-2014,14,14961,16201,6901,2749,40812,1343,371,486,2200,43012
03-09-2014,15,15299,15860,6779,2701,40638,1329,373,489,2191,42829
03-09-2014,16,15472,15281,6539,2699,39991,1307,366,492,2165,42156
03-09-2014,17,15433,15473,6631,2620,40159,1299,364,489,2152,42311
03-09-2014,18,15370,15536,6745,2511,40163,1301,391,489,2181,42344
03-09-2014,19,16222,15358,6644,2381,40606,1317,363,488,2168,42774
03-09-2014,20,16416,15254,6665,2348,40683,1349,350,492,2191,42874
03-09-2014,21,15753,14133,6221,2305,38412,1331,265,421,2017,40429
03-09-2014,22,14411,12858,5847,2165,35280,1219,175,307,1701,36981
03-09-2014,23,12514,11893,5639,1974,32021,1181,169,310,1660,33681
04-09-2014,0,11015,11281,5459,1873,29628,1147,167,294,1608,31236
04-09-2014,1,10717,10851,5412,1790,28771,1086,182,304,1572,30343
04-09-2014,2,10574,10849,5402,1709,28535,1075,184,303,1562,30097
04-09-2014,3,10790,10837,5411,1669,28709,1111,187,302,1600,30309
04-09-2014,4,11291,11065,5472,1769,29599,1111,187,299,1597,31196
04-09-2014,5,12854,11634,5852,1929,32268,1182,196,300,1678,33946
04-09-2014,6,14807,13084,6609,2282,36783,1339,338,461,2138,38921
04-09-2014,7,16422,15957,7051,2635,42065,1376,373,549,2298,44363
04-09-2014,8,16408,16875,7348,2691,43321,1364,465,669,2498,45819
04-09-2014,9,15976,16923,7279,2843,43022,1364,464,599,2427,45449
04-09-2014,10,16063,17229,7402,3056,43749,1384,462,629,2475,46224
04-09-2014,11,15799,16919,7374,3241,43334,1297,415,647,2359,45693
04-09-2014,12,15445,16459,7094,3162,42159,1301,458,646,2405,44564
04-09-2014,13,15493,15934,6554,3108,41089,1299,439,645,2383,43472
04-09-2014,14,15540,15585,6359,2989,40473,1327,353,497,2177,42650
04-09-2014,15,15764,15381,6245,2772,40162,1339,371,493,2203,42365
04-09-2014,16,15470,15150,6226,2785,39632,1305,366,496,2167,41799
04-09-2014,17,15555,15717,6443,2928,40645,1302,348,546,2196,42841
04-09-2014,18,16048,16123,6637,2955,41764,1307,349,610,2266,44030
04-09-2014,19,16368,16364,6801,2869,42402,1330,437,507,2274,44676
04-09-2014,20,16322,16136,6762,2800,42020,1311,431,510,2252,44272
04-09-2014,21,15974,14662,6423,2820,39879,1289,270,443,2002,41881
04-09-2014,22,14877,12824,5946,2532,36180,1190,170,328,1688,37868
04-09-2014,23,12723,11907,5818,2160,32610,1195,185,341,1721,34331
05-09-2014,0,11252,11164,5453,2060,29929,1100,185,352,1637,31566
05-09-2014,1,10901,10674,5379,1970,28925,1062,186,351,1599,30524
05-09-2014,2,10768,10552,5356,1849,28525,1008,188,342,1538,30063
05-09-2014,3,11044,10552,5377,1742,28716,1005,189,339,1533,30249
05-09-2014,4,11613,10681,5485,1731,29511,1020,193,333,1546,31057
05-09-2014,5,13364,11516,5893,1779,32551,1074,184,334,1592,34143
05-09-2014,6,15411,13811,6693,2365,38279,1290,321,494,2105,40384
05-09-2014,7,16951,17054,7194,2604,43804,1276,401,518,2195,45999
05-09-2014,8,17171,17804,7527,2841,45342,1278,391,701,2370,47712
05-09-2014,9,17038,17747,7468,2959,45214,1330,470,616,2416,47630
05-09-2014,10,16734,16874,7218,2929,43754,1325,438,659,2422,46176
05-09-2014,11,16837,16329,7070,2943,43180,1341,419,657,2417,45597
05-09-2014,12,16409,15813,6915,2774,41910,1294,373,585,2252,44162
05-09-2014,13,16409,15236,6688,2725,41059,1286,371,529,2186,43245
05-09-2014,14,16207,14695,6652,2544,40100,1273,367,516,2156,42256
05-09-2014,15,16145,14436,6499,2638,39717,1223,382,514,2119,41836
05-09-2014,16,16244,14887,6496,2692,40318,1237,392,501,2130,42448
05-09-2014,17,16340,15948,6542,2573,41404,1278,380,522,2180,43584
05-09-2014,18,16638,16070,6662,2517,41887,1273,377,578,2228,44115
05-09-2014,19,16423,16219,6601,2428,41670,1273,380,506,2159,43829
05-09-2014,20,16437,15912,6511,2508,41368,1272,384,586,2242,43610
05-09-2014,21,16183,15178,6020,2431,39811,1209,263,450,1922,41733
05-09-2014,22,15211,12988,5868,2461,36528,1215,169,331,1715,38243
05-09-2014,23,14101,11052,5604,2242,32999,1083,166,335,1584,34583
06-09-2014,0,13021,10329,5351,1902,30603,863,170,334,1367,31970
06-09-2014,1,12035,10142,5230,1758,29165,857,185,335,1377,30542
06-09-2014,2,11571,10054,5164,1778,28566,853,186,333,1372,29938
06-09-2014,3,11467,9994,5124,1769,28354,856,189,330,1375,29729
06-09-2014,4,11549,9998,5136,1737,28420,849,195,324,1368,29788
06-09-2014,5,11807,10167,5198,1703,28874,861,209,304,1374,30248
06-09-2014,6,12201,10594,5362,1770,29926,848,264,323,1435,31361
06-09-2014,7,13570,11339,5474,1971,32355,844,368,296,1508,33863
06-09-2014,8,14620,12390,5686,2433,35128,927,383,284,1594,36722
06-09-2014,9,15937,12839,5779,2609,37165,976,386,280,1642,38807
06-09-2014,10,16156,12948,5799,2680,37584,987,380,282,1649,39233
06-09-2014,11,16084,12942,5739,2679,37445,992,375,286,1653,39098
06-09-2014,12,15361,12932,5669,2791,36753,984,371,287,1642,38395
06-09-2014,13,14909,12672,5664,2894,36139,984,366,286,1636,37775
06-09-2014,14,14663,12417,5605,2896,35581,997,316,284,1597,37178
06-09-2014,15,14522,12376,5689,2855,35443,1006,300,286,1592,37035
06-09-2014,16,14806,12476,5832,2577,35692,997,245,286,1528,37220
06-09-2014,17,15039,12609,5867,2607,36121,1000,245,285,1530,37651
06-09-2014,18,15475,12848,5934,2722,36980,1004,219,336,1559,38539
06-09-2014,19,15585,13556,5992,2665,37799,1010,289,453,1752,39551
06-09-2014,20,15572,13613,6138,2771,38095,1003,272,432,1707,39802
06-09-2014,21,14732,12744,5843,2761,36081,1011,175,306,1492,37573
06-09-2014,22,14263,12005,5611,2748,34628,914,170,313,1397,36025
06-09-2014,23,12968,11218,5393,2530,32109,906,171,315,1392,33501
07-09-2014,0,11997,10463,5211,2253,29925,788,170,315,1273,31198
07-09-2014,1,11512,10115,5175,2056,28859,771,184,305,1260,30119
07-09-2014,2,11418,9891,5156,1690,28156,766,189,311,1266,29422
07-09-2014,3,11502,9886,5163,1532,28082,754,188,305,1247,29329
07-09-2014,4,11115,9926,5207,1656,27905,767,188,307,1262,29167
07-09-2014,5,11015,10117,5257,1677,28065,765,203,306,1274,29339
07-09-2014,6,11333,10259,5308,1668,28567,772,304,304,1380,29947
07-09-2014,7,11414,10451,5416,1629,28911,856,352,302,1510,30421
07-09-2014,8,13234,11169,5516,1587,31505,902,369,289,1560,33065
07-09-2014,9,14446,11957,5539,1749,33691,909,378,281,1568,35259
07-09-2014,10,15322,12386,5594,1783,35084,923,375,282,1580,36664
07-09-2014,11,15501,12547,5620,1761,35430,931,368,287,1586,37016
07-09-2014,12,15429,12616,5599,1757,35401,933,365,291,1589,36990
07-09-2014,13,15382,12382,5579,1715,35058,931,354,291,1576,36634
07-09-2014,14,15292,12276,5612,1699,34879,942,332,290,1564,36443
07-09-2014,15,15170,12329,5570,1670,34740,940,186,287,1413,36153
07-09-2014,16,15184,12478,5604,1701,34968,939,190,289,1418,36386
07-09-2014,17,15516,12844,5637,1994,35991,935,196,290,1421,37412
07-09-2014,18,15507,13214,5814,2188,36722,930,206,356,1492,38214
07-09-2014,19,15748,14016,6012,2106,37884,938,397,436,1771,39655
07-09-2014,20,15992,14570,6125,2087,38774,962,302,451,1715,40489
07-09-2014,21,15340,13750,5841,2124,37054,944,183,327,1454,38508
07-09-2014,22,14457,12211,5686,1923,34277,932,181,338,1451,35728
07-09-2014,23,13417,11066,5480,1757,31722,902,181,332,1415,33137
08-09-2014,0,11412,10890,5315,1542,29159,1067,178,373,1618,30777
08-09-2014,1,10671,10397,5247,1451,27767,1055,188,354,1597,29364
08-09-2014,2,10509,10260,5223,1558,27552,1046,192,349,1587,29139
08-09-2014,3,10500,10264,5257,1650,27671,1029,194,346,1569,29240
08-09-2014,4,10871,10365,5270,1754,28261,1058,195,346,1599,29860
08-09-2014,5,12631,11103,5680,1844,31259,1217,200,343,1760,33019
08-09-2014,6,15321,13177,6390,2457,37346,1363,293,499,2155,39501
08-09-2014,7,16701,15842,6984,2845,42372,1364,390,549,2303,44675
08-09-2014,8,16847,16778,7211,3143,43980,1365,445,702,2512,46492
08-09-2014,9,16171,16807,7234,3494,43705,1371,496,611,2478,46183
08-09-2014,10,16234,16882,7119,3729,43964,1387,484,612,2483,46447
08-09-2014,11,16128,16788,7048,3959,43922,1391,463,612,2466,46388
08-09-2014,12,15832,16345,6778,4199,43155,1398,467,619,2484,45639
08-09-2014,13,15640,16304,6687,3899,42530,1395,456,614,2465,44995
08-09-2014,14,15343,16324,6551,3808,42026,1401,390,654,2445,44471
08-09-2014,15,15325,16320,6553,4208,42406,1363,294,496,2153,44559
08-09-2014,16,15225,15690,6426,4310,41651,1351,281,484,2116,43767
08-09-2014,17,15662,15600,6407,4170,41839,1372,283,610,2265,44104
08-09-2014,18,15664,15655,6522,4089,41929,1348,375,636,2359,44288
08-09-2014,19,15955,15423,6540,4113,42032,1387,361,655,2403,44435
08-09-2014,20,16264,15366,6174,4152,41957,1417,356,687,2460,44417
08-09-2014,21,15974,14824,5887,3791,40477,1416,178,431,2025,42502
08-09-2014,22,15083,13273,5652,3727,37735,1414,170,317,1901,39636
08-09-2014,23,13756,11715,5608,3300,34379,1241,167,299,1707,36086
09-09-2014,0,11917,10972,5418,3053,31360,1165,166,281,1612,32972
09-09-2014,1,11232,10614,5298,3005,30150,1210,185,294,1689,31839
09-09-2014,2,10753,10482,5266,3037,29536,1227,186,278,1691,31227
09-09-2014,3,10977,10410,5260,2984,29632,1213,184,284,1681,31313
09-09-2014,4,11687,10628,5295,3100,30710,1228,189,288,1705,32415
09-09-2014,5,12808,11573,5771,3116,33269,1366,236,334,1936,35205
09-09-2014,6,14492,13701,6506,3500,38199,1362,339,462,2163,40362
09-09-2014,7,15989,15594,6956,3734,42272,1353,427,599,2379,44651
09-09-2014,8,16404,16341,7099,3787,43630,1341,619,708,2668,46298
09-09-2014,9,15850,16356,7248,4202,43656,1333,566,699,2598,46254
09-09-2014,10,15883,16036,7339,4411,43667,1336,560,687,2583,46250
09-09-2014,11,15784,15849,7296,4501,43431,1340,473,659,2472,45903
09-09-2014,12,15810,15610,6807,4419,42647,1336,472,685,2493,45140
09-09-2014,13,15817,15522,6656,4399,42393,1314,544,638,2496,44889
09-09-2014,14,15579,15571,6598,4343,42091,1310,454,698,2462,44553
09-09-2014,15,15318,15548,6604,4012,41483,1307,372,556,2235,43718
09-09-2014,16,15532,15146,6572,4152,41401,1304,366,523,2193,43594
09-09-2014,17,15586,15271,6519,4582,41959,1291,283,622,2196,44155
09-09-2014,18,16050,14784,6532,4423,41789,1294,375,648,2317,44106
09-09-2014,19,16429,14488,6728,4303,41949,1278,439,659,2376,44325
09-09-2014,20,16507,14957,6602,4159,42224,1256,354,698,2308,44532
09-09-2014,21,15986,14278,6120,4036,40419,1266,190,402,1858,42277
09-09-2014,22,15197,12809,5760,3784,37550,1264,174,286,1724,39274
09-09-2014,23,14053,11615,5473,3235,34375,1186,199,289,1674,36049
10-09-2014,0,12226,10635,5632,2949,31442,1127,206,295,1628,33070
10-09-2014,1,10898,10326,5641,2764,29629,1050,212,305,1567,31196
10-09-2014,2,10586,10317,5648,2526,29078,1047,211,311,1569,30647
10-09-2014,3,10548,10324,5649,2391,28911,1051,253,322,1626,30537
10-09-2014,4,11180,10547,5715,2222,29664,1135,263,332,1730,31394
10-09-2014,5,12828,11408,6327,1977,32538,1259,260,325,1844,34382
10-09-2014,6,14824,12979,7480,2652,37935,1273,359,472,2104,40039
10-09-2014,7,16156,15097,7895,2845,41993,1272,381,708,2361,44354
10-09-2014,8,16063,15622,7888,3039,42612,1469,652,757,2878,45490
10-09-2014,9,15847,15289,7807,3349,42292,1508,548,691,2747,45039
10-09-2014,10,15745,15556,7848,3460,42609,1513,537,714,2764,45373
10-09-2014,11,15618,15530,7782,3526,42456,1510,465,701,2676,45132
10-09-2014,12,15546,15355,7492,3567,41960,1514,532,706,2752,44712
10-09-2014,13,15622,14717,7308,3632,41278,1514,532,707,2753,44031
10-09-2014,14,15531,14720,7331,3693,41277,1513,465,714,2692,43969
10-09-2014,15,15286,14892,7281,3635,41093,1510,313,511,2334,43427
10-09-2014,16,15241,14744,7197,3595,40779,1508,244,483,2235,43014
10-09-2014,17,15080,14457,7181,3714,40431,1487,203,727,2417,42848
10-09-2014,18,15412,13988,7329,3458,40188,1471,314,734,2519,42707
10-09-2014,19,15697,13819,7549,3182,40248,1488,318,737,2543,42791
10-09-2014,20,16558,13874,7285,3041,40759,1464,336,726,2526,43285
10-09-2014,21,16074,13608,6473,3034,39189,1359,173,516,2048,41237
10-09-2014,22,15110,12532,5940,2981,36563,1296,168,306,1770,38333
10-09-2014,23,13371,11415,5550,2370,32706,1403,190,303,1896,34602
11-09-2014,0,11940,10830,5617,2118,30506,1233,191,297,1721,32227
11-09-2014,1,11619,10395,5509,2046,29569,1246,195,293,1734,31303
11-09-2014,2,11380,10369,5495,1982,29227,1238,190,290,1718,30945
11-09-2014,3,11354,10398,5579,1914,29246,1254,190,289,1733,30979
11-09-2014,4,11982,10444,5741,1881,30048,1263,244,287,1794,31842
11-09-2014,5,13332,11230,6506,1755,32822,1327,265,354,1946,34768
11-09-2014,6,15350,12837,7152,2434,37773,1333,507,471,2311,40084
11-09-2014,7,16442,14692,7401,2697,41232,1340,772,608,2720,43952
11-09-2014,8,16541,15399,7556,2842,42337,1339,957,637,2933,45270
11-09-2014,9,16210,15673,7619,2780,42283,1341,953,585,2879,45162
11-09-2014,10,16149,15650,7788,2873,42460,1340,921,584,2845,45305
11-09-2014,11,16023,15640,7678,3135,42476,1342,807,552,2701,45177
11-09-2014,12,15970,15248,7283,3016,41517,1348,810,558,2716,44233
11-09-2014,13,15969,15240,7093,2783,41085,1345,762,555,2662,43747
11-09-2014,14,15803,15171,6985,2685,40644,1347,454,560,2361,43005
11-09-2014,15,16062,14803,6995,2573,40433,1349,416,560,2325,42758
11-09-2014,16,16256,14697,6896,2539,40388,1347,360,560,2267,42655
11-09-2014,17,16315,15113,6923,2487,40839,1342,623,609,2574,43413
11-09-2014,18,16224,15166,6887,2170,40448,1339,732,607,2678,43126
11-09-2014,19,16283,15205,7020,2072,40580,1338,760,614,2712,43292
11-09-2014,20,16943,15480,7006,1708,41138,1339,726,616,2681,43819
11-09-2014,21,16510,14774,6548,1620,39453,1339,397,433,2169,41622
11-09-2014,22,15757,13165,6050,1484,36456,1340,340,306,1986,38442
11-09-2014,23,14545,11561,5658,1403,33170,1178,358,330,1866,35036
12-09-2014,0,13535,10810,5455,1416,31215,1306,222,318,1846,33061
12-09-2014,1,12780,10490,5328,1417,30015,1284,179,322,1785,31800
12-09-2014,2,12554,10378,5288,1323,29542,1228,183,348,1759,31301
12-09-2014,3,12569,10395,5265,1321,29551,1191,229,363,1783,31334
12-09-2014,4,12840,10488,5285,1598,30212,1236,268,359,1863,32075
12-09-2014,5,14026,11719,5656,1693,33094,1330,350,343,2023,35117
12-09-2014,6,15595,13838,6454,1839,37726,1331,524,535,2390,40116
12-09-2014,7,17063,15921,6955,2070,42009,1335,821,638,2794,44803
12-09-2014,8,17713,16695,7008,2352,43771,1327,985,638,2950,46721
12-09-2014,9,16902,16799,7069,2536,43305,1327,995,599,2921,46226
12-09-2014,10,16964,16536,6986,2679,43165,1332,942,602,2876,46041
12-09-2014,11,16923,16404,6973,2617,42918,1328,836,583,2747,45665
12-09-2014,12,16611,16079,6822,2419,41932,1310,566,585,2461,44393
12-09-2014,13,16358,15735,6531,2497,41120,1310,469,575,2354,43474
12-09-2014,14,16445,15210,6427,2293,40376,1218,392,580,2190,42566
12-09-2014,15,16396,14979,6382,2051,39809,1224,389,476,2089,41898
12-09-2014,16,16082,14987,6385,1942,39396,1175,522,477,2174,41570
12-09-2014,17,16035,15113,6480,2051,39679,1171,827,621,2619,42298
12-09-2014,18,16039,14947,6581,1939,39508,1162,850,631,2643,42151
12-09-2014,19,16042,15116,6582,1789,39529,1181,780,641,2602,42131
12-09-2014,20,16505,15159,6553,1797,40015,1192,631,646,2469,42484
12-09-2014,21,15883,14209,6174,1607,37873,1189,541,454,2184,40057
12-09-2014,22,15139,12839,5805,1550,35333,1196,524,336,2056,37389
12-09-2014,23,14487,11476,5658,1546,33167,1193,416,332,1941,35108
13-09-2014,0,13552,10497,5416,1452,30919,1195,202,325,1722,32641
13-09-2014,1,12904,10144,5313,1443,29804,1182,164,332,1678,31482
13-09-2014,2,12561,10091,5287,1433,29370,1168,164,326,1658,31028
13-09-2014,3,12298,10155,5243,1436,29132,1149,182,324,1655,30787
13-09-2014,4,12100,10151,5255,1469,28976,1141,203,315,1659,30635
13-09-2014,5,12321,10330,5298,1339,29288,1130,207,319,1656,30944
13-09-2014,6,12535,10769,5313,1520,30136,1130,206,317,1653,31789
13-09-2014,7,13979,11570,5541,1669,32760,1147,208,317,1672,34432
13-09-2014,8,15281,12548,5736,1681,35245,1186,296,335,1817,37062
13-09-2014,9,15793,13146,5826,1896,36662,1152,279,390,1821,38483
13-09-2014,10,16176,13233,5827,2067,37302,1151,310,329,1790,39092
13-09-2014,11,16019,13569,5706,2204,37497,1151,311,331,1793,39290
13-09-2014,12,15770,13283,5646,2393,37094,1153,327,335,1815,38909
13-09-2014,13,15679,12795,5581,2444,36498,1157,326,337,1820,38318
13-09-2014,14,15504,12284,5538,2501,35826,1154,261,423,1838,37664
13-09-2014,15,15470,12218,5562,2531,35782,1154,263,332,1749,37531
13-09-2014,16,15556,12385,5631,2518,36090,1152,228,337,1717,37807
13-09-2014,17,15687,12799,5647,2441,36573,1140,317,348,1805,38378
13-09-2014,18,15906,12965,5702,2269,36843,1131,316,430,1877,38720
13-09-2014,19,15898,13242,5866,2243,37249,1142,548,517,2207,39456
13-09-2014,20,15955,13383,5933,2312,37583,1157,394,523,2074,39657
13-09-2014,21,15598,12702,5712,2162,36174,1160,215,409,1784,37958
13-09-2014,22,14815,12009,5713,2062,34598,1159,212,388,1759,36357
13-09-2014,23,13609,11249,5486,1893,32238,1147,177,362,1686,33924
14-09-2014,0,12200,10611,5411,1941,30162,976,174,333,1483,31645
14-09-2014,1,11226,10462,5359,1835,28883,960,174,349,1483,30366
14-09-2014,2,10514,10443,5279,1885,28122,958,176,351,1485,29607
14-09-2014,3,10591,10469,5266,2046,28373,973,193,351,1517,29890
14-09-2014,4,10511,10522,5267,2226,28526,960,210,355,1525,30051
14-09-2014,5,10286,10516,5299,2418,28520,967,211,341,1519,30039
14-09-2014,6,10397,10470,5337,2633,28839,1018,201,332,1551,30390
14-09-2014,7,10585,10768,5294,2886,29534,999,276,330,1605,31139
14-09-2014,8,12775,11102,5295,3101,32271,997,294,330,1621,33892
14-09-2014,9,14345,11462,5314,3403,34526,999,301,396,1696,36222
14-09-2014,10,14822,12061,5454,3525,35862,999,186,405,1590,37452
14-09-2014,11,15165,12127,5459,3540,36291,1001,177,411,1589,37880
14-09-2014,12,14777,12126,5460,3466,35829,1003,175,394,1572,37401
14-09-2014,13,14374,12038,5386,3351,35149,996,174,407,1577,36726
14-09-2014,14,14221,11770,5352,3263,34607,997,182,433,1612,36219
14-09-2014,15,14186,11825,5320,3213,34544,1005,179,442,1626,36170
14-09-2014,16,14329,11986,5365,3121,34802,996,180,468,1644,36446
14-09-2014,17,14740,12105,5471,3048,35364,981,183,476,1640,37004
14-09-2014,18,15119,12652,5848,3034,36652,1009,185,465,1659,38311
14-09-2014,19,15844,13625,6243,3179,38889,1045,356,519,1920,40809
14-09-2014,20,16089,13746,6096,3331,39261,1044,222,524,1790,41051
14-09-2014,21,15335,12596,5745,3397,37072,994,212,502,1708,38780
14-09-2014,22,14285,11829,5627,3477,35218,1003,184,370,1557,36775
14-09-2014,23,12605,11272,5566,3455,32897,989,179,366,1534,34431
15-09-2014,0,11367,10999,5528,3254,31148,912,180,363,1455,32603
15-09-2014,1,10921,10596,5500,3200,30216,902,177,357,1436,31652
15-09-2014,2,10673,10522,5437,3158,29792,928,195,356,1479,31271
15-09-2014,3,10783,10495,5456,3159,29894,1011,212,361,1584,31478
15-09-2014,4,11510,10485,5667,3203,30865,1024,209,357,1590,32455
15-09-2014,5,13200,11337,6205,3267,34008,1109,211,351,1671,35679
15-09-2014,6,15692,13096,6988,3615,39391,1120,298,499,1917,41308
15-09-2014,7,17255,15041,7417,3854,43567,1116,308,616,2040,45607
15-09-2014,8,17419,15891,7457,4093,44861,1113,588,604,2305,47166
15-09-2014,9,17210,15652,7450,4191,44504,1112,550,602,2264,46768
15-09-2014,10,17379,15568,7495,4397,44840,1116,505,618,2239,47079
15-09-2014,11,17153,16177,7553,4459,45341,1118,432,615,2165,47506
15-09-2014,12,16890,15756,7265,4436,44347,1118,278,494,1890,46237
15-09-2014,13,16900,15394,7104,4503,43901,1117,277,473,1867,45768
15-09-2014,14,16547,15008,6911,4500,42966,1121,190,496,1807,44773
15-09-2014,15,16715,14722,6748,4211,42395,1121,174,485,1780,44175
15-09-2014,16,16658,14642,6691,4180,42171,1121,171,463,1755,43926
15-09-2014,17,16720,14716,6770,4110,42316,1118,289,600,2007,44323
15-09-2014,18,16830,14832,6983,3969,42614,1115,444,604,2163,44777
15-09-2014,19,16870,15255,7356,3936,43417,1114,373,593,2080,45497
15-09-2014,20,16942,15174,6975,3893,42986,1121,283,474,1878,44864
15-09-2014,21,16458,14112,6532,3891,40994,1122,172,467,1761,42755
15-09-2014,22,15105,12442,6177,3787,37510,1120,173,363,1656,39166
15-09-2014,23,13595,11251,5834,3637,34318,1058,173,351,1582,35900
16-09-2014,0,12198,10815,5685,3432,32131,1028,170,338,1536,33667
16-09-2014,1,11632,10457,5662,3239,30990,983,172,337,1492,32482
16-09-2014,2,11330,10384,5701,3078,30493,994,177,323,1494,31987
16-09-2014,3,11292,10271,5774,2973,30311,994,200,334,1528,31839
16-09-2014,4,11685,10524,5949,2996,31153,1006,214,337,1557,32710
16-09-2014,5,13408,11273,6432,3050,34163,1066,227,358,1651,35814
16-09-2014,6,15637,13253,7103,3200,39194,1113,299,483,1895,41089
16-09-2014,7,17239,16016,7494,3379,44127,1118,438,607,2163,46290
16-09-2014,8,17401,16297,7494,3605,44798,1112,688,615,2415,47213
16-09-2014,9,17348,15926,7462,3677,44414,1119,582,586,2287,46701
16-09-2014,10,17422,15590,7426,3824,44263,1116,527,562,2205,46468
16-09-2014,11,16910,15246,7363,3882,43400,1120,493,540,2153,45553
16-09-2014,12,16920,14657,6954,3745,42276,1106,480,538,2124,44400
16-09-2014,13,17024,14479,6794,3746,42042,1089,461,566,2116,44158
16-09-2014,14,16899,14380,6786,3766,41832,1098,373,578,2049,43881
16-09-2014,15,16591,14436,6745,3812,41583,1123,207,581,1911,43494
16-09-2014,16,16634,14503,6749,3760,41647,1102,238,602,1942,43589
16-09-2014,17,16677,14919,6914,3723,42234,1102,292,615,2009,44243
16-09-2014,18,16712,14847,7332,3619,42510,1099,412,608,2119,44629
16-09-2014,19,17037,15175,7545,3429,43187,1095,350,645,2090,45277
16-09-2014,20,17013,15319,7025,3488,42846,1114,272,506,1892,44738
16-09-2014,21,16654,13823,6638,3400,40515,1111,218,503,1832,42347
16-09-2014,22,15573,11986,6095,3303,36957,1094,207,327,1628,38585
16-09-2014,23,14161,11234,5840,3275,34511,1017,205,330,1552,36063
17-09-2014,0,12398,11088,5671,3138,32293,962,193,305,1460,33753
17-09-2014,1,11709,10821,5648,2946,31123,947,193,322,1462,32585
17-09-2014,2,11237,10784,5577,2918,30517,959,221,329,1509,32026
17-09-2014,3,11400,10841,5583,2765,30591,954,231,313,1498,32089
17-09-2014,4,12197,11004,5722,2797,31720,987,238,315,1540,33260
17-09-2014,5,13849,11835,6296,2871,34852,1063,240,339,1642,36494
17-09-2014,6,15761,13625,7138,2988,39511,1113,244,536,1893,41404
17-09-2014,7,17230,16068,7653,3121,44070,1111,470,616,2197,46267
17-09-2014,8,17724,16688,7637,3260,45307,1120,735,591,2446,47753
17-09-2014,9,17597,16538,7576,3353,45065,1127,667,581,2375,47440
17-09-2014,10,17322,16112,7480,3437,44350,1145,590,571,2306,46656
17-09-2014,11,17183,15688,7319,3524,43715,1206,581,549,2336,46051
17-09-2014,12,16902,15205,6919,3689,42716,1214,288,570,2072,44788
17-09-2014,13,16937,14722,6988,3643,42291,1213,274,571,2058,44349
17-09-2014,14,16778,14488,6886,3565,41719,1216,265,530,2011,43730
17-09-2014,15,16609,14362,6804,3429,41206,1218,252,531,2001,43207
17-09-2014,16,16418,14358,6812,3356,40945,1152,247,443,1842,42787
17-09-2014,17,16831,14621,6857,3304,41614,1137,347,605,2089,43703
17-09-2014,18,17094,15113,7148,3105,42461,1126,498,566,2190,44651
17-09-2014,19,17133,15823,7266,2981,43202,1127,278,647,2052,45254
17-09-2014,20,17098,15648,7059,3013,42818,1130,222,594,1946,44764
17-09-2014,21,16618,14535,6599,3043,40797,1132,213,485,1830,42627
17-09-2014,22,15649,12343,6079,2995,37064,1116,193,347,1656,38720
17-09-2014,23,14474,11481,5773,2760,34488,1080,180,339,1599,36087
18-09-2014,0,13073,10776,5762,2640,32250,1007,171,328,1506,33756
18-09-2014,1,12622,10382,5694,2490,31188,986,169,340,1495,32683
18-09-2014,2,12389,10368,5686,2530,30974,983,167,339,1489,32463
18-09-2014,3,12354,10410,5702,2567,31032,1044,166,337,1547,32579
18-09-2014,4,12838,10641,5849,2669,31997,1073,168,318,1559,33556
18-09-2014,5,14125,11747,6297,2727,34895,1123,223,353,1699,36594
18-09-2014,6,16213,13899,7108,2799,40021,1120,240,535,1895,41916
18-09-2014,7,17561,15902,7635,2912,44010,1114,434,617,2165,46175
18-09-2014,8,17826,16456,7724,3090,45097,1118,660,600,2378,47475
18-09-2014,9,17759,16313,7549,3245,44864,1117,668,572,2357,47221
18-09-2014,10,17828,16332,7456,3393,45009,1121,566,593,2280,47289
18-09-2014,11,17431,16154,7291,3414,44289,1123,556,560,2239,46528
18-09-2014,12,17164,15757,6995,3447,43364,1128,337,567,2032,45396
18-09-2014,13,16768,15100,6918,3517,42304,1130,254,581,1965,44269
18-09-2014,14,16828,14803,6957,3488,42076,1129,288,582,1999,44075
18-09-2014,15,16736,14651,6782,3472,41640,1128,234,605,1967,43607
18-09-2014,16,16960,15058,6825,3317,42160,1116,229,545,1890,44050
18-09-2014,17,17057,15628,6883,3325,42894,1108,323,636,2067,44961
18-09-2014,18,16808,16049,7066,3095,43019,1106,476,604,2186,45205
18-09-2014,19,16982,16279,7083,3070,43413,1111,520,669,2300,45713
18-09-2014,20,17185,16034,7030,3020,43270,1110,230,605,1945,45215
18-09-2014,21,16620,14972,6809,3083,41485,1115,210,496,1821,43306
18-09-2014,22,15763,13293,6386,3055,38498,1091,209,383,1683,40181
18-09-2014,23,14553,11665,5931,2802,34951,1040,177,395,1612,36563
19-09-2014,0,13076,10920,5786,2447,32229,1014,171,395,1580,33809
19-09-2014,1,12626,10393,5736,2297,31052,986,172,388,1546,32598
19-09-2014,2,12366,10281,5670,2265,30583,1010,189,375,1574,32157
19-09-2014,3,12433,10252,5721,2232,30638,1022,205,380,1607,32245
19-09-2014,4,13105,10472,5935,2286,31796,1034,209,376,1619,33415
19-09-2014,5,14720,11520,6528,2309,35078,1109,209,389,1707,36785
19-09-2014,6,16375,14172,7164,2518,40229,1117,213,534,1864,42093
19-09-2014,7,17626,16505,7761,2751,44644,1138,385,630,2153,46797
19-09-2014,8,18072,17090,7855,2953,45972,1134,631,620,2385,48357
19-09-2014,9,17796,16896,7786,2969,45448,1131,529,599,2259,47707
19-09-2014,10,17707,16725,7678,3035,45145,1130,540,584,2254,47399
19-09-2014,11,17537,16752,7548,3172,45009,1130,543,548,2221,47230
19-09-2014,12,17013,16170,7146,3150,43478,1135,416,559,2110,45588
19-09-2014,13,16690,15419,6905,3057,42070,1134,350,583,2067,44137
19-09-2014,14,16566,15030,6857,2865,41319,1138,275,585,1998,43317
19-09-2014,15,16410,15005,6916,2728,41058,1132,241,587,1960,43018
19-09-2014,16,16161,15248,6944,2586,40939,1123,200,603,1926,42865
19-09-2014,17,16203,15206,6985,2383,40776,1120,324,630,2074,42850
19-09-2014,18,16299,15354,7180,2266,41100,1131,376,618,2125,43225
19-09-2014,19,16717,15559,7268,2311,41854,1125,212,629,1966,43820
19-09-2014,20,16629,15283,7053,2365,41329,1148,179,468,1795,43124
19-09-2014,21,16091,14442,6778,2360,39671,1161,184,486,1831,41502
19-09-2014,22,15854,13086,6502,2171,37612,1170,181,363,1714,39326
19-09-2014,23,15094,11575,6201,1915,34786,1181,177,347,1705,36491
20-09-2014,0,14240,10746,5801,1753,32541,1006,170,348,1524,34065
20-09-2014,1,13613,10539,5605,1662,31420,844,170,345,1359,32779
20-09-2014,2,12751,10477,5549,1599,30377,797,167,387,1351,31728
20-09-2014,3,12521,10447,5548,1539,30056,770,168,349,1287,31343
20-09-2014,4,12311,10698,5506,1494,30010,853,170,373,1396,31406
20-09-2014,5,12693,10725,5563,1500,30482,858,170,335,1363,31845
20-09-2014,6,13353,10954,5783,1518,31608,876,171,341,1388,32996
20-09-2014,7,14519,11510,6109,1564,33703,940,170,328,1438,35141
20-09-2014,8,15708,12605,6476,1626,36415,941,168,312,1421,37836
20-09-2014,9,15879,13490,6584,1676,37629,932,166,534,1632,39261
20-09-2014,10,16354,13632,6672,1699,38357,931,166,372,1469,39826
20-09-2014,11,16257,13638,6679,1776,38349,933,167,318,1418,39767
20-09-2014,12,16066,13535,6536,1800,37936,940,165,351,1456,39392
20-09-2014,13,15853,13138,6536,1807,37335,928,165,329,1422,38757
20-09-2014,14,15757,12970,6504,1766,36998,925,164,296,1385,38383
20-09-2014,15,15544,12981,6477,1683,36686,922,164,294,1380,38066
20-09-2014,16,15443,13408,6516,1624,36991,918,165,286,1369,38360
20-09-2014,17,15729,13958,6737,1570,37994,920,165,284,1369,39363
20-09-2014,18,15815,14272,7015,1520,38621,930,165,274,1369,39990
20-09-2014,19,16232,14421,7172,1548,39373,946,165,506,1617,40990
20-09-2014,20,16373,14331,7054,1524,39284,960,166,306,1432,40716
20-09-2014,21,15865,13682,6764,1500,37812,963,170,325,1458,39270
20-09-2014,22,15381,12651,6405,1466,35905,965,173,341,1479,37384
20-09-2014,23,14188,11578,6170,1404,33341,905,171,328,1404,34745
21-09-2014,0,13333,10846,6068,1499,31747,771,171,319,1261,33008
21-09-2014,1,11789,10689,5917,1406,29801,751,170,317,1238,31039
21-09-2014,2,11101,10521,5751,1657,29030,741,168,310,1219,30249
21-09-2014,3,10312,10543,5655,1912,28422,735,167,306,1208,29630
21-09-2014,4,9867,10533,5651,2096,28147,751,167,307,1225,29372
21-09-2014,5,9674,10566,5673,2229,28141,742,167,310,1219,29360
21-09-2014,6,9689,10585,5710,2299,28284,762,168,310,1240,29524
21-09-2014,7,10127,10652,5736,2394,28910,790,169,311,1270,30180
21-09-2014,8,12162,10842,5934,2426,31364,779,167,306,1252,32616
21-09-2014,9,14807,11438,6101,2856,35201,821,166,301,1288,36489
21-09-2014,10,14839,11963,6206,3378,36386,849,166,303,1318,37704
21-09-2014,11,14525,12082,6293,3711,36612,865,166,301,1332,37944
21-09-2014,12,14091,11981,6277,3801,36150,870,165,301,1336,37486
21-09-2014,13,13653,12045,6289,3706,35694,861,165,308,1334,37028
21-09-2014,14,13025,12272,6212,3755,35264,861,165,366,1392,36656
21-09-2014,15,13224,12450,6217,3631,35522,854,191,417,1462,36984
21-09-2014,16,13040,12746,6291,3571,35649,842,195,446,1483,37132
21-09-2014,17,13719,13025,6551,3648,36945,841,209,436,1486,38431
21-09-2014,18,14803,13579,6908,3470,38760,843,400,434,1677,40437
21-09-2014,19,15986,14780,7160,3527,41453,851,604,449,1904,43357
21-09-2014,20,15667,14073,6982,3752,40477,853,395,438,1686,42163
21-09-2014,21,14342,13352,6597,3637,37929,846,176,300,1322,39251
21-09-2014,22,12908,13006,6220,3559,35695,831,170,318,1319,37014
21-09-2014,23,11551,12810,6025,3313,33699,815,170,331,1316,35015
22-09-2014,0,9700,13062,6027,3248,32038,988,174,331,1493,33531
22-09-2014,1,9310,12886,5960,3417,31575,981,176,323,1480,33055
22-09-2014,2,8916,12774,5974,3630,31294,980,173,312,1465,32759
22-09-2014,3,9054,12752,5982,3342,31130,979,170,307,1456,32586
22-09-2014,4,9747,12992,6028,3196,31963,990,185,305,1480,33443
22-09-2014,5,11308,13743,6414,3333,34796,1085,239,314,1638,36434
22-09-2014,6,14395,14897,7188,3767,40247,1123,342,499,1964,42211
22-09-2014,7,16423,16772,7515,4369,45079,1209,404,638,2251,47330
22-09-2014,8,16987,17512,7614,4657,46770,1202,680,654,2536,49306
22-09-2014,9,16153,17408,7695,4855,46110,1209,589,670,2468,48578
22-09-2014,10,15105,17322,7564,5202,45193,1204,564,689,2457,47650
22-09-2014,11,14671,17309,7610,5351,44942,1198,532,653,2383,47325
22-09-2014,12,14556,16923,7355,5227,44060,1200,350,645,2195,46255
22-09-2014,13,14533,17067,7149,5240,43989,1197,235,658,2090,46079
22-09-2014,14,14354,16682,7111,4968,43115,1166,232,656,2054,45169
22-09-2014,15,14355,16296,7229,4193,42072,1166,229,657,2052,44124
22-09-2014,16,14654,16562,7182,4279,42676,1168,182,631,1981,44657
22-09-2014,17,15365,16708,7219,3824,43116,1193,291,690,2174,45290
22-09-2014,18,16252,17199,7586,3822,44859,1252,527,670,2449,47308
22-09-2014,19,16802,17890,7755,3334,45782,1281,427,660,2368,48150
22-09-2014,20,16690,17407,7705,3040,44844,1295,337,582,2214,47058
22-09-2014,21,16418,16012,7436,2822,42688,1273,191,450,1914,44602
22-09-2014,22,15348,13941,6980,2341,38611,1281,199,325,1805,40416
22-09-2014,23,13752,13054,6852,2139,35797,1299,208,308,1815,37612
23-09-2014,0,12274,12833,6714,1790,33612,1226,191,324,1741,35353
23-09-2014,1,12042,12395,6592,1773,32803,1209,189,347,1745,34548
23-09-2014,2,11924,12340,6549,1754,32568,1211,188,348,1747,34315
23-09-2014,3,12334,12293,6653,1738,33020,1213,190,375,1778,34798
23-09-2014,4,13036,12381,6907,1729,34053,1214,193,388,1795,35848
23-09-2014,5,14321,13527,7529,1849,37227,1258,198,405,1861,39088
23-09-2014,6,16325,16332,8246,1925,42829,1325,196,653,2174,45003
23-09-2014,7,17868,18406,8896,2270,47439,1342,428,721,2491,49930
23-09-2014,8,17998,18879,9065,2615,48556,1334,624,753,2711,51267
23-09-2014,9,17540,18492,8978,2708,47719,1346,561,743,2650,50369
23-09-2014,10,17334,17949,8934,2645,46863,1341,474,724,2539,49402
23-09-2014,11,17188,17665,8789,2615,46257,1338,384,706,2428,48685
23-09-2014,12,17043,17072,8617,2526,45259,1335,357,702,2394,47653
23-09-2014,13,16898,16871,8626,2577,44972,1328,423,692,2443,47415
23-09-2014,14,16634,16611,8593,2631,44470,1315,410,723,2448,46918
23-09-2014,15,16593,16136,8462,2693,43885,1312,322,760,2394,46279
23-09-2014,16,16651,16214,8441,2773,44079,1321,228,755,2304,46383
23-09-2014,17,17007,17237,8511,2691,45447,1342,281,723,2346,47793
23-09-2014,18,17163,17750,8712,2640,46266,1325,478,690,2493,48759
23-09-2014,19,17732,17871,8817,2718,47138,1325,551,682,2558,49696
23-09-2014,20,16999,17397,8510,2773,45679,1332,362,686,2380,48059
23-09-2014,21,16512,16041,8361,2600,43517,1330,191,527,2048,45565
23-09-2014,22,15749,14614,7923,2703,40990,1260,186,366,1812,42802
23-09-2014,23,14231,12728,7153,2908,37018,1258,181,328,1767,38785
24-09-2014,0,13144,11888,6879,2883,34793,1141,199,323,1663,36456
24-09-2014,1,12426,11390,6870,2774,33460,1112,200,312,1624,35084
24-09-2014,2,11821,11355,6822,2687,32685,1122,200,309,1631,34316
24-09-2014,3,11779,11447,6843,2702,32771,1121,196,298,1615,34386
24-09-2014,4,12222,11791,7005,2635,33654,1159,193,292,1644,35298
24-09-2014,5,13134,13491,7473,2564,36661,1232,219,316,1767,38428
24-09-2014,6,15233,15717,8285,3055,42293,1294,369,476,2139,44432
24-09-2014,7,17046,17193,8741,3373,46353,1270,389,624,2283,48636
24-09-2014,8,17743,17951,8851,3533,48078,1242,284,633,2159,50237
24-09-2014,9,17286,17747,8886,3587,47506,1236,285,627,2148,49654
24-09-2014,10,17046,17044,8927,3605,46621,1279,286,582,2147,48768
24-09-2014,11,16863,16523,8865,3552,45803,1344,212,579,2135,47938
24-09-2014,12,16354,16173,8442,3487,44456,1367,288,618,2273,46729
24-09-2014,13,15983,15990,8144,3396,43512,1344,247,622,2213,45725
24-09-2014,14,16414,15936,8062,3299,43710,1312,217,641,2170,45880
24-09-2014,15,16457,16196,8100,3167,43920,1317,203,658,2178,46098
24-09-2014,16,16744,16859,8278,3155,45036,1340,223,700,2263,47299
24-09-2014,17,16720,17731,8645,3227,46324,1351,274,719,2344,48668
24-09-2014,18,16968,17901,8980,3258,47107,1382,405,697,2484,49591
24-09-2014,19,17081,17999,8789,3347,47216,1407,455,705,2567,49783
24-09-2014,20,16936,17029,8223,3021,45208,1432,260,710,2402,47610
24-09-2014,21,16549,15477,7768,3093,42887,1429,211,523,2163,45050
24-09-2014,22,15200,13660,7346,2978,39184,1408,203,389,2000,41184
24-09-2014,23,12979,12611,6868,2779,35239,1419,194,393,2006,37245
25-09-2014,0,11842,12027,6765,2794,33429,1331,186,393,1910,35339
25-09-2014,1,11610,11439,6630,2894,32573,1274,184,389,1847,34420
25-09-2014,2,11379,11425,6655,3027,32487,1267,184,394,1845,34332
25-09-2014,3,10987,11435,6756,3157,32335,1318,187,408,1913,34248
25-09-2014,4,11683,11611,6892,3288,33472,1360,187,396,1943,35415
25-09-2014,5,12787,12867,7609,3716,36980,1385,196,397,1978,38958
25-09-2014,6,15062,15144,8333,4337,42876,1423,256,669,2348,45224
25-09-2014,7,16872,16454,8660,4688,46675,1409,316,807,2532,49207
25-09-2014,8,16811,16597,8869,5093,47371,1409,471,778,2658,50029
25-09-2014,9,17218,16341,8822,4953,47335,1407,477,786,2670,50005
25-09-2014,10,17059,16788,8803,5122,47772,1464,482,724,2670,50442
25-09-2014,11,16585,16781,8759,5337,47463,1498,445,718,2661,50124
25-09-2014,12,15632,16090,8385,5252,45358,1438,416,729,2583,47941
25-09-2014,13,14991,15487,8016,4936,43430,1322,236,729,2287,45717
25-09-2014,14,14745,15398,7947,4536,42625,1322,238,706,2266,44891
25-09-2014,15,14574,15453,7862,4491,42381,1323,238,673,2234,44615
25-09-2014,16,15154,15117,7976,4119,42366,1443,227,709,2379,44745
25-09-2014,17,16042,15297,8454,3893,43686,1451,250,753,2454,46140
25-09-2014,18,17122,16061,8653,3424,45260,1519,565,738,2822,48082
25-09-2014,19,17708,16632,8601,3001,45941,1458,361,749,2568,48509
25-09-2014,20,17075,16127,7838,3127,44168,1409,255,590,2254,46422
25-09-2014,21,16113,14673,7517,2829,41132,1375,244,517,2136,43268
25-09-2014,22,14645,13568,7129,2760,38101,1296,229,321,1846,39947
25-09-2014,23,12929,13162,6765,2597,35453,1188,218,325,1731,37184
26-09-2014,0,11838,12348,6489,2637,33312,1178,204,298,1680,34992
26-09-2014,1,11765,11847,6383,2536,32532,1158,204,318,1680,34212
26-09-2014,2,11680,11639,6347,2429,32095,1151,202,294,1647,33742
26-09-2014,3,11580,11933,6334,2452,32300,1182,208,292,1682,33982
26-09-2014,4,11734,12124,6629,2652,33137,1267,236,296,1799,34936
26-09-2014,5,12592,13239,7363,2441,35635,1414,256,293,1963,37598
26-09-2014,6,15240,14770,8239,3135,41383,1487,347,455,2289,43672
26-09-2014,7,16714,16668,8653,3573,45609,1495,614,478,2587,48196
26-09-2014,8,17283,16757,8626,3773,46441,1497,780,490,2767,49208
26-09-2014,9,17199,16700,8638,4052,46590,1490,733,489,2712,49302
26-09-2014,10,16837,16694,8605,4505,46641,1490,657,488,2635,49276
26-09-2014,11,16168,16334,8551,4813,45865,1503,638,465,2606,48471
26-09-2014,12,15771,15838,8087,5011,44707,1486,563,460,2509,47216
26-09-2014,13,14741,15708,7852,5013,43314,1524,481,446,2451,45765
26-09-2014,14,14460,15267,7777,5099,42604,1533,471,429,2433,45037
26-09-2014,15,14285,14962,7655,5146,42047,1563,449,401,2413,44460
26-09-2014,16,14437,14944,7536,5358,42276,1556,447,339,2342,44618
26-09-2014,17,15519,14972,7907,5261,43660,1613,465,480,2558,46218
26-09-2014,18,15600,15254,8372,4952,44177,1612,610,493,2715,46892
26-09-2014,19,15831,15425,7836,4779,43871,1633,471,520,2624,46495
26-09-2014,20,15363,15211,7161,4689,42425,1497,464,423,2384,44809
26-09-2014,21,14243,14839,6631,4472,40185,1505,459,434,2398,42583
26-09-2014,22,12141,14596,6322,4116,37175,1502,457,446,2405,39580
26-09-2014,23,10301,14314,6048,3739,34403,1487,418,450,2355,36758
27-09-2014,0,9267,13934,6046,3622,32871,1293,240,457,1990,34861
27-09-2014,1,8786,13617,6080,3504,31986,1245,232,438,1915,33901
27-09-2014,2,8887,13504,6081,3437,31908,1221,234,425,1880,33788
27-09-2014,3,8475,13526,6093,3264,31359,1195,234,424,1853,33212
27-09-2014,4,8570,13552,6119,3146,31387,1192,241,424,1857,33244
27-09-2014,5,9095,13687,6109,3194,32087,1205,245,402,1852,33939
27-09-2014,6,10405,13900,6233,3215,33755,1179,254,398,1831,35586
27-09-2014,7,12138,14080,6398,3414,36030,1171,262,420,1853,37883
27-09-2014,8,13815,14618,6584,3632,38649,1182,272,402,1856,40505
27-09-2014,9,14553,15051,6631,3848,40083,1226,272,426,1924,42007
27-09-2014,10,14438,15081,6532,4348,40398,1262,271,436,1969,42367
27-09-2014,11,13227,14765,6380,4588,38960,1249,264,455,1968,40928
27-09-2014,12,11965,14610,6466,4323,37362,1241,259,457,1957,39319
27-09-2014,13,11030,14628,6440,4183,36280,1227,249,455,1931,38211
27-09-2014,14,10635,14523,6513,4076,35748,1232,248,448,1928,37676
27-09-2014,15,11083,14624,6557,3782,36047,1221,245,437,1903,37950
27-09-2014,16,11912,14732,6649,3575,36867,1206,241,421,1868,38735
27-09-2014,17,13348,14546,6876,3335,38105,1195,241,400,1836,39941
27-09-2014,18,15003,14902,7004,3030,39939,1280,256,466,2002,41941
27-09-2014,19,16055,15482,7140,2858,41534,1267,254,561,2082,43616
27-09-2014,20,15621,15125,6772,2769,40287,1152,255,566,1973,42260
27-09-2014,21,14102,14487,6607,2702,37897,1152,253,401,1806,39703
27-09-2014,22,13267,13684,6420,2525,35896,1155,234,387,1776,37672
27-09-2014,23,11095,13036,6256,2424,32812,1192,224,417,1833,34645
28-09-2014,0,9585,12890,6011,2271,30757,1094,218,376,1688,32445
28-09-2014,1,9126,12627,5923,2255,29931,1085,219,371,1675,31606
28-09-2014,2,8863,12479,5910,2342,29594,1079,220,359,1658,31252
28-09-2014,3,8703,12529,6013,2263,29507,1084,221,347,1652,31159
28-09-2014,4,8778,12505,5989,2284,29557,1100,232,344,1676,31233
28-09-2014,5,9535,12441,6005,2236,30219,1133,241,364,1738,31957
28-09-2014,6,9871,12599,6044,2329,30842,1122,254,369,1745,32587
28-09-2014,7,10655,12627,6216,2582,32080,1127,257,417,1801,33881
28-09-2014,8,11423,12593,6403,2834,33252,1212,264,533,2009,35261
28-09-2014,9,12525,12569,6552,2854,34501,1205,270,570,2045,36546
28-09-2014,10,13322,12936,6691,2918,35869,1194,274,553,2021,37890
28-09-2014,11,13337,13085,6666,3132,36221,1206,273,566,2045,38266
28-09-2014,12,13056,13082,6744,3270,36153,1192,275,557,2024,38177
28-09-2014,13,13159,13117,6629,3214,36119,1211,269,523,2003,38122
28-09-2014,14,12806,13232,6656,3033,35727,1219,273,518,2010,37737
28-09-2014,15,12504,13276,6759,2806,35345,1222,274,495,1991,37336
28-09-2014,16,12967,13650,6639,2475,35731,1209,274,506,1989,37720
28-09-2014,17,13838,14168,6618,2320,36943,1210,276,548,2034,38977
28-09-2014,18,15570,14753,6439,2236,38998,1123,348,542,2013,41011
28-09-2014,19,16776,15907,6569,2424,41676,1206,404,571,2181,43857
28-09-2014,20,16585,15707,6552,2643,41488,1194,399,502,2095,43583
28-09-2014,21,16296,14533,6459,2572,39862,1071,284,414,1769,41631
28-09-2014,22,15655,13883,6450,2469,38458,1045,263,402,1710,40168
28-09-2014,23,13392,13079,6308,2303,35082,1061,237,396,1694,36776
29-09-2014,0,10493,12689,6148,1717,31048,1230,224,391,1845,32893
29-09-2014,1,9363,12346,6048,1651,29408,1229,219,383,1831,31239
29-09-2014,2,8712,12451,6008,1867,29039,1238,214,370,1822,30861
29-09-2014,3,8875,12477,6048,1829,29229,1240,213,351,1804,31033
29-09-2014,4,10118,12688,6136,1513,30456,1255,228,351,1834,32290
29-09-2014,5,12375,13447,6572,1613,34007,1252,260,354,1866,35873
29-09-2014,6,15989,14695,7148,2221,40055,1337,446,559,2342,42397
29-09-2014,7,17759,16176,7630,2549,44115,1397,531,691,2619,46734
29-09-2014,8,18182,16484,7759,2763,45187,1406,693,693,2792,47979
29-09-2014,9,18142,16515,7780,2581,45018,1411,705,694,2810,47828
29-09-2014,10,17949,16622,7736,2665,44972,1430,623,705,2758,47730
29-09-2014,11,17698,16460,7709,2686,44552,1416,567,702,2685,47237
29-09-2014,12,17540,15993,7300,2733,43566,1399,623,692,2714,46280
29-09-2014,13,17219,15930,7136,2555,42840,1432,604,704,2740,45580
29-09-2014,14,17214,15638,7141,2525,42518,1454,582,680,2716,45234
29-09-2014,15,17056,15574,7133,2428,42190,1458,514,660,2632,44822
29-09-2014,16,16972,15484,7090,2425,41971,1423,510,644,2577,44548
29-09-2014,17,17303,16470,7362,2484,43618,1442,421,631,2494,46112
29-09-2014,18,17432,17379,7604,2486,44901,1468,634,634,2736,47637
29-09-2014,19,17744,17466,7625,2533,45368,1503,696,637,2836,48204
29-09-2014,20,17393,16626,7272,2491,43781,1478,510,632,2620,46401
29-09-2014,21,17197,15321,7188,2073,41778,1431,440,354,2225,44003
29-09-2014,22,16481,13984,7093,2053,39611,1418,336,319,2073,41684
29-09-2014,23,14487,12751,6834,1939,36012,1402,230,333,1965,37977
30-09-2014,0,13331,12113,6707,1820,33972,1333,210,305,1848,35820
30-09-2014,1,12214,11793,6645,1641,32293,1342,209,305,1856,34149
30-09-2014,2,11086,11694,6405,1751,30936,1344,219,295,1858,32794
30-09-2014,3,11102,11707,6413,1758,30981,1333,220,296,1849,32830
30-09-2014,4,12570,11951,6485,1756,32761,1366,234,299,1899,34660
30-09-2014,5,14320,13155,6863,1878,36216,1375,251,318,1944,38160
30-09-2014,6,16342,15595,7350,2464,41750,1483,278,610,2371,44121
30-09-2014,7,18346,17254,7781,2830,46212,1517,503,657,2677,48889
30-09-2014,8,18600,17947,8060,3019,47625,1565,626,663,2854,50479
30-09-2014,9,18498,18148,8002,3145,47793,1502,633,630,2765,50558
30-09-2014,10,18333,18112,8094,3183,47722,1502,652,611,2765,50487
30-09-2014,11,18086,17699,8080,3176,47042,1499,549,589,2637,49679
30-09-2014,12,17287,16816,7617,3077,44797,1483,609,592,2684,47481
30-09-2014,13,17432,16098,7552,3098,44182,1470,609,590,2669,46851
30-09-2014,14,17674,15523,7524,2985,43704,1453,603,588,2644,46348
30-09-2014,15,17522,15634,7504,3180,43840,1441,518,605,2564,46404
30-09-2014,16,17419,15724,7378,3070,43592,1463,426,623,2512,46104
30-09-2014,17,17721,16674,7733,3076,45204,1461,339,640,2440,47644
30-09-2014,18,17896,17463,8035,3109,46503,1468,553,640,2661,49164
30-09-2014,19,18095,17763,8007,3310,47174,1484,619,660,2763,49937
30-09-2014,20,17770,16727,7752,3227,45475,1398,447,672,2517,47992
30-09-2014,21,17357,15708,7623,2835,43522,1399,242,488,2129,45651
30-09-2014,22,16596,14012,7427,2761,40796,1375,235,377,1987,42783
30-09-2014,23,15373,12698,7199,2693,37962,1314,219,366,1899,39861
01-10-2014,0,14082,12157,7068,2453,35759,1313,204,356,1873,37632
01-10-2014,1,13455,11968,6951,2230,34605,1296,204,353,1853,36458
01-10-2014,2,12234,11953,6878,2180,33247,1291,208,354,1853,35100
01-10-2014,3,11483,11991,6883,2239,32595,1282,217,355,1854,34449
01-10-2014,4,12578,12221,6948,2245,33993,1292,232,352,1876,35869
01-10-2014,5,15564,13512,7283,2368,38727,1381,251,353,1985,40712
01-10-2014,6,17155,16172,7980,2632,43939,1373,418,640,2431,46370
01-10-2014,7,18271,18454,8301,2893,47920,1336,590,681,2607,50527
01-10-2014,8,18537,18675,8446,3043,48703,1337,695,665,2697,51400
01-10-2014,9,18432,18632,8432,2967,48464,1341,672,637,2650,51114
01-10-2014,10,18168,18517,8345,3131,48161,1343,667,621,2631,50792
01-10-2014,11,18248,18447,8307,3102,48103,1343,590,602,2535,50638
01-10-2014,12,17870,17860,8020,3061,46813,1342,609,595,2546,49359
01-10-2014,13,17619,17478,7867,2907,45871,1338,602,594,2534,48405
01-10-2014,14,17646,17241,7874,2841,45603,1339,571,602,2512,48115
01-10-2014,15,17986,17096,7990,2947,46020,1334,526,602,2462,48482
01-10-2014,16,17912,17226,7954,2966,46057,1333,460,629,2422,48479
01-10-2014,17,17741,17607,8056,2934,46339,1361,468,611,2440,48779
01-10-2014,18,17902,17970,8315,3116,47305,1345,604,644,2593,49898
01-10-2014,19,17985,18030,8197,3239,47451,1364,626,692,2682,50133
01-10-2014,20,17364,17289,7758,3055,45465,1374,459,702,2535,48000
01-10-2014,21,17107,15999,7582,2827,43516,1380,309,474,2163,45679
01-10-2014,22,16432,14206,7492,2770,40899,1379,269,355,2003,42902
01-10-2014,23,15378,13144,7338,2672,38532,1379,261,372,2012,40544
02-10-2014,0,14241,12342,7212,2447,36241,1382,249,377,2008,38249
02-10-2014,1,13088,12060,7038,2179,34367,1368,248,371,1987,36354
02-10-2014,2,12051,11942,6948,2011,32952,1381,249,370,2000,34952
02-10-2014,3,11600,11867,6946,1861,32275,1398,250,367,2015,34290
02-10-2014,4,12104,11855,7015,1985,32959,1403,257,368,2028,34987
02-10-2014,5,14509,12989,7315,2150,36962,1398,275,390,2063,39025
02-10-2014,6,16808,15789,7938,2628,43162,1393,460,639,2492,45654
02-10-2014,7,18376,17734,8195,3050,47355,1401,573,714,2688,50043
02-10-2014,8,18579,17990,8319,3140,48027,1408,565,819,2792,50819
02-10-2014,9,18707,17956,8250,3160,48074,1405,563,776,2744,50818
02-10-2014,10,18621,18235,8330,3235,48421,1402,540,767,2709,51130
02-10-2014,11,18237,18045,8211,3239,47732,1427,614,595,2636,50368
02-10-2014,12,18020,17488,7959,3196,46664,1415,638,601,2654,49318
02-10-2014,13,17938,16976,7820,3127,45862,1409,622,604,2635,48497
02-10-2014,14,17972,16599,7814,3027,45412,1394,553,604,2551,47963
02-10-2014,15,17979,16680,7994,2988,45642,1402,534,608,2544,48186
02-10-2014,16,17975,16778,7927,2841,45519,1393,436,626,2455,47974
02-10-2014,17,17806,17204,7967,2841,45817,1388,448,644,2480,48297
02-10-2014,18,17768,17745,8309,2781,46603,1396,588,652,2636,49239
02-10-2014,19,18100,17689,8208,3150,47146,1407,622,673,2702,49848
02-10-2014,20,17806,16853,7916,2859,45433,1412,458,678,2548,47981
02-10-2014,21,17584,15516,7696,2515,43311,1404,289,443,2136,45447
02-10-2014,22,17076,14226,7369,2303,40976,1409,252,325,1986,42962
02-10-2014,23,15805,12741,7123,2127,37796,1409,244,314,1967,39763
03-10-2014,0,13770,11726,6830,1757,34082,1390,235,314,1939,36021
03-10-2014,1,12876,11284,6742,1838,32741,1382,235,357,1974,34715
03-10-2014,2,11757,11392,6760,2008,31917,1375,236,331,1942,33859
03-10-2014,3,11499,11479,6745,2053,31777,1374,238,304,1916,33693
03-10-2014,4,12009,11775,6824,1974,32581,1369,246,303,1918,34499
03-10-2014,5,13891,12617,7069,1992,35569,1372,256,304,1932,37501
03-10-2014,6,16653,14603,7731,2435,41421,1378,388,485,2251,43672
03-10-2014,7,18312,17087,8412,2896,46708,1379,550,635,2564,49272
03-10-2014,8,18681,17426,8447,2926,47480,1380,653,739,2772,50252
03-10-2014,9,18563,16658,8279,2815,46317,1361,719,642,2722,49039
03-10-2014,10,18617,16504,8359,2752,46232,1366,570,769,2705,48937
03-10-2014,11,18054,16191,8311,2809,45364,1362,617,584,2563,47927
03-10-2014,12,17836,15868,7780,2786,44270,1358,511,478,2347,46617
03-10-2014,13,17383,15350,7509,2768,43009,1362,499,436,2297,45306
03-10-2014,14,16891,15245,7513,2671,42320,1360,499,390,2249,44569
03-10-2014,15,16746,14983,7698,2530,41959,1364,500,464,2328,44287
03-10-2014,16,17058,15047,7662,2401,42170,1362,482,464,2308,44478
03-10-2014,17,17775,15738,7831,2802,44145,1360,549,522,2431,46576
03-10-2014,18,18198,16172,8270,2773,45414,1361,615,607,2583,47997
03-10-2014,19,18277,16326,7753,2849,45206,1368,618,417,2403,47609
03-10-2014,20,17683,15553,6846,2727,42810,1364,517,374,2255,45065
03-10-2014,21,16821,14687,6429,2117,40054,1373,308,426,2107,42161
03-10-2014,22,14447,13527,6574,1859,36408,1371,272,311,1954,38362
03-10-2014,23,13001,12436,6623,1879,33941,1337,260,314,1911,35852
04-10-2014,0,11441,12013,6422,1766,31642,997,246,107,1350,32992
04-10-2014,1,10712,11854,6360,1805,30730,995,244,46,1285,32015
04-10-2014,2,10332,11796,6365,1831,30324,985,246,48,1279,31603
04-10-2014,3,10227,11779,6285,1935,30228,977,244,46,1267,31495
04-10-2014,4,10346,11724,6270,2026,30366,974,265,44,1283,31649
04-10-2014,5,10780,11618,6345,2131,30876,995,291,42,1328,32204
04-10-2014,6,11168,11916,6642,2324,32051,1073,399,60,1532,33583
04-10-2014,7,13883,12457,6695,2722,35758,1091,429,40,1560,37318
04-10-2014,8,15223,13663,6873,2964,38725,1086,427,53,1566,40291
04-10-2014,9,15777,14030,6878,3137,39824,1086,426,53,1565,41389
04-10-2014,10,15684,13497,6962,3101,39244,1085,430,60,1575,40819
04-10-2014,11,15163,13391,6919,3437,38910,1088,429,60,1577,40487
04-10-2014,12,14642,12910,6884,3732,38170,1088,428,61,1577,39747
04-10-2014,13,14589,12699,6823,3709,37820,1079,426,56,1561,39381
04-10-2014,14,14361,12810,6722,3628,37520,1067,425,56,1548,39068
04-10-2014,15,14033,13187,6715,3502,37437,1065,426,55,1546,38983
04-10-2014,16,14592,13347,6762,3425,38126,1066,421,42,1529,39655
04-10-2014,17,15451,14392,6770,3306,39919,1079,435,53,1567,41486
04-10-2014,18,16362,15199,7089,3259,41907,1087,696,56,1839,43746
04-10-2014,19,16522,15921,7051,3392,42885,1094,618,61,1773,44658
04-10-2014,20,15597,14343,6914,3651,40505,1113,457,63,1633,42138
04-10-2014,21,13877,13282,6655,3499,37313,1099,266,66,1431,38744
04-10-2014,22,12219,12942,6664,3448,35273,1121,261,57,1439,36712
04-10-2014,23,10920,12774,6504,3394,33593,1123,249,53,1425,35018
05-10-2014,0,9882,12238,6298,3173,31593,1140,238,52,1430,33023
05-10-2014,1,9289,12016,6251,2978,30532,1134,237,51,1422,31954
05-10-2014,2,8856,11941,6206,2845,29848,1121,238,51,1410,31258
05-10-2014,3,8876,11906,6185,2541,29507,1123,238,53,1414,30921
05-10-2014,4,8879,11904,6184,2284,29251,1133,242,51,1426,30677
05-10-2014,5,9242,11954,6295,2280,29769,1132,345,46,1523,31292
05-10-2014,6,9882,12178,6585,2252,30897,1161,419,47,1627,32524
05-10-2014,7,10911,12493,6723,2166,32294,1147,431,44,1622,33916
05-10-2014,8,12423,12820,6777,2222,34244,1125,439,58,1622,35866
05-10-2014,9,15053,13081,6814,2285,37234,1124,438,55,1617,38851
05-10-2014,10,16110,13683,6900,2396,39088,1146,438,49,1633,40721
05-10-2014,11,16165,13817,6854,2455,39293,1100,437,49,1586,40879
05-10-2014,12,15525,13237,6736,2209,37707,1141,435,54,1630,39337
05-10-2014,13,14909,12938,6736,2319,36902,1133,433,56,1622,38524
05-10-2014,14,14738,12949,6714,2464,36864,1106,434,58,1598,38462
05-10-2014,15,14585,12928,6775,2553,36840,1107,436,64,1607,38447
05-10-2014,16,15646,13251,6820,2510,38227,1116,436,65,1617,39844
05-10-2014,17,16208,14819,7021,2481,40529,1118,445,74,1637,42166
05-10-2014,18,17260,16921,7211,2674,44064,1158,669,91,1918,45982
05-10-2014,19,17512,17284,7257,2953,45005,1196,640,132,1968,46973
05-10-2014,20,16863,16469,7088,3064,43484,1199,483,145,1827,45311
05-10-2014,21,16430,15568,6937,2934,41871,1188,275,135,1598,43469
05-10-2014,22,15378,14512,6863,2912,39664,1185,267,127,1579,41243
05-10-2014,23,13284,13365,6744,2718,36111,1183,259,139,1581,37692
06-10-2014,0,10183,13095,6492,2696,32466,1264,258,132,1654,34120
06-10-2014,1,9480,12898,6464,2743,31585,1242,260,140,1642,33227
06-10-2014,2,8930,12860,6350,2965,31106,1238,259,136,1633,32739
06-10-2014,3,8759,12829,6311,3067,30967,1235,264,143,1642,32609
06-10-2014,4,9270,12891,6410,3109,31680,1241,273,150,1664,33344
06-10-2014,5,11270,13771,6751,3263,35057,1377,296,154,1827,36884
06-10-2014,6,15672,15584,7320,3860,42438,1511,568,295,2374,44812
06-10-2014,7,16846,17953,7859,4144,46802,1518,706,336,2560,49362
06-10-2014,8,17136,18374,7978,4493,47980,1516,915,350,2781,50761
06-10-2014,9,16921,18278,7917,4799,47915,1504,884,353,2741,50656
06-10-2014,10,17047,18148,7881,5221,48298,1491,808,365,2664,50962
06-10-2014,11,16372,17967,7828,5746,47914,1498,659,355,2512,50426
06-10-2014,12,15539,17558,7409,6067,46573,1505,585,383,2473,49046
06-10-2014,13,14783,17402,7131,5801,45118,1510,579,383,2472,47590
06-10-2014,14,14768,17067,7255,5689,44779,1514,493,392,2399,47178
06-10-2014,15,15145,17161,7431,5869,45606,1500,542,382,2424,48030
06-10-2014,16,15532,17300,7459,5893,46185,1487,547,383,2417,48602
06-10-2014,17,15991,17874,7609,5732,47206,1479,654,369,2502,49708
06-10-2014,18,16513,18295,7918,5742,48468,1483,928,362,2773,51241
06-10-2014,19,16666,18394,7546,5783,48389,1484,650,351,2485,50874
06-10-2014,20,15902,17348,7036,5840,46125,1466,594,313,2373,48498
06-10-2014,21,14806,15845,6906,5438,42995,1470,300,325,2095,45090
06-10-2014,22,13600,14864,6754,4787,40004,1486,283,200,1969,41973
06-10-2014,23,11901,14057,6619,4542,37118,1506,259,182,1947,39065
07-10-2014,0,11027,13558,6580,4671,35836,1436,270,152,1858,37694
07-10-2014,1,10193,13403,6529,4730,34855,1434,286,157,1877,36732
07-10-2014,2,9999,13254,6496,4713,34463,1455,286,163,1904,36367
07-10-2014,3,10102,13320,6442,4752,34616,1465,282,154,1901,36517
07-10-2014,4,10399,13509,6476,4719,35104,1479,294,155,1928,37032
07-10-2014,5,11833,14222,6837,4745,37638,1526,297,177,2000,39638
07-10-2014,6,14538,15825,7487,5435,43285,1552,583,352,2487,45772
07-10-2014,7,16390,17279,7902,5578,47149,1558,817,393,2768,49917
07-10-2014,8,16806,17586,7966,5489,47847,1546,951,418,2915,50762
07-10-2014,9,16930,17642,7959,5472,48002,1543,951,405,2899,50901
07-10-2014,10,16874,17558,8043,5531,48007,1551,923,404,2878,50885
07-10-2014,11,16632,18034,7886,5445,47998,1560,812,404,2776,50774
07-10-2014,12,16181,17540,7556,5514,46792,1552,600,366,2518,49310
07-10-2014,13,15592,17236,7508,5472,45810,1552,577,366,2495,48305
07-10-2014,14,15492,17081,7326,5105,45003,1488,500,414,2402,47405
07-10-2014,15,15591,17352,7485,5054,45482,1512,719,395,2626,48108
07-10-2014,16,15277,17733,7449,4979,45438,1476,680,380,2536,47974
07-10-2014,17,15844,17989,7547,5283,46662,1521,711,373,2605,49267
07-10-2014,18,16839,18487,7881,5157,48364,1552,917,386,2855,51219
07-10-2014,19,16770,18870,7562,5084,48286,1550,607,390,2547,50833
07-10-2014,20,15379,17774,7261,5007,45422,1552,573,278,2403,47825
07-10-2014,21,14069,16379,6876,4814,42139,1573,470,253,2296,44435
07-10-2014,22,13107,15348,6621,4317,39393,1547,466,242,2255,41648
07-10-2014,23,11355,14994,6412,4180,36942,1544,413,242,2199,39141
08-10-2014,0,10049,14592,6366,4126,35134,1479,281,244,2004,37138
08-10-2014,1,9252,14498,6345,4281,34377,1459,220,243,1922,36299
08-10-2014,2,9000,14294,6336,4396,34027,1461,220,234,1915,35942
08-10-2014,3,8998,14155,6316,4240,33709,1477,216,249,1942,35651
08-10-2014,4,9159,14272,6448,4150,34028,1496,232,239,1967,35995
08-10-2014,5,10863,15280,6764,4154,37062,1506,249,261,2016,39078
08-10-2014,6,14614,16650,7150,4928,43342,1622,538,401,2561,45903
08-10-2014,7,16801,18024,7411,5400,47636,1713,816,415,2944,50580
08-10-2014,8,17023,18068,7511,5432,48035,1743,985,434,3162,51197
08-10-2014,9,17446,17620,7657,5312,48036,1627,988,423,3038,51074
08-10-2014,10,17397,18022,7610,5327,48356,1656,948,424,3028,51384
08-10-2014,11,17431,18057,7495,5233,48215,1670,839,400,2909,51124
08-10-2014,12,17221,17953,7277,5094,47546,1667,514,400,2581,50127
08-10-2014,13,17256,17682,7167,4840,46944,1646,513,390,2549,49493
08-10-2014,14,17027,17555,7151,4590,46323,1625,476,368,2469,48792
08-10-2014,15,17132,17703,7272,4344,46452,1609,889,338,2836,49288
08-10-2014,16,16750,17754,7431,4028,45963,1583,779,300,2662,48625
08-10-2014,17,17267,18512,7604,4028,47411,1574,852,289,2715,50126
08-10-2014,18,17421,18822,7952,3965,48161,1584,1053,312,2949,51110
08-10-2014,19,17828,18503,7532,4087,47951,1573,706,264,2543,50494
08-10-2014,20,16944,16623,7116,4165,44848,1558,567,215,2340,47188
08-10-2014,21,15474,14876,6927,4130,41407,1543,406,207,2156,43563
08-10-2014,22,13987,14193,6841,4109,39130,1516,389,96,2001,41131
08-10-2014,23,11782,13529,6626,3844,35781,1522,337,100,1959,37740
09-10-2014,0,10287,13183,6314,3720,33503,1436,191,96,1723,35226
09-10-2014,1,9630,12945,6238,3788,32600,1417,190,88,1695,34295
09-10-2014,2,9082,12903,6311,3750,32047,1404,189,91,1684,33731
09-10-2014,3,9369,12953,6323,3498,32141,1390,188,90,1668,33809
09-10-2014,4,10020,13036,6402,3559,33016,1383,201,101,1685,34701
09-10-2014,5,11497,13939,6813,3790,36038,1403,230,137,1770,37808
09-10-2014,6,14500,15782,7355,4655,42291,1482,517,359,2358,44649
09-10-2014,7,17176,17911,7826,5063,47977,1493,801,383,2677,50654
09-10-2014,8,17431,18377,7818,5083,48708,1570,927,380,2877,51585
09-10-2014,9,17541,18272,7869,5042,48724,1468,936,362,2766,51490
09-10-2014,10,17581,17670,7818,4920,47991,1459,931,341,2731,50722
09-10-2014,11,17033,17403,7752,4953,47140,1465,855,314,2634,49774
09-10-2014,12,16427,17203,7367,4945,45941,1464,495,329,2288,48229
09-10-2014,13,16199,16685,7240,4943,45067,1456,443,310,2209,47276
09-10-2014,14,16415,16511,7261,4858,45044,1471,442,311,2224,47268
09-10-2014,15,16985,16857,7356,4583,45782,1482,815,283,2580,48362
09-10-2014,16,17323,17007,7368,4594,46292,1493,813,260,2566,48858
09-10-2014,17,17662,17763,7673,4411,47510,1506,859,264,2629,50139
09-10-2014,18,18067,17911,8109,4273,48360,1520,958,318,2796,51156
09-10-2014,19,18169,17805,7640,4236,47850,1513,486,289,2288,50138
09-10-2014,20,17727,16781,7148,4190,45847,1507,404,245,2156,48003
09-10-2014,21,16994,15234,6740,4035,43004,1518,409,282,2209,45213
09-10-2014,22,15127,14234,6561,4010,39931,1519,408,71,1998,41929
09-10-2014,23,12402,13578,6312,3743,36034,1516,346,69,1931,37965
10-10-2014,0,10553,13500,6153,3861,34066,1419,186,74,1679,35745
10-10-2014,1,9971,13239,6130,4037,33378,1337,185,79,1601,34979
10-10-2014,2,9529,13121,6093,4242,32983,1313,185,81,1579,34562
10-10-2014,3,9558,13284,6040,4067,32950,1324,189,92,1605,34555
10-10-2014,4,10111,13298,6251,4084,33743,1345,201,102,1648,35391
10-10-2014,5,11559,13918,6953,4300,36731,1373,227,212,1812,38543
10-10-2014,6,14687,15735,7615,5269,43306,1364,735,274,2373,45679
10-10-2014,7,16835,17409,7955,5560,47759,1378,943,279,2600,50359
10-10-2014,8,17480,17527,8170,5413,48590,1383,1048,270,2701,51291
10-10-2014,9,17470,17262,8199,5411,48342,1392,990,276,2658,51000
10-10-2014,10,17504,17268,8154,5409,48336,1386,924,243,2553,50889
10-10-2014,11,17302,17537,8082,5378,48297,1380,886,260,2526,50823
10-10-2014,12,17105,17009,7819,5439,47373,1376,461,261,2098,49471
10-10-2014,13,16892,16671,7528,5480,46570,1373,409,257,2039,48609
10-10-2014,14,16713,16768,7462,4970,45912,1380,427,236,2043,47955
10-10-2014,15,16234,17039,7493,4799,45565,1401,841,209,2451,48016
10-10-2014,16,16416,16864,7527,4373,45180,1407,819,199,2425,47605
10-10-2014,17,16968,17318,7788,4015,46090,1380,841,199,2420,48510
10-10-2014,18,17442,17896,8167,3771,47274,1386,1018,256,2660,49934
10-10-2014,19,17595,17925,7535,3665,46721,1395,589,215,2199,48920
10-10-2014,20,16996,16964,7012,3546,44520,1404,427,188,2019,46539
10-10-2014,21,16500,15448,6719,3458,42124,1419,404,175,1998,44122
10-10-2014,22,15619,14476,6567,3085,39748,1421,394,57,1872,41620
10-10-2014,23,13767,13831,6381,2659,36638,1422,368,53,1843,38481
11-10-2014,0,13191,13445,6195,2317,35147,1259,206,54,1519,36666
11-10-2014,1,11962,13323,6207,2377,33868,1220,194,57,1471,35339
11-10-2014,2,11577,13250,6305,2237,33370,1220,191,59,1470,34840
11-10-2014,3,11362,13007,6216,2326,32911,1225,192,55,1472,34383
11-10-2014,4,11556,12875,6144,2323,32898,1224,205,51,1480,34378
11-10-2014,5,12132,13027,6264,2425,33848,1233,207,46,1486,35334
11-10-2014,6,13414,13205,6642,2505,35767,1227,207,62,1496,37263
11-10-2014,7,15079,13753,6761,2541,38136,1231,208,44,1483,39619
11-10-2014,8,16473,14953,6826,2644,40898,1209,209,43,1461,42359
11-10-2014,9,17280,15757,7003,2809,42848,1228,208,42,1478,44326
11-10-2014,10,17285,16383,7013,2975,43656,1239,207,40,1486,45142
11-10-2014,11,17231,16396,7046,2983,43655,1258,208,40,1506,45161
11-10-2014,12,17010,15941,7113,2911,42976,1234,209,40,1483,44459
11-10-2014,13,16051,14960,6871,2723,40606,1204,206,45,1455,42061
11-10-2014,14,15805,14469,6699,2485,39460,1200,204,83,1487,40947
11-10-2014,15,15917,14606,6694,2443,39661,1198,203,140,1541,41202
11-10-2014,16,16801,15058,6778,2447,41084,1176,199,271,1646,42730
11-10-2014,17,17269,17145,7158,2393,43966,1164,196,300,1660,45626
11-10-2014,18,17691,18206,7494,2506,45898,1179,197,306,1682,47580
11-10-2014,19,17474,18253,7349,2570,45646,1179,198,319,1696,47342
11-10-2014,20,16959,16825,7024,2571,43379,1180,199,328,1707,45086
11-10-2014,21,16591,14654,6703,2551,40500,1159,196,335,1690,42190
11-10-2014,22,15541,13609,6477,2462,38089,1152,191,334,1677,39766
11-10-2014,23,14205,12745,6117,2215,35282,1151,184,339,1674,36956
12-10-2014,0,13129,12458,6109,2229,33923,1119,183,350,1652,35575
12-10-2014,1,11795,12314,6004,2195,32308,1093,185,351,1629,33937
12-10-2014,2,11544,12351,5939,2024,31859,1089,187,377,1653,33512
12-10-2014,3,11201,12383,5954,2055,31592,1078,188,391,1657,33249
12-10-2014,4,11343,12377,5950,1973,31644,1079,199,373,1651,33295
12-10-2014,5,11778,12425,5930,2195,32329,1082,206,364,1652,33981
12-10-2014,6,12380,12460,6014,2391,33244,1089,204,352,1645,34889
12-10-2014,7,12501,12576,6139,2417,33632,1087,213,371,1671,35303
12-10-2014,8,14109,12896,6195,2512,35713,1092,213,348,1653,37366
12-10-2014,9,15591,13250,6369,2793,38004,1100,241,324,1665,39669
12-10-2014,10,16645,13888,6423,2965,39921,1094,245,333,1672,41593
12-10-2014,11,16932,13972,6388,3055,40348,1174,245,324,1743,42091
12-10-2014,12,16408,13953,6339,2958,39659,1172,228,342,1742,41401
12-10-2014,13,16075,13849,6310,2920,39154,1173,226,364,1763,40917
12-10-2014,14,15834,13781,6341,2835,38792,1179,225,388,1792,40584
12-10-2014,15,15628,13989,6388,2620,38625,1184,228,386,1798,40423
12-10-2014,16,15861,14346,6498,2451,39156,1158,228,394,1780,40936
12-10-2014,17,16698,15117,6601,2299,40716,1140,282,390,1812,42528
12-10-2014,18,17747,16998,7034,2240,44020,1145,371,577,2093,46113
12-10-2014,19,18023,17647,7109,2212,44990,1150,398,561,2109,47099
12-10-2014,20,17772,16770,6862,2122,43526,1157,217,446,1820,45346
12-10-2014,21,17112,15423,6343,2094,40971,1152,217,387,1756,42727
12-10-2014,22,16215,14279,6166,1951,38610,1125,212,344,1681,40291
12-10-2014,23,14558,13431,6226,1629,35844,1109,196,353,1658,37502
13-10-2014,0,12250,13168,6293,1669,33381,1117,192,319,1628,35009
13-10-2014,1,12058,12816,6163,1443,32481,1106,191,334,1631,34112
13-10-2014,2,11819,12617,6191,1502,32130,1088,190,331,1609,33739
13-10-2014,3,12015,12571,6260,1620,32466,1086,189,324,1599,34065
13-10-2014,4,12701,12662,6424,1853,33639,1115,198,318,1631,35270
13-10-2014,5,14248,13523,6853,2071,36695,1200,214,312,1726,38421
13-10-2014,6,16333,16356,7528,2644,42862,1203,374,590,2167,45029
13-10-2014,7,18172,19690,7953,3109,48923,1203,757,607,2567,51490
13-10-2014,8,18365,20062,8006,3319,49752,1190,945,613,2748,52500
13-10-2014,9,18211,19966,8060,3587,49823,1166,988,608,2762,52585
13-10-2014,10,18203,19728,7941,3764,49637,1172,921,598,2691,52328
13-10-2014,11,18568,19703,8024,3769,50064,1163,892,565,2620,52684
13-10-2014,12,18895,19222,7709,3675,49503,1145,506,591,2242,51745
13-10-2014,13,18752,19335,7508,3700,49295,1140,452,596,2188,51483
13-10-2014,14,18411,19253,7437,3666,48767,1176,474,561,2211,50978
13-10-2014,15,18040,19025,7499,3623,48188,1169,772,570,2511,50699
13-10-2014,16,17807,19029,7536,3537,47910,1161,656,606,2423,50333
13-10-2014,17,18333,19673,7916,3337,49260,1160,738,613,2511,51771
13-10-2014,18,18793,19933,8181,3490,50397,1169,938,653,2760,53157
13-10-2014,19,18988,19828,7881,3132,49830,1174,533,657,2364,52194
13-10-2014,20,18588,19115,7324,2770,47797,1174,424,535,2133,49930
13-10-2014,21,17368,18061,6989,2963,45382,1182,210,542,1934,47316
13-10-2014,22,15790,16538,6966,3028,42321,1165,203,368,1736,44057
13-10-2014,23,14660,15035,6864,2940,39500,1085,193,371,1649,41149
14-10-2014,0,13816,13864,6518,2528,36727,1075,187,362,1624,38351
14-10-2014,1,12906,13342,6361,2197,34807,1073,188,401,1662,36469
14-10-2014,2,12345,13220,6324,2249,34138,1077,192,367,1636,35774
14-10-2014,3,12250,13269,6327,2234,34081,1070,197,353,1620,35701
14-10-2014,4,13044,13361,6496,2221,35121,1081,208,340,1629,36750
14-10-2014,5,14558,14203,6806,2529,38097,1150,214,364,1728,39825
14-10-2014,6,17797,16638,7393,2774,44603,1157,432,704,2293,46896
14-10-2014,7,19489,19096,7658,3198,49442,1167,808,715,2690,52132
14-10-2014,8,19703,19488,7804,3470,50465,1164,938,721,2823,53288
14-10-2014,9,19774,19097,7797,3601,50268,1166,956,689,2811,53079
14-10-2014,10,19748,19295,7724,3701,50467,1164,951,672,2787,53254
14-10-2014,11,19395,19140,7661,3712,49909,1162,900,625,2687,52596
14-10-2014,12,18753,18139,7331,3595,47818,1163,496,633,2292,50110
14-10-2014,13,18617,17301,7245,3477,46640,1165,452,656,2273,48913
14-10-2014,14,18501,17142,7204,3405,46252,1168,450,603,2221,48473
14-10-2014,15,18725,17845,7272,3294,47136,1177,771,657,2605,49741
14-10-2014,16,18718,18773,7474,3307,48271,1179,712,664,2555,50826
14-10-2014,17,18577,19117,7851,3349,48895,1193,781,677,2651,51546
14-10-2014,18,19260,19615,8112,3392,50378,1180,914,680,2774,53152
14-10-2014,19,18938,19629,7867,3445,49879,1189,576,647,2412,52291
14-10-2014,20,18771,18334,7431,3317,47853,1231,472,467,2170,50023
14-10-2014,21,18370,16614,7090,2969,45044,1242,249,426,1917,46961
14-10-2014,22,17621,15270,6969,2763,42624,1275,215,331,1821,44445
14-10-2014,23,15511,14388,6719,2600,39219,1264,212,327,1803,41022
15-10-2014,0,13375,13706,6566,2525,36172,1249,222,327,1798,37970
15-10-2014,1,12406,13361,6483,2498,34749,1257,224,324,1805,36554
15-10-2014,2,11846,13276,6452,2613,34186,1259,223,325,1807,35993
15-10-2014,3,11917,13294,6466,2571,34248,1263,226,326,1815,36063
15-10-2014,4,12774,13431,6539,2645,35391,1257,239,323,1819,37210
15-10-2014,5,14447,14350,6984,2742,38522,1266,250,351,1867,40389
15-10-2014,6,17367,16684,7607,3075,44732,1279,428,514,2221,46953
15-10-2014,7,19643,19206,7937,3336,50121,1279,711,681,2671,52792
15-10-2014,8,19703,20044,7959,3591,51297,1239,755,822,2816,54113
15-10-2014,9,19470,20144,8087,3439,51140,1224,780,815,2819,53959
15-10-2014,10,19655,20187,8047,3437,51325,1216,778,800,2794,54119
15-10-2014,11,19408,20305,7903,3533,51149,1203,820,638,2661,53810
15-10-2014,12,18963,19751,7605,3444,49762,1196,529,532,2257,52019
15-10-2014,13,19023,19288,7504,3375,49190,1178,503,507,2188,51378
15-10-2014,14,18833,18978,7467,3408,48686,1177,507,505,2189,50875
15-10-2014,15,18975,19004,7662,3289,48929,1176,703,603,2482,51411
15-10-2014,16,19381,19046,7807,3376,49610,1181,680,623,2484,52094
15-10-2014,17,19415,19680,8272,3517,50883,1195,639,781,2615,53498
15-10-2014,18,19829,20302,8543,3364,52038,1188,761,799,2748,54786
15-10-2014,19,19667,20256,8061,3159,51144,1184,722,499,2405,53549
15-10-2014,20,19259,19283,7567,2985,49093,1173,597,471,2241,51334
15-10-2014,21,18724,18198,7339,2845,47105,1162,273,474,1909,49014
15-10-2014,22,17451,17134,7256,2801,44642,1140,282,305,1727,46369
15-10-2014,23,15487,16007,6927,2588,41009,1163,277,302,1742,42751
16-10-2014,0,13546,15056,6818,2330,37750,1158,251,301,1710,39460
16-10-2014,1,13112,14329,6753,2323,36518,1139,224,300,1663,38181
16-10-2014,2,12865,14229,6702,2362,36158,1148,223,300,1671,37829
16-10-2014,3,13009,14203,6717,2402,36331,1142,223,299,1664,37995
16-10-2014,4,13768,14479,6878,2349,37474,1148,236,298,1682,39156
16-10-2014,5,15064,15405,7525,2471,40465,1178,267,326,1771,42236
16-10-2014,6,18055,17457,8105,2737,46356,1258,580,465,2303,48659
16-10-2014,7,20111,19777,8416,3169,51471,1248,857,644,2749,54220
16-10-2014,8,20450,20045,8468,3396,52360,1238,865,784,2887,55247
16-10-2014,9,20526,20283,8441,3441,52693,1217,865,809,2891,55584
16-10-2014,10,20609,20377,8467,3400,52852,1212,836,812,2860,55712
16-10-2014,11,20513,20208,8394,3438,52553,1228,876,626,2730,55283
16-10-2014,12,20326,19906,8028,3449,51710,1223,546,580,2349,54059
16-10-2014,13,20301,19789,7926,3303,51319,1222,547,535,2304,53623
16-10-2014,14,20430,19701,7898,3035,51065,1183,547,518,2248,53313
16-10-2014,15,20346,19896,8064,2993,51298,1179,832,510,2521,53819
16-10-2014,16,20018,20204,8161,2996,51378,1169,771,515,2455,53833
16-10-2014,17,20175,20490,8514,2908,52089,1174,747,664,2585,54674
16-10-2014,18,20968,20699,8804,2919,53390,1199,925,628,2752,56142
16-10-2014,19,20432,20539,8374,3172,52518,1228,713,460,2401,54919
16-10-2014,20,20294,19506,7938,2843,50580,1240,592,449,2281,52861
16-10-2014,21,19619,18042,7727,2765,48153,1238,536,315,2089,50242
16-10-2014,22,18137,16554,7401,2527,44619,1238,450,57,1745,46364
16-10-2014,23,16513,15411,7156,2197,41277,1242,498,53,1793,43070
17-10-2014,0,15036,14685,7033,2082,38836,1241,262,52,1555,40391
17-10-2014,1,14498,14076,7056,2038,37669,1209,236,57,1502,39171
17-10-2014,2,13869,14168,7053,2255,37345,1236,236,85,1557,38902
17-10-2014,3,13871,14387,7081,2043,37382,1231,237,128,1596,38978
17-10-2014,4,14285,14404,7252,2226,38167,1253,273,271,1797,39964
17-10-2014,5,15505,15652,7774,2276,41208,1306,361,317,1984,43192
17-10-2014,6,18207,17837,8457,2835,47335,1362,780,318,2460,49795
17-10-2014,7,20642,20148,8857,3112,52762,1364,881,547,2792,55554
17-10-2014,8,21126,20528,8866,3361,53881,1368,987,593,2948,56829
17-10-2014,9,20984,20583,8833,3459,53860,1363,1016,578,2957,56817
17-10-2014,10,20899,20523,8786,3515,53722,1360,983,552,2895,56617
17-10-2014,11,20491,20400,8672,3474,53037,1363,947,490,2800,55837
17-10-2014,12,20449,19581,8115,3343,51487,1371,797,326,2494,53981
17-10-2014,13,20372,18926,7935,3324,50557,1303,751,324,2378,52935
17-10-2014,14,20238,18649,7831,3220,49939,1302,748,337,2387,52326
17-10-2014,15,19941,18389,8177,3149,49656,1298,868,375,2541,52197
17-10-2014,16,20097,18049,8300,3107,49555,1291,880,368,2539,52094
17-10-2014,17,20350,18609,8691,3242,50893,1290,911,436,2637,53530
17-10-2014,18,20562,19350,8889,3127,51928,1259,1256,412,2927,54855
17-10-2014,19,20309,19108,8264,3032,50714,1256,828,318,2402,53116
17-10-2014,20,19708,17982,7777,2887,48355,1263,696,326,2285,50640
17-10-2014,21,19181,16893,7284,2752,46109,1259,548,317,2124,48233
17-10-2014,22,17714,15983,7209,2648,43553,1253,403,312,1968,45521
17-10-2014,23,16378,15080,7092,2424,40975,1255,395,306,1956,42931
18-10-2014,0,15292,13944,6951,2159,38346,1079,407,309,1795,40141
18-10-2014,1,14396,13697,6946,2200,37241,1059,391,307,1757,38998
18-10-2014,2,13863,13550,6960,2252,36626,1003,383,306,1692,38318
18-10-2014,3,13623,13533,6934,2243,36334,982,384,312,1678,38012
18-10-2014,4,13361,13507,6932,2227,36026,990,392,301,1683,37709
18-10-2014,5,13608,13606,7046,2232,36492,1088,480,304,1872,38364
18-10-2014,6,14890,13803,7182,2323,38198,1158,496,306,1960,40158
18-10-2014,7,16884,14299,7887,2503,41573,1100,525,341,1966,43539
18-10-2014,8,17475,15393,8186,3062,44117,1061,656,356,2073,46190
18-10-2014,9,18115,15987,8205,3380,45687,1113,688,352,2153,47840
18-10-2014,10,17633,15957,8171,3604,45365,1147,692,329,2168,47533
18-10-2014,11,17068,15495,8136,3871,44569,1151,681,305,2137,46706
18-10-2014,12,16905,15234,8087,3822,44047,1174,703,341,2218,46265
18-10-2014,13,16347,15042,8029,3850,43269,1151,719,329,2199,45468
18-10-2014,14,16040,15011,8068,3951,43071,1150,685,297,2132,45203
18-10-2014,15,15688,14986,8041,4150,42866,1146,666,296,2108,44974
18-10-2014,16,15919,15219,8330,4325,43795,1138,708,297,2143,45938
18-10-2014,17,17064,16068,8706,4630,46470,1158,926,300,2384,48854
18-10-2014,18,17501,16614,8741,4752,47607,1141,1277,381,2799,50406
18-10-2014,19,16848,16571,8571,4717,46708,1225,883,422,2530,49238
18-10-2014,20,15516,15552,8249,4595,43913,1159,788,355,2302,46215
18-10-2014,21,13493,15128,8093,4506,41209,1178,462,371,2011,43220
18-10-2014,22,12276,14925,7449,4456,39092,1278,263,383,1924,41016
18-10-2014,23,10439,14784,7256,4278,36753,1279,220,436,1935,38688
19-10-2014,0,9519,14868,6882,4083,35358,952,215,383,1550,36908
19-10-2014,1,9528,14887,6564,3948,34933,971,214,356,1541,36474
19-10-2014,2,9468,14911,6402,3827,34615,998,214,355,1567,36182
19-10-2014,3,9271,14864,6386,3784,34311,995,216,373,1584,35895
19-10-2014,4,8944,14603,6468,3663,33684,1024,229,371,1624,35308
19-10-2014,5,8884,14479,6642,3510,33519,1035,233,385,1653,35172
19-10-2014,6,9247,14483,6724,3424,33883,1054,437,388,1879,35762
19-10-2014,7,9853,14413,6802,3426,34525,1073,433,396,1902,36427
19-10-2014,8,10959,14586,7030,3605,36228,1079,519,413,2011,38239
19-10-2014,9,12853,14478,7276,3652,38269,1088,606,430,2124,40393
19-10-2014,10,13870,14850,7496,3745,39972,1200,581,422,2203,42175
19-10-2014,11,14257,14791,7615,3878,40551,1227,568,435,2230,42781
19-10-2014,12,14631,14684,7570,3741,40637,1220,563,448,2231,42868
19-10-2014,13,13773,14826,7524,4053,40187,1203,582,456,2241,42428
19-10-2014,14,13534,14611,7617,3973,39745,1162,585,447,2194,41939
19-10-2014,15,13320,14596,7630,3960,39516,1141,626,414,2181,41697
19-10-2014,16,13664,14773,7730,4251,40429,1138,715,394,2247,42676
19-10-2014,17,15009,15157,8152,4316,42635,1122,878,377,2377,45012
19-10-2014,18,15571,15611,8276,4497,43966,1109,1036,411,2556,46522
19-10-2014,19,15910,15495,7963,4606,43985,1099,969,389,2457,46442
19-10-2014,20,14949,15171,7569,4514,42214,1060,774,400,2234,44448
19-10-2014,21,13992,14641,7490,4574,40696,1052,501,406,1959,42655
19-10-2014,22,12627,14456,7329,4553,38965,1049,292,404,1745,40710
19-10-2014,23,10725,14298,6992,4572,36597,1043,227,386,1656,38253
20-10-2014,0,9418,14321,6867,4402,35007,885,226,375,1486,36493
20-10-2014,1,8957,14198,6669,4364,34189,792,224,363,1379,35568
20-10-2014,2,8878,14248,6632,4369,34127,765,230,400,1395,35522
20-10-2014,3,8630,14291,6647,4442,34008,752,211,427,1390,35398
20-10-2014,4,8875,14370,6863,4341,34449,906,235,455,1596,36045
20-10-2014,5,9585,15186,8009,4348,37128,1374,238,468,2080,39208
20-10-2014,6,13693,16258,8972,4549,43473,1393,556,466,2415,45888
20-10-2014,7,16539,18396,9317,4794,49045,1395,913,498,2806,51851
20-10-2014,8,16900,18806,9311,4986,50004,1389,978,633,3000,53004
20-10-2014,9,16993,18407,9312,5112,49825,1383,1010,648,3041,52866
20-10-2014,10,16486,18714,9419,5206,49825,1387,990,611,2988,52813
20-10-2014,11,15895,18648,9294,5343,49179,1391,984,473,2848,52027
20-10-2014,12,15599,17893,8867,5350,47708,1374,932,482,2788,50496
20-10-2014,13,15724,17761,8663,5178,47326,1364,924,485,2773,50099
20-10-2014,14,15443,18131,8695,5087,47356,1361,866,485,2712,50068
20-10-2014,15,15592,18425,9121,4995,48132,1377,777,484,2638,50770
20-10-2014,16,16000,19124,9235,4676,49036,1369,790,479,2638,51674
20-10-2014,17,16840,19768,9540,4296,50443,1396,921,568,2885,53328
20-10-2014,18,17742,20009,9590,4022,51362,1407,1217,561,3185,54547
20-10-2014,19,17980,19939,9276,3734,50929,1416,788,493,2697,53626
20-10-2014,20,17558,19475,8438,3428,48900,1413,679,495,2587,51487
20-10-2014,21,17222,18631,8045,2997,46895,1402,358,485,2245,49140
20-10-2014,22,15930,16756,7856,2994,43536,1431,255,464,2150,45686
20-10-2014,23,14079,15205,7602,2676,39563,1442,256,449,2147,41710
21-10-2014,0,13046,14011,7277,2436,36771,1361,208,399,1968,38739
21-10-2014,1,12269,13782,7214,2367,35633,1347,187,363,1897,37530
21-10-2014,2,12233,13489,7181,2192,35095,1339,187,343,1869,36964
21-10-2014,3,12025,13400,7233,2145,34803,1336,188,326,1850,36653
21-10-2014,4,12570,13531,7487,2205,35791,1331,199,318,1848,37639
21-10-2014,5,14139,14501,8558,2312,39511,1329,217,317,1863,41374
21-10-2014,6,16616,17534,9489,2777,46417,1329,460,497,2286,48703
21-10-2014,7,18688,19647,9892,3124,51351,1335,688,572,2595,53946
21-10-2014,8,18595,20135,9913,3344,51989,1332,822,531,2685,54674
21-10-2014,9,18556,19453,9952,3647,51607,1328,832,538,2698,54305
21-10-2014,10,18488,19407,9945,3858,51698,1297,822,515,2634,54332
21-10-2014,11,18237,19002,9890,4106,51235,1261,652,574,2487,53722
21-10-2014,12,17976,18276,9457,4111,49819,1257,643,505,2405,52224
21-10-2014,13,17474,17858,9392,4320,49044,1257,652,497,2406,51450
21-10-2014,14,17069,17961,9384,4614,49026,1265,618,508,2391,51417
21-10-2014,15,16745,18057,9656,4785,49242,1263,778,374,2415,51657
21-10-2014,16,16293,18264,9812,4891,49261,1264,834,302,2400,51661
21-10-2014,17,17157,18848,10221,4795,51023,1296,983,307,2586,53609
21-10-2014,18,18322,19273,10202,4724,52522,1368,1177,328,2873,55395
21-10-2014,19,18373,18400,9805,4593,51171,1311,826,342,2479,53650
21-10-2014,20,17776,17478,8847,4157,48258,1274,690,318,2282,50540
21-10-2014,21,16744,16665,8416,3790,45615,1292,471,294,2057,47672
21-10-2014,22,15096,16243,8215,3518,43072,1278,422,95,1795,44867
21-10-2014,23,13629,15804,7824,3055,40314,1274,401,108,1783,42097
22-10-2014,0,11918,15304,7591,2724,37537,1205,404,127,1736,39273
22-10-2014,1,11340,15052,7501,2505,36400,1070,405,137,1612,38012
22-10-2014,2,11237,15073,7489,2300,36100,1056,402,132,1590,37690
22-10-2014,3,11228,15095,7565,2272,36161,1197,409,144,1750,37911
22-10-2014,4,11232,15130,8089,2425,36876,1233,426,167,1826,38702
22-10-2014,5,12281,15791,9121,2410,39604,1227,432,214,1873,41477
22-10-2014,6,16269,16433,9913,2448,45061,1227,790,396,2413,47474
22-10-2014,7,19404,17620,10233,3147,50404,1253,1107,452,2812,53216
22-10-2014,8,19172,17828,10225,3332,50555,1245,1315,523,3083,53638
22-10-2014,9,18792,17781,10246,3463,50282,1267,1415,485,3167,53449
22-10-2014,10,18894,17846,10205,3613,50558,1276,1278,491,3045,53603
22-10-2014,11,19000,18021,10237,3706,50964,1264,1163,463,2890,53854
22-10-2014,12,19104,18158,9910,3752,50922,1218,831,399,2448,53370
22-10-2014,13,18966,18174,9737,3798,50675,1197,797,431,2425,53100
22-10-2014,14,18912,17941,9711,3753,50316,1213,790,412,2415,52731
22-10-2014,15,18958,17970,9922,3686,50536,1251,958,398,2607,53143
22-10-2014,16,19152,17911,9948,3543,50554,1327,982,346,2655,53209
22-10-2014,17,19400,18664,10220,3779,52063,1351,1257,492,3100,55163
22-10-2014,18,19961,19768,10391,3731,53851,1371,1536,540,3447,57298
22-10-2014,19,20092,19300,10143,3755,53289,1445,1000,356,2801,56090
22-10-2014,20,19097,18188,9282,3611,50177,1455,677,336,2468,52645
22-10-2014,21,17860,17052,9032,3292,47236,1423,504,297,2224,49460
22-10-2014,22,16748,16126,8634,2881,44390,1375,449,173,1997,46387
22-10-2014,23,15107,15683,8202,2577,41571,1342,432,158,1932,43503
23-10-2014,0,13851,15116,7941,2485,39393,1279,403,172,1854,41247
23-10-2014,1,12895,15173,7843,2303,38214,1271,403,158,1832,40046
23-10-2014,2,12376,15047,7826,2185,37435,1268,399,136,1803,39238
23-10-2014,3,12535,15052,7835,2068,37490,1265,397,135,1797,39287
23-10-2014,4,13064,15110,8183,2138,38495,1285,409,133,1827,40322
23-10-2014,5,14284,15757,9166,2133,41340,1398,551,158,2107,43447
23-10-2014,6,17755,17186,10078,2565,47584,1396,1142,231,2769,50353
23-10-2014,7,20274,19436,10438,3032,53181,1380,1325,378,3083,56264
23-10-2014,8,20590,20122,10472,3146,54330,1380,1375,435,3190,57520
23-10-2014,9,20187,20168,10478,3428,54261,1380,1454,398,3232,57493
23-10-2014,10,20384,20211,10487,3424,54506,1380,1393,407,3180,57686
23-10-2014,11,20338,20064,10298,3492,54192,1377,1322,384,3083,57275
23-10-2014,12,20141,19560,9950,3500,53152,1362,1072,157,2591,55743
23-10-2014,13,19927,19549,9619,3537,52633,1350,1085,139,2574,55207
23-10-2014,14,20002,19284,9806,3638,52729,1353,1052,151,2556,55285
23-10-2014,15,19927,19185,10037,3568,52717,1354,1179,162,2695,55412
23-10-2014,16,19806,19317,10093,3523,52739,1354,1284,146,2784,55523
23-10-2014,17,20149,20017,10431,3673,54270,1357,1394,338,3089,57359
23-10-2014,18,20248,20088,10443,3750,54530,1388,1583,375,3346,57876
23-10-2014,19,19948,19833,10061,3722,53563,1390,1132,187,2709,56272
23-10-2014,20,19150,19132,9322,3639,51244,1412,933,170,2515,53759
23-10-2014,21,17854,18138,8895,3545,48432,1437,748,127,2312,50744
23-10-2014,22,15952,17258,8476,3528,45214,1431,444,139,2014,47228
23-10-2014,23,14319,16778,7907,3564,42569,1382,419,143,1944,44513
24-10-2014,0,13425,16339,7580,3513,40859,1359,420,141,1920,42779
24-10-2014,1,13343,16200,7478,3392,40412,1179,426,147,1752,42164
24-10-2014,2,13055,16128,7427,3328,39938,1071,413,158,1642,41580
24-10-2014,3,12726,16058,7461,3357,39603,1126,405,152,1683,41286
24-10-2014,4,12341,16132,7746,3504,39724,1332,419,144,1895,41619
24-10-2014,5,13030,16879,9163,3673,42745,1358,426,145,1929,44674
24-10-2014,6,16282,17873,9910,3895,47959,1421,1099,143,2663,50622
24-10-2014,7,18525,19457,10257,4258,52496,1447,1249,330,3026,55522
24-10-2014,8,18513,20244,10333,4451,53540,1452,1293,354,3099,56639
24-10-2014,9,17766,20449,10339,4551,53105,1448,1273,347,3068,56173
24-10-2014,10,17545,20912,10293,4524,53273,1441,1128,305,2874,56147
24-10-2014,11,16981,21263,10145,4620,53008,1454,1095,227,2776,55784
24-10-2014,12,16793,20134,9526,4604,51057,1477,1102,201,2780,53837
24-10-2014,13,16908,19347,9008,4614,49877,1484,1099,204,2787,52664
24-10-2014,14,17004,18985,9194,4455,49637,1478,1061,169,2708,52345
24-10-2014,15,16908,19006,9611,4421,49945,1481,1079,135,2695,52640
24-10-2014,16,17040,18866,9780,4361,50047,1475,1108,148,2731,52778
24-10-2014,17,17445,19188,10139,4478,51250,1485,1220,280,2985,54235
24-10-2014,18,17680,19258,10056,4650,51644,1489,1354,326,3169,54813
24-10-2014,19,16875,18882,9476,4722,49955,1503,1084,250,2837,52792
24-10-2014,20,15671,18069,8528,4774,47043,1529,985,188,2702,49745
24-10-2014,21,14718,17570,8104,4678,45070,1506,709,189,2404,47474
24-10-2014,22,13676,17020,7775,4564,43035,1499,447,186,2132,45167
24-10-2014,23,12724,16562,7400,4348,41033,1383,407,182,1972,43005
25-10-2014,0,11589,15868,7349,4103,38910,1117,406,171,1694,40604
25-10-2014,1,10744,15660,7219,4061,37684,1052,406,173,1631,39315
25-10-2014,2,10500,15578,7110,3851,37040,1045,406,175,1626,38666
25-10-2014,3,10473,15490,7084,3472,36520,1039,410,179,1628,38148
25-10-2014,4,10903,15450,7189,3024,36565,1067,418,174,1659,38224
25-10-2014,5,11442,15581,7425,2806,37255,1073,418,158,1649,38904
25-10-2014,6,12296,15859,7584,2754,38493,1151,473,268,1892,40385
25-10-2014,7,13695,15924,7463,2911,39995,1181,579,282,2042,42037
25-10-2014,8,15254,15949,7653,3122,41978,1189,717,289,2195,44173
25-10-2014,9,16419,16380,7759,3143,43702,1199,782,130,2111,45813
25-10-2014,10,17110,16393,7812,3150,44465,1200,804,110,2114,46579
25-10-2014,11,17424,16354,7818,3037,44633,1190,804,117,2111,46744
25-10-2014,12,17332,16400,7731,2964,44427,1207,779,250,2236,46663
25-10-2014,13,17088,16190,7710,2951,43939,1213,764,244,2221,46160
25-10-2014,14,16876,16042,7831,2824,43573,1195,714,251,2160,45733
25-10-2014,15,17187,16058,8047,2760,44054,1208,727,252,2187,46241
25-10-2014,16,17747,16345,8423,2498,45014,1200,757,256,2213,47227
25-10-2014,17,18175,16912,8885,2484,46456,1202,889,147,2238,48694
25-10-2014,18,18275,17201,8816,2830,47121,1225,964,167,2356,49477
25-10-2014,19,17963,17067,8425,2942,46398,1222,864,166,2252,48650
25-10-2014,20,16976,16524,7954,2983,44437,1226,744,260,2230,46667
25-10-2014,21,16132,16142,7680,3122,43077,1212,574,235,2021,45098
25-10-2014,22,15183,15872,7455,3161,41671,1185,419,116,1720,43391
25-10-2014,23,14323,15501,7051,3199,40074,1195,395,116,1706,41780
26-10-2014,0,12986,15092,6862,2975,37915,1028,390,117,1535,39450
26-10-2014,1,11791,14980,6742,2912,36427,991,391,108,1490,37917
26-10-2014,2,10776,14838,6650,2986,35250,942,392,108,1442,36692
26-10-2014,2,10429,14756,6536,2990,34711,934,394,105,1433,36144
26-10-2014,3,10759,14880,6657,3052,35349,930,395,113,1438,36787
26-10-2014,4,10842,15050,6652,3150,35693,978,405,110,1493,37186
26-10-2014,5,11039,15265,6663,3295,36263,1066,493,104,1663,37926
26-10-2014,6,11341,15442,6777,3524,37084,945,550,96,1591,38675
26-10-2014,7,11811,15733,6858,3586,37987,950,621,99,1670,39657
26-10-2014,8,13353,15990,6994,3796,40134,991,708,113,1812,41946
26-10-2014,9,14242,16277,7175,4064,41758,1088,671,203,1962,43720
26-10-2014,10,14539,16468,7289,4241,42536,1088,610,236,1934,44470
26-10-2014,11,14368,16609,7351,4530,42859,1082,622,241,1945,44804
26-10-2014,12,13979,16831,7323,4701,42835,1104,596,242,1942,44777
26-10-2014,13,13473,16861,7256,4729,42320,1176,589,235,2000,44320
26-10-2014,14,13350,16839,7284,4647,42119,1171,610,235,2016,44135
26-10-2014,15,14271,16910,7491,4572,43246,1189,613,263,2065,45311
26-10-2014,16,15016,17451,7857,4715,45040,1204,703,301,2208,47248
26-10-2014,17,15824,18314,8050,4919,47107,1213,760,303,2276,49383
26-10-2014,18,15588,18217,7921,4966,46693,1209,628,290,2127,48820
26-10-2014,19,14666,17851,7627,5032,45176,1215,588,272,2075,47251
26-10-2014,20,14194,17404,7207,4913,43719,1198,591,250,2039,45758
26-10-2014,21,13442,17058,7007,4779,42286,1201,423,132,1756,44042
26-10-2014,22,11930,16872,6935,4673,40410,1161,422,126,1709,42119
26-10-2014,23,10719,16337,6545,4613,38216,1042,414,122,1578,39794
27-10-2014,0,9326,16158,6320,4480,36285,1098,419,145,1662,37947
27-10-2014,1,9003,16107,6274,4415,35800,1072,422,151,1645,37445
27-10-2014,2,8632,16052,6275,4397,35356,1064,418,147,1629,36985
27-10-2014,3,8560,16117,6334,4374,35384,1053,421,146,1620,37004
27-10-2014,4,8959,16125,6584,4457,36127,1120,438,153,1711,37838
27-10-2014,5,10125,16912,7306,4333,38677,1439,522,175,2136,40813
27-10-2014,6,13444,17656,8373,4431,43905,1499,710,316,2525,46430
27-10-2014,7,16066,18753,8800,4574,48194,1496,841,523,2860,51054
27-10-2014,8,16583,19046,8814,4832,49274,1552,938,533,3023,52297
27-10-2014,9,16222,18382,8918,5023,48546,1501,947,531,2979,51525
27-10-2014,10,16233,18333,8942,5021,48529,1509,915,538,2962,51491
27-10-2014,11,16329,18627,8878,4974,48808,1523,726,524,2773,51581
27-10-2014,12,15995,18780,8606,4805,48187,1562,730,381,2673,50860
27-10-2014,13,15942,18852,8465,4701,47962,1550,730,382,2662,50624
27-10-2014,14,16348,19071,8446,4540,48405,1556,852,377,2785,51190
27-10-2014,15,16448,19122,8824,4283,48677,1581,958,366,2905,51582
27-10-2014,16,17060,19295,9146,4195,49695,1585,1078,380,3043,52738
27-10-2014,17,17769,19598,9189,4403,50959,1572,1024,531,3127,54086
27-10-2014,18,17537,19705,9094,4545,50881,1574,846,498,2918,53799
27-10-2014,19,16706,19264,8488,4192,48651,1573,795,495,2863,51514
27-10-2014,20,15908,18745,7649,4119,46423,1474,661,467,2602,49025
27-10-2014,21,15150,17862,7254,3978,44245,1460,446,185,2091,46336
27-10-2014,22,13693,16930,6859,3841,41323,1450,421,172,2043,43366
27-10-2014,23,12903,16342,6671,3621,39536,1129,409,158,1696,41232
28-10-2014,0,12042,15667,6547,3297,37552,1089,404,160,1653,39205
28-10-2014,1,11679,15578,6495,3180,36933,1092,406,145,1643,38576
28-10-2014,2,11611,15493,6445,3159,36709,1062,406,147,1615,38324
28-10-2014,3,11688,15475,6476,3121,36760,1098,404,146,1648,38408
28-10-2014,4,12016,15423,6745,3101,37284,1357,420,133,1910,39194
28-10-2014,5,12878,15986,7487,3183,39534,1430,427,241,2098,41632
28-10-2014,6,15130,17440,8309,3469,44348,1492,650,305,2447,46795
28-10-2014,7,17062,18298,8679,3770,47808,1491,953,374,2818,50626
28-10-2014,8,16936,18656,8845,4047,48483,1496,1047,378,2921,51404
28-10-2014,9,16514,18640,8825,4172,48150,1513,1042,375,2930,51080
28-10-2014,10,16487,18512,8741,4210,47948,1510,1004,369,2883,50831
28-10-2014,11,16562,18320,8606,4049,47537,1516,1045,356,2917,50454
28-10-2014,12,16542,18096,8129,3994,46762,1501,957,147,2605,49367
28-10-2014,13,16737,18346,8012,3983,47078,1517,696,139,2352,49430
28-10-2014,14,16447,18283,8131,3873,46735,1529,635,155,2319,49054
28-10-2014,15,16969,18358,8696,3755,47778,1556,889,383,2828,50606
28-10-2014,16,17365,18768,9145,3712,48990,1572,989,387,2948,51938
28-10-2014,17,17828,19256,9102,3841,50027,1588,1102,418,3108,53135
28-10-2014,18,17878,18942,9063,3904,49787,1591,1027,426,3044,52831
28-10-2014,19,17492,18424,8389,3914,48220,1593,757,232,2582,50802
28-10-2014,20,16672,17870,7534,3990,46066,1576,662,181,2419,48485
28-10-2014,21,15718,17177,7252,3991,44137,1566,471,194,2231,46368
28-10-2014,22,14793,16299,6781,3976,41851,1523,430,185,2138,43989
28-10-2014,23,13422,15652,6823,3829,39726,1337,416,184,1937,41663
29-10-2014,0,12187,15312,6497,3651,37648,1237,407,175,1819,39467
29-10-2014,1,11633,15149,6430,3505,36719,1147,404,167,1718,38437
29-10-2014,2,11849,14915,6389,3522,36675,1144,404,158,1706,38381
29-10-2014,3,12265,14775,6370,3539,36949,1164,405,160,1729,38678
29-10-2014,4,12492,14910,6492,3418,37312,1284,419,176,1879,39191
29-10-2014,5,13310,15683,7347,3220,39562,1499,518,187,2204,41766
29-10-2014,6,15546,17415,8175,2908,44045,1588,721,289,2598,46643
29-10-2014,7,17069,18891,8508,3354,47823,1601,968,387,2956,50779
29-10-2014,8,17753,19342,8679,3214,48989,1603,1044,387,3034,52023
29-10-2014,9,17905,19317,8534,3339,49095,1597,1060,358,3015,52110
29-10-2014,10,18155,19396,8587,3209,49346,1607,1014,326,2947,52293
29-10-2014,11,17493,19788,8570,3220,49072,1638,922,312,2872,51944
29-10-2014,12,17191,19626,8306,3078,48201,1616,695,114,2425,50626
29-10-2014,13,17177,19704,8251,3042,48174,1552,680,115,2347,50521
29-10-2014,14,17130,19476,8313,2931,47850,1606,678,107,2391,50241
29-10-2014,15,17148,19857,8833,2860,48699,1603,967,300,2870,51569
29-10-2014,16,17652,19881,9207,3048,49788,1584,1112,321,3017,52805
29-10-2014,17,19340,20005,9203,3149,51698,1567,1116,380,3063,54761
29-10-2014,18,19488,19714,9118,3445,51765,1551,1120,307,2978,54743
29-10-2014,19,19447,18873,8562,3248,50130,1506,824,118,2448,52578
29-10-2014,20,19116,18112,7813,2930,47971,1451,653,112,2216,50187
29-10-2014,21,18595,17431,7548,2785,46359,1426,491,110,2027,48386
29-10-2014,22,17548,16844,7279,2479,44152,1396,403,107,1906,46058
29-10-2014,23,16453,16109,7000,2193,41756,1368,380,109,1857,43613
30-10-2014,0,16058,15456,6931,1736,40180,1300,379,97,1776,41956
30-10-2014,1,16022,15247,6870,1848,39988,1040,378,84,1502,41490
30-10-2014,2,15981,14926,6891,1888,39687,942,376,75,1393,41080
30-10-2014,3,16219,14835,6983,1872,39910,1017,376,73,1466,41376
30-10-2014,4,16448,15174,7159,1823,40604,1313,385,67,1765,42369
30-10-2014,5,17295,15904,7933,1903,43036,1347,396,63,1806,44842
30-10-2014,6,18995,17793,8777,2538,48103,1347,768,256,2371,50474
30-10-2014,7,20888,19069,9346,2644,51948,1343,1046,309,2698,54646
30-10-2014,8,21294,19705,9433,2933,53365,1347,1131,310,2788,56153
30-10-2014,9,20631,19492,9315,3108,52545,1347,1183,309,2839,55384
30-10-2014,10,20699,19321,9181,3163,52364,1344,1173,304,2821,55185
30-10-2014,11,20548,19202,9007,3050,51808,1338,1109,292,2739,54547
30-10-2014,12,20219,18805,8587,3231,50842,1353,749,59,2161,53003
30-10-2014,13,20185,18474,8353,3160,50172,1353,733,56,2142,52314
30-10-2014,14,20210,18371,8419,3083,50083,1365,759,84,2208,52291
30-10-2014,15,20333,18382,8937,2840,50493,1404,1095,287,2786,53279
30-10-2014,16,20892,18913,9441,2829,52076,1441,1212,298,2951,55027
30-10-2014,17,21165,19917,9649,3201,53931,1452,1217,295,2964,56895
30-10-2014,18,21081,20014,9572,3505,54172,1469,1163,260,2892,57064
30-10-2014,19,20833,19778,8873,3258,52744,1428,812,126,2366,55110
30-10-2014,20,20158,18917,8266,3048,50388,1429,697,241,2367,52755
30-10-2014,21,19600,17989,7819,2823,48231,1405,535,189,2129,50360
30-10-2014,22,18675,16954,7580,2497,45705,1398,428,51,1877,47582
30-10-2014,23,17380,15919,7314,2225,42837,1379,382,52,1813,44650
31-10-2014,0,16547,15357,7288,2096,41290,1401,379,54,1834,43124
31-10-2014,1,16335,15123,7318,2022,40799,1384,379,54,1817,42616
31-10-2014,2,16152,14890,7324,2115,40481,1407,379,55,1841,42322
31-10-2014,3,15936,14525,7306,2244,40012,1410,380,53,1843,41855
31-10-2014,4,15901,14804,7372,2321,40399,1423,390,52,1865,42264
31-10-2014,5,16669,15904,8147,2448,43167,1470,481,271,2222,45389
31-10-2014,6,19193,17984,9034,2714,48923,1470,774,389,2633,51556
31-10-2014,7,21027,19362,9449,3016,52854,1457,1103,392,2952,55806
31-10-2014,8,21359,20334,9568,2957,54218,1442,1184,392,3018,57236
31-10-2014,9,21171,20177,9566,2957,53871,1412,1181,393,2986,56857
31-10-2014,10,21129,19724,9497,3148,53498,1407,1137,406,2950,56448
31-10-2014,11,21045,19371,9386,3015,52815,1412,1031,390,2833,55648
31-10-2014,12,20930,18828,9058,2992,51809,1407,776,238,2421,54230
31-10-2014,13,20548,18737,8865,2798,50948,1397,748,244,2389,53337
31-10-2014,14,20457,18724,8934,2646,50763,1404,739,237,2380,53143
31-10-2014,15,20480,18850,9283,2686,51298,1436,966,365,2767,54065
31-10-2014,16,20665,19496,9699,2605,52467,1413,1148,394,2955,55422
31-10-2014,17,21057,19674,9826,2794,53351,1393,1205,375,2973,56324
31-10-2014,18,20701,19339,9794,3051,52886,1402,1105,374,2881,55767
31-10-2014,19,20066,18558,9124,2895,50643,1398,705,267,2370,53013
31-10-2014,20,19270,17650,8247,2524,47693,1388,637,350,2375,50068
31-10-2014,21,18635,17411,7921,2427,46393,1300,477,247,2024,48417
31-10-2014,22,17695,16859,7558,2397,44508,1302,418,179,1899,46407
31-10-2014,23,16629,15690,7112,2322,41754,1275,389,65,1729,43483
01-11-2014,0,15827,14667,7164,2316,39975,1116,377,66,1559,41534
01-11-2014,1,15330,14404,7185,2089,39010,1069,374,75,1518,40528
01-11-2014,2,14778,14148,7151,1993,38070,1068,372,72,1512,39582
01-11-2014,3,13970,14150,7149,2010,37279,1063,373,81,1517,38796
01-11-2014,4,13602,14267,7341,2115,37324,1069,383,91,1543,38867
01-11-2014,5,13633,14396,7574,2194,37798,1071,385,90,1546,39344
01-11-2014,6,14465,14500,7812,2423,39200,1066,403,89,1558,40758
01-11-2014,7,15019,14733,7580,2645,39976,1069,391,91,1551,41527
01-11-2014,8,16447,15402,7663,2857,42369,1071,441,89,1601,43970
01-11-2014,9,17242,15428,7881,2932,43482,1074,476,88,1638,45120
01-11-2014,10,17490,15993,7904,3024,44412,1072,475,86,1633,46045
01-11-2014,11,17505,16374,7861,3092,44832,1056,474,92,1622,46454
01-11-2014,12,17336,16776,7741,3384,45236,1059,476,91,1626,46862
01-11-2014,13,17002,16755,7765,3334,44856,1057,474,88,1619,46475
01-11-2014,14,17026,16881,7857,3179,44943,1058,474,88,1620,46563
01-11-2014,15,17196,17142,8327,3223,45889,1059,536,91,1686,47575
01-11-2014,16,18403,17521,8751,3204,47879,1085,606,97,1788,49667
01-11-2014,17,19092,18090,8743,3167,49093,1099,788,99,1986,51079
01-11-2014,18,18691,18178,8776,3011,48657,1103,577,105,1785,50442
01-11-2014,19,17537,17841,8496,2997,46871,1111,532,115,1758,48629
01-11-2014,20,16302,17335,8108,2896,44639,1127,485,110,1722,46361
01-11-2014,21,15556,16737,7946,2893,43133,1137,397,103,1637,44770
01-11-2014,22,15287,16154,7645,2605,41691,1147,389,109,1645,43336
01-11-2014,23,14620,15911,7315,2304,40150,1122,403,120,1645,41795
02-11-2014,0,13083,15608,7110,2331,38131,1166,380,118,1664,39795
02-11-2014,1,12687,15372,6876,2314,37248,1146,384,128,1658,38906
02-11-2014,2,12463,15172,6740,2282,36658,1051,386,133,1570,38228
02-11-2014,3,12345,14997,6676,2429,36447,1088,389,141,1618,38065
02-11-2014,4,12538,14884,6668,2566,36657,1187,401,145,1733,38390
02-11-2014,5,12395,14940,6848,2745,36927,1221,400,153,1774,38701
02-11-2014,6,12388,14938,6978,2877,37181,1196,410,169,1775,38956
02-11-2014,7,12436,14901,6946,2801,37084,1120,454,162,1736,38820
02-11-2014,8,13076,15144,6962,2800,37984,1052,474,173,1699,39683
02-11-2014,9,13927,15362,7118,2987,39394,1196,506,178,1880,41274
02-11-2014,10,14097,15801,7276,3241,40415,1220,505,197,1922,42337
02-11-2014,11,14071,16083,7453,3571,41177,1233,496,176,1905,43082
02-11-2014,12,13792,16098,7421,3705,41016,1225,488,172,1885,42901
02-11-2014,13,13884,16070,7305,3706,40966,1188,491,185,1864,42830
02-11-2014,14,13840,16126,7350,3802,41119,1171,500,186,1857,42976
02-11-2014,15,14417,16370,7719,3732,42239,1189,569,173,1931,44170
02-11-2014,16,16035,16655,8070,3821,44581,1224,666,210,2100,46681
02-11-2014,17,16591,17583,7585,4183,45960,1246,776,211,2233,48193
02-11-2014,18,16555,17812,7225,4272,45883,1218,598,298,2114,47997
02-11-2014,19,15884,17554,6957,4428,44843,1217,579,196,1992,46835
02-11-2014,20,15051,17141,6550,4300,43061,1076,511,214,1801,44862
02-11-2014,21,13871,16737,6386,4093,41086,1023,387,232,1642,42728
02-11-2014,22,13218,16311,6351,3972,39852,1048,404,205,1657,41509
02-11-2014,23,12621,15618,6292,3536,38067,1005,395,227,1627,39694
03-11-2014,0,12311,15055,6137,3215,36718,934,368,202,1504,38222
03-11-2014,1,11929,14955,6080,2989,35953,940,338,210,1488,37441
03-11-2014,2,10914,15116,6064,2951,35045,964,339,204,1507,36552
03-11-2014,3,9765,14968,5993,3038,33764,960,347,191,1498,35262
03-11-2014,4,10443,15145,6085,3212,34886,993,398,198,1589,36475
03-11-2014,5,12909,15843,6602,3439,38795,1102,552,192,1846,40641
03-11-2014,6,15785,16892,7124,3980,43782,1356,639,184,2179,45961
03-11-2014,7,17948,18108,7272,4390,47718,1364,736,177,2277,49995
03-11-2014,8,18293,18263,7371,4560,48486,1358,782,168,2308,50794
03-11-2014,9,18234,17750,7398,4787,48169,1353,736,166,2255,50424
03-11-2014,10,17925,17871,7712,4818,48326,1358,753,165,2276,50602
03-11-2014,11,18074,18091,7707,4643,48514,1353,781,259,2393,50907
03-11-2014,12,17778,18025,7522,4625,47950,1360,812,279,2451,50401
03-11-2014,13,17812,18323,7486,4676,48297,1356,810,286,2452,50749
03-11-2014,14,18202,18339,7470,4652,48664,1367,708,196,2271,50935
03-11-2014,15,18373,18848,7564,4472,49257,1389,719,193,2301,51558
03-11-2014,16,19035,19522,7641,4333,50532,1406,853,188,2447,52979
03-11-2014,17,19237,19955,7596,4508,51297,1419,943,233,2595,53892
03-11-2014,18,18816,19707,7416,4749,50689,1420,882,341,2643,53332
03-11-2014,19,17801,18837,7298,4962,48897,1427,805,278,2510,51407
03-11-2014,20,16494,17712,6950,4971,46126,1403,739,182,2324,48450
03-11-2014,21,15150,16972,6590,4763,43477,1404,524,281,2209,45686
03-11-2014,22,14696,16387,6396,4001,41481,1148,432,154,1734,43215
03-11-2014,23,13543,15947,6135,3337,38961,1020,392,153,1565,40526
04-11-2014,0,13065,15617,6137,3006,37825,963,366,156,1485,39310
04-11-2014,1,13188,15476,6119,2866,37650,929,384,152,1465,39115
04-11-2014,2,12718,15389,6088,2767,36963,903,383,157,1443,38406
04-11-2014,3,12593,15349,6159,2699,36800,891,288,175,1354,38154
04-11-2014,4,13027,15449,6357,2756,37589,952,332,193,1477,39066
04-11-2014,5,14052,16017,6974,2967,40011,1180,479,350,2009,42020
04-11-2014,6,16898,17709,7678,3652,45938,1183,556,445,2184,48122
04-11-2014,7,18697,19833,7669,4132,50332,1228,665,460,2353,52685
04-11-2014,8,19004,19845,7588,4275,50713,1293,736,482,2511,53224
04-11-2014,9,18863,19286,7568,4078,49795,1291,721,460,2472,52267
04-11-2014,10,19250,19607,7740,4000,50597,1311,679,440,2430,53027
04-11-2014,11,19331,20220,7621,3899,51071,1300,589,423,2312,53383
04-11-2014,12,19001,20462,7568,3865,50896,1295,585,388,2268,53164
04-11-2014,13,18772,20416,7446,3893,50526,1315,539,402,2256,52782
04-11-2014,14,19020,20256,7582,3508,50366,1350,651,444,2445,52811
04-11-2014,15,19395,20631,7655,3220,50900,1395,667,482,2544,53444
04-11-2014,16,20026,21007,7821,3099,51954,1476,801,490,2767,54721
04-11-2014,17,20769,21276,7805,3457,53306,1465,906,426,2797,56103
04-11-2014,18,20683,21110,7711,3435,52940,1476,787,450,2713,55653
04-11-2014,19,20375,20587,7423,3162,51546,1488,628,411,2527,54073
04-11-2014,20,20007,19835,7219,2724,49786,1478,600,368,2446,52232
04-11-2014,21,19510,18746,7141,2544,47941,1473,531,340,2344,50285
04-11-2014,22,18551,17870,6977,2178,45575,1474,445,165,2084,47659
04-11-2014,23,17103,16310,6675,2025,42113,1479,391,148,2018,44131
05-11-2014,0,16783,15375,6718,1895,40773,1330,375,136,1841,42614
05-11-2014,1,16530,15068,6607,1927,40132,1307,375,140,1822,41954
05-11-2014,2,16325,14981,6611,1757,39674,1257,373,150,1780,41454
05-11-2014,3,16274,14974,6543,1712,39503,1212,379,152,1743,41246
05-11-2014,4,16211,15186,6673,1915,39986,1233,434,149,1816,41802
05-11-2014,5,17029,16319,6792,2246,42386,1253,455,313,2021,44407
05-11-2014,6,19111,18872,7707,2581,48272,1282,728,416,2426,50698
05-11-2014,7,20726,21152,8088,3354,53321,1330,953,460,2743,56064
05-11-2014,8,20867,21450,8083,3643,54044,1411,1032,459,2902,56946
05-11-2014,9,20897,21255,8257,3706,54115,1362,1015,457,2834,56949
05-11-2014,10,21110,21323,7886,3535,53856,1371,813,362,2546,56402
05-11-2014,11,21018,21391,7714,3645,53769,1375,787,336,2498,56267
05-11-2014,12,20827,21043,7770,3552,53191,1379,774,338,2491,55682
05-11-2014,13,20992,21017,7780,3350,53138,1401,791,328,2520,55658
05-11-2014,14,21106,21101,8323,3281,53810,1406,956,393,2755,56565
05-11-2014,15,21521,21358,8572,3123,54573,1421,1094,381,2896,57469
05-11-2014,16,22039,22557,8695,3020,56312,1422,1436,406,3264,59576
05-11-2014,17,22274,22928,8665,3344,57211,1438,1475,405,3318,60529
05-11-2014,18,21721,22184,8669,3761,56335,1457,1324,401,3182,59517
05-11-2014,19,21216,21220,8381,3586,54402,1456,700,320,2476,56878
05-11-2014,20,20605,20457,7883,3593,52538,1447,544,314,2305,54843
05-11-2014,21,19889,19823,7682,3761,51156,1442,491,289,2222,53378
05-11-2014,22,19038,18845,7525,3495,48903,1385,433,121,1939,50842
05-11-2014,23,17596,17527,7260,3434,45817,1403,400,129,1932,47749
06-11-2014,0,17227,16300,6890,3132,43550,1427,386,125,1938,45488
06-11-2014,1,16964,15978,6852,2876,42670,1346,385,116,1847,44517
06-11-2014,2,16637,15804,6848,2831,42120,1438,387,117,1942,44062
06-11-2014,3,16630,15782,6860,2736,42009,1436,394,122,1952,43961
06-11-2014,4,17154,15922,7101,2783,42961,1456,394,135,1985,44946
06-11-2014,5,18163,17009,7695,2840,45707,1493,491,225,2209,47916
06-11-2014,6,20198,19054,8517,3353,51122,1495,740,356,2591,53713
06-11-2014,7,21733,21210,8943,3944,55829,1495,957,395,2847,58676
06-11-2014,8,21989,21832,8971,4152,56945,1495,1040,386,2921,59866
06-11-2014,9,21922,21553,8956,3998,56430,1508,1036,409,2953,59383
06-11-2014,10,21930,21628,8584,3947,56089,1512,599,347,2458,58547
06-11-2014,11,21917,21800,8530,3723,55970,1504,583,333,2420,58390
06-11-2014,12,21491,21873,8478,3787,55631,1499,597,335,2431,58062
06-11-2014,13,21335,21622,8562,3803,55321,1480,607,330,2417,57738
06-11-2014,14,21568,21862,8822,3700,55954,1458,918,340,2716,58670
06-11-2014,15,21965,22204,8981,3698,56848,1458,1062,335,2855,59703
06-11-2014,16,22356,22809,9108,3583,57855,1443,1195,357,2995,60850
06-11-2014,17,23038,22840,9071,3615,58564,1435,1228,457,3120,61684
06-11-2014,18,22937,22483,8984,3528,57934,1427,1164,403,2994,60928
06-11-2014,19,22676,21971,8640,3417,56704,1410,714,303,2427,59131
06-11-2014,20,22125,21407,8122,3084,54738,1414,602,310,2326,57064
06-11-2014,21,21465,20315,7981,2857,52619,1414,505,285,2204,54823
06-11-2014,22,20727,18729,7565,2705,49727,1419,421,140,1980,51707
06-11-2014,23,19439,16998,7317,2598,46351,1413,417,120,1950,48301
07-11-2014,0,18679,15698,7027,2324,43728,1303,403,110,1816,45544
07-11-2014,1,17746,15223,6906,2376,42250,1279,394,111,1784,44034
07-11-2014,2,17458,15083,6967,2182,41690,1280,390,115,1785,43475
07-11-2014,3,17518,14933,6867,2100,41418,1286,390,113,1789,43207
07-11-2014,4,17723,14947,7090,2137,41899,1281,424,121,1826,43725
07-11-2014,5,18576,16008,7924,2362,44871,1302,507,279,2088,46959
07-11-2014,6,20969,18470,8913,2880,51233,1376,752,359,2487,53720
07-11-2014,7,22791,20909,9397,3394,56492,1374,1056,368,2798,59290
07-11-2014,8,23112,21125,9378,3755,57370,1378,1109,392,2879,60249
07-11-2014,9,22946,20924,9386,3903,57159,1368,1109,381,2858,60017
07-11-2014,10,22889,20725,8985,3933,56532,1372,614,333,2319,58851
07-11-2014,11,22804,20467,8890,3959,56120,1359,611,322,2292,58412
07-11-2014,12,22108,20154,8920,3847,55030,1357,591,321,2269,57299
07-11-2014,13,21706,19971,8771,3792,54239,1357,631,318,2306,56545
07-11-2014,14,21595,20197,9064,3793,54651,1363,998,340,2701,57352
07-11-2014,15,21452,20320,9199,3962,54931,1422,1158,361,2941,57872
07-11-2014,16,21624,20394,9373,4163,55554,1439,1337,390,3166,58720
07-11-2014,17,22332,20536,9280,4560,56709,1475,1374,369,3218,59927
07-11-2014,18,21790,20140,9084,4773,55787,1478,1151,387,3016,58803
07-11-2014,19,20968,19487,8528,4760,53742,1424,747,328,2499,56241
07-11-2014,20,19544,18081,7974,4731,50331,1419,512,338,2269,52600
07-11-2014,21,18704,16975,7837,4439,47955,1364,476,320,2160,50115
07-11-2014,22,18094,16285,7920,4244,46543,1360,407,117,1884,48427
07-11-2014,23,17115,15675,7257,4039,44086,1312,387,118,1817,45903
08-11-2014,0,14943,15295,7143,3697,41079,1230,385,108,1723,42802
08-11-2014,1,14141,15109,6966,3502,39718,1084,385,107,1576,41294
08-11-2014,2,13693,14891,6909,3530,39024,1057,386,101,1544,40568
08-11-2014,3,13207,14851,6910,3570,38537,996,389,103,1488,40025
08-11-2014,4,13071,14786,6957,3606,38420,1083,399,101,1583,40003
08-11-2014,5,13120,15002,7085,3583,38790,1230,438,101,1769,40559
08-11-2014,6,14495,15102,7194,3610,40402,1212,471,110,1793,42195
08-11-2014,7,16683,15416,7378,3599,43077,1210,479,129,1818,44895
08-11-2014,8,17938,16156,7434,3747,45274,1168,477,163,1808,47082
08-11-2014,9,18803,16431,7425,3705,46364,1222,477,195,1894,48258
08-11-2014,10,19153,16613,7461,3901,47128,1236,476,201,1913,49041
08-11-2014,11,18961,16773,7530,3807,47071,1204,475,200,1879,48950
08-11-2014,12,18670,16878,7510,3610,46668,1199,474,196,1869,48537
08-11-2014,13,18543,16672,7543,3527,46286,1205,473,196,1874,48160
08-11-2014,14,18696,16916,7733,3438,46783,1229,474,197,1900,48683
08-11-2014,15,19286,17853,8130,3432,48701,1212,566,267,2045,50746
08-11-2014,16,19933,18857,8506,3553,50849,1222,707,307,2236,53085
08-11-2014,17,20370,19131,8529,3856,51887,1210,760,306,2276,54163
08-11-2014,18,20165,18947,8471,3553,51136,1179,572,325,2076,53212
08-11-2014,19,19446,18429,8080,3367,49322,1189,462,246,1897,51219
08-11-2014,20,18744,17311,7647,3235,46937,1192,450,206,1848,48785
08-11-2014,21,18299,16407,7473,3158,45337,1200,437,132,1769,47106
08-11-2014,22,17370,15970,7589,2947,43876,1202,400,125,1727,45603
08-11-2014,23,16028,15615,7156,2829,41627,1166,387,121,1674,43301
09-11-2014,0,13849,15131,6846,2589,38414,994,385,117,1496,39910
09-11-2014,1,12924,14817,6674,2656,37072,861,385,113,1359,38431
09-11-2014,2,11931,14766,6615,2720,36032,841,385,112,1338,37370
09-11-2014,3,11893,14595,6574,2754,35814,847,388,109,1344,37158
09-11-2014,4,11734,14414,6603,2872,35622,856,388,112,1356,36978
09-11-2014,5,12090,14377,6641,3058,36167,885,389,114,1388,37555
09-11-2014,6,12586,14512,6646,3087,36832,869,405,115,1389,38221
09-11-2014,7,12815,14852,6759,3131,37558,873,418,115,1406,38964
09-11-2014,8,13489,15103,6815,3284,38690,1005,488,114,1607,40297
09-11-2014,9,15065,15204,6868,3354,40492,1213,492,114,1819,42311
09-11-2014,10,15913,15540,6971,3313,41738,1201,503,113,1817,43555
09-11-2014,11,16780,15827,7089,3129,42826,1186,501,110,1797,44623
09-11-2014,12,16642,16139,7058,3259,43097,1165,497,108,1770,44867
09-11-2014,13,16697,16187,7016,3224,43124,1164,496,111,1771,44895
09-11-2014,14,16735,16249,7050,3198,43232,1151,504,118,1773,45005
09-11-2014,15,17646,17026,7307,3183,45162,1154,600,129,1883,47045
09-11-2014,16,18715,18011,7537,3409,47672,1161,758,217,2136,49808
09-11-2014,17,19008,18792,7542,3474,48816,1157,833,214,2204,51020
09-11-2014,18,18825,18707,7420,3377,48329,1242,621,242,2105,50434
09-11-2014,19,18616,17938,7230,3346,47131,1253,606,198,2057,49188
09-11-2014,20,18233,17087,7067,3207,45595,1259,522,216,1997,47592
09-11-2014,21,17773,16665,6871,3044,44352,1259,469,179,1907,46259
09-11-2014,22,17358,16466,6739,2821,43385,1229,409,177,1815,45200
09-11-2014,23,15508,16046,6648,2551,40753,1221,386,166,1773,42526
10-11-2014,0,14503,15581,6624,2423,39130,1363,385,164,1912,41042
10-11-2014,1,13758,15366,6608,2289,38022,1379,385,159,1923,39945
10-11-2014,2,13829,15078,6439,2121,37466,1368,386,143,1897,39363
10-11-2014,3,13500,15095,6452,2128,37174,1304,394,147,1845,39019
10-11-2014,4,13883,15077,6536,2211,37709,1410,396,159,1965,39674
10-11-2014,5,15994,16051,6949,2379,41373,1418,442,292,2152,43525
10-11-2014,6,18632,17744,7683,3034,47094,1454,659,380,2493,49587
10-11-2014,7,20115,19899,8253,3431,51699,1456,860,508,2824,54523
10-11-2014,8,20221,20167,8347,3489,52224,1452,934,493,2879,55103
10-11-2014,9,20249,20102,8252,3447,52051,1447,992,474,2913,54964
10-11-2014,10,20390,20005,7983,3352,51729,1420,716,351,2487,54216
10-11-2014,11,20227,20440,7911,3412,51990,1415,658,348,2421,54411
10-11-2014,12,19640,20314,8098,3749,51800,1407,699,347,2453,54253
10-11-2014,13,19570,20306,8077,3702,51655,1407,709,338,2454,54109
10-11-2014,14,19866,20267,8310,3830,52273,1396,870,481,2747,55020
10-11-2014,15,20105,20365,8597,3787,52855,1400,1007,484,2891,55746
10-11-2014,16,20842,20563,8686,3493,53585,1419,1098,472,2989,56574
10-11-2014,17,21193,20564,8457,3968,54182,1433,1116,445,2994,57176
10-11-2014,18,20860,20024,8276,3715,52875,1445,926,499,2870,55745
10-11-2014,19,20398,19401,7755,3446,50999,1455,814,368,2637,53636
10-11-2014,20,19726,18353,7652,3267,48997,1459,575,359,2393,51390
10-11-2014,21,19170,17350,7477,3345,47341,1449,535,323,2307,49648
10-11-2014,22,18125,16529,7015,3173,44842,1418,409,184,2011,46853
10-11-2014,23,16543,15771,6591,3119,42024,1409,392,173,1974,43998
11-11-2014,0,15099,15051,6569,3049,39769,1261,391,161,1813,41582
11-11-2014,1,14513,14648,6579,2952,38692,1248,390,156,1794,40486
11-11-2014,2,14405,14524,6575,2977,38483,1257,391,147,1795,40278
11-11-2014,3,14089,14496,6585,2892,38063,1263,395,146,1804,39867
11-11-2014,4,14184,14730,6570,2841,38326,1275,397,149,1821,40147
11-11-2014,5,16278,15486,6896,2679,41340,1293,470,299,2062,43402
11-11-2014,6,18558,17106,7569,2993,46225,1369,710,446,2525,48750
11-11-2014,7,20672,19108,8143,3276,51199,1398,975,467,2840,54039
11-11-2014,8,20930,19279,8250,3353,51812,1365,1039,471,2875,54687
11-11-2014,9,21012,19186,8244,3202,51644,1360,1026,460,2846,54490
11-11-2014,10,20819,19763,7882,3113,51578,1349,624,440,2413,53991
11-11-2014,11,20630,19946,7846,3221,51642,1329,591,384,2304,53946
11-11-2014,12,20317,19729,7904,3050,51000,1297,592,373,2262,53262
11-11-2014,13,20044,19744,7859,3187,50834,1287,600,365,2252,53086
11-11-2014,14,20077,19879,7958,3203,51117,1287,926,431,2644,53761
11-11-2014,15,20469,19996,8143,3223,51832,1285,1080,426,2791,54623
11-11-2014,16,20994,20383,8245,3477,53099,1286,1192,503,2981,56080
11-11-2014,17,21522,20243,8255,3889,53908,1281,1176,430,2887,56795
11-11-2014,18,21101,19892,8220,3830,53042,1278,1074,400,2752,55794
11-11-2014,19,20486,19243,7786,3743,51258,1268,820,298,2386,53644
11-11-2014,20,19526,18569,7490,3797,49382,1263,671,282,2216,51598
11-11-2014,21,18578,17854,7232,3980,47644,1272,514,246,2032,49676
11-11-2014,22,17004,16985,7049,4129,45167,1266,428,108,1802,46969
11-11-2014,23,15337,15877,6733,4282,42229,1260,402,111,1773,44002
12-11-2014,0,13764,14879,6554,4178,39375,1075,406,112,1593,40968
12-11-2014,1,12961,14551,6616,4138,38266,918,408,120,1446,39712
12-11-2014,2,12685,14467,6555,4211,37917,897,407,131,1435,39352
12-11-2014,3,12556,14504,6550,4246,37857,905,413,148,1466,39323
12-11-2014,4,12851,14668,6591,4484,38593,1037,420,163,1620,40213
12-11-2014,5,14145,15649,7149,4741,41684,1068,477,313,1858,43542
12-11-2014,6,17182,17622,7779,4883,47466,1161,763,407,2331,49797
12-11-2014,7,19442,19696,8256,5145,52540,1156,938,472,2566,55106
12-11-2014,8,19578,20120,8362,5308,53368,1145,966,500,2611,55979
12-11-2014,9,19730,19580,8422,5282,53014,1145,981,495,2621,55635
12-11-2014,10,19969,19640,7967,5154,52731,1159,582,260,2001,54732
12-11-2014,11,19726,20162,7829,4976,52694,1163,567,224,1954,54648
12-11-2014,12,19463,20303,7700,4875,52342,1157,571,258,1986,54328
12-11-2014,13,19518,20424,7673,4651,52266,1168,574,271,2013,54279
12-11-2014,14,19828,20633,8237,4537,53236,1238,863,502,2603,55839
12-11-2014,15,20388,20799,8561,4468,54215,1214,1000,540,2754,56969
12-11-2014,16,20834,21320,8582,4610,55347,1259,1096,573,2928,58275
12-11-2014,17,21160,21601,8542,4957,56261,1177,1172,532,2881,59142
12-11-2014,18,20897,21218,8538,4492,55144,1169,998,519,2686,57830
12-11-2014,19,20517,20581,8062,3987,53146,1174,868,204,2246,55392
12-11-2014,20,20063,19360,7573,3909,50903,1167,634,245,2046,52949
12-11-2014,21,19640,18888,7305,3414,49247,1175,454,193,1822,51069
12-11-2014,22,18797,17947,7066,3255,47066,1160,431,195,1786,48852
12-11-2014,23,17232,17376,6815,2893,44315,1184,421,185,1790,46105
13-11-2014,0,15614,16771,7010,2793,42187,1180,424,180,1784,43971
13-11-2014,1,14667,16333,7069,2632,40703,1185,426,184,1795,42498
13-11-2014,2,13563,16228,6962,2569,39321,1181,424,181,1786,41107
13-11-2014,3,12450,16142,6876,2431,37898,1186,434,180,1800,39698
13-11-2014,4,13183,16141,7076,2389,38791,1208,450,180,1838,40629
13-11-2014,5,15320,16829,7666,2381,42197,1243,452,295,1990,44187
13-11-2014,6,18699,19153,8299,3118,49269,1304,692,413,2409,51678
13-11-2014,7,20522,20540,8686,3771,53519,1305,924,508,2737,56256
13-11-2014,8,20923,20731,8834,4022,54509,1291,953,533,2777,57286
13-11-2014,9,20977,20721,8832,4211,54741,1284,963,528,2775,57516
13-11-2014,10,20871,20885,8440,4435,54630,1282,681,278,2241,56871
13-11-2014,11,20840,20800,8345,4493,54477,1286,663,260,2209,56686
13-11-2014,12,20382,20719,8346,4392,53837,1287,663,278,2228,56065
13-11-2014,13,20429,20693,8438,4281,53841,1299,614,265,2178,56019
13-11-2014,14,20477,20869,8972,4251,54568,1295,925,361,2581,57149
13-11-2014,15,20947,21006,9132,4251,55337,1309,1208,373,2890,58227
13-11-2014,16,21427,21328,9105,4267,56129,1300,1497,391,3188,59317
13-11-2014,17,21713,21232,9061,4408,56415,1333,1308,345,2986,59401
13-11-2014,18,21590,20764,8995,4310,55660,1328,1165,356,2849,58509
13-11-2014,19,21105,20407,8490,4012,54015,1317,861,207,2385,56400
13-11-2014,20,20204,19799,8110,3692,51804,1300,749,164,2213,54017
13-11-2014,21,19888,18770,7933,3547,50138,1310,445,168,1923,52061
13-11-2014,22,19054,17948,7720,3053,47774,1305,423,164,1892,49666
13-11-2014,23,17870,16966,7422,2810,45068,1285,404,162,1851,46919
14-11-2014,0,16023,15944,7493,2559,42019,1271,401,163,1835,43854
14-11-2014,1,14413,15156,7364,2466,39400,1262,426,159,1847,41247
14-11-2014,2,13011,14958,7269,2487,37724,1264,434,153,1851,39575
14-11-2014,3,12670,14893,7268,2626,37455,1261,437,159,1857,39312
14-11-2014,4,13287,15060,7412,2818,38577,1264,442,168,1874,40451
14-11-2014,5,15639,15779,7833,2997,42250,1254,456,265,1975,44225
14-11-2014,6,19275,18365,8634,3345,49618,1259,765,342,2366,51984
14-11-2014,7,21458,20120,9098,3636,54311,1247,1022,435,2704,57015
14-11-2014,8,21830,20507,9144,3782,55263,1270,1005,487,2762,58025
14-11-2014,9,21577,20428,9105,3791,54902,1258,1011,500,2769,57671
14-11-2014,10,21467,20622,8710,3910,54709,1250,646,253,2149,56858
14-11-2014,11,21268,20716,8567,4017,54568,1252,609,277,2138,56706
14-11-2014,12,20844,20504,8487,4104,53939,1280,613,296,2189,56128
14-11-2014,13,20217,20424,8569,4225,53436,1323,610,286,2219,55655
14-11-2014,14,19936,20061,8908,4276,53181,1337,995,420,2752,55933
14-11-2014,15,20022,19994,9131,4365,53512,1341,1022,515,2878,56390
14-11-2014,16,20304,20140,9120,4583,54147,1347,1220,531,3098,57245
14-11-2014,17,20608,20029,9003,4806,54446,1331,1228,529,3088,57534
14-11-2014,18,19841,19682,8925,5004,53452,1327,1011,485,2823,56275
14-11-2014,19,18764,18918,8307,5036,51027,1302,836,205,2343,53370
14-11-2014,20,17661,17844,7768,5130,48402,1297,703,210,2210,50612
14-11-2014,21,17283,16919,7319,5034,46556,1265,477,236,1978,48534
14-11-2014,22,16175,16358,7189,4767,44489,1285,447,229,1961,46450
14-11-2014,23,14588,15480,7156,4619,41842,1286,421,217,1924,43766
15-11-2014,0,13022,14662,7054,4578,39316,1229,407,218,1854,41170
15-11-2014,1,12130,14438,7034,4587,38189,1240,404,209,1853,40042
15-11-2014,2,11822,14547,6910,4529,37806,1241,399,209,1849,39655
15-11-2014,3,11000,14505,6785,4634,36924,1240,406,214,1860,38784
15-11-2014,4,11050,14542,6788,4664,37045,1262,408,222,1892,38937
15-11-2014,5,11515,14617,6809,4666,37606,1301,410,225,1936,39542
15-11-2014,6,12442,14807,6915,4836,39002,1311,411,235,1957,40959
15-11-2014,7,14413,15029,7036,4924,41402,1312,414,248,1974,43376
15-11-2014,8,16116,15687,7132,4983,43918,1309,456,250,2015,45933
15-11-2014,9,17479,16424,7431,5109,46445,1316,478,277,2071,48516
15-11-2014,10,17977,16960,7644,5247,47828,1312,492,286,2090,49918
15-11-2014,11,17907,17101,7559,5369,47935,1313,477,290,2080,50015
15-11-2014,12,17768,17400,7583,5209,47959,1316,490,268,2074,50033
15-11-2014,13,17643,17589,7568,5083,47884,1319,502,266,2087,49971
15-11-2014,14,17489,17812,7630,5243,48174,1321,519,259,2099,50273
15-11-2014,15,17637,18125,7814,5605,49181,1329,586,285,2200,51381
15-11-2014,16,18316,18611,7815,5649,50391,1323,688,279,2290,52681
15-11-2014,17,18735,18896,7893,5530,51055,1340,712,275,2327,53382
15-11-2014,18,18305,18396,7805,5608,50114,1354,603,283,2240,52354
15-11-2014,19,17751,17566,7544,5649,48510,1359,517,285,2161,50671
15-11-2014,20,17253,17339,7403,5245,47241,1373,492,301,2166,49407
15-11-2014,21,16682,16628,7218,5074,45601,1364,390,304,2058,47659
15-11-2014,22,16058,16046,7045,4888,44037,1342,438,294,2074,46111
15-11-2014,23,14360,15427,6811,4655,41254,1337,415,298,2050,43304
16-11-2014,0,12742,15010,6651,4480,38883,1271,240,304,1815,40698
16-11-2014,1,11687,15038,6647,4392,37763,1228,237,305,1770,39533
16-11-2014,2,11196,15025,6602,4332,37155,1062,233,296,1591,38746
16-11-2014,3,10964,15053,6561,4389,36968,1045,235,280,1560,38528
16-11-2014,4,10771,15075,6578,4474,36898,992,236,291,1519,38417
16-11-2014,5,10922,15116,6515,4612,37166,1089,237,292,1618,38784
16-11-2014,6,11472,15179,6567,4766,37983,1283,262,302,1847,39830
16-11-2014,7,12171,15276,6639,4887,38973,1278,316,307,1901,40874
16-11-2014,8,13098,15442,6642,5097,40280,1255,404,413,2072,42352
16-11-2014,9,15210,15402,6707,5436,42755,1251,467,394,2112,44867
16-11-2014,10,17121,16075,6867,5626,45688,1250,465,417,2132,47820
16-11-2014,11,17732,16928,6961,5705,47326,1266,459,420,2145,49471
16-11-2014,12,17584,17150,6970,5609,47313,1271,468,398,2137,49450
16-11-2014,13,17000,17053,6911,5581,46546,1267,466,384,2117,48663
16-11-2014,14,16551,17100,7023,5544,46219,1252,480,367,2099,48318
16-11-2014,15,17306,17373,7165,5573,47417,1272,550,432,2254,49671
16-11-2014,16,17758,18159,7388,5720,49025,1286,728,459,2473,51498
16-11-2014,17,18575,18815,7435,5920,50746,1282,707,446,2435,53181
16-11-2014,18,18439,19053,7521,5808,50822,1310,666,434,2410,53232
16-11-2014,19,17947,18627,7422,5747,49743,1283,585,425,2293,52036
16-11-2014,20,17348,18231,7256,5661,48497,1285,564,406,2255,50752
16-11-2014,21,16917,17728,7223,5538,47405,1252,420,355,2027,49432
16-11-2014,22,16117,17062,7091,5369,45639,1248,317,267,1832,47471
16-11-2014,23,14460,16269,6819,4865,42415,1222,277,259,1758,44173
17-11-2014,0,12143,15943,6772,4737,39597,1231,223,255,1709,41306
17-11-2014,1,11163,15744,6683,4561,38152,1241,222,245,1708,39860
17-11-2014,2,10907,15639,6676,4399,37621,1243,219,234,1696,39317
17-11-2014,3,11096,15547,6773,4152,37568,1255,224,231,1710,39278
17-11-2014,4,11636,15612,7003,4057,38308,1260,227,237,1724,40032
17-11-2014,5,14101,16390,7592,4028,42111,1338,259,282,1879,43990
17-11-2014,6,18185,18578,8347,4312,49422,1337,394,453,2184,51606
17-11-2014,7,20552,20441,8760,4112,53865,1328,524,612,2464,56329
17-11-2014,8,20895,21303,8921,4141,55261,1331,602,622,2555,57816
17-11-2014,9,21039,21071,8836,4140,55087,1304,657,638,2599,57686
17-11-2014,10,21362,21156,8538,4010,55066,1310,538,530,2378,57444
17-11-2014,11,21203,21365,8446,4061,55076,1314,525,470,2309,57385
17-11-2014,12,21233,21212,8481,3906,54832,1317,524,479,2320,57152
17-11-2014,13,21176,21348,8534,3862,54920,1310,541,460,2311,57231
17-11-2014,14,21342,21352,9009,3932,55634,1303,604,588,2495,58129
17-11-2014,15,21559,21695,9101,3903,56259,1311,938,620,2869,59128
17-11-2014,16,21761,22146,9144,3888,56939,1323,1028,656,3007,59946
17-11-2014,17,21909,21829,9242,4245,57224,1336,892,594,2822,60046
17-11-2014,18,21927,21427,9277,4005,56637,1320,708,548,2576,59213
17-11-2014,19,21401,21039,8701,3728,54869,1311,633,438,2382,57251
17-11-2014,20,20530,20046,8410,3357,52344,1306,511,415,2232,54576
17-11-2014,21,20019,19054,8320,2994,50389,1318,395,378,2091,52480
17-11-2014,22,19077,17992,8036,2943,48049,1309,308,233,1850,49899
17-11-2014,23,17119,16958,7840,2773,44690,1301,284,225,1810,46500
18-11-2014,0,15618,15842,7734,2697,41893,1290,217,231,1738,43631
18-11-2014,1,14880,15465,7731,2654,40729,1249,216,234,1699,42428
18-11-2014,2,13572,15305,7610,2669,39155,1231,216,249,1696,40851
18-11-2014,3,12341,15221,7694,2647,37905,1221,221,257,1699,39604
18-11-2014,4,13603,15525,7705,2705,39538,1260,224,254,1738,41276
18-11-2014,5,16475,16501,8207,3024,44209,1359,228,360,1947,46156
18-11-2014,6,19523,18447,8746,3515,50232,1357,398,464,2219,52451
18-11-2014,7,21186,20532,9329,3578,54624,1354,642,492,2488,57112
18-11-2014,8,21724,20953,9357,3891,55926,1351,702,557,2610,58536
18-11-2014,9,21635,20812,9243,3946,55637,1345,702,552,2599,58236
18-11-2014,10,21793,20543,8872,3978,55186,1340,555,527,2422,57608
18-11-2014,11,21609,20429,8790,4144,54971,1336,547,516,2399,57370
18-11-2014,12,21468,20324,8701,4247,54741,1342,492,561,2395,57136
18-11-2014,13,21331,20259,8733,4322,54646,1343,501,544,2388,57034
18-11-2014,14,21324,20273,9296,4425,55319,1350,745,503,2598,57917
18-11-2014,15,21692,21039,9559,4580,56870,1359,816,590,2765,59635
18-11-2014,16,21821,21503,9529,4791,57644,1372,1043,501,2916,60560
18-11-2014,17,21805,21680,9460,4785,57729,1365,971,485,2821,60550
18-11-2014,18,21608,21363,9338,5009,57318,1363,852,522,2737,60055
18-11-2014,19,21163,20698,8950,4739,55551,1357,748,487,2592,58143
18-11-2014,20,20309,19541,8424,4579,52852,1361,618,484,2463,55315
18-11-2014,21,19706,18649,8112,4600,51067,1408,462,430,2300,53367
18-11-2014,22,18720,17358,7888,4271,48238,1405,316,299,2020,50258
18-11-2014,23,16982,16486,7672,4062,45202,1385,258,264,1907,47109
19-11-2014,0,15831,15388,7625,3870,42716,1379,225,260,1864,44580
19-11-2014,1,14851,15022,7672,3976,41521,1382,223,248,1853,43374
19-11-2014,2,14301,14908,7571,4008,40788,1375,226,257,1858,42646
19-11-2014,3,13641,14928,7622,3782,39973,1369,231,259,1859,41832
19-11-2014,4,14710,15084,7599,3986,41379,1390,232,261,1883,43262
19-11-2014,5,17136,16196,7885,3876,45094,1404,276,442,2122,47216
19-11-2014,6,20010,18559,8422,3989,50979,1410,642,502,2554,53533
19-11-2014,7,21815,21114,8874,4661,56464,1429,751,624,2804,59268
19-11-2014,8,22189,21760,8875,4619,57443,1491,817,627,2935,60378
19-11-2014,9,21940,21595,8953,4669,57155,1386,821,617,2824,59979
19-11-2014,10,21838,21250,8774,4704,56568,1372,539,548,2459,59027
19-11-2014,11,22028,20967,8664,4314,55974,1418,527,529,2474,58448
19-11-2014,12,21826,21030,8607,4494,55957,1445,526,532,2503,58460
19-11-2014,13,21798,21525,8616,4396,56336,1448,516,529,2493,58829
19-11-2014,14,21694,22095,9043,4233,57064,1453,798,603,2854,59918
19-11-2014,15,22580,22605,9413,4082,58680,1472,953,526,2951,61631
19-11-2014,16,22975,22667,9512,4185,59341,1479,1073,492,3044,62385
19-11-2014,17,23054,22322,9454,4036,58866,1474,971,500,2945,61811
19-11-2014,18,22889,21803,9284,3970,57946,1452,885,496,2833,60779
19-11-2014,19,22470,20926,8921,3759,56076,1520,795,395,2710,58786
19-11-2014,20,21596,20202,8474,3552,53825,1526,640,379,2545,56370
19-11-2014,21,20972,19386,8332,3336,52026,1519,422,355,2296,54322
19-11-2014,22,20208,17964,8181,3077,49429,1504,403,207,2114,51543
19-11-2014,23,19073,16829,7976,2632,46510,1481,398,203,2082,48592
20-11-2014,0,18100,15630,7754,2444,43929,1487,405,198,2090,46019
20-11-2014,1,17224,15296,7600,2358,42478,1479,408,196,2083,44561
20-11-2014,2,16457,15019,7473,2512,41462,1481,421,196,2098,43560
20-11-2014,3,15299,14973,7441,2355,40068,1469,437,198,2104,42172
20-11-2014,4,15949,15054,7591,2371,40965,1478,447,210,2135,43100
20-11-2014,5,18542,16597,8081,2591,45812,1492,454,346,2292,48104
20-11-2014,6,20848,19283,8658,3074,51865,1482,737,414,2633,54498
20-11-2014,7,22362,21429,9117,3617,56525,1531,855,573,2959,59484
20-11-2014,8,22886,21912,9184,3762,57744,1540,873,559,2972,60716
20-11-2014,9,23016,22094,9180,3737,58027,1536,890,553,2979,61006
20-11-2014,10,22986,21806,8897,3765,57456,1521,721,469,2711,60167
20-11-2014,11,22598,21662,8743,3732,56735,1516,654,454,2624,59359
20-11-2014,12,22384,21271,8835,3450,55941,1516,686,446,2648,58589
20-11-2014,13,22556,21317,8823,3558,56254,1521,718,440,2679,58933
20-11-2014,14,22997,21623,9182,3527,57328,1527,857,524,2908,60236
20-11-2014,15,23473,21986,9479,3454,58391,1534,1043,534,3111,61502
20-11-2014,16,23606,22197,9513,3419,58735,1526,1077,535,3138,61873
20-11-2014,17,23732,22276,9456,3734,59199,1521,933,527,2981,62180
20-11-2014,18,23172,21965,9417,3695,58249,1518,938,528,2984,61233
20-11-2014,19,22884,21185,8976,3612,56656,1530,899,375,2804,59460
20-11-2014,20,22294,19839,8483,3302,53919,1533,676,402,2611,56530
20-11-2014,21,22011,18600,8318,3120,52050,1520,439,332,2291,54341
20-11-2014,22,20702,17470,8180,2861,49213,1498,261,203,1962,51175
20-11-2014,23,19656,16136,7982,2680,46454,1494,228,202,1924,48378
21-11-2014,0,18549,15212,7768,2535,44065,1428,299,170,1897,45962
21-11-2014,1,17667,14895,7724,2477,42763,1436,263,167,1866,44629
21-11-2014,2,17032,14973,7745,2545,42295,1447,247,167,1861,44156
21-11-2014,3,15982,14870,7781,2475,41109,1470,265,166,1901,43010
21-11-2014,4,16439,15004,7932,2474,41849,1490,245,172,1907,43756
21-11-2014,5,18793,16122,8414,2642,45971,1536,404,330,2270,48241
21-11-2014,6,21212,19123,9076,3003,52413,1536,758,417,2711,55124
21-11-2014,7,23394,21024,9550,3502,57469,1549,877,563,2989,60458
21-11-2014,8,23379,21526,9587,3583,58075,1560,903,578,3041,61116
21-11-2014,9,23131,21482,9539,3654,57807,1559,980,567,3106,60913
21-11-2014,10,23205,21461,9318,3631,57615,1548,859,235,2642,60257
21-11-2014,11,23311,20945,9020,3590,56866,1535,839,237,2611,59477
21-11-2014,12,23276,20797,8909,3534,56516,1534,821,237,2592,59108
21-11-2014,13,23093,20842,9015,3360,56312,1548,823,242,2613,58925
21-11-2014,14,23200,20849,9440,3202,56690,1543,945,541,3029,59719
21-11-2014,15,23070,21195,9797,3124,57187,1537,1084,536,3157,60344
21-11-2014,16,23210,21341,9839,3253,57643,1534,1122,545,3201,60844
21-11-2014,17,23165,21351,9680,3431,57628,1620,980,532,3132,60760
21-11-2014,18,22914,21244,9632,3339,57129,1614,908,516,3038,60167
21-11-2014,19,22758,20469,9072,3169,55467,1579,644,359,2582,58049
21-11-2014,20,22079,19477,8581,2937,53076,1591,474,351,2416,55492
21-11-2014,21,21747,18580,8356,2651,51334,1606,250,323,2179,53513
21-11-2014,22,20833,17701,8211,2580,49325,1593,233,182,2008,51333
21-11-2014,23,18421,17122,7986,2543,46072,1608,229,180,2017,48089
22-11-2014,0,17616,15826,7771,2324,43537,1275,229,179,1683,45220
22-11-2014,1,16498,15304,7708,2221,41732,1250,230,174,1654,43386
22-11-2014,2,16193,14851,7592,2178,40815,1255,239,172,1666,42481
22-11-2014,3,15416,14504,7562,2178,39660,1239,245,170,1654,41314
22-11-2014,4,15005,14539,7582,2231,39358,1227,247,170,1644,41002
22-11-2014,5,15577,14754,7594,2517,40442,1233,264,171,1668,42110
22-11-2014,6,16984,15499,7757,2636,42877,1240,333,183,1756,44633
22-11-2014,7,19606,16671,7996,2828,47101,1246,456,181,1883,48984
22-11-2014,8,19962,17864,8051,3018,48894,1245,497,180,1922,50816
22-11-2014,9,20761,18411,8140,3361,50673,1253,526,181,1960,52633
22-11-2014,10,21274,18679,8303,3548,51803,1252,538,179,1969,53772
22-11-2014,11,21259,18646,8340,3716,51962,1252,519,180,1951,53913
22-11-2014,12,20823,18530,8242,3584,51179,1251,512,179,1942,53121
22-11-2014,13,20216,18346,8231,3572,50365,1250,509,179,1938,52303
22-11-2014,14,20605,18472,8328,3583,50989,1250,529,171,1950,52939
22-11-2014,15,21092,19013,8517,3815,52438,1251,617,167,2035,54473
22-11-2014,16,22044,19839,8803,3842,54527,1243,663,180,2086,56613
22-11-2014,17,22164,20229,8745,4187,55325,1222,659,179,2060,57385
22-11-2014,18,21796,19731,8507,4281,54315,1219,579,175,1973,56288
22-11-2014,19,20614,19117,8340,4405,52477,1225,526,165,1916,54393
22-11-2014,20,19411,18218,8069,4273,49970,1205,491,164,1860,51830
22-11-2014,21,18034,17189,7963,4253,47440,1193,326,164,1683,49123
22-11-2014,22,17762,16187,7885,4028,45863,1188,225,164,1577,47440
22-11-2014,23,16258,15207,7750,3724,42939,1205,223,164,1592,44531
23-11-2014,0,14680,14748,7580,3209,40216,1124,218,164,1506,41722
23-11-2014,1,13606,14719,7466,3309,39101,1088,218,165,1471,40572
23-11-2014,2,13132,14597,7420,3297,38446,1080,218,166,1464,39910
23-11-2014,3,12892,14510,7337,3177,37915,1082,222,165,1469,39384
23-11-2014,4,12806,14519,7314,3243,37883,1084,224,167,1475,39358
23-11-2014,5,13176,14639,7374,3274,38463,1091,225,172,1488,39951
23-11-2014,6,13752,14811,7458,3447,39468,1150,225,182,1557,41025
23-11-2014,7,14614,15222,7592,3475,40906,1159,225,180,1564,42470
23-11-2014,8,15336,15782,7667,3729,42513,1167,265,183,1615,44128
23-11-2014,9,16214,16812,7716,3932,44674,1173,343,188,1704,46378
23-11-2014,10,16690,17458,7752,4137,46037,1180,381,191,1752,47789
23-11-2014,11,16913,17702,7821,4324,46762,1183,359,179,1721,48483
23-11-2014,12,16957,17956,7747,4580,47240,1168,362,178,1708,48948
23-11-2014,13,16502,17782,7703,4458,46445,1164,360,179,1703,48148
23-11-2014,14,16559,18002,7699,4505,46767,1176,381,180,1737,48504
23-11-2014,15,17117,18281,7943,4702,48044,1174,543,187,1904,49948
23-11-2014,16,17896,19159,8179,4960,50194,1180,655,198,2033,52227
23-11-2014,17,18707,19618,8309,5379,52014,1188,641,217,2046,54060
23-11-2014,18,18350,19592,8156,5342,51439,1187,590,235,2012,53451
23-11-2014,19,17580,19276,8002,5171,50028,1194,506,236,1936,51964
23-11-2014,20,16333,18795,7769,5013,47910,1197,462,249,1908,49818
23-11-2014,21,15378,17967,7571,4601,45517,1191,256,259,1706,47223
23-11-2014,22,14518,17494,7553,4458,44022,1128,230,237,1595,45617
23-11-2014,23,12268,17102,7354,3931,40656,1130,231,242,1603,42259
24-11-2014,0,11257,16873,7200,3517,38847,976,233,247,1456,40303
24-11-2014,1,11044,16819,7189,3264,38316,927,233,268,1428,39744
24-11-2014,2,10817,16813,7072,3152,37854,936,235,284,1455,39309
24-11-2014,3,10772,16775,7015,3063,37624,947,243,279,1469,39093
24-11-2014,4,10894,17043,7128,3144,38211,1071,246,286,1603,39814
24-11-2014,5,11881,17922,7642,3402,40848,1473,260,287,2020,42868
24-11-2014,6,16634,19734,8255,4116,48739,1502,638,537,2677,51416
24-11-2014,7,19867,21345,8852,4518,54581,1518,856,590,2964,57545
24-11-2014,8,20499,21861,8906,4552,55818,1526,844,155,2525,58343
24-11-2014,9,20704,21836,8862,4668,56070,1550,870,721,3141,59211
24-11-2014,10,20836,21663,8464,4639,55601,1576,530,618,2724,58325
24-11-2014,11,20679,21844,8326,4723,55573,1575,522,562,2659,58232
24-11-2014,12,20348,21780,8371,4743,55243,1566,518,584,2668,57911
24-11-2014,13,20361,21544,8448,4878,55230,1570,539,584,2693,57923
24-11-2014,14,20687,21344,8881,4915,55828,1580,710,704,2994,58822
24-11-2014,15,21094,21521,9191,4761,56569,1572,929,675,3176,59745
24-11-2014,16,21493,21745,9215,4685,57138,1591,1012,629,3232,60370
24-11-2014,17,21872,21393,9073,4907,57244,1605,966,641,3212,60456
24-11-2014,18,21477,20603,8953,4984,56017,1601,801,683,3085,59102
24-11-2014,19,20752,19828,8475,4959,54013,1605,761,528,2894,56907
24-11-2014,20,19675,19060,8131,4833,51698,1606,667,485,2758,54456
24-11-2014,21,19019,18277,7958,4544,49799,1602,511,444,2557,52356
24-11-2014,22,17601,17558,7748,4019,46925,1577,441,301,2319,49244
24-11-2014,23,16014,16792,7477,3795,44078,1570,485,284,2339,46417
25-11-2014,0,14743,15878,7315,3683,41618,1563,442,272,2277,43895
25-11-2014,1,13997,15605,7253,3568,40423,1570,413,255,2238,42661
25-11-2014,2,13570,15486,7226,3423,39706,1565,414,250,2229,41935
25-11-2014,3,13278,15462,7325,3094,39158,1566,414,247,2227,41385
25-11-2014,4,14872,15708,7478,2869,40929,1568,414,234,2216,43145
25-11-2014,5,17360,16560,7822,3014,44755,1574,467,314,2355,47110
25-11-2014,6,19615,20157,8442,3366,51579,1568,733,445,2746,54325
25-11-2014,7,21467,22623,9104,4044,57239,1567,834,586,2987,60226
25-11-2014,8,21293,22955,9111,4269,57627,1572,880,622,3074,60701
25-11-2014,9,20988,22322,9157,4096,56561,1545,867,614,3026,59587
25-11-2014,10,20708,22556,8920,3927,56111,1537,679,629,2845,58956
25-11-2014,11,20530,22057,8696,3924,55206,1539,530,580,2649,57855
25-11-2014,12,20833,22041,8639,3808,55322,1523,562,553,2638,57960
25-11-2014,13,20799,21824,8715,3738,55076,1510,693,547,2750,57826
25-11-2014,14,20966,22209,9074,3673,55922,1498,859,580,2937,58859
25-11-2014,15,21154,22454,9510,3698,56816,1484,992,556,3032,59848
25-11-2014,16,21776,22390,9394,3770,57329,1493,1089,539,3121,60450
25-11-2014,17,21585,22605,9349,4032,57571,1498,973,539,3010,60581
25-11-2014,18,21615,22805,9391,3710,57521,1481,899,513,2893,60414
25-11-2014,19,21343,22248,8976,3414,55981,1480,854,418,2752,58733
25-11-2014,20,20354,21931,8274,3175,53734,1478,679,404,2561,56295
25-11-2014,21,20193,21254,7992,2876,52315,1473,417,340,2230,54545
25-11-2014,22,19707,19206,7708,2506,49127,1385,421,200,2006,51133
25-11-2014,23,17882,17757,7424,2242,45305,1371,402,203,1976,47281
26-11-2014,0,17025,16570,7271,2109,42976,1287,215,198,1700,44676
26-11-2014,1,16043,16255,7220,2122,41641,1285,214,192,1691,43332
26-11-2014,2,14557,15697,7077,2166,39498,1296,214,192,1702,41200
26-11-2014,3,13828,15574,7034,1938,38375,1299,220,194,1713,40088
26-11-2014,4,14484,15912,7142,2054,39592,1344,243,194,1781,41373
26-11-2014,5,16938,17237,7530,2327,44032,1357,435,356,2148,46180
26-11-2014,6,19725,20419,8569,2941,51652,1438,722,492,2652,54304
26-11-2014,7,20989,22183,9158,3677,56007,1545,911,576,3032,59039
26-11-2014,8,21200,22149,9231,3796,56377,1595,918,574,3087,59464
26-11-2014,9,21357,21873,9329,3890,56449,1570,917,566,3053,59502
26-11-2014,10,21715,21919,9109,4070,56813,1522,853,230,2605,59418
26-11-2014,11,21516,21543,9136,4100,56296,1495,749,245,2489,58785
26-11-2014,12,21167,21464,9051,4177,55860,1546,761,247,2554,58414
26-11-2014,13,21172,21458,8945,4358,55934,1528,777,285,2590,58524
26-11-2014,14,21610,21433,9263,4504,56811,1539,928,530,2997,59808
26-11-2014,15,21723,22038,9387,4468,57617,1540,1024,537,3101,60718
26-11-2014,16,21821,22236,9414,4681,58152,1544,1145,517,3206,61358
26-11-2014,17,21507,21954,9489,4833,57783,1546,1013,490,3049,60832
26-11-2014,18,21735,21716,9453,4680,57583,1546,925,491,2962,60545
26-11-2014,19,21377,21717,8988,4461,56544,1533,828,324,2685,59229
26-11-2014,20,21252,20067,8397,4349,54065,1534,630,260,2424,56489
26-11-2014,21,20749,18993,7982,4125,51849,1522,405,243,2170,54019
26-11-2014,22,19581,17817,7814,4044,49256,1533,421,194,2148,51404
26-11-2014,23,17048,16316,7453,4042,44860,1460,405,197,2062,46922
27-11-2014,0,14906,15657,7259,3726,41549,1296,399,194,1889,43438
27-11-2014,1,14118,15424,7234,3844,40622,1268,398,190,1856,42478
27-11-2014,2,13643,15313,7159,3910,40026,1263,399,191,1853,41879
27-11-2014,3,13749,15307,7172,3865,40093,1268,403,198,1869,41962
27-11-2014,4,14098,15839,7279,4036,41252,1331,406,197,1934,43186
27-11-2014,5,15806,17161,7924,4314,45204,1367,445,363,2175,47379
27-11-2014,6,18756,19836,8443,4394,51429,1518,800,448,2766,54195
27-11-2014,7,21502,21745,8959,4701,56907,1536,975,579,3090,59997
27-11-2014,8,21460,22352,9142,4798,57753,1550,994,604,3148,60901
27-11-2014,9,21341,21708,9109,5065,57223,1534,984,617,3135,60358
27-11-2014,10,21492,21875,8953,5179,57499,1527,841,270,2638,60137
27-11-2014,11,20873,21698,8775,5338,56683,1538,820,287,2645,59328
27-11-2014,12,20579,21267,8754,5297,55898,1563,841,267,2671,58569
27-11-2014,13,20864,21251,8753,5275,56142,1577,849,281,2707,58849
27-11-2014,14,21210,21854,8989,5211,57263,1582,950,581,3113,60376
27-11-2014,15,21691,22405,9293,5140,58530,1579,1068,571,3218,61748
27-11-2014,16,21651,22610,9340,5410,59011,1588,1154,530,3272,62283
27-11-2014,17,21566,22446,9338,5555,58905,1581,1020,521,3122,62027
27-11-2014,18,21416,22207,9038,5429,58090,1577,971,512,3060,61150
27-11-2014,19,20605,21602,8582,5413,56203,1578,794,270,2642,58845
27-11-2014,20,19440,20643,8153,5411,53647,1594,776,228,2598,56245
27-11-2014,21,18800,19161,7904,5322,51188,1589,441,216,2246,53434
27-11-2014,22,17742,17668,7631,5111,48152,1572,434,193,2199,50351
27-11-2014,23,15597,16853,7374,4878,44701,1542,397,193,2132,46833
28-11-2014,0,14485,15644,7209,4717,42055,1472,234,190,1896,43951
28-11-2014,1,14024,15168,7141,4579,40913,1469,233,188,1890,42803
28-11-2014,2,13798,15100,7112,4561,40570,1472,233,187,1892,42462
28-11-2014,3,13743,15076,7110,4518,40447,1470,235,185,1890,42337
28-11-2014,4,14167,15331,7200,4484,41182,1468,243,182,1893,43075
28-11-2014,5,15672,16544,7643,4557,44416,1471,452,343,2266,46682
28-11-2014,6,18608,18668,8620,4832,50728,1467,817,402,2686,53414
28-11-2014,7,21358,21212,9256,5519,57345,1459,950,575,2984,60329
28-11-2014,8,21648,21859,9198,5974,58680,1456,999,594,3049,61729
28-11-2014,9,21178,21543,9177,6041,57938,1443,942,591,2976,60914
28-11-2014,10,21193,21175,8765,6072,57207,1462,873,448,2783,59990
28-11-2014,11,20776,20950,8560,6059,56346,1479,860,426,2765,59111
28-11-2014,12,20341,20712,8539,5926,55519,1441,901,426,2768,58287
28-11-2014,13,20361,20539,8721,5829,55450,1458,915,423,2796,58246
28-11-2014,14,20470,20780,9258,5700,56209,1437,936,532,2905,59114
28-11-2014,15,20619,21236,9582,5678,57115,1431,1061,557,3049,60164
28-11-2014,16,20774,21821,9575,5724,57893,1459,1066,559,3084,60977
28-11-2014,17,21191,21792,9494,5705,58182,1444,987,556,2987,61169
28-11-2014,18,20937,21130,9340,5692,57099,1435,926,544,2905,60004
28-11-2014,19,20164,20510,8656,5630,54961,1439,885,276,2600,57561
28-11-2014,20,19096,19309,8255,5421,52081,1448,818,251,2517,54598
28-11-2014,21,18019,18404,8097,5460,49979,1445,429,248,2122,52101
28-11-2014,22,16662,17760,7822,5320,47565,1443,416,228,2087,49652
28-11-2014,23,15607,16574,7640,4967,44789,1409,414,213,2036,46825
29-11-2014,0,15305,15163,7236,4983,42687,1139,412,208,1759,44446
29-11-2014,1,14607,14874,7206,4451,41139,1081,409,201,1691,42830
29-11-2014,2,14135,14725,7179,4248,40287,1083,407,196,1686,41973
29-11-2014,3,13848,14723,7170,4171,39912,1080,409,193,1682,41594
29-11-2014,4,13891,14732,7156,4178,39956,1082,411,191,1684,41640
29-11-2014,5,14412,15126,7220,4189,40948,1086,473,188,1747,42695
29-11-2014,6,15486,15733,7477,4292,42989,1084,584,185,1853,44842
29-11-2014,7,17284,16409,7700,4168,45561,1083,642,184,1909,47470
29-11-2014,8,18647,17248,7836,4338,48069,1086,671,181,1938,50007
29-11-2014,9,19942,18082,7907,4574,50504,1087,709,189,1985,52489
29-11-2014,10,20126,18920,7922,4673,51642,1089,709,190,1988,53630
29-11-2014,11,20220,18883,8123,4755,51981,1088,709,190,1987,53968
29-11-2014,12,20344,19085,8082,4741,52253,1090,706,191,1987,54240
29-11-2014,13,19745,19405,8105,4625,51882,1081,705,194,1980,53862
29-11-2014,14,19822,19788,8139,4618,52369,1082,707,196,1985,54354
29-11-2014,15,20512,19978,8471,4535,53495,1072,707,219,1998,55493
29-11-2014,16,21184,20527,8625,4549,54886,991,813,231,2035,56921
29-11-2014,17,21269,20904,8603,4545,55322,1085,710,223,2018,57340
29-11-2014,18,20933,20594,8368,4566,54463,1093,711,213,2017,56480
29-11-2014,19,20212,20111,7997,4588,52909,1093,701,208,2002,54911
29-11-2014,20,19336,19145,7677,4649,50807,1093,489,188,1770,52577
29-11-2014,21,18803,18119,7835,4554,49310,1093,415,171,1679,50989
29-11-2014,22,18327,17364,7573,4561,47825,1085,405,183,1673,49498
29-11-2014,23,16971,16658,7454,4739,45825,1072,407,185,1664,47489
30-11-2014,0,15581,15416,7291,4401,42690,990,406,184,1580,44270
30-11-2014,1,14355,14909,7113,4047,40423,994,408,183,1585,42008
30-11-2014,2,13515,14741,7107,3800,39163,993,407,183,1583,40746
30-11-2014,3,13220,14703,7108,3841,38872,997,411,185,1593,40465
30-11-2014,4,13185,14670,6982,4030,38868,1000,413,185,1598,40466
30-11-2014,5,13618,14739,6823,4045,39225,1001,413,183,1597,40822
30-11-2014,6,14641,14929,7084,3925,40578,994,420,188,1602,42180
30-11-2014,7,15482,15433,7103,4038,42054,994,551,190,1735,43789
30-11-2014,8,16401,15956,7185,4380,43922,1001,470,188,1659,45581
30-11-2014,9,18182,16593,7291,4985,47052,1025,536,179,1740,48792
30-11-2014,10,19414,17685,7521,5186,49805,1081,576,194,1851,51656
30-11-2014,11,19728,18727,7425,5254,51134,999,586,195,1780,52914
30-11-2014,12,19908,18771,7534,5152,51366,989,596,196,1781,53147
30-11-2014,13,19486,19082,7545,4887,50998,991,604,198,1793,52791
30-11-2014,14,19424,19041,7651,4741,50857,996,705,213,1914,52771
30-11-2014,15,20117,18800,8049,4830,51796,1058,710,260,2028,53824
30-11-2014,16,20962,19857,8312,5008,54139,1111,710,354,2175,56314
30-11-2014,17,20746,20161,8343,5356,54606,1135,710,390,2235,56841
30-11-2014,18,20697,20103,8313,5353,54467,1118,682,337,2137,56604
30-11-2014,19,20612,19523,8042,5193,53369,997,704,288,1989,55358
30-11-2014,20,20244,19454,7793,4947,52438,1026,609,208,1843,54281
30-11-2014,21,19571,18587,7709,4791,50659,993,428,202,1623,52282
30-11-2014,22,19000,17516,7583,4626,48725,1014,403,167,1584,50309
30-11-2014,23,17227,16396,7294,4239,45155,1040,402,165,1607,46762
01-12-2014,0,15491,15860,7185,4016,42553,1187,401,163,1751,44304
01-12-2014,1,14552,15241,7106,4395,41294,1189,397,164,1750,43044
01-12-2014,2,14335,15193,7118,4174,40821,1188,398,165,1751,42572
01-12-2014,3,14389,15197,7227,4089,40902,1207,403,165,1775,42677
01-12-2014,4,14948,15379,7332,4213,41872,1259,410,165,1834,43706
01-12-2014,5,15831,16395,8200,4355,44782,1394,552,346,2292,47074
01-12-2014,6,18999,19087,9154,4759,52000,1467,772,519,2758,54758
01-12-2014,7,22234,21572,9571,5072,58451,1505,1118,568,3191,61642
01-12-2014,8,23038,22501,9499,5202,60240,1502,1100,589,3191,63431
01-12-2014,9,22961,22324,9464,5154,59902,1521,1068,590,3179,63081
01-12-2014,10,22662,22313,9077,5520,59573,1537,780,599,2916,62489
01-12-2014,11,22351,21957,8847,5481,58637,1542,718,579,2839,61476
01-12-2014,12,22428,21530,8809,5303,58069,1542,751,594,2887,60956
01-12-2014,13,22451,21690,8981,5297,58419,1535,703,580,2818,61237
01-12-2014,14,22665,21904,9457,5171,59196,1563,1021,554,3138,62334
01-12-2014,15,22581,22637,9790,5393,60401,1547,1308,566,3421,63822
01-12-2014,16,23062,22946,9762,5314,61085,1542,1284,559,3385,64470
01-12-2014,17,22993,22895,9545,5537,60972,1538,1142,512,3192,64164
01-12-2014,18,22764,22292,9644,5355,60056,1533,865,491,2889,62945
01-12-2014,19,22252,21432,9073,5265,58023,1536,676,395,2607,60630
01-12-2014,20,20910,21351,8685,5098,56044,1537,418,346,2301,58345
01-12-2014,21,20119,20432,8374,4877,53802,1535,407,283,2225,56027
01-12-2014,22,19061,19203,8215,4622,51101,1541,402,191,2134,53235
01-12-2014,23,17110,18353,7941,4579,47983,1578,402,186,2166,50149
02-12-2014,0,16575,17040,7654,4315,45585,1600,405,190,2195,47780
02-12-2014,1,16123,16527,7484,4237,44370,1598,405,191,2194,46564
02-12-2014,2,15931,16354,7471,4093,43850,1595,406,193,2194,46044
02-12-2014,3,15410,16275,7464,3706,42856,1591,409,197,2197,45053
02-12-2014,4,16237,16578,7603,3619,44037,1601,411,204,2216,46253
02-12-2014,5,18322,18093,8133,3643,48190,1601,505,402,2508,50698
02-12-2014,6,20834,20502,8889,3984,54208,1623,732,579,2934,57142
02-12-2014,7,22836,22689,9382,4565,59472,1638,1072,596,3306,62778
02-12-2014,8,23143,23494,9474,4673,60782,1651,1094,596,3341,64123
02-12-2014,9,22927,23557,9372,4530,60385,1673,1050,591,3314,63699
02-12-2014,10,22988,23527,8957,4481,59952,1665,759,503,2927,62879
02-12-2014,11,22747,23224,8851,4310,59132,1660,771,489,2920,62052
02-12-2014,12,22633,23047,9092,4160,58933,1659,819,490,2968,61901
02-12-2014,13,22859,23160,8955,4032,59005,1679,872,463,3014,62019
02-12-2014,14,23202,23399,9337,4086,60024,1686,974,571,3231,63255
02-12-2014,15,23200,23583,9567,4072,60423,1711,1158,672,3541,63964
02-12-2014,16,23302,23699,10071,4200,61272,1725,1134,694,3553,64825
02-12-2014,17,23168,23684,9977,4316,61144,1769,997,709,3475,64619
02-12-2014,18,22748,23261,9408,4299,59715,1764,979,577,3320,63035
02-12-2014,19,22503,22477,8769,4049,57798,1789,755,504,3048,60846
02-12-2014,20,21802,21705,8338,3713,55557,1827,721,438,2986,58543
02-12-2014,21,21376,20947,8048,3335,53707,1829,607,339,2775,56482
02-12-2014,22,20419,19836,7952,3337,51545,1813,602,244,2659,54204
02-12-2014,23,18944,18721,7774,2904,48343,1786,597,245,2628,50971
03-12-2014,0,17561,17441,7585,2754,45340,1762,595,246,2603,47943
03-12-2014,1,17402,16610,7527,2491,44031,1736,597,241,2574,46605
03-12-2014,2,16995,16402,7499,2453,43350,1742,596,239,2577,45927
03-12-2014,3,17006,16308,7494,2442,43249,1740,600,235,2575,45824
03-12-2014,4,17128,16542,7521,2538,43729,1748,612,229,2589,46318
03-12-2014,5,19751,17496,7877,2673,47798,1726,675,252,2653,50451
03-12-2014,6,21509,19865,8595,2904,52872,1689,786,567,3042,55914
03-12-2014,7,23225,22179,9239,3620,58263,1681,1031,602,3314,61577
03-12-2014,8,22939,23160,9357,4052,59507,1653,1033,604,3290,62797
03-12-2014,9,22932,22844,9202,4262,59240,1648,986,584,3218,62458
03-12-2014,10,23036,22536,8814,4408,58795,1632,819,324,2775,61570
03-12-2014,11,22712,22382,8469,4543,58106,1610,728,313,2651,60757
03-12-2014,12,22351,22318,8464,4440,57571,1593,726,306,2625,60196
03-12-2014,13,22515,22318,8568,4337,57739,1618,827,297,2742,60481
03-12-2014,14,22900,22174,9019,4120,58214,1625,1019,535,3179,61393
03-12-2014,15,22767,22702,9421,4213,59103,1620,1259,538,3417,62520
03-12-2014,16,23053,22663,9437,4323,59476,1665,1250,503,3418,62894
03-12-2014,17,23125,22422,9333,4549,59429,1666,1124,500,3290,62719
03-12-2014,18,22965,22324,9046,4507,58842,1650,987,498,3135,61977
03-12-2014,19,22577,21930,8365,4409,57282,1681,823,233,2737,60019
03-12-2014,20,21590,21291,8185,3990,55057,1706,776,181,2663,57720
03-12-2014,21,21458,19981,7899,3449,52788,1713,706,163,2582,55370
03-12-2014,22,20424,19028,7693,3305,50449,1728,597,161,2486,52935
03-12-2014,23,18526,18100,7612,3080,47319,1731,596,158,2485,49804
04-12-2014,0,16979,17294,7475,2851,44599,1717,589,156,2462,47061
04-12-2014,1,16208,17028,7353,2609,43199,1680,588,155,2423,45622
04-12-2014,2,15943,16847,7375,2630,42795,1703,588,154,2445,45240
04-12-2014,3,16054,16734,7423,2628,42841,1701,593,155,2449,45290
04-12-2014,4,16680,16793,7478,2667,43620,1707,598,166,2471,46091
04-12-2014,5,18402,17911,7831,2825,46969,1717,682,188,2587,49556
04-12-2014,6,21163,19929,8375,3591,53059,1708,832,463,3003,56062
04-12-2014,7,22838,22119,9030,4108,58096,1702,1083,593,3378,61474
04-12-2014,8,23203,22128,9184,4331,58846,1670,1207,556,3433,62279
04-12-2014,9,23033,22127,8944,4458,58561,1655,1234,547,3436,61997
04-12-2014,10,23042,21811,8733,4583,58168,1670,797,309,2776,60944
04-12-2014,11,22910,21677,8624,4609,57820,1655,682,303,2640,60460
04-12-2014,12,22533,21608,8566,4601,57308,1646,701,296,2643,59951
04-12-2014,13,22736,21704,8675,4749,57864,1642,807,297,2746,60610
04-12-2014,14,22988,21927,9021,4647,58583,1621,1126,546,3293,61876
04-12-2014,15,23474,22185,9302,4703,59664,1615,1288,546,3449,63113
04-12-2014,16,23364,22864,9432,4930,60590,1610,1338,506,3454,64044
04-12-2014,17,23033,22744,9467,5205,60450,1701,1525,377,3603,64053
04-12-2014,18,23301,22040,9218,4863,59423,1601,1174,478,3253,62676
04-12-2014,19,23376,21145,8570,4556,57646,1600,907,206,2713,60359
04-12-2014,20,22280,20814,8126,4101,55322,1612,748,187,2547,57869
04-12-2014,21,21697,19985,7960,4187,53829,1597,591,161,2349,56178
04-12-2014,22,20332,18484,7842,4190,50849,1572,584,160,2316,53165
04-12-2014,23,18498,17493,7685,4062,47738,1560,584,153,2297,50035
05-12-2014,0,17096,17122,7435,3759,45413,1618,584,153,2355,47768
05-12-2014,1,16611,16794,7337,3598,44342,1625,584,158,2367,46709
05-12-2014,2,16222,16615,7316,3639,43792,1630,582,164,2376,46168
05-12-2014,3,16334,16633,7349,3489,43806,1630,586,167,2383,46189
05-12-2014,4,17027,17108,7362,3398,44896,1636,589,180,2405,47301
05-12-2014,5,18430,18396,7835,3395,48056,1572,591,192,2355,50411
05-12-2014,6,20560,20676,8560,3862,53659,1568,673,517,2758,56417
05-12-2014,7,23027,22139,9222,4331,58719,1600,930,579,3109,61828
05-12-2014,8,23352,22919,9269,4535,60075,1636,1031,566,3233,63308
05-12-2014,9,23309,22889,9492,4568,60259,1607,977,545,3129,63388
05-12-2014,10,22977,22851,9390,4655,59874,1610,816,347,2773,62647
05-12-2014,11,22685,22759,9024,4406,58875,1642,749,343,2734,61609
05-12-2014,12,22525,22640,8870,4149,58183,1679,810,342,2831,61014
05-12-2014,13,22252,22421,9016,4117,57806,1689,868,444,3001,60807
05-12-2014,14,22345,21944,9401,4102,57793,1696,888,532,3116,60909
05-12-2014,15,22842,22074,9499,3920,58336,1685,1043,548,3276,61612
05-12-2014,16,22720,22218,9464,4246,58649,1665,1088,551,3304,61953
05-12-2014,17,22782,22269,9121,4086,58256,1666,1031,524,3221,61477
05-12-2014,18,22383,21874,8814,4000,57071,1660,924,490,3074,60145
05-12-2014,19,21933,21290,8354,3626,55205,1653,831,358,2842,58047
05-12-2014,20,20743,20446,7901,3459,52550,1664,540,267,2471,55021
05-12-2014,21,19990,19687,7491,3385,50554,1661,425,259,2345,52899
05-12-2014,22,19506,18591,7308,3407,48812,1668,418,234,2320,51132
05-12-2014,23,18279,17616,6977,3469,46341,1663,415,219,2297,48638
06-12-2014,0,17846,16190,6810,3484,44330,1239,414,200,1853,46183
06-12-2014,1,16990,15630,6619,3597,42836,1198,415,185,1798,44634
06-12-2014,2,16341,15452,6453,3622,41869,1198,415,176,1789,43658
06-12-2014,3,16403,15383,6460,3547,41793,1196,416,174,1786,43579
06-12-2014,4,16564,15429,6474,3528,41995,1200,415,174,1789,43784
06-12-2014,5,16967,15728,6739,3614,43048,1209,466,175,1850,44898
06-12-2014,6,17824,16224,6893,3721,44662,1248,554,188,1990,46652
06-12-2014,7,18985,17222,6946,3747,46902,1250,613,187,2050,48952
06-12-2014,8,19203,18388,7258,3886,48735,1253,719,272,2244,50979
06-12-2014,9,19724,19582,7132,3937,50375,1268,721,388,2377,52752
06-12-2014,10,20902,20056,7376,3730,52065,1258,744,412,2414,54479
06-12-2014,11,20662,20424,7594,3772,52453,1257,750,407,2414,54867
06-12-2014,12,20585,20473,7629,3667,52354,1257,735,394,2386,54740
06-12-2014,13,20537,20466,7669,3560,52233,1229,745,377,2351,54584
06-12-2014,14,20814,20380,7894,3506,52594,1202,750,368,2320,54914
06-12-2014,15,21537,20581,8347,3591,54055,1199,752,253,2204,56259
06-12-2014,16,22460,20660,8441,3911,55472,1198,748,245,2191,57663
06-12-2014,17,22638,20590,8451,4039,55720,1198,711,231,2140,57860
06-12-2014,18,21994,20468,8337,4034,54835,1185,708,227,2120,56955
06-12-2014,19,21148,20337,8024,3781,53289,1168,698,220,2086,55375
06-12-2014,20,20957,19694,7740,3746,52137,1149,508,198,1855,53992
06-12-2014,21,19977,19161,7721,3875,50733,1143,415,193,1751,52484
06-12-2014,22,18299,18241,7501,4061,48104,1129,402,188,1719,49823
06-12-2014,23,16329,17081,7197,4272,44880,1112,403,182,1697,46577
07-12-2014,0,14478,16734,7087,4252,42552,1015,402,179,1596,44148
07-12-2014,1,13395,16287,7041,4185,40909,1016,401,191,1608,42517
07-12-2014,2,13105,16245,6930,4160,40440,1021,397,187,1605,42045
07-12-2014,3,12265,16301,6896,4286,39749,987,403,179,1569,41318
07-12-2014,4,12230,16496,6911,4515,40153,982,407,183,1572,41725
07-12-2014,5,12356,16672,6964,4803,40795,999,492,214,1705,42500
07-12-2014,6,12732,16775,7054,4999,41559,1033,580,224,1837,43396
07-12-2014,7,13811,16972,7115,5341,43240,1029,659,225,1913,45153
07-12-2014,8,14902,17286,7279,5409,44878,1066,584,201,1851,46729
07-12-2014,9,16229,17754,7453,5523,46959,1060,657,191,1908,48867
07-12-2014,10,16901,18650,7577,5652,48781,1079,669,200,1948,50729
07-12-2014,11,17097,19142,7642,5669,49551,1135,672,208,2015,51566
07-12-2014,12,16952,19273,7626,5667,49520,1117,670,213,2000,51520
07-12-2014,13,16426,19225,7596,5573,48821,1083,672,213,1968,50789
07-12-2014,14,16460,19327,7553,5516,48856,1122,677,226,2025,50881
07-12-2014,15,17152,19459,7660,5270,49541,1129,679,283,2091,51632
07-12-2014,16,18049,20372,7621,5142,51186,1164,662,328,2154,53340
07-12-2014,17,18691,20716,7719,4961,52088,1167,662,300,2129,54217
07-12-2014,18,18534,20428,7695,4923,51581,1177,662,276,2115,53696
07-12-2014,19,17684,19878,7585,4779,49927,1184,661,240,2085,52012
07-12-2014,20,15973,19129,7400,4556,47058,1196,555,231,1982,49040
07-12-2014,21,15989,18480,7231,4243,45942,1233,436,229,1898,47840
07-12-2014,22,15912,17714,6972,4209,44806,1222,425,221,1868,46674
07-12-2014,23,14299,16700,6799,3831,41630,1258,424,228,1910,43540
08-12-2014,0,13187,16292,6802,3661,39943,1523,426,214,2163,42106
08-12-2014,1,12776,15970,6792,3538,39075,1511,425,237,2173,41248
08-12-2014,2,12706,15871,6761,3442,38779,1518,423,245,2186,40965
08-12-2014,3,12954,15659,6789,3516,38917,1513,431,230,2174,41091
08-12-2014,4,12888,16098,6921,3648,39555,1509,430,214,2153,41708
08-12-2014,5,14187,17035,7459,3909,42590,1524,437,269,2230,44820
08-12-2014,6,18280,19505,8357,4287,50431,1578,659,493,2730,53161
08-12-2014,7,21900,21709,8874,4549,57033,1638,867,638,3143,60176
08-12-2014,8,22697,22321,8757,4589,58364,1645,956,658,3259,61623
08-12-2014,9,22639,22100,8670,4661,58070,1633,971,649,3253,61323
08-12-2014,10,22411,21881,8337,4713,57344,1627,711,615,2953,60297
08-12-2014,11,22257,21533,8234,4705,56729,1626,702,605,2933,59662
08-12-2014,12,22032,21453,8253,4606,56343,1617,701,583,2901,59244
08-12-2014,13,22342,21588,8386,4425,56742,1601,708,561,2870,59612
08-12-2014,14,22742,21714,8759,4312,57526,1587,1018,542,3147,60673
08-12-2014,15,23415,22049,9008,4106,58579,1581,1378,615,3574,62153
08-12-2014,16,23747,22554,9127,4066,59494,1577,1217,626,3420,62914
08-12-2014,17,23711,22564,9163,4199,59636,1565,1124,544,3233,62869
08-12-2014,18,23303,22259,9017,4131,58710,1548,1073,446,3067,61777
08-12-2014,19,22907,21834,8459,4003,57202,1529,717,425,2671,59873
08-12-2014,20,21797,21200,7984,3979,54960,1505,655,356,2516,57476
08-12-2014,21,20907,20842,7795,3833,53377,1503,448,330,2281,55658
08-12-2014,22,19315,19877,7686,3774,50652,1483,405,245,2133,52785
08-12-2014,23,17965,18162,7538,3732,47396,1483,398,201,2082,49478
09-12-2014,0,17958,16868,7338,3238,45404,1420,401,181,2002,47406
09-12-2014,1,17119,16205,7248,3297,43870,1411,398,176,1985,45855
09-12-2014,2,16809,16085,7219,3270,43383,1429,399,166,1994,45377
09-12-2014,3,16839,16273,7197,3229,43538,1425,402,177,2004,45542
09-12-2014,4,17793,17034,7310,3182,45321,1430,406,210,2046,47367
09-12-2014,5,19093,18594,7784,3133,48604,1459,488,213,2160,50764
09-12-2014,6,21488,21135,8487,3332,54442,1525,710,405,2640,57082
09-12-2014,7,23792,22967,8954,4166,59880,1533,1089,425,3047,62927
09-12-2014,8,24372,23349,8964,4539,61224,1544,1111,438,3093,64317
09-12-2014,9,23625,23256,8893,4578,60352,1536,1097,445,3078,63430
09-12-2014,10,23204,22998,8759,4576,59537,1519,788,445,2752,62289
09-12-2014,11,23123,22728,8477,4488,58816,1520,723,419,2662,61478
09-12-2014,12,23431,22566,8320,4412,58727,1541,739,435,2715,61442
09-12-2014,13,23327,22686,8488,4506,59007,1546,758,430,2734,61741
09-12-2014,14,23597,22657,9112,4416,59782,1538,1040,425,3003,62785
09-12-2014,15,23739,22740,9310,4742,60531,1535,1180,446,3161,63692
09-12-2014,16,24129,22727,9170,5112,61138,1533,1183,434,3150,64288
09-12-2014,17,23397,22906,8956,5430,60688,1549,1133,443,3125,63813
09-12-2014,18,22268,22326,8755,5879,59229,1554,1049,445,3048,62277
09-12-2014,19,21230,21572,8289,6291,57383,1551,703,387,2641,60024
09-12-2014,20,19371,21124,7884,6401,54780,1568,707,270,2545,57325
09-12-2014,21,18176,20541,7621,6311,52648,1557,426,200,2183,54831
09-12-2014,22,17003,19466,7263,6147,49879,1539,417,193,2149,52028
09-12-2014,23,14693,18893,7073,5574,46233,1532,412,199,2143,48376
10-12-2014,0,13054,18176,6970,5261,43461,1402,410,213,2025,45486
10-12-2014,1,12346,17939,6912,5177,42376,1330,410,206,1946,44322
10-12-2014,2,11638,18039,6907,5106,41692,1303,413,214,1930,43622
10-12-2014,3,11682,18159,6935,5262,42038,1311,419,221,1951,43989
10-12-2014,4,12092,18584,6983,5270,42927,1342,426,230,1998,44925
10-12-2014,5,13373,19562,7369,5450,45755,1386,503,283,2172,47927
10-12-2014,6,16164,20871,8129,5487,50652,1610,729,463,2802,53454
10-12-2014,7,19481,22399,8724,5810,56415,1630,784,683,3097,59512
10-12-2014,8,20108,23235,8728,5757,57829,1655,792,704,3151,60980
10-12-2014,9,19911,23214,8600,5796,57520,1618,726,725,3069,60589
10-12-2014,10,20288,23199,8316,5895,57698,1465,729,732,2926,60624
10-12-2014,11,20078,23131,8068,5903,57181,1379,728,688,2795,59976
10-12-2014,12,19884,23058,8127,5842,56913,1385,729,716,2830,59743
10-12-2014,13,20082,22672,8324,5709,56785,1501,730,724,2955,59740
10-12-2014,14,20459,22598,8699,5466,57222,1582,735,729,3046,60268
10-12-2014,15,20850,23005,8988,5520,58364,1617,869,722,3208,61572
10-12-2014,16,21051,23087,8929,5835,58902,1625,776,779,3180,62082
10-12-2014,17,20995,23114,8746,6064,58919,1638,742,760,3140,62059
10-12-2014,18,20226,22919,8617,6177,57939,1625,805,637,3067,61006
10-12-2014,19,19446,22388,8252,6227,56313,1425,739,450,2614,58927
10-12-2014,20,18006,21794,7859,6203,53862,1392,606,358,2356,56218
10-12-2014,21,17658,20851,7639,5958,52106,1393,447,337,2177,54283
10-12-2014,22,16617,19792,7638,5539,49585,1407,437,313,2157,51742
10-12-2014,23,14742,18801,7301,5388,46232,1418,433,273,2124,48356
11-12-2014,0,13487,17893,6918,5280,43579,1426,431,243,2100,45679
11-12-2014,1,13014,17326,6843,5139,42322,1412,427,221,2060,44382
11-12-2014,2,12904,17063,6840,5125,41932,1414,426,218,2058,43990
11-12-2014,3,12827,17053,6949,5136,41966,1404,427,212,2043,44009
11-12-2014,4,13140,17327,7120,5240,42829,1388,435,234,2057,44886
11-12-2014,5,14106,18405,7599,5350,45460,1406,597,247,2250,47710
11-12-2014,6,17966,19941,8086,5333,51328,1608,799,406,2813,54141
11-12-2014,7,20881,21591,8699,5462,56633,1642,918,621,3181,59814
11-12-2014,8,21431,21955,8792,5604,57784,1637,1022,605,3264,61048
11-12-2014,9,21359,22133,8678,5443,57614,1640,1025,593,3258,60872
11-12-2014,10,21132,22301,8379,5438,57252,1548,1025,503,3076,60328
11-12-2014,11,20793,22200,8263,5266,56523,1405,813,638,2856,59379
11-12-2014,12,20697,22051,8160,5290,56199,1365,812,650,2827,59026
11-12-2014,13,20902,22157,8228,5281,56569,1495,881,641,3017,59586
11-12-2014,14,21293,22406,8741,4974,57414,1585,1022,572,3179,60593
11-12-2014,15,22001,22928,9052,4744,58726,1570,1036,685,3291,62017
11-12-2014,16,22174,23118,8992,4865,59148,1564,1037,687,3288,62436
11-12-2014,17,22181,22619,8854,5234,58888,1569,1029,587,3185,62073
11-12-2014,18,21504,22276,8854,5239,57874,1557,859,665,3081,60955
11-12-2014,19,20844,21605,8332,5024,55804,1522,787,618,2927,58731
11-12-2014,20,20148,20417,8165,4959,53689,1446,706,327,2479,56168
11-12-2014,21,19504,19286,7980,4987,51757,1362,455,306,2123,53880
11-12-2014,22,18115,18123,7684,4794,48715,1372,433,280,2085,50800
11-12-2014,23,16090,17206,7560,4773,45630,1356,429,269,2054,47684
12-12-2014,0,14687,16206,7311,4510,42714,1318,428,268,2014,44728
12-12-2014,1,14056,15771,7140,4162,41130,1293,425,265,1983,43113
12-12-2014,2,13880,15605,7143,4070,40698,1303,424,260,1987,42685
12-12-2014,3,14171,15515,7173,3945,40806,1277,425,259,1961,42767
12-12-2014,4,14928,15766,7262,3959,41915,1271,430,250,1951,43866
12-12-2014,5,16525,17236,7714,4093,45568,1397,597,260,2254,47822
12-12-2014,6,19719,19725,8629,4535,52609,1581,799,461,2841,55450
12-12-2014,7,22311,21441,9237,4765,57755,1558,875,667,3100,60855
12-12-2014,8,23086,21987,9157,4887,59118,1566,1008,676,3250,62368
12-12-2014,9,22945,21981,8963,4887,58774,1562,988,658,3208,61982
12-12-2014,10,22579,21569,8544,4894,57585,1547,959,528,3034,60619
12-12-2014,11,21827,21086,8380,4719,56012,1519,820,588,2927,58939
12-12-2014,12,21585,20639,8411,4545,55180,1488,834,605,2927,58107
12-12-2014,13,21216,20450,8566,4642,54874,1492,848,618,2958,57832
12-12-2014,14,21551,20590,9023,4699,55863,1505,941,667,3113,58976
12-12-2014,15,21923,20635,9232,5026,56817,1511,1128,678,3317,60134
12-12-2014,16,22378,21035,9222,5242,57879,1515,1192,674,3381,61260
12-12-2014,17,22318,21170,9138,5392,58017,1529,1004,671,3204,61221
12-12-2014,18,21657,20661,9057,5513,56887,1559,917,660,3136,60023
12-12-2014,19,20865,20070,8501,5356,54791,1577,775,571,2923,57714
12-12-2014,20,19713,19470,8077,5431,52692,1553,638,363,2554,55246
12-12-2014,21,19020,18425,7907,5067,50418,1518,452,366,2336,52754
12-12-2014,22,17926,17509,7703,4990,48130,1374,447,357,2178,50308
12-12-2014,23,16065,16992,7470,4886,45413,1352,442,354,2148,47561
13-12-2014,0,14960,16156,7180,4809,43105,1201,440,358,1999,45104
13-12-2014,1,14627,15618,7073,4756,42076,1204,437,361,2002,44078
13-12-2014,2,14094,15343,6980,4797,41214,1218,422,362,2002,43216
13-12-2014,3,13860,15228,7099,5049,41237,1226,404,360,1990,43227
13-12-2014,4,14243,15286,7193,4977,41700,1220,348,362,1930,43630
13-12-2014,5,14394,15648,7150,5084,42276,1214,418,358,1990,44266
13-12-2014,6,15315,16253,7172,5152,43894,1181,462,370,2013,45907
13-12-2014,7,16832,16808,7248,5031,45918,1129,516,369,2014,47932
13-12-2014,8,19267,17712,7460,5279,49717,1146,505,368,2019,51736
13-12-2014,9,20233,18393,7656,5252,51534,1144,548,373,2065,53599
13-12-2014,10,20419,18922,7738,5317,52396,1110,583,371,2064,54460
13-12-2014,11,20364,18846,7747,5335,52292,1175,571,341,2087,54379
13-12-2014,12,19967,19135,7787,5202,52091,1187,578,320,2085,54176
13-12-2014,13,19830,19083,7823,5167,51903,1195,596,348,2139,54042
13-12-2014,14,20064,19319,7936,5180,52499,1171,618,370,2159,54658
13-12-2014,15,20958,19766,8148,5033,53904,1111,683,393,2187,56091
13-12-2014,16,21938,20733,8296,4936,55903,1146,752,381,2279,58182
13-12-2014,17,22343,21254,8301,4792,56692,1128,765,389,2282,58974
13-12-2014,18,21896,20787,8253,4714,55651,1126,666,379,2171,57822
13-12-2014,19,21185,19763,8022,4634,53604,1116,691,353,2160,55764
13-12-2014,20,20455,19134,7807,4341,51738,1103,548,353,2004,53742
13-12-2014,21,20164,18772,7620,4111,50669,1091,447,335,1873,52542
13-12-2014,22,19325,18421,7473,4090,49309,1093,436,315,1844,51153
13-12-2014,23,17894,17756,7367,3998,47015,1081,432,307,1820,48835
14-12-2014,0,16964,16901,7174,3972,45012,1045,430,310,1785,46797
14-12-2014,1,15925,16232,7216,4128,43504,1066,429,311,1806,45310
14-12-2014,2,15445,15706,7193,4185,42529,1059,427,307,1793,44322
14-12-2014,3,14886,15542,7188,4161,41777,1043,431,303,1777,43554
14-12-2014,4,15575,15498,7234,4200,42507,1064,431,290,1785,44292
14-12-2014,5,15761,15605,7250,4176,42792,1075,432,280,1787,44579
14-12-2014,6,15449,15952,7341,4147,42891,1068,429,267,1764,44655
14-12-2014,7,15926,16611,7453,4445,44435,1056,429,260,1745,46180
14-12-2014,8,18086,17240,7608,4801,47734,1125,477,250,1852,49586
14-12-2014,9,19521,17823,7691,5054,50089,1138,534,259,1931,52020
14-12-2014,10,19842,18275,7751,5199,51067,1117,584,259,1960,53027
14-12-2014,11,19791,18803,7689,5392,51675,1103,577,263,1943,53618
14-12-2014,12,19386,19147,7623,5596,51753,1079,602,228,1909,53662
14-12-2014,13,19116,19478,7581,5628,51804,1077,611,214,1902,53706
14-12-2014,14,19120,19621,7791,5699,52231,1052,616,212,1880,54111
14-12-2014,15,19911,19990,7785,5801,53488,1127,688,267,2082,55570
14-12-2014,16,20102,20487,7919,5881,54391,1123,749,283,2155,56546
14-12-2014,17,19998,20715,7862,6088,54662,1120,774,238,2132,56794
14-12-2014,18,19282,20433,7790,6290,53796,1136,688,235,2059,55855
14-12-2014,19,19025,19766,7698,6084,52572,1137,707,235,2079,54651
14-12-2014,20,17777,19388,7647,5920,50732,1129,627,203,1959,52691
14-12-2014,21,16887,18847,7612,5782,49130,1136,467,207,1810,50940
14-12-2014,22,15934,18452,7371,5694,47452,1116,413,198,1727,49179
14-12-2014,23,13636,17730,7197,5613,44176,1121,397,183,1701,45877
15-12-2014,0,11816,17304,6992,5408,41521,1128,236,186,1550,43071
15-12-2014,1,10942,17198,6936,5437,40514,1128,234,191,1553,42067
15-12-2014,2,10887,17131,6933,5402,40354,1135,234,193,1562,41916
15-12-2014,3,10925,17084,6964,5347,40319,1160,245,202,1607,41926
15-12-2014,4,11688,17324,7130,5104,41246,1168,350,219,1737,42983
15-12-2014,5,13026,18293,7581,4807,43708,1255,569,233,2057,45765
15-12-2014,6,16658,19880,8405,4989,49931,1525,760,512,2797,52728
15-12-2014,7,20681,21797,9009,5380,56867,1553,928,624,3105,59972
15-12-2014,8,21421,22367,9008,5500,58296,1551,1033,613,3197,61493
15-12-2014,9,21403,22421,8871,5409,58104,1547,929,608,3084,61188
15-12-2014,10,21473,22465,8451,5273,57662,1543,926,443,2912,60574
15-12-2014,11,21187,22209,8437,5304,57137,1548,833,461,2842,59979
15-12-2014,12,20889,22109,8366,5364,56728,1538,843,463,2844,59572
15-12-2014,13,21100,22079,8528,5371,57078,1521,867,503,2891,59969
15-12-2014,14,21867,22017,9057,5229,58171,1521,893,647,3061,61232
15-12-2014,15,22266,22341,9160,5227,58996,1544,1056,687,3287,62283
15-12-2014,16,22873,22279,9176,5102,59429,1542,935,712,3189,62618
15-12-2014,17,23018,22377,9019,5138,59553,1525,951,648,3124,62677
15-12-2014,18,22353,22124,8856,5073,58405,1513,889,632,3034,61439
15-12-2014,19,21381,21623,8503,4997,56505,1511,815,452,2778,59283
15-12-2014,20,20278,20956,8203,4726,54164,1514,728,405,2647,56811
15-12-2014,21,19812,20118,8087,4407,52424,1513,445,283,2241,54665
15-12-2014,22,18858,19247,7702,4177,49986,1436,420,274,2130,52116
15-12-2014,23,16930,18145,7494,3759,46328,1334,417,277,2028,48356
16-12-2014,0,16378,17381,7243,3160,44161,1283,415,291,1989,46150
16-12-2014,1,15903,16932,7217,3208,43260,1231,418,279,1928,45188
16-12-2014,2,15672,16592,7220,3348,42831,1230,421,261,1912,44743
16-12-2014,3,15546,16589,7214,3490,42840,1268,421,260,1949,44789
16-12-2014,4,15818,16735,7218,3817,43589,1297,430,271,1998,45587
16-12-2014,5,17129,17789,7663,4195,46776,1322,566,290,2178,48954
16-12-2014,6,20230,19428,8431,4721,52809,1537,762,465,2764,55573
16-12-2014,7,22940,21421,8853,5116,58331,1596,827,622,3045,61376
16-12-2014,8,23560,22455,8907,5274,60196,1605,789,606,3000,63196
16-12-2014,9,23452,22394,8884,5014,59744,1566,820,560,2946,62690
16-12-2014,10,23344,21951,8664,4934,58892,1598,792,365,2755,61647
16-12-2014,11,22892,21814,8574,4958,58239,1628,731,367,2726,60965
16-12-2014,12,22715,21899,8539,4936,58090,1620,682,410,2712,60802
16-12-2014,13,22848,21917,8733,5010,58508,1591,681,386,2658,61166
16-12-2014,14,23062,22383,8944,5111,59501,1609,762,522,2893,62394
16-12-2014,15,23427,22791,9101,5204,60524,1618,987,566,3171,63695
16-12-2014,16,23529,23138,9071,5396,61135,1628,934,582,3144,64279
16-12-2014,17,23455,23189,8985,5550,61180,1634,925,351,2910,64090
16-12-2014,18,23055,22847,8985,5418,60306,1658,924,299,2881,63187
16-12-2014,19,21971,22276,8740,5683,58672,1679,812,255,2746,61418
16-12-2014,20,20500,21562,8370,5882,56315,1656,526,225,2407,58722
16-12-2014,21,20011,20272,7886,5654,53823,1665,437,216,2318,56141
16-12-2014,22,19256,18771,7573,5667,51268,1576,427,215,2218,53486
16-12-2014,23,17675,17539,7282,5419,47914,1474,421,233,2128,50042
17-12-2014,0,15857,16686,6989,5301,44833,1439,419,254,2112,46945
17-12-2014,1,14589,16331,6901,5086,42906,1397,414,255,2066,44972
17-12-2014,2,14078,16483,6913,5131,42605,1402,420,270,2092,44697
17-12-2014,3,14161,16315,6856,4815,42147,1419,411,268,2098,44245
17-12-2014,4,14460,16515,6925,4510,42408,1428,407,232,2067,44475
17-12-2014,5,16378,17677,7571,4140,45766,1449,439,231,2119,47885
17-12-2014,6,21213,19610,8381,4064,53267,1606,762,256,2624,55891
17-12-2014,7,24564,21791,8941,4290,59585,1622,968,506,3096,62681
17-12-2014,8,25101,22676,8941,4754,61473,1633,1059,436,3128,64601
17-12-2014,9,24638,22444,8784,4684,60551,1809,1006,336,3151,63702
17-12-2014,10,24429,22230,8491,4959,60108,1840,884,334,3058,63166
17-12-2014,11,24197,21988,8338,4768,59290,1664,822,322,2808,62098
17-12-2014,12,23995,21701,8363,4488,58549,1829,844,302,2975,61524
17-12-2014,13,24567,21960,8589,4351,59467,1626,850,319,2795,62262
17-12-2014,14,24995,22255,8883,4306,60440,1620,976,699,3295,63735
17-12-2014,15,25814,22759,8999,4279,61850,1698,1274,720,3692,65542
17-12-2014,16,26076,23124,9048,4531,62781,1610,1348,727,3685,66466
17-12-2014,17,25980,22892,9126,4668,62666,1817,1146,539,3502,66168
17-12-2014,18,25271,22352,8948,4487,61057,1732,1141,538,3411,64468
17-12-2014,19,24879,21935,8661,4092,59567,1680,771,298,2749,62316
17-12-2014,20,23881,20890,8533,3924,57227,1598,565,279,2442,59669
17-12-2014,21,22729,19431,8162,3844,54166,1605,273,242,2120,56286
17-12-2014,22,20671,18322,7927,3606,50526,1591,237,226,2054,52580
17-12-2014,23,18478,19254,7728,3728,49190,1424,231,192,1847,51037
18-12-2014,0,16993,15929,7404,3785,44111,1347,226,184,1757,45868
18-12-2014,1,16097,15500,7336,3867,42800,1324,220,186,1730,44530
18-12-2014,2,15144,15496,7298,3836,41776,1332,222,182,1736,43512
18-12-2014,3,15009,15473,7250,3870,41602,1309,227,177,1713,43315
18-12-2014,4,15577,15690,7396,3811,42475,1320,230,175,1725,44200
18-12-2014,5,17154,16737,7762,3979,45632,1575,245,379,2199,47831
18-12-2014,6,20536,19406,8448,4477,52869,1623,756,561,2940,55809
18-12-2014,7,23489,21481,8967,5172,59109,1603,1070,651,3324,62433
18-12-2014,8,24103,22049,8994,5315,60462,1627,1113,630,3370,63832
18-12-2014,9,23586,21962,8890,5296,59734,1826,970,558,3354,63088
18-12-2014,10,23566,21478,8444,5368,58857,1852,642,562,3056,61913
18-12-2014,11,23064,21164,8297,5429,57954,1857,574,567,2998,60952
18-12-2014,12,22697,21045,8275,5515,57533,1833,617,576,3026,60559
18-12-2014,13,22784,20957,8402,5428,57571,1830,636,586,3052,60623
18-12-2014,14,22968,20960,8775,5327,58030,1668,966,675,3309,61339
18-12-2014,15,23092,20940,8879,5340,58252,1694,1214,691,3599,61851
18-12-2014,16,23204,20981,8851,5097,58133,1703,1150,713,3566,61699
18-12-2014,17,22988,20982,8859,5288,58117,1901,794,620,3315,61432
18-12-2014,18,21927,20354,8714,5499,56494,1903,793,600,3296,59790
18-12-2014,19,21530,19428,8164,5554,54675,1709,460,622,2791,57466
18-12-2014,20,20247,18744,7772,5384,52147,1673,277,594,2544,54691
18-12-2014,21,19578,18253,7704,5197,50732,1551,253,477,2281,53013
18-12-2014,22,18454,17046,7369,5357,48225,1451,242,309,2002,50227
18-12-2014,23,16493,16420,6982,5081,44975,1437,247,326,2010,46985
19-12-2014,0,15953,15546,6714,4776,42991,1445,247,340,2032,45023
19-12-2014,1,15100,15341,6636,4521,41597,1434,244,344,2022,43619
19-12-2014,2,14450,15262,6703,4281,40694,1402,238,345,1985,42679
19-12-2014,3,13769,15330,6732,4143,39974,1406,236,326,1968,41942
19-12-2014,4,13521,15561,6769,3921,39773,1410,236,341,1987,41760
19-12-2014,5,15033,16301,7266,3955,42555,1427,242,412,2081,44636
19-12-2014,6,18450,18028,8078,4158,48714,1615,347,628,2590,51304
19-12-2014,7,21915,20351,8643,4530,55437,1674,694,661,3029,58466
19-12-2014,8,22634,21023,8703,4618,56978,1688,697,636,3021,59999
19-12-2014,9,21931,20775,8466,4742,55912,1887,675,628,3190,59102
19-12-2014,10,21792,20597,8180,5125,55692,1681,495,595,2771,58463
19-12-2014,11,20920,20421,8008,5414,54762,1685,431,579,2695,57457
19-12-2014,12,20187,20010,7988,5826,54010,1735,431,590,2756,56766
19-12-2014,13,19738,19601,8065,5953,53356,1868,450,558,2876,56232
19-12-2014,14,19884,19676,8445,5942,53947,1725,639,567,2931,56878
19-12-2014,15,20652,19731,8676,5932,54991,1698,767,565,3030,58021
19-12-2014,16,21081,20897,8624,6079,56681,1679,770,578,3027,59708
19-12-2014,17,21523,21529,8476,6085,57613,1674,770,532,2976,60589
19-12-2014,18,21340,21077,8289,5993,56698,1866,754,448,3068,59766
19-12-2014,19,20377,20838,7676,6002,54893,1713,497,451,2661,57554
19-12-2014,20,18894,19538,7207,6003,51642,1490,292,470,2252,53894
19-12-2014,21,18517,18108,7146,5587,49358,1468,264,396,2128,51486
19-12-2014,22,17146,17323,7228,5253,46950,1406,249,337,1992,48942
19-12-2014,23,15542,16790,7153,5094,44579,1380,262,344,1986,46565
20-12-2014,0,14059,16556,7213,4913,42741,1201,261,348,1810,44551
20-12-2014,1,12742,16327,7182,4987,41238,1206,259,340,1805,43043
20-12-2014,2,12300,16086,7122,4882,40390,1226,260,335,1821,42211
20-12-2014,3,11899,15978,7104,4920,39901,1219,267,346,1832,41733
20-12-2014,4,11922,15990,7125,4939,39976,1209,268,354,1831,41807
20-12-2014,5,12501,16065,7152,5014,40732,1235,241,350,1826,42558
20-12-2014,6,13392,16424,7341,5076,42235,1228,250,335,1813,44048
20-12-2014,7,15310,16889,7460,5216,44875,1151,239,354,1744,46619
20-12-2014,8,16783,18363,7584,5337,48068,1139,237,416,1792,49860
20-12-2014,9,17666,18898,7569,5485,49618,1380,228,376,1984,51602
20-12-2014,10,18118,19411,7574,5704,50808,1216,236,414,1866,52674
20-12-2014,11,18136,19669,7630,5766,51200,1235,234,448,1917,53117
20-12-2014,12,18028,19687,7634,5663,51012,1190,241,453,1884,52896
20-12-2014,13,17908,19701,7665,5528,50802,1290,238,424,1952,52754
20-12-2014,14,18196,19678,7732,5856,51463,1168,244,489,1901,53364
20-12-2014,15,18829,19974,7905,6179,52887,1205,343,493,2041,54928
20-12-2014,16,19480,20189,8013,6158,53841,1206,419,460,2085,55926
20-12-2014,17,19673,20367,8054,6304,54399,1218,414,480,2112,56511
20-12-2014,18,19400,20148,7962,6113,53624,1346,342,464,2152,55776
20-12-2014,19,18539,19924,7787,5833,52082,1259,314,444,2017,54099
20-12-2014,20,17652,19497,7828,5404,50379,1162,231,449,1842,52221
20-12-2014,21,17253,19049,7800,5161,49263,1147,223,412,1782,51045
20-12-2014,22,16367,18511,7666,5078,47623,1095,216,205,1516,49139
20-12-2014,23,14932,17672,7445,4927,44977,1106,203,193,1502,46479
21-12-2014,0,14024,16856,7320,4753,42953,1091,205,175,1471,44424
21-12-2014,1,13257,16614,7289,4641,41801,1098,212,178,1488,43289
21-12-2014,2,12958,16434,7228,4532,41152,1106,236,186,1528,42680
21-12-2014,3,13027,16407,7220,4364,41018,1123,243,198,1564,42582
21-12-2014,4,13359,16323,7236,4167,41085,1117,249,232,1598,42683
21-12-2014,5,13677,16448,7349,4195,41669,1122,260,241,1623,43292
21-12-2014,6,14009,16662,7505,4266,42443,1142,220,243,1605,44048
21-12-2014,7,14740,17046,7659,4321,43766,1148,204,307,1659,45425
21-12-2014,8,15530,17647,7736,4290,45205,1168,228,356,1752,46957
21-12-2014,9,16800,18147,7803,4360,47110,1164,249,427,1840,48950
21-12-2014,10,17689,18706,7797,4461,48654,1164,254,413,1831,50485
21-12-2014,11,18195,19035,7784,4615,49628,1185,249,416,1850,51478
21-12-2014,12,18302,19079,7780,4656,49819,1182,249,424,1855,51674
21-12-2014,13,18238,19176,7787,4801,50003,1184,247,431,1862,51865
21-12-2014,14,18610,19164,7786,4949,50507,1186,261,480,1927,52434
21-12-2014,15,19715,19383,7947,5151,52198,1200,406,467,2073,54271
21-12-2014,16,19941,19822,7946,5447,53156,1207,543,441,2191,55347
21-12-2014,17,19959,19777,7962,5583,53281,1201,510,457,2168,55449
21-12-2014,18,19738,19497,7902,5761,52899,1183,460,459,2102,55001
21-12-2014,19,19289,19025,7867,5665,51845,1180,401,449,2030,53875
21-12-2014,20,18645,18685,7703,5640,50672,1150,216,451,1817,52489
21-12-2014,21,17955,18234,7489,5669,49346,1111,214,356,1681,51027
21-12-2014,22,16692,17516,7427,5506,47142,1109,210,239,1558,48700
21-12-2014,23,15375,16520,7408,4025,43327,1090,192,203,1485,44812
22-12-2014,0,13927,15821,7280,4037,41066,1151,188,203,1542,42608
22-12-2014,1,12937,15390,7258,4008,39592,1185,184,268,1637,41229
22-12-2014,2,12320,15404,7221,4159,39103,1176,183,302,1661,40764
22-12-2014,3,12003,15414,7233,3927,38577,1158,193,327,1678,40255
22-12-2014,4,12527,15577,7254,3953,39311,1152,194,313,1659,40970
22-12-2014,5,14266,16305,7469,3999,42040,1167,201,334,1702,43742
22-12-2014,6,16042,17876,8001,4545,46465,1222,396,491,2109,48574
22-12-2014,7,18120,19766,8572,5091,51549,1335,682,530,2547,54096
22-12-2014,8,19747,20581,8666,5142,54136,1364,801,545,2710,56846
22-12-2014,9,19839,21006,8439,5396,54679,1384,831,537,2752,57431
22-12-2014,10,19862,21141,8150,5301,54454,1231,654,560,2445,56899
22-12-2014,11,19491,21293,8004,5531,54318,1217,551,577,2345,56663
22-12-2014,12,19101,21326,7966,5396,53789,1205,594,590,2389,56178
22-12-2014,13,19105,20899,7988,5348,53340,1228,592,567,2387,55727
22-12-2014,14,19199,21314,8555,5299,54367,1423,743,562,2728,57095
22-12-2014,15,19694,21388,8899,5315,55298,1455,844,599,2898,58196
22-12-2014,16,20224,21445,8776,5266,55709,1465,896,565,2926,58635
22-12-2014,17,20314,21774,8567,5495,56150,1466,809,526,2801,58951
22-12-2014,18,19657,21310,8498,5485,54952,1468,704,555,2727,57679
22-12-2014,19,18887,20969,8053,5115,53024,1406,521,542,2469,55493
22-12-2014,20,17500,20719,7917,4947,51083,1415,362,519,2296,53379
22-12-2014,21,16970,19857,7833,4794,49455,1472,244,456,2172,51627
22-12-2014,22,16136,18908,7681,4675,47400,1437,236,325,1998,49398
22-12-2014,23,14719,17764,7538,4145,44166,1432,213,324,1969,46135
23-12-2014,0,14350,16503,7337,3765,41955,1435,219,318,1972,43927
23-12-2014,1,13225,16284,7259,3620,40387,1445,207,326,1978,42365
23-12-2014,2,12388,16208,7222,3604,39422,1458,205,325,1988,41410
23-12-2014,3,12043,16121,7241,3547,38953,1427,205,308,1940,40893
23-12-2014,4,12177,16135,7299,3619,39230,1388,194,301,1883,41113
23-12-2014,5,14133,16660,7414,3653,41860,1366,195,312,1873,43733
23-12-2014,6,16254,18258,7775,3999,46286,1325,429,439,2193,48479
23-12-2014,7,18016,20264,8309,4339,50928,1409,722,457,2588,53516
23-12-2014,8,19019,20912,8620,4479,53031,1371,845,415,2631,55662
23-12-2014,9,19352,21214,8442,4562,53570,1371,852,420,2643,56213
23-12-2014,10,19678,21360,8044,4605,53687,1252,595,414,2261,55948
23-12-2014,11,19102,21436,7838,4676,53052,1247,563,378,2188,55240
23-12-2014,12,18561,21245,7796,4512,52115,1248,597,379,2224,54339
23-12-2014,13,18670,20781,7954,4460,51866,1258,601,364,2223,54089
23-12-2014,14,18719,20576,8387,4437,52120,1398,786,369,2553,54673
23-12-2014,15,19230,20709,8841,4553,53332,1404,896,410,2710,56042
23-12-2014,16,20156,21006,8854,4690,54704,1400,969,432,2801,57505
23-12-2014,17,21362,21453,8857,5019,56692,1405,902,431,2738,59430
23-12-2014,18,21408,21477,8695,4645,56226,1378,868,436,2682,58908
23-12-2014,19,20513,21361,8250,4305,54429,1251,604,437,2292,56721
23-12-2014,20,18259,20627,7826,3929,50642,1224,427,417,2068,52710
23-12-2014,21,17212,19620,7713,3491,48035,1223,265,383,1871,49906
23-12-2014,22,16642,18544,7658,3041,45886,1217,236,319,1772,47658
23-12-2014,23,15475,17473,7535,3008,43491,1218,191,309,1718,45209
24-12-2014,0,15075,16922,7397,3014,42410,1085,191,297,1573,43983
24-12-2014,1,13825,16289,7321,2948,40383,995,189,296,1480,41863
24-12-2014,2,13265,15946,7318,3014,39543,1003,188,271,1462,41005
24-12-2014,3,13009,15754,7324,3006,39093,1009,192,258,1459,40552
24-12-2014,4,13009,15660,7337,3168,39175,1020,196,233,1449,40624
24-12-2014,5,13832,15766,7458,3506,40563,1022,200,231,1453,42016
24-12-2014,6,15987,16497,7738,3624,43846,1036,258,205,1499,45345
24-12-2014,7,17535,17516,8435,3705,47189,1036,341,397,1774,48963
24-12-2014,8,18700,18492,8710,3810,49711,1035,496,377,1908,51619
24-12-2014,9,19460,19271,8784,4071,51586,1040,545,402,1987,53573
24-12-2014,10,19616,19524,8432,4397,51968,1034,537,221,1792,53760
24-12-2014,11,19483,19495,8061,4629,51670,1029,521,202,1752,53422
24-12-2014,12,18951,19653,8043,4701,51348,1024,519,211,1754,53102
24-12-2014,13,18919,19684,8097,4812,51511,1019,519,229,1767,53278
24-12-2014,14,18891,19774,8780,4661,52107,1011,622,420,2053,54160
24-12-2014,15,19300,20076,8971,4760,53108,1012,878,410,2300,55408
24-12-2014,16,19765,20557,8813,4857,53991,1022,945,421,2388,56379
24-12-2014,17,18739,20242,8570,5010,52562,1008,804,400,2212,54774
24-12-2014,18,18029,19281,8347,4628,50285,1012,626,398,2036,52321
24-12-2014,19,17218,18844,7902,4003,47968,1022,521,248,1791,49759
24-12-2014,20,16715,18217,7753,4049,46733,1017,257,242,1516,48249
24-12-2014,21,16712,18041,7636,3966,46355,1031,233,281,1545,47900
24-12-2014,22,16597,18092,7537,3904,46130,1094,192,280,1566,47696
24-12-2014,23,16079,17926,7483,3834,45322,1091,240,282,1613,46935
25-12-2014,0,16057,16709,7347,3526,43641,1108,193,282,1583,45224
25-12-2014,1,15201,15927,7249,3252,41629,1121,200,280,1601,43230
25-12-2014,2,14430,15754,7233,2988,40405,1129,193,300,1622,42027
25-12-2014,3,14268,15671,7252,2904,40096,1137,201,287,1625,41721
25-12-2014,4,14354,15749,7331,3091,40525,1145,204,277,1626,42151
25-12-2014,5,15285,16046,7391,3369,42094,1150,205,240,1595,43689
25-12-2014,6,15810,17003,7629,3396,43838,1158,200,216,1574,45412
25-12-2014,7,16383,17915,7925,3741,45963,1138,373,223,1734,47697
25-12-2014,8,17678,18440,8099,4102,48319,1097,441,214,1752,50071
25-12-2014,9,18720,18976,8311,4027,50034,1076,445,276,1797,51831
25-12-2014,10,19678,19387,7925,4232,51221,1059,443,258,1760,52981
25-12-2014,11,19785,19593,7785,4178,51343,1043,338,377,1758,53101
25-12-2014,12,19523,19772,7770,4142,51209,1039,340,370,1749,52958
25-12-2014,13,19298,19746,7969,4178,51192,1039,299,353,1691,52883
25-12-2014,14,19438,19670,8499,4025,51633,1055,388,669,2112,53745
25-12-2014,15,20490,19794,8800,3882,52966,1041,700,668,2409,55375
25-12-2014,16,21170,20314,8750,3947,54179,1041,839,671,2551,56730
25-12-2014,17,21225,20647,8609,3795,54277,1030,966,639,2635,56912
25-12-2014,18,21142,20540,8510,3630,53823,1042,963,613,2618,56441
25-12-2014,19,21341,20514,8283,3430,53569,1032,545,291,1868,55437
25-12-2014,20,20462,20373,7756,3326,51917,1029,242,466,1737,53654
25-12-2014,21,20078,19709,7732,3034,50553,1053,223,374,1650,52203
25-12-2014,22,19579,19537,7393,3088,49597,1062,190,227,1479,51076
25-12-2014,23,18422,18234,7277,3038,46971,1091,205,201,1497,48468
26-12-2014,0,18644,17710,7250,2764,46367,1098,192,195,1485,47852
26-12-2014,1,17628,17500,7247,2878,45254,1103,193,186,1482,46736
26-12-2014,2,16840,17473,7237,2926,44477,1170,193,175,1538,46015
26-12-2014,3,16789,17355,7261,2942,44347,1168,192,171,1531,45878
26-12-2014,4,16880,17542,7278,2994,44694,1164,197,173,1534,46228
26-12-2014,5,17917,17781,7337,3025,46060,1173,204,177,1554,47614
26-12-2014,6,18780,18303,7559,2969,47612,1187,206,252,1645,49257
26-12-2014,7,19711,18912,7951,3181,49755,1211,294,374,1879,51634
26-12-2014,8,19786,20095,8024,3511,51416,1225,400,391,2016,53432
26-12-2014,9,22142,20768,8199,3632,54740,1240,504,398,2142,56882
26-12-2014,10,23215,22013,8008,3627,56863,1238,387,383,2008,58871
26-12-2014,11,23079,22401,8068,3661,57209,1260,365,381,2006,59215
26-12-2014,12,22717,21923,7803,3621,56063,1257,363,385,2005,58068
26-12-2014,13,22701,21722,7906,3542,55870,1237,330,405,1972,57842
26-12-2014,14,22707,21921,8268,3444,56341,1209,365,431,2005,58346
26-12-2014,15,22929,22398,8492,3444,57262,1212,728,429,2369,59631
26-12-2014,16,24015,22879,8592,3722,59208,1201,864,459,2524,61732
26-12-2014,17,23953,22966,8569,3797,59287,1205,943,471,2619,61906
26-12-2014,18,23358,22860,8451,3895,58564,1218,878,465,2561,61125
26-12-2014,19,22784,22378,8166,3803,57132,1222,501,478,2201,59333
26-12-2014,20,22254,21645,7846,3610,55355,1217,404,468,2089,57444
26-12-2014,21,22005,20878,7725,3517,54125,1204,231,441,1876,56001
26-12-2014,22,21114,19904,7580,3364,51961,1186,212,207,1605,53566
26-12-2014,23,19941,18356,7443,3422,49163,1194,209,190,1593,50756
27-12-2014,0,18559,16399,7207,3269,45434,1194,194,203,1591,47025
27-12-2014,1,16247,15660,7158,3174,42238,1186,193,203,1582,43820
27-12-2014,2,15677,15431,7123,3140,41371,1169,195,196,1560,42931
27-12-2014,3,15851,15395,7137,2985,41367,1182,198,199,1579,42946
27-12-2014,4,16308,15339,7192,2912,41752,1190,205,212,1607,43359
27-12-2014,5,17315,15721,7274,2677,42987,1180,204,210,1594,44581
27-12-2014,6,18463,16046,7354,2726,44589,1163,204,258,1625,46214
27-12-2014,7,20037,16534,7547,2752,46870,1143,236,419,1798,48668
27-12-2014,8,21857,17655,7666,2793,49971,1122,309,468,1899,51870
27-12-2014,9,22783,18852,7759,2865,52259,1124,331,481,1936,54195
27-12-2014,10,23064,19569,7919,3038,53589,1121,343,469,1933,55522
27-12-2014,11,23585,20260,8041,3122,55008,1120,345,491,1956,56964
27-12-2014,12,24129,21184,7965,3199,56478,1120,346,499,1965,58443
27-12-2014,13,23582,21333,7995,3176,56086,1123,328,499,1950,58036
27-12-2014,14,23213,20802,7980,3021,55016,1121,323,498,1942,56958
27-12-2014,15,23398,20615,8091,3094,55198,1118,333,481,1932,57130
27-12-2014,16,24119,21476,8277,3339,57210,1129,438,489,2056,59266
27-12-2014,17,24643,22500,8573,3486,59203,1133,248,663,2044,61247
27-12-2014,18,24889,22575,8646,3839,59948,1130,336,500,1966,61914
27-12-2014,19,24258,21998,8380,3626,58262,1129,363,501,1993,60255
27-12-2014,20,22849,20423,7974,3352,54599,1136,346,492,1974,56573
27-12-2014,21,22588,19417,7800,3153,52960,1127,236,433,1796,54756
27-12-2014,22,21983,18360,7667,3256,51265,1140,222,204,1566,52831
27-12-2014,23,20901,17568,7484,3272,49226,1139,224,187,1550,50776
28-12-2014,0,19992,16447,7304,3075,46818,1123,175,178,1476,48294
28-12-2014,1,19160,15927,7293,2931,45312,1118,175,180,1473,46785
28-12-2014,2,19029,15969,7332,2911,45241,1121,174,178,1473,46714
28-12-2014,3,19439,16187,7402,2908,45936,1118,178,178,1474,47410
28-12-2014,4,19585,16430,7485,2799,46298,1118,179,178,1475,47773
28-12-2014,5,20211,17117,7553,2705,47588,1128,185,180,1493,49081
28-12-2014,6,20121,16938,7596,2683,47339,1129,216,181,1526,48865
28-12-2014,7,20904,17592,7759,2661,48916,1118,244,255,1617,50533
28-12-2014,8,21943,18018,7914,2697,50573,1116,250,340,1706,52279
28-12-2014,9,23244,18407,8177,2787,52616,1116,324,376,1816,54432
28-12-2014,10,24724,19593,8546,3415,56278,1121,403,399,1923,58201
28-12-2014,11,24827,20555,8710,4016,58107,1111,340,395,1846,59953
28-12-2014,12,24921,20686,8583,4175,58367,1101,363,388,1852,60219
28-12-2014,13,24445,20815,8256,4085,57602,1106,360,387,1853,59455
28-12-2014,14,24271,20517,8229,3834,56850,1142,384,387,1913,58763
28-12-2014,15,24685,21243,8558,3983,58469,1161,426,356,1943,60412
28-12-2014,16,25489,22220,8951,4416,61075,1155,445,378,1978,63053
28-12-2014,17,25816,22323,9092,4727,61957,1152,497,381,2030,63987
28-12-2014,18,25381,22740,9058,4928,62107,1144,504,367,2015,64122
28-12-2014,19,25110,22528,8801,4548,60988,1157,545,368,2070,63058
28-12-2014,20,25004,21480,8772,4159,59415,1151,544,339,2034,61449
28-12-2014,21,24946,20601,8611,3861,58018,1154,539,266,1959,59977
28-12-2014,22,24290,19799,8461,3675,56224,1163,406,169,1738,57962
28-12-2014,23,23344,18569,8261,3665,53838,1148,433,168,1749,55587
29-12-2014,0,21535,17099,7916,3555,50104,1173,394,169,1736,51840
29-12-2014,1,20022,16292,7901,3582,47799,1165,402,174,1741,49540
29-12-2014,2,19574,16131,7906,3579,47191,1152,419,179,1750,48941
29-12-2014,3,19806,16317,8021,3308,47452,1145,403,200,1748,49200
29-12-2014,4,20105,16685,8208,3202,48199,1172,455,232,1859,50058
29-12-2014,5,20681,17323,9085,3266,50356,1231,634,422,2287,52643
29-12-2014,6,22573,18318,9927,3173,53990,1233,913,466,2612,56602
29-12-2014,7,24490,20336,10415,3494,58735,1214,1291,508,3013,61748
29-12-2014,8,25193,22225,10520,3849,61789,1207,1285,555,3047,64836
29-12-2014,9,25791,22816,10506,4039,63153,1222,1247,522,2991,66144
29-12-2014,10,25663,23138,10243,4255,63298,1208,821,488,2517,65815
29-12-2014,11,25597,23223,10099,4219,63139,1205,754,479,2438,65577
29-12-2014,12,25477,23276,9996,4228,62977,1210,732,486,2428,65405
29-12-2014,13,25559,23074,10043,4253,62929,1199,747,508,2454,65383
29-12-2014,14,25617,23346,10359,4340,63663,1189,1253,581,3023,66686
29-12-2014,15,25502,23702,10541,4668,64414,1209,1447,728,3384,67798
29-12-2014,16,25376,23518,10685,4764,64345,1196,1436,676,3308,67653
29-12-2014,17,25462,23300,10544,4815,64120,1179,1318,668,3165,67285
29-12-2014,18,25345,23114,10494,4834,63788,1176,1291,608,3075,66863
29-12-2014,19,25063,22532,10130,4577,62303,1172,790,584,2546,64849
29-12-2014,20,24353,21668,9531,4542,60095,1194,518,393,2105,62200
29-12-2014,21,24160,20150,9209,4018,57538,1223,404,385,2012,59550
29-12-2014,22,23122,19458,8918,3932,55431,1219,397,194,1810,57241
29-12-2014,23,21465,18212,8547,4094,52317,1176,397,177,1750,54067
30-12-2014,0,19248,17047,8046,3544,47884,1168,403,173,1744,49628
30-12-2014,1,17618,16709,7946,3303,45577,1198,404,172,1774,47351
30-12-2014,2,16764,16777,7813,3521,44874,1254,415,187,1856,46730
30-12-2014,3,16435,16699,7788,3588,44510,1268,422,187,1877,46387
30-12-2014,4,16575,16885,7938,3736,45134,1282,428,205,1915,47049
30-12-2014,5,17482,17493,8483,3868,47325,1314,499,226,2039,49364
30-12-2014,6,19597,18691,9558,4013,51858,1333,660,417,2410,54268
30-12-2014,7,22157,20629,10033,3917,56736,1335,809,593,2737,59473
30-12-2014,8,23330,21436,10005,3903,58673,1337,809,600,2746,61419
30-12-2014,9,23771,21495,9873,3950,59090,1342,813,576,2731,61821
30-12-2014,10,24224,21830,9313,4082,59451,1356,782,280,2418,61869
30-12-2014,11,24186,21631,8816,4289,58923,1353,768,281,2402,61325
30-12-2014,12,23933,21728,8701,4068,58429,1331,742,291,2364,60793
30-12-2014,13,23649,21827,8895,4059,58429,1286,742,306,2334,60763
30-12-2014,14,23331,21919,9495,4223,58968,1313,884,566,2763,61731
30-12-2014,15,23633,21948,9591,4261,59434,1281,1254,674,3209,62643
30-12-2014,16,24046,22066,9909,4354,60375,1246,861,693,2800,63175
30-12-2014,17,24203,22502,9788,4004,60497,1246,805,722,2773,63270
30-12-2014,18,23583,22161,9656,4194,59593,1251,802,638,2691,62284
30-12-2014,19,22980,21080,8969,4267,57294,1266,722,383,2371,59665
30-12-2014,20,22180,20113,8224,4230,54748,1278,513,361,2152,56900
30-12-2014,21,21251,19609,7960,4287,53107,1256,432,354,2042,55149
30-12-2014,22,19967,18664,7574,4244,50451,1265,414,330,2009,52460
30-12-2014,23,18093,17892,7300,4139,47424,1303,413,334,2050,49474
31-12-2014,0,16132,16965,7073,4067,44237,1294,418,331,2043,46280
31-12-2014,1,14293,16411,7011,3783,41497,1321,422,328,2071,43568
31-12-2014,2,12920,16201,6964,3850,39936,1329,426,308,2063,41999
31-12-2014,3,12446,16104,6944,3898,39391,1315,426,299,2040,41431
31-12-2014,4,12755,16033,7031,4035,39855,1306,426,311,2043,41898
31-12-2014,5,13959,16337,7310,4070,41676,1298,430,304,2032,43708
31-12-2014,6,14951,16924,7948,4215,44039,1284,435,324,2043,46082
31-12-2014,7,16796,17972,8485,4199,47452,1292,653,482,2427,49879
31-12-2014,8,18926,18551,8593,4343,50413,1297,705,456,2458,52871
31-12-2014,9,20018,19236,8605,4290,52149,1285,694,483,2462,54611
31-12-2014,10,20510,19762,8119,4278,52670,1279,626,384,2289,54959
31-12-2014,11,20341,20309,7798,4266,52712,1306,625,341,2272,54984
31-12-2014,12,20039,20385,7781,4275,52481,1298,641,328,2267,54748
31-12-2014,13,19681,20399,7958,4442,52480,1272,647,274,2193,54673
31-12-2014,14,19923,20332,8534,4492,53280,1280,789,353,2422,55702
31-12-2014,15,20881,20768,8917,4268,54833,1307,806,544,2657,57490
31-12-2014,16,21584,21592,8988,4185,56349,1292,991,588,2871,59220
31-12-2014,17,21645,21671,8945,4249,56509,1275,997,523,2795,59304
31-12-2014,18,20614,21010,8571,4312,54507,1265,870,357,2492,56999
31-12-2014,19,19134,20099,7766,4269,51268,1236,742,231,2209,53477
31-12-2014,20,16959,19384,7289,4105,47738,1171,572,236,1979,49717
31-12-2014,21,15777,18892,7059,4286,46015,1191,416,224,1831,47846
31-12-2014,22,15604,18841,6889,4355,45690,1219,415,228,1862,47552
31-12-2014,23,13815,18109,6823,4489,43235,1194,429,225,1848,45083
01-01-2015,0,12830,16864,6818,4423,40934,979,199,237,1415,42349
01-01-2015,1,12633,16793,6751,4426,40602,882,180,253,1315,41917
01-01-2015,2,12248,16634,6764,4159,39804,870,181,261,1312,41116
01-01-2015,3,11979,16611,6587,4065,39242,880,186,263,1329,40571
01-01-2015,4,11762,16623,6601,4110,39097,890,188,278,1356,40453
01-01-2015,5,11859,16643,6698,4611,39812,883,191,287,1361,41173
01-01-2015,6,11896,16659,6881,4717,40152,927,190,278,1395,41547
01-01-2015,7,11830,17089,7010,4936,40864,961,190,295,1446,42310
01-01-2015,8,11924,17334,7131,5118,41509,937,206,307,1450,42959
01-01-2015,9,11907,17455,7131,5266,41759,927,210,324,1461,43220
01-01-2015,10,12130,18164,7130,5515,42940,947,210,328,1485,44425
01-01-2015,11,12384,18900,7111,5653,44049,954,192,316,1462,45511
01-01-2015,12,12623,18974,7197,5741,44536,965,213,333,1511,46047
01-01-2015,13,12656,19154,7262,5747,44821,973,207,309,1489,46310
01-01-2015,14,13119,19763,7273,5550,45707,969,210,314,1493,47200
01-01-2015,15,14126,20148,7315,5612,47201,1024,220,425,1669,48870
01-01-2015,16,15445,20241,7333,5766,48786,1041,313,467,1821,50607
01-01-2015,17,15493,20238,7297,5984,49013,1073,314,482,1869,50882
01-01-2015,18,14929,20272,7248,6247,48696,1065,282,499,1846,50542
01-01-2015,19,14328,19865,7097,6429,47719,1060,279,505,1844,49563
01-01-2015,20,13732,19374,7087,6318,46511,1010,225,472,1707,48218
01-01-2015,21,13026,19015,7024,6112,45178,1029,233,367,1629,46807
01-01-2015,22,12509,18243,6970,5952,43673,1000,224,365,1589,45262
01-01-2015,23,12006,17716,6729,5733,42186,994,205,349,1548,43734
02-01-2015,0,11469,16924,6658,5076,40127,971,209,349,1529,41656
02-01-2015,1,11468,16694,6616,4340,39118,951,203,306,1460,40578
02-01-2015,2,11147,16562,6546,4191,38446,934,205,326,1465,39911
02-01-2015,3,10424,16524,6563,4086,37598,944,207,331,1482,39080
02-01-2015,4,10025,16748,6680,4119,37572,970,213,332,1515,39087
02-01-2015,5,11243,17195,7011,4291,39740,1038,217,356,1611,41351
02-01-2015,6,12481,17872,7149,5320,42822,1044,218,371,1633,44455
02-01-2015,7,14420,18420,7283,5746,45868,1034,243,375,1652,47520
02-01-2015,8,14862,19390,7337,5870,47458,1201,358,375,1934,49392
02-01-2015,9,14917,19765,7332,6020,48035,1187,368,383,1938,49973
02-01-2015,10,15126,20229,7315,5952,48621,1225,358,383,1966,50587
02-01-2015,11,15482,20498,7269,6049,49299,1249,388,395,2032,51331
02-01-2015,12,15697,20764,7292,6044,49796,1239,395,395,2029,51825
02-01-2015,13,15459,21004,7237,6244,49945,1242,412,384,2038,51983
02-01-2015,14,15632,21164,7350,6220,50367,1238,487,384,2109,52476
02-01-2015,15,16143,21570,7547,6242,51502,1305,544,380,2229,53731
02-01-2015,16,16713,21982,7533,6427,52656,1292,602,379,2273,54929
02-01-2015,17,16865,22111,7554,6632,53163,1286,555,378,2219,55382
02-01-2015,18,16525,22055,7489,6551,52620,1249,485,377,2111,54731
02-01-2015,19,16353,21359,7342,6406,51458,1304,456,378,2138,53596
02-01-2015,20,15253,20794,7185,6380,49612,1257,460,378,2095,51707
02-01-2015,21,14328,20316,7085,6235,47965,1251,217,376,1844,49809
02-01-2015,22,14232,19457,7053,5857,46599,1271,212,375,1858,48457
02-01-2015,23,13452,18845,6889,5420,44606,1242,211,374,1827,46433
03-01-2015,0,12740,18201,6690,5398,43030,1110,210,372,1692,44722
03-01-2015,1,12470,18035,6578,5314,42398,1088,210,374,1672,44070
03-01-2015,2,12417,17907,6527,5304,42154,1072,211,374,1657,43811
03-01-2015,3,12650,17907,6563,5203,42323,1051,214,375,1640,43963
03-01-2015,4,12683,18091,6624,5109,42508,1041,218,377,1636,44144
03-01-2015,5,12579,18156,6951,5024,42711,1040,215,375,1630,44341
03-01-2015,6,12637,18470,7065,5078,43249,1030,215,374,1619,44868
03-01-2015,7,13492,18965,7217,5075,44749,1053,218,398,1669,46418
03-01-2015,8,14109,19430,7344,5057,45940,1076,336,376,1788,47728
03-01-2015,9,15082,20011,7436,5139,47668,1101,349,377,1827,49495
03-01-2015,10,16013,20321,7505,5184,49023,1107,504,374,1985,51008
03-01-2015,11,16226,20544,7575,5166,49511,1110,485,375,1970,51481
03-01-2015,12,15972,20389,7573,5294,49228,1099,518,373,1990,51218
03-01-2015,13,15966,20148,7632,5292,49039,1089,549,368,2006,51045
03-01-2015,14,16662,20228,7602,5335,49828,1091,547,360,1998,51826
03-01-2015,15,18393,20509,7736,5390,52029,1101,552,360,2013,54042
03-01-2015,16,19657,21059,7845,5367,53929,1111,766,360,2237,56166
03-01-2015,17,20273,21670,7886,5284,55114,1108,714,361,2183,57297
03-01-2015,18,20184,21472,7787,5348,54791,1103,705,358,2166,56957
03-01-2015,19,19204,20824,7703,5336,53068,1093,545,367,2005,55073
03-01-2015,20,18131,19383,7555,5187,50255,1105,494,335,1934,52189
03-01-2015,21,16948,18659,7327,5067,48002,1116,249,316,1681,49683
03-01-2015,22,15910,18286,7315,4946,46456,1108,240,295,1643,48099
03-01-2015,23,14857,17796,7244,4642,44540,1113,203,312,1628,46168
04-01-2015,0,14514,17152,7047,4377,43091,1039,216,329,1584,44675
04-01-2015,1,14196,16994,6973,4275,42439,1055,291,335,1681,44120
04-01-2015,2,13765,16927,6962,4291,41946,1012,299,334,1645,43591
04-01-2015,3,13643,16917,6922,4372,41854,997,284,328,1609,43463
04-01-2015,4,13557,16969,6949,4397,41872,1030,414,340,1784,43656
04-01-2015,5,13876,16918,7090,4372,42255,1024,438,348,1810,44065
04-01-2015,6,14078,17021,7263,4445,42809,1010,490,349,1849,44658
04-01-2015,7,14258,17104,7387,4504,43255,1024,493,350,1867,45122
04-01-2015,8,14849,17749,7429,4811,44838,1059,702,354,2115,46953
04-01-2015,9,16338,18187,7519,5031,47074,1056,701,377,2134,49208
04-01-2015,10,17714,19218,7647,5265,49844,1049,721,365,2135,51979
04-01-2015,11,17807,18190,7722,5486,49205,1064,672,367,2103,51308
04-01-2015,12,17282,18685,7777,5462,49205,1056,631,373,2060,51265
04-01-2015,13,17359,18606,7854,5239,49057,1072,647,374,2093,51150
04-01-2015,14,17820,18654,7876,4941,49292,1075,790,377,2242,51534
04-01-2015,15,19101,19297,8038,4709,51148,1083,802,378,2263,53411
04-01-2015,16,20427,20292,8197,4713,53629,1087,836,379,2302,55931
04-01-2015,17,21192,20795,8365,4691,55042,1095,916,394,2405,57447
04-01-2015,18,21344,21067,8352,4726,55491,1090,910,384,2384,57875
04-01-2015,19,21082,20755,8209,4654,54700,1094,814,366,2274,56974
04-01-2015,20,19753,19986,8142,4563,52445,1073,543,378,1994,54439
04-01-2015,21,18892,19023,8178,4541,50633,1058,267,364,1689,52322
04-01-2015,22,18502,18466,7968,4601,49539,1032,222,350,1604,51143
04-01-2015,23,16507,17232,7723,4544,46004,1014,210,337,1561,47565
05-01-2015,0,16802,16133,7498,4536,44970,987,210,343,1540,46510
05-01-2015,1,16419,15592,7491,4456,43958,951,210,324,1485,45443
05-01-2015,2,16473,15454,7482,4353,43762,932,206,311,1449,45211
05-01-2015,3,16397,15393,7515,4181,43487,945,211,307,1463,44950
05-01-2015,4,16647,15672,7752,3986,44056,955,228,313,1496,45552
05-01-2015,5,18575,16265,8323,3695,46859,1079,314,397,1790,48649
05-01-2015,6,20565,17351,8668,3778,50360,1510,510,488,2508,52868
05-01-2015,7,23395,19848,9026,3930,56198,1568,731,479,2778,58976
05-01-2015,8,24620,21172,9127,3844,58763,1575,753,276,2604,61367
05-01-2015,9,24299,20611,9076,3735,57722,1573,800,281,2654,60376
05-01-2015,10,24736,19967,9149,3509,57359,1589,791,288,2668,60027
05-01-2015,11,24900,20956,9175,3442,58473,1563,731,277,2571,61044
05-01-2015,12,24238,20893,9210,3396,57737,1560,682,351,2593,60330
05-01-2015,13,24423,20464,9193,3323,57402,1530,678,369,2577,59979
05-01-2015,14,24569,20140,9403,3287,57399,1538,710,321,2569,59968
05-01-2015,15,25083,21352,9649,3461,59545,1550,945,306,2801,62346
05-01-2015,16,24831,21799,9625,3511,59766,1552,1323,280,3155,62921
05-01-2015,17,24748,21812,9632,3636,59829,1529,1349,297,3175,63004
05-01-2015,18,24688,21646,9634,3632,59601,1507,1616,306,3429,63030
05-01-2015,19,24487,21342,9508,3526,58864,1502,1261,289,3052,61916
05-01-2015,20,24046,21563,9269,3065,57942,1494,663,394,2551,60493
05-01-2015,21,23792,21310,9149,2972,57225,1486,460,268,2214,59439
05-01-2015,22,23021,20430,8642,2892,54985,1472,426,211,2109,57094
05-01-2015,23,21292,18614,8248,2827,50981,1466,418,201,2085,53066
06-01-2015,0,21069,16551,7973,2741,48335,1454,423,196,2073,50408
06-01-2015,1,21150,16198,7793,2767,47908,1359,422,192,1973,49881
06-01-2015,2,20895,16348,7878,2766,47887,1145,421,192,1758,49645
06-01-2015,3,20546,16407,7898,2866,47716,1126,424,196,1746,49462
06-01-2015,4,20836,16701,7920,3003,48460,1153,426,197,1776,50236
06-01-2015,5,20893,17217,8214,3106,49429,1227,435,396,2058,51487
06-01-2015,6,21668,18327,8648,3461,52106,1299,670,392,2361,54467
06-01-2015,7,23266,20496,8711,3708,56184,1439,789,515,2743,58927
06-01-2015,8,23272,21337,8793,4124,57527,1442,752,507,2701,60228
06-01-2015,9,23042,21244,8874,4259,57421,1512,748,504,2764,60185
06-01-2015,10,23181,21236,8851,4357,57626,1504,746,483,2733,60359
06-01-2015,11,22820,21196,8798,4535,57350,1494,697,455,2646,59996
06-01-2015,12,22771,21011,8817,4695,57296,1500,679,496,2675,59971
06-01-2015,13,22543,20727,9015,4777,57061,1461,805,373,2639,59700
06-01-2015,14,22715,21013,9202,4733,57662,1463,816,378,2657,60319
06-01-2015,15,23330,22067,9599,4747,59744,1484,888,382,2754,62498
06-01-2015,16,23368,22716,9672,4896,60653,1492,993,343,2828,63481
06-01-2015,17,23092,22830,9618,5266,60807,1504,1003,250,2757,63564
06-01-2015,18,22489,22386,9546,5320,59742,1505,1004,216,2725,62467
06-01-2015,19,21916,21766,9270,5382,58334,1510,994,216,2720,61054
06-01-2015,20,21092,21131,8837,5347,56408,1529,647,324,2500,58908
06-01-2015,21,20580,19945,8592,5178,54296,1541,461,242,2244,56540
06-01-2015,22,19075,18934,8296,5041,51346,1561,468,249,2278,53624
06-01-2015,23,17018,17799,8119,4653,47588,1375,455,244,2074,49662
07-01-2015,0,16409,16640,7926,4503,45479,1274,440,248,1962,47441
07-01-2015,1,15681,16492,7834,4404,44411,1282,420,249,1951,46362
07-01-2015,2,15370,16350,7820,4259,43799,1285,418,253,1956,45755
07-01-2015,3,15619,16213,7812,4150,43794,1279,423,258,1960,45754
07-01-2015,4,16854,16255,7857,4133,45098,1289,427,254,1970,47068
07-01-2015,5,19260,16941,8462,3957,48621,1528,440,419,2387,51008
07-01-2015,6,21710,19363,9124,4206,54405,1639,691,498,2828,57233
07-01-2015,7,24347,21792,9227,4651,60017,1637,881,602,3120,63137
07-01-2015,8,24415,23472,9278,4702,61865,1647,734,518,2899,64764
07-01-2015,9,24506,22821,9135,4695,61157,1659,713,522,2894,64051
07-01-2015,10,24558,22454,9234,4669,60916,1663,718,483,2864,63780
07-01-2015,11,24442,22314,9192,4817,60765,1658,664,465,2787,63552
07-01-2015,12,24528,22316,8734,4606,60186,1668,662,478,2808,62994
07-01-2015,13,24316,22509,8666,4357,59849,1683,677,462,2822,62671
07-01-2015,14,24186,22616,8885,4361,60049,1696,686,474,2856,62905
07-01-2015,15,24260,22731,9056,4244,60292,1693,782,446,2921,63213
07-01-2015,16,24587,22845,9207,4347,60987,1676,1217,355,3248,64235
07-01-2015,17,24071,22731,9124,4700,60627,1679,1253,337,3269,63896
07-01-2015,18,23724,22447,8884,4831,59886,1675,962,318,2955,62841
07-01-2015,19,22820,21782,8422,5094,58118,1668,963,313,2944,61062
07-01-2015,20,21441,20405,7912,5405,55164,1680,607,318,2605,57769
07-01-2015,21,20505,18535,7557,5728,52325,1680,445,308,2433,54758
07-01-2015,22,19149,17413,7615,5810,49986,1463,439,296,2198,52184
07-01-2015,23,17255,16497,7314,5794,46860,1446,435,287,2168,49028
08-01-2015,0,16180,15604,7148,5810,44743,1346,437,295,2078,46821
08-01-2015,1,15092,15264,7084,5784,43224,1325,438,284,2047,45271
08-01-2015,2,14412,15326,7096,5877,42712,1346,437,278,2061,44773
08-01-2015,3,13865,15594,7050,5919,42428,1348,445,274,2067,44495
08-01-2015,4,13609,15866,7082,5863,42420,1364,446,275,2085,44505
08-01-2015,5,15222,16605,7529,5965,45323,1483,451,357,2291,47614
08-01-2015,6,18448,18576,8074,5985,51083,1613,602,479,2694,53777
08-01-2015,7,21568,20603,8422,6061,56653,1621,794,513,2928,59581
08-01-2015,8,22046,21683,8305,5826,57861,1623,667,586,2876,60737
08-01-2015,9,22104,21355,8235,5586,57280,1587,648,611,2846,60126
08-01-2015,10,22567,21048,8152,5218,56986,1623,605,639,2867,59853
08-01-2015,11,22652,21354,8052,5017,57076,1628,544,667,2839,59915
08-01-2015,12,22583,21406,8085,5051,57126,1634,546,680,2860,59986
08-01-2015,13,22599,21364,8205,4833,57000,1650,574,679,2903,59903
08-01-2015,14,22811,21677,8393,4505,57384,1649,695,569,2913,60297
08-01-2015,15,23148,22361,8441,4634,58584,1626,759,561,2946,61530
08-01-2015,16,23165,22739,8421,4933,59257,1637,825,537,2999,62256
08-01-2015,17,23160,22812,8247,5035,59255,1602,825,520,2947,62202
08-01-2015,18,22553,22306,8237,5092,58188,1587,765,482,2834,61022
08-01-2015,19,21910,21744,8031,4995,56681,1542,683,475,2700,59381
08-01-2015,20,20981,20530,7739,5101,54351,1318,490,450,2258,56609
08-01-2015,21,20084,19097,7657,5225,52064,1248,214,423,1885,53949
08-01-2015,22,18279,18159,7294,5284,49015,1258,210,256,1724,50739
08-01-2015,23,16424,16831,7071,5254,45580,1220,202,255,1677,47257
09-01-2015,0,15489,15924,7005,5095,43512,1120,196,238,1554,45066
09-01-2015,1,14709,15765,6976,5007,42459,1081,193,235,1509,43968
09-01-2015,2,14292,15700,6941,5091,42024,1063,197,239,1499,43523
09-01-2015,3,14295,15639,6952,4971,41855,1061,209,252,1522,43377
09-01-2015,4,14805,15751,7027,5017,42599,1050,215,308,1573,44172
09-01-2015,5,16205,16511,7618,5066,45401,1144,240,418,1802,47203
09-01-2015,6,18718,18446,8268,5628,51058,1263,399,556,2218,53276
09-01-2015,7,21781,20849,8651,5972,57254,1275,620,554,2449,59703
09-01-2015,8,22526,21679,8700,6080,58986,1281,478,548,2307,61293
09-01-2015,9,22208,21650,8504,6159,58521,1286,476,541,2303,60824
09-01-2015,10,22364,21911,8422,6251,58947,1234,468,487,2189,61136
09-01-2015,11,22225,22146,8372,6430,59172,1216,414,522,2152,61324
09-01-2015,12,21877,21902,8291,6456,58526,1231,442,513,2186,60712
09-01-2015,13,21623,21674,8339,6477,58112,1211,471,485,2167,60279
09-01-2015,14,21474,21413,8486,6457,57832,1200,473,448,2121,59953
09-01-2015,15,21505,21578,8809,6544,58436,1189,575,272,2036,60472
09-01-2015,16,21817,21730,8859,6607,59013,1180,669,388,2237,61250
09-01-2015,17,22153,21780,8819,6735,59487,1176,665,348,2189,61676
09-01-2015,18,21934,21505,8638,6783,58860,1173,595,332,2100,60960
09-01-2015,19,20933,20522,8510,6683,56650,1161,560,285,2006,58656
09-01-2015,20,20319,19154,8075,6312,53861,1105,401,310,1816,55677
09-01-2015,21,19540,18075,7860,5864,51340,1158,199,232,1589,52929
09-01-2015,22,18681,17279,7629,5545,49134,1091,188,171,1450,50584
09-01-2015,23,17689,16653,7525,4743,46612,1033,186,172,1391,48003
10-01-2015,0,17749,15048,7539,4205,44541,821,190,176,1187,45728
10-01-2015,1,17665,14628,7385,3723,43403,814,187,174,1175,44578
10-01-2015,2,16741,15093,7454,3525,42814,839,186,172,1197,44011
10-01-2015,3,16684,14563,7423,3532,42203,848,188,169,1205,43408
10-01-2015,4,16844,14553,7450,3430,42279,862,195,167,1224,43503
10-01-2015,5,16189,14689,7528,4000,42407,833,372,166,1371,43778
10-01-2015,6,16646,15053,7607,4701,44007,808,549,168,1525,45532
10-01-2015,7,17883,16125,7807,5314,47128,823,591,170,1584,48712
10-01-2015,8,19380,16987,7970,5654,49993,868,695,167,1730,51723
10-01-2015,9,19832,17918,7963,5989,51703,893,754,170,1817,53520
10-01-2015,10,20279,18708,7978,5959,52922,894,781,185,1860,54782
10-01-2015,11,20054,19322,7849,5885,53112,873,764,204,1841,54953
10-01-2015,12,20053,19535,7901,5738,53228,863,755,220,1838,55066
10-01-2015,13,19923,19664,7941,5559,53086,894,721,245,1860,54946
10-01-2015,14,19758,19961,8150,5488,53357,987,658,272,1917,55274
10-01-2015,15,19929,20230,8535,5333,54028,1028,682,299,2009,56037
10-01-2015,16,20537,20682,8732,5048,54998,1054,738,337,2129,57127
10-01-2015,17,20802,21196,8774,5141,55913,1090,683,366,2139,58052
10-01-2015,18,20445,21244,8682,4741,55111,1100,659,380,2139,57250
10-01-2015,19,19800,21150,8480,4247,53677,1019,612,382,2013,55690
10-01-2015,20,19322,20135,8205,4247,51910,1052,468,381,1901,53811
10-01-2015,21,19018,19707,8293,4028,51045,1028,249,382,1659,52704
10-01-2015,22,17925,19146,8080,4155,49307,1000,237,379,1616,50923
10-01-2015,23,17127,18733,7984,3940,47784,936,221,376,1533,49317
11-01-2015,0,15534,18012,7951,4154,45652,902,218,377,1497,47149
11-01-2015,1,14882,17387,7848,4307,44424,927,217,371,1515,45939
11-01-2015,2,14526,17035,7823,4372,43756,944,214,357,1515,45271
11-01-2015,3,13848,16977,7759,4556,43140,895,219,347,1461,44601
11-01-2015,4,13961,16954,7817,4363,43094,875,216,338,1429,44523
11-01-2015,5,14182,17119,7883,4342,43526,858,217,338,1413,44939
11-01-2015,6,14385,17612,7950,4372,44321,842,248,345,1435,45756
11-01-2015,7,14889,17891,8093,4691,45566,895,298,351,1544,47110
11-01-2015,8,16208,18469,8206,4987,47870,917,435,352,1704,49574
11-01-2015,9,18029,19116,8348,5121,50616,924,523,360,1807,52423
11-01-2015,10,19096,19615,8443,5306,52460,946,583,360,1889,54349
11-01-2015,11,19515,19110,8538,5423,52586,943,597,357,1897,54483
11-01-2015,12,18936,19540,8696,5675,52849,952,601,353,1906,54755
11-01-2015,13,18876,19552,8726,5686,52840,961,585,355,1901,54741
11-01-2015,14,19070,19771,8814,5553,53207,985,595,355,1935,55142
11-01-2015,15,19618,20209,9097,5545,54469,1119,727,353,2199,56668
11-01-2015,16,20342,20799,9266,5631,56039,1153,858,352,2363,58402
11-01-2015,17,20019,21271,9280,6118,56690,1199,868,339,2406,59096
11-01-2015,18,20030,22045,9210,5879,57164,1202,861,340,2403,59567
11-01-2015,19,19608,21871,9111,5753,56345,1167,756,340,2263,58608
11-01-2015,20,19020,21435,8916,5271,54641,1100,651,346,2097,56738
11-01-2015,21,18689,20658,8847,4826,53019,1200,387,352,1939,54958
11-01-2015,22,18244,19563,8760,4358,50925,1154,212,343,1709,52634
11-01-2015,23,17987,18749,8394,3883,49012,1059,211,325,1595,50607
12-01-2015,0,17846,18242,8183,3723,47995,1030,201,314,1545,49540
12-01-2015,1,17470,16906,8097,3978,46451,1038,206,323,1567,48018
12-01-2015,2,16515,16766,8198,4266,45744,1034,217,298,1549,47293
12-01-2015,3,15951,17270,8368,4449,46038,1068,220,302,1590,47628
12-01-2015,4,15962,17596,8550,4553,46662,1253,229,288,1770,48432
12-01-2015,5,16446,18461,9422,4797,49127,1528,703,469,2700,51827
12-01-2015,6,19167,21437,10021,5235,55860,1587,1029,649,3265,59125
12-01-2015,7,21922,23312,10563,5833,61630,1569,1354,729,3652,65282
12-01-2015,8,22208,23966,11046,6164,63384,1551,1262,649,3462,66846
12-01-2015,9,21558,24230,10880,6476,63144,1548,1221,672,3441,66585
12-01-2015,10,21352,23155,10387,6294,61186,1561,1206,682,3449,64635
12-01-2015,11,21584,22470,10045,6223,60322,1623,1249,671,3543,63865
12-01-2015,12,21622,22582,10175,6161,60540,1627,1096,627,3350,63890
12-01-2015,13,21076,22936,10130,6096,60238,1629,1010,665,3304,63542
12-01-2015,14,21920,22251,10218,6085,60476,1560,1350,697,3607,64083
12-01-2015,15,22703,22152,10210,5975,61038,1549,1777,764,4090,65128
12-01-2015,16,22841,22519,10192,6196,61749,1548,1812,766,4126,65875
12-01-2015,17,22931,22870,10197,6500,62497,1551,1527,791,3869,66366
12-01-2015,18,22461,22689,10164,6387,61701,1563,1353,748,3664,65365
12-01-2015,19,21951,21415,9973,6219,59560,1557,870,446,2873,62433
12-01-2015,20,21139,20212,9530,5904,56785,1518,653,450,2621,59406
12-01-2015,21,20433,19324,9259,5541,54558,1548,318,541,2407,56965
12-01-2015,22,19355,18674,8996,5408,52432,1447,256,382,2085,54517
12-01-2015,23,17926,17829,8667,5133,49555,1392,252,381,2025,51580
13-01-2015,0,16165,16852,8361,4740,46117,1444,249,381,2074,48191
13-01-2015,1,15136,16481,8172,4177,43966,1458,249,379,2086,46052
13-01-2015,2,14942,16511,8167,3604,43223,1456,245,377,2078,45301
13-01-2015,3,15128,16415,8143,3329,43015,1451,248,377,2076,45091
13-01-2015,4,16107,16635,8342,3167,44250,1483,252,380,2115,46365
13-01-2015,5,17000,17684,8945,3357,46986,1746,448,379,2573,49559
13-01-2015,6,19406,19653,9551,3773,52382,1747,594,723,3064,55446
13-01-2015,7,21977,21714,9776,4766,58232,1763,860,750,3373,61605
13-01-2015,8,22609,22931,9739,4877,60157,1802,860,675,3337,63494
13-01-2015,9,21981,22364,9553,4917,58816,1855,810,627,3292,62108
13-01-2015,10,21696,21346,9493,4542,57076,1876,839,543,3258,60334
13-01-2015,11,21098,20939,9364,4536,55938,1876,973,497,3346,59284
13-01-2015,12,20518,21022,9245,4552,55338,1875,1091,479,3445,58783
13-01-2015,13,20577,20886,9213,4935,55611,1845,1008,420,3273,58884
13-01-2015,14,20957,20802,9330,5388,56477,1836,881,449,3166,59643
13-01-2015,15,22273,20863,9649,5259,58043,1836,1197,383,3416,61459
13-01-2015,16,23138,21886,9782,5057,59864,1816,1201,464,3481,63345
13-01-2015,17,23298,22773,9880,4896,60848,1680,898,636,3214,64062
13-01-2015,18,22654,22749,9842,4829,60075,1648,721,653,3022,63097
13-01-2015,19,22038,21844,9456,4799,58138,1562,637,526,2725,60863
13-01-2015,20,21215,20223,9138,4487,55064,1522,553,454,2529,57593
13-01-2015,21,20364,19235,8776,4274,52648,1506,486,364,2356,55004
13-01-2015,22,19384,17798,8562,4121,49866,1417,269,341,2027,51893
13-01-2015,23,16864,16872,8351,4146,46233,1227,262,338,1827,48060
14-01-2015,0,16067,15820,7999,3990,43875,1246,251,317,1814,45689
14-01-2015,1,16088,15619,7700,3774,43180,1275,246,298,1819,44999
14-01-2015,2,15897,15506,7826,4048,43277,1288,250,269,1807,45084
14-01-2015,3,15924,15440,7809,4122,43297,1291,251,264,1806,45103
14-01-2015,4,16573,15799,8049,3885,44306,1355,259,259,1873,46179
14-01-2015,5,17567,17249,8580,3687,47083,1696,484,232,2412,49495
14-01-2015,6,20294,19418,9260,4274,53245,1725,643,507,2875,56120
14-01-2015,7,22898,21777,9574,4821,59069,1680,812,648,3140,62209
14-01-2015,8,23640,22692,9581,5127,61039,1651,833,632,3116,64155
14-01-2015,9,23490,21577,9375,5067,59509,1620,732,628,2980,62489
14-01-2015,10,23188,21489,9297,5017,58991,1639,680,638,2957,61948
14-01-2015,11,23184,21420,9286,5247,59136,1679,624,665,2968,62104
14-01-2015,12,22812,21938,9328,5414,59493,1644,628,653,2925,62418
14-01-2015,13,22563,21828,9307,5560,59258,1661,625,639,2925,62183
14-01-2015,14,22795,21992,9416,5341,59545,1629,622,661,2912,62457
14-01-2015,15,23390,22504,9482,5267,60642,1669,781,697,3147,63789
14-01-2015,16,23566,23463,9405,5031,61466,1662,843,716,3221,64687
14-01-2015,17,23985,23744,9352,4924,62004,1645,746,717,3108,65112
14-01-2015,18,23408,23532,9163,5086,61190,1608,631,700,2939,64129
14-01-2015,19,23238,22593,8697,4694,59222,1608,675,484,2767,61989
14-01-2015,20,21988,20753,8443,4616,55800,1441,682,330,2453,58253
14-01-2015,21,21256,19127,8358,4721,53463,1200,476,337,2013,55476
14-01-2015,22,19702,18082,7983,4740,50507,1153,244,318,1715,52222
14-01-2015,23,18111,17106,7728,4726,47670,1224,247,297,1768,49438
15-01-2015,0,16688,16134,7527,4895,45244,1446,250,260,1956,47200
15-01-2015,1,15494,15432,7372,4765,43063,1457,249,264,1970,45033
15-01-2015,2,15009,15433,7373,4695,42511,1453,247,255,1955,44466
15-01-2015,3,14957,15419,7354,4838,42567,1455,252,259,1966,44533
15-01-2015,4,15537,15542,7488,5096,43664,1483,253,270,2006,45670
15-01-2015,5,16725,16868,7977,5401,46970,1643,447,300,2390,49360
15-01-2015,6,19874,18730,8871,6093,53569,1657,808,394,2859,56428
15-01-2015,7,21904,21667,9204,6568,59341,1667,1120,430,3217,62558
15-01-2015,8,22254,22338,9251,6764,60607,1674,1041,472,3187,63794
15-01-2015,9,21742,22379,8981,6810,59911,1662,1048,471,3181,63092
15-01-2015,10,21659,22340,8812,6849,59658,1656,1014,455,3125,62783
15-01-2015,11,21346,21789,8719,6840,58694,1660,926,473,3059,61753
15-01-2015,12,21139,21535,8697,6762,58132,1683,934,481,3098,61230
15-01-2015,13,21128,21761,8743,6797,58429,1658,981,401,3040,61469
15-01-2015,14,20864,21966,8942,6561,58333,1663,1042,379,3084,61417
15-01-2015,15,21236,22308,9233,6391,59170,1682,1161,426,3269,62439
15-01-2015,16,22018,22721,9281,6305,60324,1706,1139,456,3301,63625
15-01-2015,17,22228,23012,9091,6204,60537,1725,1113,460,3298,63835
15-01-2015,18,21659,22518,8900,6131,59208,1711,1000,465,3176,62384
15-01-2015,19,21016,21511,8371,5975,56873,1700,778,400,2878,59751
15-01-2015,20,20057,19705,7954,5988,53706,1641,619,410,2670,56376
15-01-2015,21,19358,18813,7830,5659,51660,1659,468,414,2541,54201
15-01-2015,22,18478,17816,7741,5572,49608,1587,275,363,2225,51833
15-01-2015,23,16864,17084,7477,5377,46802,1363,270,364,1997,48799
16-01-2015,0,15534,16443,7337,5421,44735,1333,267,361,1961,46696
16-01-2015,1,14810,16186,7276,5446,43718,1302,269,394,1965,45683
16-01-2015,2,14507,16085,7275,5466,43332,1322,269,375,1966,45298
16-01-2015,3,14044,16213,7283,5512,43052,1331,272,378,1981,45033
16-01-2015,4,14519,16348,7447,5685,43999,1361,273,339,1973,45972
16-01-2015,5,15685,17479,7972,5852,46988,1678,379,341,2398,49386
16-01-2015,6,18316,18980,8926,6152,52376,1695,745,424,2864,55240
16-01-2015,7,20650,21344,9348,6693,58035,1690,1012,488,3190,61225
16-01-2015,8,20677,22074,9286,7161,59199,1697,1053,512,3262,62461
16-01-2015,9,20708,21623,9162,6888,58381,1700,1072,550,3322,61703
16-01-2015,10,20676,21866,9173,6893,58609,1705,1054,491,3250,61859
16-01-2015,11,20445,21883,9096,6812,58236,1712,1008,541,3261,61497
16-01-2015,12,19758,22263,9043,6663,57729,1711,1029,483,3223,60952
16-01-2015,13,19746,21881,8845,6607,57080,1702,942,485,3129,60209
16-01-2015,14,19991,21735,8889,6358,56973,1701,928,482,3111,60084
16-01-2015,15,20679,21941,9070,5879,57570,1710,1030,499,3239,60809
16-01-2015,16,21821,22212,9124,5426,58583,1720,1116,523,3359,61942
16-01-2015,17,22486,22459,9059,5422,59425,1719,1195,384,3298,62723
16-01-2015,18,22886,22286,8860,5088,59120,1726,1078,374,3178,62298
16-01-2015,19,21608,21738,8363,4896,56605,1695,782,334,2811,59416
16-01-2015,20,20494,20818,7930,4707,53950,1698,685,312,2695,56645
16-01-2015,21,20146,19482,7814,4506,51947,1693,560,297,2550,54497
16-01-2015,22,19572,18437,7564,4404,49977,1690,254,213,2157,52134
16-01-2015,23,18499,17345,7303,4283,47430,1635,206,211,2052,49482
17-01-2015,0,18265,16188,7128,4287,45869,1241,196,192,1629,47498
17-01-2015,1,17734,15742,7035,4261,44773,1150,194,197,1541,46314
17-01-2015,2,17492,15598,6953,4178,44222,1096,191,214,1501,45723
17-01-2015,3,17542,15486,6987,4002,44016,1118,198,191,1507,45523
17-01-2015,4,17208,15489,6963,4155,43816,1109,202,185,1496,45312
17-01-2015,5,17371,15664,7062,4099,44197,1133,316,202,1651,45848
17-01-2015,6,17652,16068,7241,4429,45390,1132,323,244,1699,47089
17-01-2015,7,19163,16656,7421,4495,47737,1148,471,190,1809,49546
17-01-2015,8,20128,17479,7392,4830,49828,1181,520,298,1999,51827
17-01-2015,9,21168,18293,7713,4956,52130,1184,647,227,2058,54188
17-01-2015,10,21370,19024,7830,4952,53176,1171,670,244,2085,55261
17-01-2015,11,21041,19005,7632,5295,52975,1153,583,320,2056,55031
17-01-2015,12,20010,19172,7554,5474,52210,1166,608,320,2094,54304
17-01-2015,13,19642,19160,7478,5386,51666,1117,713,184,2014,53680
17-01-2015,14,19560,19350,7556,5296,51762,1125,718,193,2036,53798
17-01-2015,15,20155,19591,7829,5060,52635,1167,756,227,2150,54785
17-01-2015,16,21318,20492,8045,4851,54706,1192,793,266,2251,56957
17-01-2015,17,21978,21053,8166,4765,55962,1199,770,280,2249,58211
17-01-2015,18,21707,20730,8004,4758,55200,1199,747,320,2266,57466
17-01-2015,19,20987,19972,7822,4816,53598,1204,726,293,2223,55821
17-01-2015,20,19456,18888,7715,4907,50968,1152,613,327,2092,53060
17-01-2015,21,18608,18022,7544,4831,49004,1152,328,341,1821,50825
17-01-2015,22,18175,17304,7418,4744,47639,1141,214,288,1643,49282
17-01-2015,23,16924,16438,7210,4472,45043,1117,212,270,1599,46642
18-01-2015,0,15357,16041,7043,4078,42520,1046,217,266,1529,44049
18-01-2015,1,15037,15951,6971,3847,41806,974,217,257,1448,43254
18-01-2015,2,14615,15842,6881,3945,41281,960,215,268,1443,42724
18-01-2015,3,14756,15681,6930,3748,41114,980,219,263,1462,42576
18-01-2015,4,14433,15564,6920,3533,40451,998,220,254,1472,41923
18-01-2015,5,14769,15650,6962,3432,40814,988,272,241,1501,42315
18-01-2015,6,15627,15927,7019,3605,42179,1049,274,254,1577,43756
18-01-2015,7,16782,16342,7153,3780,44059,1039,485,239,1763,45822
18-01-2015,8,17621,17077,7411,3930,46041,1018,488,224,1730,47771
18-01-2015,9,18718,17662,7649,3875,47906,1037,646,218,1901,49807
18-01-2015,10,20002,18346,7700,3848,49897,1067,647,286,2000,51897
18-01-2015,11,20826,19155,7732,3944,51658,1051,498,232,1781,53439
18-01-2015,12,20291,19645,7596,3871,51402,1030,495,203,1728,53130
18-01-2015,13,19845,19653,7577,3663,50738,998,491,193,1682,52420
18-01-2015,14,20559,19891,7762,3454,51666,1028,473,190,1691,53357
18-01-2015,15,22107,20468,7868,3370,53812,1034,589,219,1842,55654
18-01-2015,16,23128,21044,8132,3424,55728,1032,672,216,1920,57648
18-01-2015,17,24030,21504,8434,3523,57491,1047,693,216,1956,59447
18-01-2015,18,23801,21922,8434,3475,57633,1037,679,221,1937,59570
18-01-2015,19,23132,21719,8273,3491,56615,1045,648,224,1917,58532
18-01-2015,20,22601,20976,8207,3355,55139,1063,577,203,1843,56982
18-01-2015,21,22676,19734,8050,3026,53486,1036,306,218,1560,55046
18-01-2015,22,22287,18690,7916,2953,51846,964,194,183,1341,53187
18-01-2015,23,20999,17527,7608,2895,49030,877,192,182,1251,50281
19-01-2015,0,19636,16862,7523,2636,46657,1032,191,177,1400,48057
19-01-2015,1,18997,16737,7466,2784,45983,1111,190,176,1477,47460
19-01-2015,2,18801,16663,7489,2889,45842,1124,276,179,1579,47421
19-01-2015,3,18922,16667,7653,2775,46017,1094,370,179,1643,47660
19-01-2015,4,19893,16915,7934,2754,47496,1131,453,176,1760,49256
19-01-2015,5,21217,18491,8693,2819,51220,1279,466,203,1948,53168
19-01-2015,6,23774,21249,9341,3053,57416,1312,934,230,2476,59892
19-01-2015,7,25987,23659,9832,3967,63445,1305,1227,434,2966,66411
19-01-2015,8,25646,23950,10071,4589,64258,1299,1291,442,3032,67290
19-01-2015,9,25713,23864,9795,4440,63813,1306,1118,456,2880,66693
19-01-2015,10,26026,24080,9702,4361,64169,1304,1063,438,2805,66974
19-01-2015,11,25765,24028,9558,4745,64095,1301,1134,326,2761,66856
19-01-2015,12,25669,24018,9473,4559,63718,1300,1154,348,2802,66520
19-01-2015,13,25794,23957,9550,4409,63711,1301,1075,343,2719,66430
19-01-2015,14,25688,23919,9485,4848,63939,1296,1313,329,2938,66877
19-01-2015,15,25858,24019,9757,4469,64102,1293,1329,366,2988,67090
19-01-2015,16,25814,24499,10151,4225,64689,1297,1328,424,3049,67738
19-01-2015,17,25999,24431,10324,4455,65210,1295,1242,378,2915,68125
19-01-2015,18,25534,24401,10165,4343,64443,1305,1169,353,2827,67270
19-01-2015,19,25175,23940,9725,3971,62813,1297,849,199,2345,65158
19-01-2015,20,24173,23013,9205,3801,60192,1284,720,175,2179,62371
19-01-2015,21,23692,21984,9046,3579,58301,1277,420,226,1923,60224
19-01-2015,22,22727,20913,8897,3460,56000,1278,224,177,1679,57679
19-01-2015,23,21483,19701,8603,3365,53152,1209,187,171,1567,54719
20-01-2015,0,21193,17959,8333,3336,50821,1167,187,175,1529,52350
20-01-2015,1,20558,17631,8271,3180,49640,1161,187,179,1527,51167
20-01-2015,2,20367,17535,8264,3055,49221,1134,212,182,1528,50749
20-01-2015,3,20276,17577,8273,2992,49118,1093,219,182,1494,50612
20-01-2015,4,21025,17781,8566,2930,50301,1161,223,189,1573,51874
20-01-2015,5,21800,19340,9555,3133,53828,1198,270,320,1788,55616
20-01-2015,6,23482,22337,10421,3705,59948,1284,592,467,2343,62291
20-01-2015,7,25401,24470,10716,4266,64853,1327,1093,479,2899,67752
20-01-2015,8,25777,24784,10570,4459,65592,1412,1019,480,2911,68503
20-01-2015,9,25594,24807,10566,4611,65579,1322,1013,470,2805,68384
20-01-2015,10,25780,24760,10420,4652,65614,1334,967,471,2772,68386
20-01-2015,11,25508,24914,10426,4791,65639,1341,903,500,2744,68383
20-01-2015,12,25248,24883,10527,4625,65282,1342,949,509,2800,68082
20-01-2015,13,25166,24833,10533,4512,65043,1344,916,517,2777,67820
20-01-2015,14,25153,24759,10540,4375,64828,1356,907,515,2778,67606
20-01-2015,15,25299,24857,10631,3947,64735,1357,960,595,2912,67647
20-01-2015,16,25378,24972,10917,4155,65423,1371,1359,702,3432,68855
20-01-2015,17,25157,24937,10931,4484,65509,1380,1498,736,3614,69123
20-01-2015,18,25027,24383,10806,4362,64578,1371,1364,594,3329,67907
20-01-2015,19,25190,23534,10179,3710,62613,1370,601,527,2498,65111
20-01-2015,20,24457,22662,9534,3403,60057,1369,467,516,2352,62409
20-01-2015,21,24141,22156,9190,3050,58536,1354,361,355,2070,60606
20-01-2015,22,23201,21016,8942,2825,55984,1355,215,258,1828,57812
20-01-2015,23,21629,19754,8690,2832,52904,1344,206,235,1785,54689
21-01-2015,0,20832,18550,8431,2883,50695,1325,204,232,1761,52456
21-01-2015,1,20404,18133,8406,2817,49760,1257,202,257,1716,51476
21-01-2015,2,20315,17913,8415,2797,49441,1275,202,255,1732,51173
21-01-2015,3,20661,17837,8415,2752,49664,1294,204,240,1738,51402
21-01-2015,4,21275,17929,8580,2831,50615,1385,218,242,1845,52460
21-01-2015,5,22420,18945,9450,3017,53834,1509,319,420,2248,56082
21-01-2015,6,23950,21791,10199,3522,59462,1558,652,476,2686,62148
21-01-2015,7,25337,24024,10783,3992,64135,1592,1232,469,3293,67428
21-01-2015,8,25447,24184,10921,4015,64568,1688,1281,616,3585,68153
21-01-2015,9,25638,23723,10901,3932,64194,1565,1285,639,3489,67683
21-01-2015,10,25671,23824,10902,3887,64284,1564,1189,556,3309,67593
21-01-2015,11,25538,23980,10832,3939,64289,1574,1079,419,3072,67361
21-01-2015,12,25158,23924,10735,3958,63776,1579,1104,420,3103,66879
21-01-2015,13,25177,23844,10757,3836,63613,1583,1019,426,3028,66641
21-01-2015,14,25144,23662,10836,3788,63430,1582,1059,412,3053,66483
21-01-2015,15,25235,23567,10919,3812,63533,1588,1146,639,3373,66906
21-01-2015,16,25450,23687,10941,3828,63906,1563,1221,788,3572,67478
21-01-2015,17,25548,23768,11068,3819,64204,1553,1345,879,3777,67981
21-01-2015,18,25201,23587,10996,3829,63612,1539,1196,647,3382,66994
21-01-2015,19,25377,23181,10401,3470,62428,1537,690,409,2636,65064
21-01-2015,20,25177,22451,9543,3314,60487,1467,582,404,2453,62940
21-01-2015,21,24883,21431,9284,3231,58829,1461,335,325,2121,60950
21-01-2015,22,24367,19953,9124,2999,56443,1453,189,165,1807,58250
21-01-2015,23,22841,18874,8807,2891,53415,1434,187,164,1785,55200
22-01-2015,0,21878,17647,8623,2655,50803,1343,185,220,1748,52551
22-01-2015,1,21637,17299,8595,2599,50130,1310,185,219,1714,51844
22-01-2015,2,21035,17244,8626,2482,49386,1290,186,207,1683,51069
22-01-2015,3,20619,17372,8657,2491,49140,1365,206,163,1734,50874
22-01-2015,4,21213,17547,8879,2409,50047,1379,299,164,1842,51889
22-01-2015,5,22564,18593,9864,2561,53582,1393,489,228,2110,55692
22-01-2015,6,24369,21481,10611,2840,59302,1390,939,229,2558,61860
22-01-2015,7,25812,23735,10992,3118,63658,1385,1138,424,2947,66605
22-01-2015,8,25890,23960,11120,3300,64271,1385,1216,632,3233,67504
22-01-2015,9,25697,23827,11106,3310,63942,1386,1176,533,3095,67037
22-01-2015,10,25660,23732,11132,3337,63861,1390,1191,430,3011,66872
22-01-2015,11,25739,23653,11117,3463,63971,1393,1190,420,3003,66974
22-01-2015,12,25538,23750,11051,3492,63832,1390,1199,383,2972,66804
22-01-2015,13,25234,23779,10887,3433,63333,1394,1049,387,2830,66163
22-01-2015,14,25080,23625,10788,3492,62984,1397,1046,419,2862,65846
22-01-2015,15,25513,23245,10632,3442,62831,1399,1170,418,2987,65818
22-01-2015,16,25781,23252,10766,3507,63306,1399,1184,557,3140,66446
22-01-2015,17,26100,23224,10841,3584,63748,1405,1444,663,3512,67260
22-01-2015,18,25794,23495,10917,3653,63860,1393,1108,628,3129,66989
22-01-2015,19,26190,23624,10564,3278,63657,1395,880,225,2500,66157
22-01-2015,20,25805,23036,10021,2909,61771,1386,731,229,2346,64117
22-01-2015,21,25954,21586,9793,3073,60406,1389,417,232,2038,62444
22-01-2015,22,25217,20040,9381,2962,57600,1393,187,175,1755,59355
22-01-2015,23,24097,18880,8904,2879,54759,1390,184,169,1743,56502
23-01-2015,0,22953,18227,8679,2721,52578,1307,191,169,1667,54245
23-01-2015,1,22127,17703,8749,2601,51179,1297,192,168,1657,52836
23-01-2015,2,21597,17313,8726,2610,50246,1340,193,165,1698,51944
23-01-2015,3,21400,17463,8733,2546,50142,1390,223,166,1779,51921
23-01-2015,4,22291,17690,8935,2650,51567,1408,302,172,1882,53449
23-01-2015,5,23651,19105,9616,2711,55084,1407,423,297,2127,57211
23-01-2015,6,25170,22257,10259,3126,60813,1409,827,383,2619,63432
23-01-2015,7,26454,23755,10767,3800,64777,1411,1138,618,3167,67944
23-01-2015,8,26139,24109,10810,3857,64915,1423,1247,685,3355,68270
23-01-2015,9,26275,23689,11120,3837,64922,1442,1553,687,3682,68604
23-01-2015,10,26634,23807,11164,4037,65644,1427,1219,684,3330,68974
23-01-2015,11,26487,23865,11070,4222,65644,1441,1223,546,3210,68854
23-01-2015,12,26348,23859,10905,4304,65418,1453,1218,441,3112,68530
23-01-2015,13,26141,23842,10918,3932,64834,1437,973,397,2807,67641
23-01-2015,14,26132,23952,10773,3750,64606,1440,958,389,2787,67393
23-01-2015,15,26230,23855,10690,3988,64762,1449,1088,355,2892,67654
23-01-2015,16,26402,23800,10798,4036,65038,1431,1107,387,2925,67963
23-01-2015,17,26335,24018,10834,4605,65793,1427,1227,455,3109,68902
23-01-2015,18,26030,24009,10619,4567,65225,1446,1023,373,2842,68067
23-01-2015,19,25131,23346,9817,4364,62659,1419,697,360,2476,65135
23-01-2015,20,24270,22433,9185,4545,60434,1408,603,333,2344,62778
23-01-2015,21,23211,21234,8945,4725,58116,1414,429,251,2094,60210
23-01-2015,22,21801,20257,8595,4915,55568,1420,198,170,1788,57356
23-01-2015,23,20328,19113,8275,5262,52979,1400,196,173,1769,54748
24-01-2015,0,18502,18044,8014,5432,49993,993,198,174,1365,51358
24-01-2015,1,17454,17394,7944,5512,48304,941,198,170,1309,49613
24-01-2015,2,16576,17338,7875,5588,47379,945,195,166,1306,48685
24-01-2015,3,16224,17251,7909,5550,46933,922,198,165,1285,48218
24-01-2015,4,16225,17411,7954,5605,47194,1000,198,166,1364,48558
24-01-2015,5,16507,17746,7945,5710,47908,981,198,176,1355,49263
24-01-2015,6,16874,18520,8008,5541,48944,997,200,217,1414,50358
24-01-2015,7,17627,19327,8259,5353,50565,1085,314,220,1619,52184
24-01-2015,8,18822,20513,8400,5491,53226,1140,482,182,1804,55030
24-01-2015,9,20532,21449,8448,5505,55934,1229,518,209,1956,57890
24-01-2015,10,21666,22010,8466,5079,57222,1248,516,228,1992,59214
24-01-2015,11,21959,22030,8462,4730,57180,1268,500,232,2000,59180
24-01-2015,12,21696,22068,8408,4644,56816,1275,500,235,2010,58826
24-01-2015,13,21428,21909,8461,4512,56309,1290,483,244,2017,58326
24-01-2015,14,21344,21749,8444,4347,55885,1288,483,253,2024,57909
24-01-2015,15,21682,22007,8758,4165,56613,1297,502,252,2051,58664
24-01-2015,16,22657,22517,8969,3998,58139,1287,609,262,2158,60297
24-01-2015,17,23639,22706,9023,4133,59503,1285,635,272,2192,61695
24-01-2015,18,23154,22736,8841,4140,58871,1297,574,259,2130,61001
24-01-2015,19,22157,22101,8623,4068,56949,1289,537,257,2083,59032
24-01-2015,20,20862,20832,8401,4202,54298,1294,443,241,1978,56276
24-01-2015,21,19524,19844,8128,4041,51538,1272,220,234,1726,53264
24-01-2015,22,19019,18725,8026,4050,49820,1219,194,171,1584,51404
24-01-2015,23,17996,17515,7927,4013,47451,1157,208,166,1531,48982
25-01-2015,0,16967,16553,7711,3547,44780,1113,191,194,1498,46278
25-01-2015,1,16238,16221,7635,3548,43643,1105,190,178,1473,45116
25-01-2015,2,15792,16058,7589,3592,43031,1081,189,168,1438,44469
25-01-2015,3,15473,16092,7545,3615,42726,1020,194,169,1383,44109
25-01-2015,4,15483,16068,7528,3599,42680,1062,195,168,1425,44105
25-01-2015,5,15967,16334,7540,3572,43413,1103,229,219,1551,44964
25-01-2015,6,16576,16525,7699,3637,44439,1118,264,220,1602,46041
25-01-2015,7,17564,17268,7817,3593,46242,1133,339,221,1693,47935
25-01-2015,8,18682,18070,7860,3523,48135,1109,444,220,1773,49908
25-01-2015,9,20089,18903,7929,3671,50591,1135,521,220,1876,52467
25-01-2015,10,21522,19889,7999,3542,52951,1114,550,220,1884,54835
25-01-2015,11,22330,20470,8108,3469,54378,1102,550,221,1873,56251
25-01-2015,12,22201,20785,8122,3258,54366,1100,529,221,1850,56216
25-01-2015,13,21562,20628,8068,3166,53425,1096,527,221,1844,55269
25-01-2015,14,21073,20501,8075,3124,52772,1087,511,220,1818,54590
25-01-2015,15,21843,20720,8196,3014,53773,1091,530,221,1842,55615
25-01-2015,16,23502,21252,8496,3056,56305,1097,698,224,2019,58324
25-01-2015,17,24366,22085,8693,3306,58449,1110,750,226,2086,60535
25-01-2015,18,23997,21977,8703,3262,57940,1109,722,226,2057,59997
25-01-2015,19,23281,21749,8470,3321,56822,1112,683,224,2019,58841
25-01-2015,20,22517,21202,8275,3296,55289,1106,586,227,1919,57208
25-01-2015,21,21417,20431,8050,3371,53269,1084,376,225,1685,54954
25-01-2015,22,20208,19791,7809,3399,51209,1060,193,174,1427,52636
25-01-2015,23,18073,18703,7690,3629,48096,1036,204,171,1411,49507
26-01-2015,0,16081,17934,7680,3621,45318,1037,187,171,1395,46713
26-01-2015,1,15236,17822,7632,3652,44342,904,185,169,1258,45600
26-01-2015,2,14759,17667,7635,3885,43945,890,187,169,1246,45191
26-01-2015,3,14449,17913,7646,4133,44141,884,214,169,1267,45408
26-01-2015,4,14806,17910,7762,4350,44828,910,323,172,1405,46233
26-01-2015,5,16562,19601,8440,4840,49445,1286,397,371,2054,51499
26-01-2015,6,19401,21523,9344,5159,55426,1370,904,389,2663,58089
26-01-2015,7,22336,22956,9606,5451,60348,1383,1073,542,2998,63346
26-01-2015,8,22787,23031,9589,5527,60935,1386,1137,559,3082,64017
26-01-2015,9,22759,22782,9589,5560,60690,1393,1141,479,3013,63703
26-01-2015,10,23376,22618,9524,5527,61045,1399,1095,440,2934,63979
26-01-2015,11,23042,22766,9427,5394,60629,1388,1066,362,2816,63445
26-01-2015,12,22755,22895,9302,5359,60311,1409,1095,376,2880,63191
26-01-2015,13,22650,22933,9286,5170,60038,1410,1060,364,2834,62872
26-01-2015,14,22678,22957,9339,5019,59993,1415,1052,368,2835,62828
26-01-2015,15,22822,23051,9579,4961,60413,1437,1098,367,2902,63315
26-01-2015,16,23485,23221,9642,4947,61294,1444,1149,447,3040,64334
26-01-2015,17,23670,23529,9753,5139,62090,1458,1089,403,2950,65040
26-01-2015,18,23236,23290,9519,5142,61187,1455,1027,375,2857,64044
26-01-2015,19,22985,22698,8917,4947,59547,1430,691,381,2502,62049
26-01-2015,20,21416,21789,8348,4970,56523,1354,564,389,2307,58830
26-01-2015,21,20365,20518,8066,4851,53800,1360,324,387,2071,55871
26-01-2015,22,18243,19533,7881,5053,50711,1289,194,223,1706,52417
26-01-2015,23,16116,18012,7765,5082,46977,1281,194,237,1712,48689
27-01-2015,0,15189,17035,7860,4698,44782,1176,196,238,1610,46392
27-01-2015,1,14557,16784,7756,4611,43708,1099,196,249,1544,45252
27-01-2015,2,14070,16809,7619,4752,43252,1080,197,253,1530,44782
27-01-2015,3,14342,16823,7600,4685,43450,1076,198,266,1540,44990
27-01-2015,4,15127,17204,7689,4619,44638,1146,286,276,1708,46346
27-01-2015,5,16426,18613,8158,4796,47993,1411,212,289,1912,49905
27-01-2015,6,19479,20865,9001,5309,54655,1402,253,288,1943,56598
27-01-2015,7,22100,22965,9640,5356,60063,1398,1045,749,3192,63255
27-01-2015,8,22956,23352,9687,5237,61233,1397,1083,742,3222,64455
27-01-2015,9,22916,23177,9534,5171,60798,1397,1057,729,3183,63981
27-01-2015,10,23138,23064,9414,4888,60504,1403,1115,680,3198,63702
27-01-2015,11,22819,22961,9356,4822,59958,1426,1093,703,3222,63180
27-01-2015,12,22461,22631,9343,4706,59142,1512,1062,617,3191,62333
27-01-2015,13,22409,22401,9405,4643,58859,1505,1035,553,3093,61952
27-01-2015,14,22462,22283,9536,4337,58618,1509,968,521,2998,61616
27-01-2015,15,22808,22452,9630,4042,58932,1500,1063,696,3259,62191
27-01-2015,16,24037,22672,9674,3764,60147,1518,1281,685,3484,63631
27-01-2015,17,24239,23190,9616,4127,61171,1531,1214,683,3428,64599
27-01-2015,18,24200,23536,9316,4151,61202,1532,1020,376,2928,64130
27-01-2015,19,23496,23258,8621,3915,59289,1530,654,392,2576,61865
27-01-2015,20,22052,22439,8392,3804,56689,1522,511,393,2426,59115
27-01-2015,21,21287,21503,8205,3684,54679,1537,287,393,2217,56896
27-01-2015,22,19913,20759,8046,3763,52482,1491,197,167,1855,54337
27-01-2015,23,17749,19359,7954,3796,48856,1273,191,168,1632,50488
28-01-2015,0,16318,18100,8020,3988,46426,1170,190,165,1525,47951
28-01-2015,1,15516,17515,7960,4015,45008,1171,188,166,1525,46533
28-01-2015,2,14897,17256,7952,4109,44214,1141,188,166,1495,45709
28-01-2015,3,14056,17322,7882,4312,43571,1118,195,166,1479,45050
28-01-2015,4,14441,17438,8032,4703,44614,1149,266,170,1585,46199
28-01-2015,5,15629,18598,8398,5087,47714,1398,442,342,2182,49896
28-01-2015,6,18521,21186,9146,5316,54170,1413,814,383,2610,56780
28-01-2015,7,21146,22957,9547,5450,59100,1425,1046,419,2890,61990
28-01-2015,8,21259,23098,9400,5699,59456,1446,1114,428,2988,62444
28-01-2015,9,20901,22538,9295,5871,58604,1484,1092,427,3003,61607
28-01-2015,10,20593,22552,9138,6021,58304,1506,1079,421,3006,61310
28-01-2015,11,20150,22227,9117,6359,57854,1519,1005,411,2935,60789
28-01-2015,12,19388,22268,9022,6690,57369,1520,1017,422,2959,60328
28-01-2015,13,19052,22443,8927,6718,57140,1539,952,424,2915,60055
28-01-2015,14,18851,22251,8915,6752,56769,1526,917,428,2871,59640
28-01-2015,15,18723,22297,9163,6883,57066,1562,948,426,2936,60002
28-01-2015,16,19544,22742,9389,6893,58570,1579,1020,447,3046,61616
28-01-2015,17,20262,23710,9337,6578,59886,1584,999,453,3036,62922
28-01-2015,18,19992,23311,9308,6212,58824,1588,908,463,2959,61783
28-01-2015,19,18784,22628,8690,6235,56338,1533,497,461,2491,58829
28-01-2015,20,17744,21890,8351,6081,54067,1386,384,448,2218,56285
28-01-2015,21,17406,20611,8501,5700,52217,1352,301,320,1973,54190
28-01-2015,22,15951,20038,8101,5469,49558,1241,248,310,1799,51357
28-01-2015,23,13955,19140,7974,5225,46296,1191,244,334,1769,48065
29-01-2015,0,13149,18481,7889,4856,44377,1123,246,331,1700,46077
29-01-2015,1,12481,18349,7808,4940,43579,1108,245,340,1693,45272
29-01-2015,2,12138,18230,7783,5130,43280,1108,251,351,1710,44990
29-01-2015,3,12094,18124,7790,5291,43298,1106,254,354,1714,45012
29-01-2015,4,12623,18364,7841,5175,44004,1232,258,358,1848,45852
29-01-2015,5,13856,19351,8251,5247,46706,1525,259,367,2151,48857
29-01-2015,6,17090,21746,8833,5663,53330,1607,286,367,2260,55590
29-01-2015,7,20956,23454,9406,5655,59471,1664,775,531,2970,62441
29-01-2015,8,21843,23676,9391,5244,60154,1680,843,561,3084,63238
29-01-2015,9,21369,23628,9340,5262,59600,1656,931,533,3120,62720
29-01-2015,10,21220,23792,9290,5308,59611,1647,915,533,3095,62706
29-01-2015,11,20717,23952,9198,5331,59198,1684,869,522,3075,62273
29-01-2015,12,20545,23339,9041,5312,58238,1661,889,522,3072,61310
29-01-2015,13,20227,23674,8993,5362,58256,1637,843,508,2988,61244
29-01-2015,14,20972,23419,9032,5034,58458,1643,857,492,2992,61450
29-01-2015,15,21238,23247,9375,4820,58679,1641,932,470,3043,61722
29-01-2015,16,22335,23377,9545,4816,60072,1624,998,463,3085,63157
29-01-2015,17,23108,24344,9510,4705,61668,1632,992,434,3058,64726
29-01-2015,18,22806,24342,9447,4556,61151,1618,892,469,2979,64130
29-01-2015,19,22170,23827,8837,4589,59421,1580,471,476,2527,61948
29-01-2015,20,20847,22961,8512,4303,56623,1507,396,463,2366,58989
29-01-2015,21,19969,22081,8465,4196,54712,1439,321,293,2053,56765
29-01-2015,22,18688,21035,8439,4061,52223,1410,247,282,1939,54162
29-01-2015,23,16554,19285,8224,3881,47944,1323,245,281,1849,49793
30-01-2015,0,15943,17803,8020,3697,45462,1328,245,277,1850,47312
30-01-2015,1,15584,17435,7972,3267,44258,1233,244,276,1753,46011
30-01-2015,2,15788,17259,8000,3222,44268,1317,244,298,1859,46127
30-01-2015,3,15652,17018,7984,2967,43620,1330,248,310,1888,45508
30-01-2015,4,15945,17682,8013,2997,44638,1363,253,316,1932,46570
30-01-2015,5,17845,19360,8388,3130,48723,1521,250,320,2091,50814
30-01-2015,6,21585,22138,9032,3388,56143,1566,262,308,2136,58279
30-01-2015,7,24337,23103,9686,3991,61118,1562,914,482,2958,64076
30-01-2015,8,25179,23107,9586,4134,62005,1555,948,520,3023,65028
30-01-2015,9,25224,22915,9444,3961,61546,1560,960,501,3021,64567
30-01-2015,10,25095,23069,9471,3793,61426,1548,932,505,2985,64411
30-01-2015,11,25093,23155,9353,3754,61355,1548,865,502,2915,64270
30-01-2015,12,24609,23222,9264,3730,60825,1557,867,510,2934,63759
30-01-2015,13,23668,23372,9118,3768,59925,1545,792,500,2837,62762
30-01-2015,14,23714,23301,9153,3613,59780,1503,742,516,2761,62541
30-01-2015,15,23429,23094,9496,3542,59561,1502,794,522,2818,62379
30-01-2015,16,24200,23280,9802,3478,60761,1509,897,527,2933,63694
30-01-2015,17,24745,23696,9688,3702,61831,1523,933,514,2970,64801
30-01-2015,18,24154,23566,9611,3841,61172,1522,818,490,2830,64002
30-01-2015,19,22880,23343,9027,3695,58945,1500,495,493,2488,61433
30-01-2015,20,21179,22761,8627,3502,56067,1529,390,473,2392,58459
30-01-2015,21,20468,22240,8398,3262,54366,1522,271,381,2174,56540
30-01-2015,22,19466,21214,8219,3295,52195,1515,263,316,2094,54289
30-01-2015,23,17831,19603,8197,3405,49037,1370,258,356,1984,51021
31-01-2015,0,16929,18036,8098,3242,46305,1295,262,313,1870,48175
31-01-2015,1,16108,17123,8068,3154,44452,1252,269,310,1831,46283
31-01-2015,2,15777,16847,8052,3124,43801,1257,267,294,1818,45619
31-01-2015,3,15389,16802,8059,3075,43326,1267,267,277,1811,45137
31-01-2015,4,15417,16749,8049,3173,43387,1250,265,254,1769,45156
31-01-2015,5,15799,17083,8086,3202,44171,1250,260,252,1762,45933
31-01-2015,6,16168,18145,8209,3266,45790,1253,262,238,1753,47543
31-01-2015,7,16916,19671,8426,3290,48305,1312,304,257,1873,50178
31-01-2015,8,18565,21259,8534,3386,51743,1302,419,241,1962,53705
31-01-2015,9,20202,22095,8523,3367,54187,1343,532,222,2097,56284
31-01-2015,10,20956,22388,8557,3317,55219,1350,546,213,2109,57328
31-01-2015,11,20636,22629,8706,3341,55312,1347,554,207,2108,57420
31-01-2015,12,19934,22622,8767,3609,54933,1346,535,203,2084,57017
31-01-2015,13,19283,22725,8700,3810,54518,1341,521,200,2062,56580
31-01-2015,14,19142,22777,8696,3759,54376,1348,506,201,2055,56431
31-01-2015,15,19878,22782,8817,3549,55026,1355,533,207,2095,57121
31-01-2015,16,21404,23132,8846,3667,57047,1348,621,223,2192,59239
31-01-2015,17,22294,23432,8866,3979,58573,1325,611,261,2197,60770
31-01-2015,18,21634,23484,8797,4048,57964,1311,577,267,2155,60119
31-01-2015,19,20001,23203,8684,3970,55857,1298,515,265,2078,57935
31-01-2015,20,18663,22658,8577,3890,53790,1290,452,264,2006,55796
31-01-2015,21,17848,21924,8462,3889,52125,1269,346,241,1856,53981
31-01-2015,22,17155,20980,8293,3900,50329,1249,270,227,1746,52075
31-01-2015,23,15269,19572,8185,4004,47031,1251,232,232,1715,48746
01-02-2015,0,15416,18353,8147,3967,45883,1221,194,242,1657,47540
01-02-2015,1,14522,18172,8147,3591,44432,1202,193,265,1660,46092
01-02-2015,2,13854,18102,8105,3670,43729,949,195,262,1406,45135
01-02-2015,3,13457,17948,8072,3631,43110,901,201,290,1392,44502
01-02-2015,4,13519,17837,8028,3682,43065,908,202,301,1411,44476
01-02-2015,5,13606,17698,8010,3625,42939,955,213,308,1476,44415
01-02-2015,6,14011,17790,8062,3810,43673,1184,260,305,1749,45422
01-02-2015,7,14958,18253,8164,4102,45477,1316,258,324,1898,47375
01-02-2015,8,16535,19219,8357,4125,48236,1314,349,328,1991,50227
01-02-2015,9,18213,20468,8425,4108,51215,1339,398,341,2078,53293
01-02-2015,10,19038,21138,8492,4141,52808,1399,389,377,2165,54973
01-02-2015,11,19052,21200,8472,4101,52826,1461,401,397,2259,55085
01-02-2015,12,18630,21354,8418,4212,52615,1492,409,373,2274,54889
01-02-2015,13,18003,21453,8438,4112,52007,1466,440,380,2286,54293
01-02-2015,14,18010,21494,8444,4139,52087,1462,454,374,2290,54377
01-02-2015,15,18812,21357,8481,4146,52796,1477,474,345,2296,55092
01-02-2015,16,20516,21934,8575,4088,55112,1494,488,359,2341,57453
01-02-2015,17,21585,22239,8702,4440,56967,1477,534,346,2357,59324
01-02-2015,18,21653,22217,8801,4389,57061,1481,509,376,2366,59427
01-02-2015,19,21396,22024,8770,4387,56576,1479,483,370,2332,58908
01-02-2015,20,19763,21619,8612,4402,54395,1484,419,415,2318,56713
01-02-2015,21,18790,21537,8414,4268,53009,1482,360,426,2268,55277
01-02-2015,22,17950,20763,8352,4231,51295,1481,267,360,2108,53403
01-02-2015,23,16239,19528,8176,4183,48127,1459,258,324,2041,50168
02-02-2015,0,15732,18080,8067,3855,45735,1598,216,300,2114,47849
02-02-2015,1,14836,17620,8048,3467,43970,1555,212,288,2055,46025
02-02-2015,2,14325,17575,8066,3481,43447,1508,211,284,2003,45450
02-02-2015,3,14396,17546,8083,3650,43676,1547,300,278,2125,45801
02-02-2015,4,15195,17652,8190,3633,44670,1519,304,272,2095,46765
02-02-2015,5,17584,19551,8467,3941,49545,1608,418,299,2325,51870
02-02-2015,6,22268,22111,9174,4038,57592,1629,550,563,2742,60334
02-02-2015,7,24588,23408,9767,4669,62432,1637,824,544,3005,65437
02-02-2015,8,24609,23887,10047,4872,63414,1615,1069,527,3211,66625
02-02-2015,9,24658,23704,10077,4844,63284,1615,984,543,3142,66426
02-02-2015,10,24963,23576,9926,4727,63194,1624,836,537,2997,66191
02-02-2015,11,24934,23599,9630,4666,62829,1624,487,518,2629,65458
02-02-2015,12,24817,23583,9400,4451,62252,1595,446,516,2557,64809
02-02-2015,13,24649,23642,9457,4647,62396,1584,494,530,2608,65004
02-02-2015,14,24556,23671,9489,4667,62383,1587,816,512,2915,65298
02-02-2015,15,24736,23658,9718,4629,62741,1594,795,519,2908,65649
02-02-2015,16,24722,23538,10040,4639,62939,1580,1062,544,3186,66125
02-02-2015,17,25169,23733,10154,4857,63912,1578,1426,619,3623,67535
02-02-2015,18,25056,23728,10092,5014,63890,1571,1155,583,3309,67199
02-02-2015,19,24615,23520,9585,4714,62434,1560,531,535,2626,65060
02-02-2015,20,23632,22958,9161,4308,60060,1538,384,516,2438,62498
02-02-2015,21,23110,22344,8925,3828,58208,1536,398,316,2250,60458
02-02-2015,22,21909,21375,8568,3679,55530,1534,396,248,2178,57708
02-02-2015,23,20742,19875,8368,3535,52519,1463,197,250,1910,54429
03-02-2015,0,20698,18097,8347,3151,50293,1383,195,271,1849,52142
03-02-2015,1,19441,17699,8315,3102,48557,1384,197,263,1844,50401
03-02-2015,2,18717,17658,8361,3231,47966,1373,201,259,1833,49799
03-02-2015,3,18795,17625,8375,3169,47965,1439,204,252,1895,49860
03-02-2015,4,19405,17756,8495,3135,48791,1454,212,233,1899,50690
03-02-2015,5,21757,19294,8865,3480,53397,1471,354,282,2107,55504
03-02-2015,6,24464,22068,9547,3676,59754,1548,885,288,2721,62475
03-02-2015,7,25137,23586,10528,4529,63780,1562,1096,483,3141,66921
03-02-2015,8,25135,23710,10822,4851,64519,1539,1111,678,3328,67847
03-02-2015,9,25239,23317,10888,4911,64356,1543,1120,640,3303,67659
03-02-2015,10,25491,23300,10703,5033,64528,1536,1082,566,3184,67712
03-02-2015,11,25355,23298,10311,5111,64076,1523,680,249,2452,66528
03-02-2015,12,24848,23281,10106,5269,63505,1514,733,234,2481,65986
03-02-2015,13,24697,23306,10135,5060,63199,1514,723,239,2476,65675
03-02-2015,14,24650,23050,10191,5030,62920,1510,873,402,2785,65705
03-02-2015,15,25398,22946,10370,4616,63332,1515,853,403,2771,66103
03-02-2015,16,25182,23395,10735,4603,63915,1503,922,487,2912,66827
03-02-2015,17,25307,23450,10830,4849,64436,1433,1410,694,3537,67973
03-02-2015,18,25321,23477,10823,4753,64375,1438,1105,642,3185,67560
03-02-2015,19,25102,23439,10582,4401,63524,1421,812,265,2498,66022
03-02-2015,20,24665,22743,9918,3738,61065,1400,673,252,2325,63390
03-02-2015,21,24364,21830,9746,3521,59462,1401,405,257,2063,61525
03-02-2015,22,23461,20608,9367,3402,56837,1387,203,208,1798,58635
03-02-2015,23,22378,19547,8914,3238,54077,1403,197,197,1797,55874
04-02-2015,0,21739,18120,8817,3163,51839,1297,196,199,1692,53531
04-02-2015,1,21266,17588,8733,3112,50699,1204,196,205,1605,52304
04-02-2015,2,20846,17464,8766,3023,50099,1366,196,209,1771,51870
04-02-2015,3,21030,,8808,3086,50401,1357,200,254,1811,52212
04-02-2015,4,21842,17682,8938,3411,51873,1427,218,200,1845,53718
04-02-2015,5,22566,,9283,3646,54471,1447,369,230,2046,56517
04-02-2015,6,24723,21438,10080,4161,60400,1470,722,406,2598,62998
04-02-2015,7,25484,22991,10905,4679,64059,1459,1115,569,3143,67202
04-02-2015,8,25440,23010,11004,4665,64120,1459,1222,852,3533,67653
04-02-2015,9,25704,22751,10903,4434,63792,1455,1106,743,3304,67096
04-02-2015,10,25644,23067,11148,4676,64537,1465,1079,527,3071,67608
04-02-2015,11,25264,22796,10926,5050,64034,1445,1055,355,2855,66889
04-02-2015,12,25179,22235,10748,4858,63020,1449,1036,349,2834,65854
04-02-2015,13,25308,,10881,4865,63197,1452,1062,359,2873,66070
04-02-2015,14,25328,22021,10888,4736,62973,1444,1074,385,2903,65876
04-02-2015,15,25432,22102,10825,4679,63038,1452,1099,364,2915,65953
04-02-2015,16,25693,22296,10927,4665,63581,1455,1119,438,3012,66593
04-02-2015,17,25743,22305,11049,4812,63909,1455,1308,780,3543,67452
04-02-2015,18,25631,22392,11005,5021,64048,1458,1310,649,3417,67465
04-02-2015,19,25678,22252,10729,4585,63246,1466,1000,385,2851,66097
04-02-2015,20,25445,22041,10021,4271,61780,1472,594,339,2405,64185
04-02-2015,21,25388,21627,9352,4059,60427,1462,472,201,2135,62562
04-02-2015,22,24491,20638,9132,3568,57829,1460,192,169,1821,59650
04-02-2015,23,23441,18906,8810,3536,54693,1428,188,167,1783,56476
05-02-2015,0,22859,17661,8446,3198,52164,1283,187,207,1677,53841
05-02-2015,1,22245,17658,8321,3165,51389,1184,187,172,1543,52932
05-02-2015,2,21753,17707,8346,3159,50965,1229,188,169,1586,52551
05-02-2015,3,21542,17581,8323,3138,50585,1300,192,169,1661,52246
05-02-2015,4,22010,17868,8408,3247,51535,1339,198,168,1705,53240
05-02-2015,5,23070,19243,8733,3326,54373,1362,305,246,1913,56286
05-02-2015,6,24918,21539,9476,3635,59567,1428,736,380,2544,62111
05-02-2015,7,25822,23048,10176,4199,63245,1437,1120,579,3136,66381
05-02-2015,8,25729,23175,10275,4411,63590,1442,1363,860,3665,67255
05-02-2015,9,25893,22830,10182,3877,62782,1439,1139,871,3449,66231
05-02-2015,10,25895,23153,10282,3983,63312,1429,1098,834,3361,66673
05-02-2015,11,25562,23258,10347,3924,63090,1431,606,401,2438,65528
05-02-2015,12,25210,23303,10144,3859,62516,1443,635,401,2479,64995
05-02-2015,13,25153,,10188,3767,62456,1426,625,394,2445,64901
05-02-2015,14,25152,23404,9913,3537,62006,1413,830,388,2631,64637
05-02-2015,15,25287,23378,9741,3468,61875,1442,824,379,2645,64520
05-02-2015,16,25453,23439,10013,3484,62390,1442,940,370,2752,65142
05-02-2015,17,25509,23824,10425,3551,63309,1452,1223,826,3501,66810
05-02-2015,18,24913,23961,10438,3917,63230,1456,1119,701,3276,66506
05-02-2015,19,24791,,9909,3839,62007,1452,701,343,2496,64503
05-02-2015,20,24323,23216,9305,3330,60174,1453,589,339,2381,62555
05-02-2015,21,23972,22275,9066,2939,58252,1436,329,309,2074,60326
05-02-2015,22,22602,21663,8862,2724,55852,1456,195,168,1819,57671
05-02-2015,23,20247,20603,8708,2666,52223,1461,197,168,1826,54049
06-02-2015,0,19473,19371,8149,2652,49646,1490,198,168,1856,51502
06-02-2015,1,18267,18946,7973,2672,47859,1507,198,162,1867,49726
06-02-2015,2,17683,18837,7921,2829,47270,1536,199,203,1938,49208
06-02-2015,3,17516,18822,7903,2857,47099,1557,207,169,1933,49032
06-02-2015,4,18394,19254,7978,2925,48550,1562,229,167,1958,50508
06-02-2015,5,20142,20323,8129,3069,51664,1720,432,251,2403,54067
06-02-2015,6,23192,22398,8920,3620,58130,1770,883,326,2979,61109
06-02-2015,7,24696,24030,9327,4121,62175,1790,990,431,3211,65386
06-02-2015,8,24919,24119,9481,4340,62859,1804,1037,460,3301,66160
06-02-2015,9,25047,24004,9460,4180,62690,1810,1175,471,3456,66146
06-02-2015,10,24621,23741,9190,4169,61721,1787,1006,443,3236,64957
06-02-2015,11,24378,23469,8740,4051,60639,1738,652,342,2732,63371
06-02-2015,12,24001,23206,8474,3971,59652,1719,655,363,2737,62389
06-02-2015,13,23714,22735,8411,3903,58764,1695,604,377,2676,61440
06-02-2015,14,23503,22533,8403,3724,58163,1694,853,399,2946,61109
06-02-2015,15,23462,22469,8543,3601,58075,1682,929,343,2954,61029
06-02-2015,16,23827,22757,8881,3708,59172,1699,937,449,3085,62257
06-02-2015,17,24282,23148,9056,3998,60484,1723,983,455,3161,63645
06-02-2015,18,23878,23595,9127,4131,60732,1708,910,429,3047,63779
06-02-2015,19,22997,23307,8334,3922,58560,1640,695,326,2661,61221
06-02-2015,20,21823,22791,7927,3747,56288,1616,577,308,2501,58789
06-02-2015,21,21213,22093,7837,3473,54617,1603,343,279,2225,56842
06-02-2015,22,20175,21049,7638,3425,52285,1584,203,193,1980,54265
06-02-2015,23,19006,19833,7483,3529,49853,1617,212,190,2019,51872
07-02-2015,0,17716,18687,7429,3851,47683,1205,195,195,1595,49278
07-02-2015,1,16703,18397,7169,4051,46320,0,194,198,392,46712
07-02-2015,2,15836,18187,7089,4198,45310,0,195,203,398,45708
07-02-2015,3,15552,18120,7146,4239,45059,0,202,223,425,45484
07-02-2015,4,15199,18215,7222,4571,45207,0,208,224,432,45639
07-02-2015,5,14840,18582,7255,5120,45797,0,345,232,577,46374
07-02-2015,6,15214,19037,7478,5442,47171,0,237,273,510,47681
07-02-2015,7,16113,19770,7452,5828,49162,0,379,290,669,49831
07-02-2015,8,16793,20887,7509,5835,51024,0,416,346,762,51786
07-02-2015,9,17369,21466,7653,6007,52496,0,496,352,848,53344
07-02-2015,10,17748,21438,7522,6197,52905,1203,488,370,2061,54966
07-02-2015,11,17295,20875,7459,6434,52062,1174,466,371,2011,54073
07-02-2015,12,16447,21063,7474,6473,51457,1193,490,382,2065,53522
07-02-2015,13,16130,20434,7479,6245,50288,1094,426,376,1896,52184
07-02-2015,14,15849,20711,7374,6157,50091,1032,438,373,1843,51934
07-02-2015,15,16162,20818,7552,6149,50682,1078,491,369,1938,52620
07-02-2015,16,17158,21651,7909,6254,52973,1346,543,358,2247,55220
07-02-2015,17,18806,22459,8034,6669,55968,1369,740,351,2460,58428
07-02-2015,18,18841,23120,8019,6728,56708,1356,537,335,2228,58936
07-02-2015,19,17806,22835,7752,6654,55048,1430,507,283,2220,57268
07-02-2015,20,16498,22125,7590,6611,52826,1363,412,279,2054,54880
07-02-2015,21,16088,21066,7451,6215,50821,1417,234,288,1939,52760
07-02-2015,22,15448,20528,7413,6034,49424,1191,223,316,1730,51154
07-02-2015,23,14599,19913,7255,5638,47406,1186,222,325,1733,49139
08-02-2015,0,14404,19342,7275,4943,45963,1102,233,292,1627,47590
08-02-2015,1,14050,19043,7205,5077,45376,1077,219,290,1586,46962
08-02-2015,2,13865,18991,7120,4881,44858,1077,217,294,1588,46446
08-02-2015,3,13888,18851,7105,4771,44613,1072,225,286,1583,46196
08-02-2015,4,14074,18723,7183,4717,44696,1064,230,286,1580,46276
08-02-2015,5,14434,18811,7221,4570,45037,1084,236,321,1641,46678
08-02-2015,6,14805,19195,7386,4401,45788,1072,325,331,1728,47516
08-02-2015,7,15057,19714,7457,4308,46536,1068,409,327,1804,48340
08-02-2015,8,15327,20216,7624,4536,47702,1089,559,359,2007,49709
08-02-2015,9,15797,20532,7736,4878,48944,1207,614,368,2189,51133
08-02-2015,10,16590,20730,7814,4851,49984,1221,618,372,2211,52195
08-02-2015,11,16655,20894,7802,5295,50645,1213,546,364,2123,52768
08-02-2015,12,16332,20721,7797,5162,50013,1216,529,349,2094,52107
08-02-2015,13,16318,20412,7828,5323,49881,1205,532,317,2054,51935
08-02-2015,14,16428,20251,7815,5097,49590,1210,534,342,2086,51676
08-02-2015,15,16586,20048,7810,4768,49213,1225,582,337,2144,51357
08-02-2015,16,19037,20359,8130,4561,52087,1235,764,343,2342,54429
08-02-2015,17,21057,22360,8297,4761,56474,1263,784,397,2444,58918
08-02-2015,18,20853,22597,8398,5004,56851,1232,762,314,2308,59159
08-02-2015,19,20114,21331,8317,5433,55193,1215,712,371,2298,57491
08-02-2015,20,18631,19996,8105,5754,52487,1207,650,301,2158,54645
08-02-2015,21,17181,19695,8081,5827,50784,1171,357,308,1836,52620
08-02-2015,22,16111,18877,7857,5780,48626,1122,215,292,1629,50255
08-02-2015,23,14919,18087,7543,5467,46016,1069,196,264,1529,47545
09-02-2015,0,14211,17571,7343,5400,44526,972,187,194,1353,45879
09-02-2015,1,13751,17118,7328,5293,43490,940,185,224,1349,44839
09-02-2015,2,13654,16988,7314,5132,43090,912,184,206,1302,44392
09-02-2015,3,13751,17028,7400,5216,43396,953,203,181,1337,44733
09-02-2015,4,14289,17168,7790,5246,44493,1156,225,200,1581,46074
09-02-2015,5,14911,18188,8757,5311,47168,1410,599,392,2401,49569
09-02-2015,6,17415,19880,9268,5593,52156,1448,1117,630,3195,55351
09-02-2015,7,20015,22180,9333,5892,57421,1452,1164,671,3287,60708
09-02-2015,8,21491,22921,9395,5286,59093,1561,1233,580,3374,62467
09-02-2015,9,21502,22584,9562,5183,58833,1570,1235,426,3231,62064
09-02-2015,10,21735,22609,9506,5260,59110,1577,1160,392,3129,62239
09-02-2015,11,21387,22565,9097,5283,58331,1569,724,281,2574,60905
09-02-2015,12,20765,22212,9021,5157,57157,1566,640,414,2620,59777
09-02-2015,13,20624,21904,9309,5058,56895,1551,695,395,2641,59536
09-02-2015,14,20554,21709,9348,4845,56456,1557,886,428,2871,59327
09-02-2015,15,20455,21889,9328,4460,56132,1541,981,314,2836,58968
09-02-2015,16,20796,22144,9496,4261,56697,1559,1069,350,2978,59675
09-02-2015,17,22294,22304,9563,4157,58316,1592,1114,355,3061,61377
09-02-2015,18,21885,23033,9322,4430,58669,1625,1101,362,3088,61757
09-02-2015,19,21423,22265,8794,4325,56807,1623,677,385,2685,59492
09-02-2015,20,20228,21785,7978,4397,54387,1629,638,279,2546,56933
09-02-2015,21,19294,21008,7838,4260,52401,1603,472,222,2297,54698
09-02-2015,22,17892,19945,7752,4141,49731,1599,231,169,1999,51730
09-02-2015,23,16219,18841,7374,4242,46675,1576,223,167,1966,48641
10-02-2015,0,14307,17765,7268,4217,43558,1289,223,166,1678,45236
10-02-2015,1,13935,17322,7264,4110,42632,1184,224,167,1575,44207
10-02-2015,2,13926,17175,7208,3746,42055,1208,224,174,1606,43661
10-02-2015,3,14586,17356,7221,3890,43053,1207,250,175,1632,44685
10-02-2015,4,14876,17676,7373,3954,43879,1224,259,171,1654,45533
10-02-2015,5,16121,19134,7801,4054,47110,1570,429,186,2185,49295
10-02-2015,6,18972,20982,8629,4722,53305,1664,952,188,2804,56109
10-02-2015,7,21879,22684,8582,4703,57849,1677,1020,342,3039,60888
10-02-2015,8,21965,22772,8591,5181,58510,1671,1042,378,3091,61601
10-02-2015,9,21615,22385,8475,5210,57686,1671,1125,387,3183,60869
10-02-2015,10,21640,22149,8463,5201,57453,1649,1059,372,3080,60533
10-02-2015,11,20798,21751,8490,5234,56273,1616,787,176,2579,58852
10-02-2015,12,20399,21396,8357,5270,55422,1629,807,177,2613,58035
10-02-2015,13,19987,21254,8454,5324,55019,1663,782,180,2625,57644
10-02-2015,14,20199,21485,8228,5079,54992,1631,877,322,2830,57822
10-02-2015,15,19871,21715,8278,4807,54672,1629,912,261,2802,57474
10-02-2015,16,20370,21912,8683,4729,55694,1609,940,375,2924,58618
10-02-2015,17,21734,22638,8839,4526,57737,1624,1081,302,3007,60744
10-02-2015,18,21520,23135,8852,4669,58177,1641,1014,263,2918,61095
10-02-2015,19,21266,21702,8339,4467,55774,1615,830,201,2646,58420
10-02-2015,20,20603,21142,7779,3935,53460,1575,686,191,2452,55912
10-02-2015,21,20295,20487,7428,3691,51901,1605,432,188,2225,54126
10-02-2015,22,19080,19891,7130,3676,49777,1595,236,182,2013,51790
10-02-2015,23,17557,19135,7060,3522,47274,1605,223,191,2019,49293
11-02-2015,0,16965,18074,7075,3226,45340,1533,222,185,1940,47280
11-02-2015,1,16477,17887,7001,3152,44518,1554,221,173,1948,46466
11-02-2015,2,16136,17775,6971,3335,44217,1268,221,169,1658,45875
11-02-2015,3,16294,17855,6992,3229,44369,1296,226,165,1687,46056
11-02-2015,4,16672,18341,7075,3231,45319,1514,229,165,1908,47227
11-02-2015,5,18636,19850,7393,3373,49253,1628,456,335,2419,51672
11-02-2015,6,21185,21929,8295,3345,54755,1636,961,374,2971,57726
11-02-2015,7,22692,22596,8424,4673,58387,1639,1163,605,3407,61794
11-02-2015,8,23263,22095,8638,4765,58760,1627,1263,602,3492,62252
11-02-2015,9,23185,22023,8607,4684,58500,1602,1127,604,3333,61833
11-02-2015,10,23300,22027,8445,4654,58426,1573,1057,456,3086,61512
11-02-2015,11,22725,21681,8091,4617,57115,1555,723,387,2665,59780
11-02-2015,12,22669,21569,7927,4323,56487,1530,713,393,2636,59123
11-02-2015,13,22370,21720,8139,4514,56742,1611,705,387,2703,59445
11-02-2015,14,22251,21851,8164,4486,56754,1616,937,400,2953,59707
11-02-2015,15,22111,22034,8214,4396,56753,1597,949,400,2946,59699
11-02-2015,16,22232,22442,8394,4427,57494,1681,1117,425,3223,60717
11-02-2015,17,22351,22862,8562,4749,58525,1683,1243,656,3582,62107
11-02-2015,18,22231,22785,8536,4637,58190,1721,1105,646,3472,61662
11-02-2015,19,22280,22278,8169,4399,57127,1690,794,391,2875,60002
11-02-2015,20,21959,22149,7687,4002,55796,1660,667,396,2723,58519
11-02-2015,21,21354,21557,7488,3603,54003,1701,423,374,2498,56501
11-02-2015,22,20236,20183,7263,3460,51141,1699,250,213,2162,53303
11-02-2015,23,18549,19585,7209,3022,48366,1666,252,228,2146,50512
12-02-2015,0,17620,18827,7089,2703,46239,1624,249,235,2108,48347
12-02-2015,1,17203,18497,7119,2770,45589,1627,251,227,2105,47694
12-02-2015,2,16835,18541,7038,2648,45062,1591,253,231,2075,47137
12-02-2015,3,16795,18711,7045,2710,45260,1616,259,234,2109,47369
12-02-2015,4,17154,18765,7354,2863,46136,1673,394,245,2312,48448
12-02-2015,5,18343,20035,8103,2861,49341,1730,549,265,2544,51885
12-02-2015,6,21169,21595,8751,3282,54797,1737,1039,419,3195,57992
12-02-2015,7,22874,23011,9055,4322,59263,1730,1057,382,3169,62432
12-02-2015,8,23273,23165,9066,4452,59956,1752,1032,520,3304,63260
12-02-2015,9,23579,23214,8947,4500,60241,1704,1043,487,3234,63475
12-02-2015,10,22871,23500,9096,4855,60323,1659,1010,509,3178,63501
12-02-2015,11,21728,23273,8911,5121,59033,1647,847,286,2780,61813
12-02-2015,12,21476,23002,8813,4532,57824,1644,867,272,2783,60607
12-02-2015,13,22003,22601,8871,4180,57653,1645,852,268,2765,60418
12-02-2015,14,22164,22549,8921,4235,57870,1636,990,431,3057,60927
12-02-2015,15,21931,22212,9023,4224,57390,1619,1026,501,3146,60536
12-02-2015,16,22089,21934,9234,4216,57475,1614,1023,685,3322,60797
12-02-2015,17,22616,21806,9379,4502,58303,1602,1058,816,3476,61779
12-02-2015,18,23041,21658,9407,4265,58373,1585,1413,899,3897,62270
12-02-2015,19,23173,21360,9045,4026,57604,1549,1081,494,3124,60728
12-02-2015,20,22945,21353,8555,3547,56400,1515,809,212,2536,58936
12-02-2015,21,22502,20735,8053,3586,54876,1497,545,206,2248,57124
12-02-2015,22,21767,20080,7777,3275,52899,1405,241,193,1839,54738
12-02-2015,23,20391,19133,7492,3366,50382,1422,231,227,1880,52262
13-02-2015,0,19503,18141,7380,2835,47861,1438,232,170,1840,49701
13-02-2015,1,18829,17557,7356,2686,46428,1487,232,167,1886,48314
13-02-2015,2,18199,17520,7331,2812,45861,1443,231,163,1837,47698
13-02-2015,3,18266,17445,7368,2874,45953,1444,235,165,1844,47797
13-02-2015,4,18540,17755,7834,2882,47011,1507,335,185,2027,49038
13-02-2015,5,19407,19233,8520,2879,50040,1517,554,259,2330,52370
13-02-2015,6,21287,21588,8853,3135,54864,1519,1372,454,3345,58209
13-02-2015,7,22301,22159,9137,4255,57852,1526,1269,617,3412,61264
13-02-2015,8,22825,21833,9382,4477,58517,1527,1227,883,3637,62154
13-02-2015,9,23307,21997,9475,4610,59389,1513,1110,676,3299,62688
13-02-2015,10,23297,22286,9455,5011,60047,1504,1140,525,3169,63216
13-02-2015,11,22692,22191,9360,5238,59481,1525,822,281,2628,62109
13-02-2015,12,23284,22028,9156,4416,58884,1519,860,262,2641,61525
13-02-2015,13,23346,21766,9063,4164,58341,1517,1020,214,2751,61092
13-02-2015,14,23266,21700,9135,3853,57955,1543,1045,363,2951,60906
13-02-2015,15,23262,21729,9186,3704,57884,1554,1041,263,2858,60742
13-02-2015,16,23218,21685,9322,3461,57686,1566,1068,455,3089,60775
13-02-2015,17,23442,21686,9431,3578,58137,1568,1128,503,3199,61336
13-02-2015,18,23220,21748,9271,3763,58002,1568,1075,500,3143,61145
13-02-2015,19,22980,21480,8885,3713,57059,1563,793,292,2648,59707
13-02-2015,20,21648,21288,7996,3611,54543,1559,667,293,2519,57062
13-02-2015,21,20489,20909,7794,3583,52776,1568,428,284,2280,55056
13-02-2015,22,19872,20087,7365,3554,50878,1554,235,200,1989,52867
13-02-2015,23,18963,19266,7080,3172,48480,1531,230,187,1948,50428
14-02-2015,0,18295,18022,6957,3083,46357,1277,231,178,1686,48043
14-02-2015,1,17963,17365,6983,2913,45224,1202,228,169,1599,46823
14-02-2015,2,17650,17289,6890,2953,44782,1124,227,165,1516,46298
14-02-2015,3,17369,17280,6888,2965,44502,1152,232,163,1547,46049
14-02-2015,4,17397,17333,6964,2975,44671,1174,233,164,1571,46242
14-02-2015,5,17938,17608,6916,3072,45534,1198,242,202,1642,47176
14-02-2015,6,17724,18666,7057,3091,46539,1193,278,205,1676,48215
14-02-2015,7,17595,19756,7174,3259,47784,1197,350,200,1747,49531
14-02-2015,8,18478,20461,7272,3505,49716,1207,451,199,1857,51573
14-02-2015,9,19735,20646,7358,3526,51266,1210,548,197,1955,53221
14-02-2015,10,20350,20546,7390,3526,51811,1198,570,204,1972,53783
14-02-2015,11,20692,20537,7403,3526,52157,1196,568,204,1968,54125
14-02-2015,12,19924,20847,7427,3552,51750,1207,566,202,1975,53725
14-02-2015,13,19598,20937,7393,3590,51517,1240,557,203,2000,53517
14-02-2015,14,18907,20794,7373,3564,50639,1238,556,195,1989,52628
14-02-2015,15,18955,20379,7615,3839,50790,1252,547,198,1997,52787
14-02-2015,16,19880,20273,8005,3832,51991,1254,779,204,2237,54228
14-02-2015,17,21517,21063,8079,4108,54768,1227,1115,211,2553,57321
14-02-2015,18,21521,21574,8204,4261,55561,1216,894,209,2319,57880
14-02-2015,19,20225,21568,8053,4457,54303,1206,630,209,2045,56348
14-02-2015,20,18719,21299,7851,4602,52470,1219,532,211,1962,54432
14-02-2015,21,17766,21001,7767,4475,51010,1087,322,214,1623,52633
14-02-2015,22,17122,20273,7581,4528,49505,1082,183,183,1448,50953
14-02-2015,23,16893,18881,7475,4592,47841,1139,183,185,1507,49348
15-02-2015,0,16446,17735,7317,4498,45995,1260,180,189,1629,47624
15-02-2015,1,15929,17150,7288,4430,44796,1263,183,204,1650,46446
15-02-2015,2,15563,17043,7262,4650,44520,1220,184,220,1624,46144
15-02-2015,3,15506,17108,7262,4795,44670,1024,188,230,1442,46112
15-02-2015,4,15386,17211,7273,4962,44831,998,191,248,1437,46268
15-02-2015,5,15478,17404,7360,5117,45359,1029,195,269,1493,46852
15-02-2015,6,15573,17981,7454,5227,46237,1170,196,280,1646,47883
15-02-2015,7,15707,18495,7498,5426,47126,1226,251,271,1748,48874
15-02-2015,8,16504,19108,7583,5377,48571,1242,376,254,1872,50443
15-02-2015,9,17009,19978,7549,5591,50126,1319,399,288,2006,52132
15-02-2015,10,16843,20727,7636,5808,51014,1278,401,329,2008,53022
15-02-2015,11,16731,20926,7646,5574,50878,1259,401,318,1978,52856
15-02-2015,12,15985,20870,7726,5377,49959,1140,387,316,1843,51802
15-02-2015,13,15207,20744,7589,5283,48822,1003,387,317,1707,50529
15-02-2015,14,14973,20844,7568,5233,48619,999,382,315,1696,50315
15-02-2015,15,15495,20973,7571,5284,49323,1106,383,292,1781,51104
15-02-2015,16,16852,21781,7870,5686,52190,1208,458,319,1985,54175
15-02-2015,17,18599,22602,8138,5856,55197,1228,602,304,2134,57331
15-02-2015,18,18649,22790,8236,5945,55620,1245,613,310,2168,57788
15-02-2015,19,18010,22851,8069,5901,54832,1238,539,323,2100,56932
15-02-2015,20,17150,22351,7853,5839,53193,1239,435,352,2026,55219
15-02-2015,21,16812,21620,7857,5833,52123,1238,299,334,1871,53994
15-02-2015,22,16304,20713,7667,5688,50373,1237,204,328,1769,52142
15-02-2015,23,15638,19916,7597,5397,48550,1217,198,338,1753,50303
16-02-2015,0,15163,19617,7410,5306,47496,1007,197,314,1518,49014
16-02-2015,1,14665,19098,7413,5235,46411,989,200,300,1489,47900
16-02-2015,2,14400,19027,7406,5188,46023,1000,198,282,1480,47503
16-02-2015,3,14691,19000,7460,5155,46307,1006,203,275,1484,47791
16-02-2015,4,14984,19106,7572,5144,46807,1088,228,281,1597,48404
16-02-2015,5,15889,20340,8058,5444,49730,1527,391,448,2366,52096
16-02-2015,6,18456,22264,8687,5741,55149,1560,1045,447,3052,58201
16-02-2015,7,21293,23642,8941,5924,59801,1558,1126,482,3166,62967
16-02-2015,8,22030,23874,9025,5930,60859,1555,1167,499,3221,64080
16-02-2015,9,22136,24121,9096,5820,61173,1545,1126,507,3178,64351
16-02-2015,10,22931,23972,8973,5741,61618,1541,1103,480,3124,64742
16-02-2015,11,22721,24207,8641,5653,61222,1533,520,377,2430,63652
16-02-2015,12,22114,24155,8505,5591,60365,1563,498,365,2426,62791
16-02-2015,13,22056,24126,8744,5623,60548,1540,529,413,2482,63030
16-02-2015,14,21989,24047,8766,5442,60243,1563,666,359,2588,62831
16-02-2015,15,21956,24008,8718,5351,60033,1566,683,380,2629,62662
16-02-2015,16,22304,23996,8854,5032,60187,1563,1123,415,3101,63288
16-02-2015,17,23650,24373,8948,4831,61801,1575,1270,480,3325,65126
16-02-2015,18,23060,24655,9022,4864,61602,1611,1140,495,3246,64848
16-02-2015,19,22407,24409,8648,4638,60101,1643,658,475,2776,62877
16-02-2015,20,21266,23874,8003,4319,57462,1652,544,460,2656,60118
16-02-2015,21,20191,23505,7825,3968,55488,1693,409,428,2530,58018
16-02-2015,22,19229,23031,7606,3881,53747,1696,240,328,2264,56011
16-02-2015,23,17899,21549,7380,3728,50556,1703,223,322,2248,52804
17-02-2015,0,16782,20603,7506,3623,48514,1594,200,327,2121,50635
17-02-2015,1,16369,20266,7520,3595,47749,1455,197,343,1995,49744
17-02-2015,2,16234,20251,7538,3490,47513,1338,202,347,1887,49400
17-02-2015,3,16350,20214,7579,3296,47439,1499,207,333,2039,49478
17-02-2015,4,16976,20351,7728,3299,48355,1607,248,329,2184,50539
17-02-2015,5,18441,21411,8216,3348,51417,1660,484,333,2477,53894
17-02-2015,6,21353,22965,8829,3464,56611,1639,1125,571,3335,59946
17-02-2015,7,23262,24393,8940,3761,60355,1652,1134,639,3425,63780
17-02-2015,8,23671,24331,8983,4067,61052,1661,1227,741,3629,64681
17-02-2015,9,23612,24275,8904,4107,60899,1632,1118,732,3482,64381
17-02-2015,10,24136,24247,8876,4068,61326,1671,1087,623,3381,64707
17-02-2015,11,24001,24316,8743,4396,61455,1649,525,529,2703,64158
17-02-2015,12,23591,24195,8622,4472,60881,1663,540,508,2711,63592
17-02-2015,13,23305,24261,8590,4304,60459,1675,731,501,2907,63366
17-02-2015,14,22959,24181,8671,3967,59779,1680,826,543,3049,62828
17-02-2015,15,22654,24167,8623,4008,59453,1661,938,603,3202,62655
17-02-2015,16,22674,24279,8676,4072,59701,1651,1111,774,3536,63237
17-02-2015,17,23242,24590,8735,4126,60693,1643,1319,798,3760,64453
17-02-2015,18,22942,24694,8614,4457,60705,1656,1265,790,3711,64416
17-02-2015,19,22118,24464,8389,4562,59534,1700,680,482,2862,62396
17-02-2015,20,20278,24234,7793,4673,56978,1706,548,441,2695,59673
17-02-2015,21,18826,23884,7533,4719,54962,1710,320,390,2420,57382
17-02-2015,22,17290,23160,7298,4763,52511,1647,220,317,2184,54695
17-02-2015,23,15803,21488,7165,4621,49077,1396,216,314,1926,51003
18-02-2015,0,14433,20270,7125,4532,46360,1302,213,318,1833,48193
18-02-2015,1,13799,19571,7076,4459,44905,1304,207,319,1830,46735
18-02-2015,2,13463,19437,7035,4434,44369,1321,207,290,1818,46187
18-02-2015,3,13521,19191,7092,4485,44289,1329,214,270,1813,46102
18-02-2015,4,14207,19527,7257,4545,45536,1364,221,266,1851,47387
18-02-2015,5,15157,20517,7862,4591,48127,1659,468,312,2439,50566
18-02-2015,6,17898,22194,8186,5057,53335,1691,871,533,3095,56430
18-02-2015,7,20727,23245,8188,5258,57418,1698,951,585,3234,60652
18-02-2015,8,21796,22788,8347,5411,58341,1695,978,552,3225,61566
18-02-2015,9,21267,22592,8334,5722,57915,1695,944,563,3202,61117
18-02-2015,10,20944,22379,8248,6059,57630,1707,930,532,3169,60799
18-02-2015,11,20661,22477,7748,6172,57057,1682,541,553,2776,59833
18-02-2015,12,20012,22188,7584,6298,56084,1671,596,563,2830,58914
18-02-2015,13,19953,22430,7821,6227,56432,1672,632,551,2855,59287
18-02-2015,14,19980,22511,7962,6071,56524,1645,868,553,3066,59590
18-02-2015,15,20015,22234,8060,5916,56226,1584,870,545,2999,59225
18-02-2015,16,19958,22732,8169,5991,56851,1568,1126,658,3352,60203
18-02-2015,17,20913,23030,8462,5796,58202,1559,1226,770,3555,61757
18-02-2015,18,20595,23738,8404,5680,58417,1545,1296,756,3597,62014
18-02-2015,19,19331,23131,8038,5699,56200,1558,737,495,2790,58990
18-02-2015,20,17633,22516,7528,5641,53320,1566,589,457,2612,55932
18-02-2015,21,16954,21655,7288,5517,51415,1524,326,435,2285,53700
18-02-2015,22,15908,20767,7149,5422,49247,1253,211,359,1823,51070
18-02-2015,23,14338,19894,7007,5405,46644,1188,206,347,1741,48385
19-02-2015,0,13089,18668,6987,5339,44083,1195,208,348,1751,45834
19-02-2015,1,12652,18202,6954,5080,42889,1164,202,335,1701,44590
19-02-2015,2,12466,18110,6905,5034,42515,1152,201,340,1693,44208
19-02-2015,3,12558,18132,6892,5053,42637,1167,205,336,1708,44345
19-02-2015,4,13142,18341,7125,5192,43800,1242,200,324,1766,45566
19-02-2015,5,14139,19310,7804,5049,46302,1572,382,333,2287,48589
19-02-2015,6,16499,21249,8375,5124,51246,1663,870,406,2939,54185
19-02-2015,7,18565,22919,8187,5555,55228,1708,989,573,3270,58498
19-02-2015,8,19295,22751,8329,5760,56136,1781,1005,484,3270,59406
19-02-2015,9,19152,22671,8313,5861,55997,1692,1004,548,3244,59241
19-02-2015,10,19205,22528,8273,5838,55845,1685,976,504,3165,59010
19-02-2015,11,18912,22889,7968,5864,55634,1697,691,380,2768,58402
19-02-2015,12,18402,22637,7766,5970,54776,1687,719,382,2788,57564
19-02-2015,13,18208,22670,8096,5743,54717,1677,742,344,2763,57480
19-02-2015,14,18251,22924,8157,5567,54900,1680,855,472,3007,57907
19-02-2015,15,18482,22813,8037,5556,54887,1710,842,446,2998,57885
19-02-2015,16,18282,23206,8318,5599,55405,1746,962,443,3151,58556
19-02-2015,17,19398,23525,8512,5664,57098,1760,1116,540,3416,60514
19-02-2015,18,19667,23722,8355,5591,57335,1736,1063,504,3303,60638
19-02-2015,19,19015,23062,7996,5414,55486,1717,743,380,2840,58326
19-02-2015,20,17479,22574,7349,5534,52935,1643,626,344,2613,55548
19-02-2015,21,17140,21642,7055,5640,51478,1563,395,311,2269,53747
19-02-2015,22,15874,20922,6946,5614,49356,1375,212,284,1871,51227
19-02-2015,23,13973,19912,6832,5447,46163,1333,208,269,1810,47973
20-02-2015,0,12665,19041,6700,5339,43746,1305,198,256,1759,45505
20-02-2015,1,12147,18780,6650,5166,42744,1307,198,228,1733,44477
20-02-2015,2,12072,18727,6616,5016,42433,1304,194,251,1749,44182
20-02-2015,3,12365,18821,6645,4800,42631,1305,196,250,1751,44382
20-02-2015,4,12869,19140,6934,4762,43706,1412,237,251,1900,45606
20-02-2015,5,13746,20066,7808,4765,46386,1659,426,263,2348,48734
20-02-2015,6,16115,21819,8225,4661,50820,1743,1026,426,3195,54015
20-02-2015,7,18594,23240,8321,4696,54851,1778,1028,474,3280,58131
20-02-2015,8,19546,23668,8411,4671,56296,1868,990,523,3381,59677
20-02-2015,9,19792,23815,8425,4707,56739,1750,986,521,3257,59996
20-02-2015,10,19317,23315,8360,4806,55799,1756,948,521,3225,59024
20-02-2015,11,18783,22927,8074,4765,54549,1756,691,350,2797,57346
20-02-2015,12,18234,22242,7913,4868,53258,1753,691,334,2778,56036
20-02-2015,13,18046,22087,7789,4683,52607,1730,678,316,2724,55331
20-02-2015,14,17859,22272,8097,4558,52788,1765,852,450,3067,55855
20-02-2015,15,18191,22167,8348,4361,53068,1778,862,421,3061,56129
20-02-2015,16,19120,23309,8481,4187,55097,1782,889,508,3179,58276
20-02-2015,17,20151,23851,8583,4293,56879,1779,1142,561,3482,60361
20-02-2015,18,20363,24178,8558,3875,56974,1787,1070,529,3386,60360
20-02-2015,19,19722,23986,8121,3415,55244,1697,726,367,2790,58034
20-02-2015,20,18513,23482,7462,3200,52657,1584,631,342,2557,55214
20-02-2015,21,17734,22856,7219,3161,50970,1562,503,350,2415,53385
20-02-2015,22,16902,22089,7213,3041,49245,1312,216,250,1778,51023
20-02-2015,23,15976,21287,6914,2833,47010,1252,204,229,1685,48695
21-02-2015,0,15666,19942,6824,2780,45211,1036,203,222,1461,46672
21-02-2015,1,15235,19230,6785,2356,43606,1005,202,231,1438,45044
21-02-2015,2,15084,18930,6665,2338,43018,1042,200,223,1465,44483
21-02-2015,3,14909,18803,6684,2271,42668,1029,201,223,1453,44121
21-02-2015,4,14925,18706,6707,2258,42597,1052,201,231,1484,44081
21-02-2015,5,14571,18888,6741,2445,42644,1022,197,259,1478,44122
21-02-2015,6,14880,19521,6878,2539,43818,1015,208,288,1511,45329
21-02-2015,7,16510,20085,6981,2618,46193,1050,231,313,1594,47787
21-02-2015,8,18099,20740,7118,2648,48604,1071,340,330,1741,50345
21-02-2015,9,19516,21425,7148,2665,50753,1217,421,308,1946,52699
21-02-2015,10,20204,21721,7165,2878,51967,1202,378,280,1860,53827
21-02-2015,11,19562,21235,7071,2952,50820,1171,366,290,1827,52647
21-02-2015,12,18400,21414,7053,3025,49891,1125,367,296,1788,51679
21-02-2015,13,18063,21159,7099,2987,49309,1054,334,301,1689,50998
21-02-2015,14,18144,21039,7109,2956,49247,1008,333,307,1648,50895
21-02-2015,15,18406,21130,7201,3118,49856,1095,303,328,1726,51582
21-02-2015,16,18940,21582,7613,3360,51496,1154,313,339,1806,53302
21-02-2015,17,20272,21896,7956,3445,53569,1190,508,360,2058,55627
21-02-2015,18,20627,22256,7866,3508,54259,1204,496,364,2064,56323
21-02-2015,19,19597,22191,7543,3410,52741,1228,424,355,2007,54748
21-02-2015,20,18339,21654,7236,3500,50728,1238,343,346,1927,52655
21-02-2015,21,17681,21428,7042,3532,49684,1245,233,327,1805,51489
21-02-2015,22,16994,20845,6934,3537,48311,1208,204,301,1713,50024
21-02-2015,23,16093,20157,6824,3529,46603,1132,204,304,1640,48243
22-02-2015,0,15409,19215,6781,3490,44896,1033,211,333,1577,46473
22-02-2015,1,14812,18754,6747,3533,43846,1026,215,324,1565,45411
22-02-2015,2,14589,18473,6725,3420,43206,1046,212,306,1564,44770
22-02-2015,3,14422,18495,6723,3459,43099,1075,216,316,1607,44706
22-02-2015,4,14498,18563,6734,3588,43382,1079,217,317,1613,44995
22-02-2015,5,14735,18711,6736,3982,44165,1071,218,325,1614,45779
22-02-2015,6,15028,19203,6815,4008,45055,1091,217,310,1618,46673
22-02-2015,7,15464,19781,6851,3913,46010,1110,209,296,1615,47625
22-02-2015,8,16882,20270,6943,3972,48068,1119,223,283,1625,49693
22-02-2015,9,17715,21026,6965,3899,49605,1136,277,302,1715,51320
22-02-2015,10,18062,21384,6986,3905,50338,1206,307,291,1804,52142
22-02-2015,11,17872,21680,6970,3904,50426,1201,303,295,1799,52225
22-02-2015,12,17157,21831,7007,3921,49915,1103,301,292,1696,51611
22-02-2015,13,16492,21754,7007,3956,49208,1084,283,281,1648,50856
22-02-2015,14,16063,21754,7050,3939,48806,1065,254,273,1592,50398
22-02-2015,15,15422,21854,7056,3910,48243,1102,293,264,1659,49902
22-02-2015,16,16943,22127,7196,4092,50357,1152,356,259,1767,52124
22-02-2015,17,18996,22385,7626,3995,53002,1180,571,258,2009,55011
22-02-2015,18,19986,22491,7603,4143,54223,1160,603,267,2030,56253
22-02-2015,19,18990,22513,7423,4419,53345,1158,556,281,1995,55340
22-02-2015,20,17976,22105,7174,4706,51963,1064,459,283,1806,53769
22-02-2015,21,17347,21108,7054,5071,50580,1150,285,280,1715,52295
22-02-2015,22,16491,20398,6868,5355,49113,1135,198,194,1527,50640
22-02-2015,23,15191,19533,6666,5219,46608,1018,192,179,1389,47997
23-02-2015,0,13389,18464,6593,5080,43526,1013,187,176,1376,44902
23-02-2015,1,12667,18286,6573,5125,42650,962,181,166,1309,43959
23-02-2015,2,12457,18198,6555,5080,42289,920,180,162,1262,43551
23-02-2015,3,12527,18307,6553,5120,42508,919,187,171,1277,43785
23-02-2015,4,12737,18717,6635,5237,43327,1041,233,195,1469,44796
23-02-2015,5,13158,19963,7086,5376,45582,1443,240,192,1875,47457
23-02-2015,6,16423,22108,7640,5335,51506,1464,391,205,2060,53566
23-02-2015,7,19381,23841,7755,5704,56681,1457,643,212,2312,58993
23-02-2015,8,19808,24542,7745,5828,57923,1483,548,370,2401,60324
23-02-2015,9,19903,25014,7609,5781,58307,1465,541,364,2370,60677
23-02-2015,10,20048,25294,7526,5416,58284,1438,542,202,2182,60466
23-02-2015,11,20087,25543,7448,5238,58315,1449,451,200,2100,60415
23-02-2015,12,19840,25628,7459,5178,58106,1452,435,198,2085,60191
23-02-2015,13,19659,25542,7358,5187,57746,1462,459,178,2099,59845
23-02-2015,14,19658,25145,7396,5071,57270,1384,473,181,2038,59308
23-02-2015,15,19855,24921,7356,5072,57203,1380,499,204,2083,59286
23-02-2015,16,20096,24754,7519,4782,57151,1439,532,223,2194,59345
23-02-2015,17,21318,24868,7776,4514,58475,1460,578,410,2448,60923
23-02-2015,18,21644,24804,7734,4388,58570,1472,554,413,2439,61009
23-02-2015,19,20804,24443,7668,4463,57378,1494,497,262,2253,59631
23-02-2015,20,19177,23919,7334,4511,54941,1432,423,265,2120,57061
23-02-2015,21,18744,22796,7152,4283,52975,1432,279,265,1976,54951
23-02-2015,22,17789,21760,7122,4198,50867,1180,191,223,1594,52461
23-02-2015,23,15481,20375,6983,4024,46865,1137,186,204,1527,48392
24-02-2015,0,15146,19830,6973,3853,45803,1126,188,206,1520,47323
24-02-2015,1,14621,19471,6903,3994,44989,1113,186,195,1494,46483
24-02-2015,2,13846,19379,6853,3971,44050,1117,185,193,1495,45545
24-02-2015,3,13976,19174,6977,3888,44015,1110,189,169,1468,45483
24-02-2015,4,14885,19459,7332,3890,45567,1133,197,168,1498,47065
24-02-2015,5,15042,20676,7973,4044,47735,1356,593,346,2295,50030
24-02-2015,6,17971,22247,8408,4090,52716,1351,944,395,2690,55406
24-02-2015,7,20438,23072,8555,4804,56869,1421,880,389,2690,59559
24-02-2015,8,21092,22943,8696,5036,57768,1450,957,610,3017,60785
24-02-2015,9,20440,22676,9261,5260,57636,1482,955,441,2878,60514
24-02-2015,10,20489,22654,8907,5507,57556,1436,940,409,2785,60341
24-02-2015,11,19832,22725,8289,5573,56418,1468,625,400,2493,58911
24-02-2015,12,19438,22587,7978,5660,55665,1447,571,388,2406,58071
24-02-2015,13,19327,22954,8133,5463,55876,1464,697,383,2544,58420
24-02-2015,14,19271,23122,8502,5221,56115,1470,838,378,2686,58801
24-02-2015,15,18993,23297,8588,5072,55951,1479,802,383,2664,58615
24-02-2015,16,18926,23504,8694,5098,56223,1487,836,372,2695,58918
24-02-2015,17,19983,23720,8811,5372,57886,1483,983,627,3093,60979
24-02-2015,18,20240,23791,8903,5336,58270,1492,1076,538,3106,61376
24-02-2015,19,19314,23559,8417,5347,56637,1501,748,350,2599,59236
24-02-2015,20,18133,23046,7988,5287,54453,1364,550,317,2231,56684
24-02-2015,21,17299,22269,7856,5160,52584,1181,484,283,1948,54532
24-02-2015,22,15866,21640,7754,5010,50269,1126,231,194,1551,51820
24-02-2015,23,14527,20667,7672,4666,47532,1123,195,178,1496,49028
25-02-2015,0,13511,19065,7570,4466,44612,1140,189,174,1503,46115
25-02-2015,1,13010,18773,7554,4248,43586,1119,191,182,1492,45078
25-02-2015,2,12970,18667,7511,4136,43285,1134,192,185,1511,44796
25-02-2015,3,13100,18616,7532,4034,43283,1155,194,192,1541,44824
25-02-2015,4,13594,19080,7764,3967,44405,1194,287,190,1671,46076
25-02-2015,5,15191,20271,8152,3759,47374,1425,383,365,2173,49547
25-02-2015,6,18039,22323,8662,3610,52637,1522,692,402,2616,55253
25-02-2015,7,21405,23163,8737,3756,57062,1525,874,382,2781,59843
25-02-2015,8,22105,23033,8794,3774,57707,1508,1018,386,2912,60619
25-02-2015,9,22377,22848,8753,3440,57419,1498,965,378,2841,60260
25-02-2015,10,22477,22900,8633,3534,57546,1493,922,361,2776,60322
25-02-2015,11,21914,22551,8360,3615,56438,1495,571,360,2426,58864
25-02-2015,12,21560,22223,8143,3529,55454,1477,615,362,2454,57908
25-02-2015,13,21474,22470,8190,3483,55618,1428,609,350,2387,58005
25-02-2015,14,21399,22267,8370,3434,55469,1489,828,348,2665,58134
25-02-2015,15,21429,22123,8395,3159,55106,1483,780,348,2611,57717
25-02-2015,16,21460,21898,8688,2956,55001,1485,781,339,2605,57606
25-02-2015,17,22577,22540,9000,3092,57208,1492,1088,242,2822,60030
25-02-2015,18,22725,23288,9051,3120,58186,1491,1117,227,2835,61021
25-02-2015,19,22581,22697,8467,2992,56739,1473,671,335,2479,59218
25-02-2015,20,21840,21918,8186,2755,54698,1465,545,329,2339,57037
25-02-2015,21,20691,21783,8119,2609,53201,1425,431,310,2166,55367
25-02-2015,22,19340,20973,7980,2634,50929,1435,191,150,1776,52705
25-02-2015,23,17720,20414,7861,2557,48553,1173,188,146,1507,50060
26-02-2015,0,16902,18773,7790,2386,45852,1094,185,147,1426,47278
26-02-2015,1,16513,18588,7755,2374,45231,1086,184,145,1415,46646
26-02-2015,2,16017,18437,7729,2397,44580,1084,186,146,1416,45996
26-02-2015,3,16020,18498,7791,2557,44866,1090,191,149,1430,46296
26-02-2015,4,16753,18539,7947,2658,45898,1109,284,162,1555,47453
26-02-2015,5,17685,19836,8199,2850,48570,1367,480,177,2024,50594
26-02-2015,6,20196,21599,8590,3238,53624,1427,881,185,2493,56117
26-02-2015,7,22943,22398,8685,3792,57818,1430,1017,256,2703,60521
26-02-2015,8,22891,22790,8755,4080,58516,1444,1069,312,2825,61341
26-02-2015,9,22348,22480,8646,4411,57885,1442,1034,298,2774,60659
26-02-2015,10,21796,22232,8646,4792,57465,1438,1021,275,2734,60199
26-02-2015,11,21223,22017,8302,5075,56617,1393,665,162,2220,58837
26-02-2015,12,19581,22214,8134,5147,55077,1362,684,158,2204,57281
26-02-2015,13,18958,22534,8079,5097,54669,1365,695,156,2216,56885
26-02-2015,14,18426,22612,8414,5022,54474,1433,908,258,2599,57073
26-02-2015,15,18655,22767,8659,4928,55010,1436,922,195,2553,57563
26-02-2015,16,18587,23744,8733,4916,55980,1430,955,184,2569,58549
26-02-2015,17,19517,24293,9140,5241,58190,1430,991,317,2738,60928
26-02-2015,18,19670,24094,9172,5323,58259,1432,1117,257,2806,61065
26-02-2015,19,18742,24145,8570,5335,56792,1406,764,181,2351,59143
26-02-2015,20,17904,23371,8151,5366,54792,1152,633,187,1972,56764
26-02-2015,21,17183,22962,8062,5093,53301,1083,442,186,1711,55012
26-02-2015,22,15877,21754,7821,4878,50329,1080,182,162,1424,51753
26-02-2015,23,14342,21079,7659,4557,47637,1088,176,168,1432,49069
27-02-2015,0,13429,20502,7553,4179,45662,1036,176,173,1385,47047
27-02-2015,1,12948,20398,7585,3663,44594,1018,179,171,1368,45962
27-02-2015,2,13025,20541,7548,3268,44382,1017,178,169,1364,45746
27-02-2015,3,13377,20525,7545,2991,44438,1020,184,172,1376,45814
27-02-2015,4,13994,21038,7744,2822,45596,1096,276,182,1554,47150
27-02-2015,5,15186,22248,8398,2554,48387,1400,463,204,2067,50454
27-02-2015,6,18006,24058,8851,2537,53453,1428,648,405,2481,55934
27-02-2015,7,20586,25323,9004,2838,57753,1427,805,430,2662,60415
27-02-2015,8,21568,25528,9177,3017,59290,1413,948,481,2842,62132
27-02-2015,9,21560,25421,9127,3045,59153,1407,996,487,2890,62043
27-02-2015,10,21515,25286,9163,3059,59023,1415,893,418,2726,61749
27-02-2015,11,21023,25218,8532,3047,57820,1417,550,389,2356,60176
27-02-2015,12,20080,25232,8305,3174,56792,1379,610,356,2345,59137
27-02-2015,13,19688,24892,8306,3207,56094,1378,626,325,2329,58423
27-02-2015,14,19247,24680,8629,3060,55619,1422,891,352,2665,58284
27-02-2015,15,18894,24560,8709,3031,55196,1423,764,344,2531,57727
27-02-2015,16,19150,24059,8975,2867,55050,1416,846,341,2603,57653
27-02-2015,17,21105,23952,9274,2780,57111,1411,988,344,2743,59854
27-02-2015,18,21636,23948,9250,2995,57829,1401,969,435,2805,60634
27-02-2015,19,21134,23622,8747,2846,56350,1315,716,295,2326,58676
27-02-2015,20,19014,23315,8320,2770,53419,1287,697,255,2239,55658
27-02-2015,21,18333,22939,8212,2811,52294,922,606,238,1766,54060
27-02-2015,22,17519,21895,8062,2907,50385,874,287,167,1328,51713
27-02-2015,23,16541,21009,7936,2832,48318,854,243,160,1257,49575
28-02-2015,0,16262,19539,7740,2646,46187,824,214,151,1189,47376
28-02-2015,1,15720,18904,7711,2430,44766,835,190,150,1175,45941
28-02-2015,2,15458,18680,7674,2463,44277,839,190,150,1179,45456
28-02-2015,3,15233,18578,7635,2545,43990,833,194,149,1176,45166
28-02-2015,4,15310,18571,7658,2716,44256,818,196,153,1167,45423
28-02-2015,5,15748,18679,7711,2849,44986,820,267,203,1290,46276
28-02-2015,6,15931,19053,7836,2941,45762,808,309,205,1322,47084
28-02-2015,7,17249,19597,8000,3027,47872,815,438,205,1458,49330
28-02-2015,8,18069,20280,8084,3468,49903,852,586,206,1644,51547
28-02-2015,9,18211,20711,8105,3875,50903,882,678,214,1774,52677
28-02-2015,10,18207,20957,8131,4256,51552,882,743,183,1808,53360
28-02-2015,11,17553,20954,8156,4524,51188,881,725,183,1789,52977
28-02-2015,12,16445,21095,8132,4787,50460,882,727,182,1791,52251
28-02-2015,13,15742,21041,8111,4992,49884,883,664,185,1732,51616
28-02-2015,14,15587,21017,8070,4918,49593,880,641,183,1704,51297
28-02-2015,15,15692,21342,8130,4882,50047,879,639,204,1722,51769
28-02-2015,16,16076,21656,8241,4921,50894,894,678,211,1783,52677
28-02-2015,17,17245,21997,8574,5012,52828,895,874,219,1988,54816
28-02-2015,18,17783,22408,8579,5153,53924,895,833,214,1942,55866
28-02-2015,19,16601,22331,8252,5270,52456,896,732,217,1845,54301
28-02-2015,20,15541,21647,8052,5144,50385,872,628,217,1717,52102
28-02-2015,21,14028,21006,7848,5200,48081,864,470,271,1605,49686
28-02-2015,22,12999,20224,7653,5220,46096,832,189,164,1185,47281
28-02-2015,23,12211,19386,7477,5166,44241,882,187,180,1249,45490
01-03-2015,0,11587,18451,7443,4721,42203,869,344,176,1389,43592
01-03-2015,1,11200,17894,7369,4473,40938,875,347,176,1398,42336
01-03-2015,2,11245,17712,7359,4417,40733,857,346,179,1382,42115
01-03-2015,3,11222,17836,7387,4401,40846,800,347,177,1324,42170
01-03-2015,4,10756,17955,7330,4457,40499,803,333,185,1321,41820
01-03-2015,5,10363,18071,7405,4505,40343,796,327,206,1329,41672
01-03-2015,6,10341,18327,7493,4542,40703,819,477,209,1505,42208
01-03-2015,7,10953,18175,7432,4783,41345,791,456,205,1452,42797
01-03-2015,8,12061,18809,7619,5048,43537,866,581,231,1678,45215
01-03-2015,9,13669,19844,7781,5113,46406,887,586,278,1751,48157
01-03-2015,10,14288,21339,7984,5080,48692,924,593,267,1784,50476
01-03-2015,11,14458,21603,8031,5090,49183,934,596,282,1812,50995
01-03-2015,12,13965,21620,7871,4952,48409,938,600,304,1842,50251
01-03-2015,13,14064,21497,7792,4887,48240,944,549,305,1798,50038
01-03-2015,14,13225,21037,7766,4866,46895,965,518,298,1781,48676
01-03-2015,15,13464,20921,7884,4787,47057,981,563,281,1825,48882
01-03-2015,16,13989,21455,8138,4752,48333,971,576,303,1850,50183
01-03-2015,17,15167,22133,8361,4906,50567,983,699,378,2060,52627
01-03-2015,18,16385,23201,8599,5508,53692,999,728,404,2131,55823
01-03-2015,19,15917,23071,8547,5597,53132,1022,676,425,2123,55255
01-03-2015,20,15114,21972,8723,4956,50765,1032,610,372,2014,52779
01-03-2015,21,14499,21380,8497,4808,49185,1030,402,404,1836,51021
01-03-2015,22,13845,20636,8431,4399,47309,1050,347,320,1717,49026
01-03-2015,23,12557,19695,8297,4183,44732,1010,310,292,1612,46344
02-03-2015,0,11243,18308,7789,3743,41084,1000,447,254,1701,42785
02-03-2015,1,10689,17838,7798,3421,39745,981,446,240,1667,41412
02-03-2015,2,10217,17563,7568,3362,38709,967,431,226,1624,40333
02-03-2015,3,10491,17785,7604,3210,39090,959,459,206,1624,40714
02-03-2015,4,10832,18094,7737,3210,39872,1031,376,196,1603,41475
02-03-2015,5,12690,19215,8137,3561,43603,1376,639,216,2231,45834
02-03-2015,6,17159,21242,8655,3689,50743,1417,946,252,2615,53358
02-03-2015,7,20347,22903,8842,3753,55846,1402,1124,318,2844,58690
02-03-2015,8,20913,23432,9015,3802,57163,1406,1178,423,3007,60170
02-03-2015,9,20694,23281,8932,3893,56801,1392,1163,444,2999,59800
02-03-2015,10,20493,23006,8861,4103,56464,1377,1172,420,2969,59433
02-03-2015,11,19432,22853,8799,4268,55354,1358,1170,322,2850,58204
02-03-2015,12,17889,22517,8395,4435,53238,1316,1045,232,2593,55831
02-03-2015,13,17713,22523,8295,4699,53230,1310,1013,234,2557,55787
02-03-2015,14,17840,22494,8559,4748,53640,1301,1172,286,2759,56399
02-03-2015,15,18605,22481,8434,4742,54261,1317,1190,238,2745,57006
02-03-2015,16,18334,22507,8584,4862,54286,1310,1145,243,2698,56984
02-03-2015,17,19792,22605,8877,4974,56249,1310,1294,390,2994,59243
02-03-2015,18,20500,22901,8976,4715,57092,1307,1303,387,2997,60089
02-03-2015,19,19724,22966,8463,4828,55982,1246,1075,241,2562,58544
02-03-2015,20,18172,22838,8054,4493,53557,1221,906,231,2358,55915
02-03-2015,21,17414,22531,7876,4145,51967,1036,661,254,1951,53918
02-03-2015,22,15293,21520,7735,4030,48577,1012,534,263,1809,50386
02-03-2015,23,13587,19814,7595,3986,44982,1030,537,267,1834,46816
03-03-2015,0,12898,18089,7484,3773,42244,1030,633,309,1972,44216
03-03-2015,1,12681,17661,7411,3877,41630,995,482,330,1807,43437
03-03-2015,2,12459,17626,7333,4104,41523,997,466,348,1811,43334
03-03-2015,3,12519,17553,7357,4227,41656,1038,460,365,1863,43519
03-03-2015,4,13053,18118,7529,4040,42739,1086,624,367,2077,44816
03-03-2015,5,14046,19520,7905,4118,45589,1308,854,363,2525,48114
03-03-2015,6,17400,21255,8620,4346,51623,1356,870,361,2587,54210
03-03-2015,7,20209,22954,8758,4556,56477,1372,1193,366,2931,59408
03-03-2015,8,20836,23396,8850,4577,57659,1434,1253,443,3130,60789
03-03-2015,9,19261,23113,8790,4674,55838,1344,1233,575,3152,58990
03-03-2015,10,18605,22794,8723,4579,54701,1338,1225,502,3065,57766
03-03-2015,11,17913,22903,8662,4740,54217,1333,1205,433,2971,57188
03-03-2015,12,17235,22554,8304,4725,52818,1324,920,388,2632,55450
03-03-2015,13,17099,22403,8091,4619,52211,1316,875,398,2589,54800
03-03-2015,14,17947,22502,8596,4210,53255,1331,1047,381,2759,56014
03-03-2015,15,19052,22798,8687,3926,54463,1341,1010,388,2739,57202
03-03-2015,16,19188,23026,8712,3827,54754,1348,995,398,2741,57495
03-03-2015,17,21067,23302,8795,3540,56704,1335,1364,546,3245,59949
03-03-2015,18,21766,23959,8791,3643,58158,1350,1345,598,3293,61451
03-03-2015,19,21440,23760,8359,3591,57149,1359,945,397,2701,59850
03-03-2015,20,20300,23232,7890,3179,54601,1318,905,372,2595,57196
03-03-2015,21,19020,22801,7740,3065,52627,1323,898,366,2587,55214
03-03-2015,22,17585,22513,7521,3119,50738,1142,827,348,2317,53055
03-03-2015,23,15434,20302,7419,3098,46252,1174,678,305,2157,48409
04-03-2015,0,14170,18180,7333,3184,42867,1125,667,273,2065,44932
04-03-2015,1,13400,17748,7393,3167,41710,1112,657,252,2021,43731
04-03-2015,2,13180,17701,7377,3272,41530,1122,656,231,2009,43539
04-03-2015,3,13433,17770,7394,3272,41869,1114,657,210,1981,43850
04-03-2015,4,14337,18385,7498,3288,43507,1137,660,210,2007,45514
04-03-2015,5,16078,20048,8037,3487,47652,1278,864,222,2364,50016
04-03-2015,6,19905,21473,8514,3710,53601,1285,898,380,2563,56164
04-03-2015,7,22358,22861,8608,3901,57728,1311,1165,386,2862,60590
04-03-2015,8,23392,22892,8622,3843,58750,1397,1217,446,3060,61810
04-03-2015,9,22145,22713,8699,3951,57508,1267,1230,491,2988,60496
04-03-2015,10,21000,22405,8690,4135,56233,1288,1215,485,2988,59221
04-03-2015,11,20555,22514,8629,3894,55592,1293,1210,377,2880,58472
04-03-2015,12,20124,22319,8342,3731,54517,1285,1110,375,2770,57287
04-03-2015,13,20445,22174,8233,3660,54511,1254,1100,403,2757,57268
04-03-2015,14,20786,21997,8450,3582,54815,1223,1187,401,2811,57626
04-03-2015,15,20079,22540,8415,3693,54727,1221,1157,389,2767,57494
04-03-2015,16,20191,22336,8507,3726,54762,1203,1199,389,2791,57553
04-03-2015,17,21514,22433,8780,3707,56435,1196,1407,680,3283,59718
04-03-2015,18,22477,23091,8796,3588,57951,1198,1513,684,3395,61346
04-03-2015,19,21968,22808,8491,3552,56820,1201,1087,385,2673,59493
04-03-2015,20,20991,22117,8129,3670,54906,1155,981,372,2508,57414
04-03-2015,21,19691,21574,7855,3676,52797,1152,880,256,2288,55085
04-03-2015,22,17923,20490,7611,3588,49613,1140,811,178,2129,51742
04-03-2015,23,16129,19250,7447,3410,46236,1040,775,175,1990,48226
05-03-2015,0,14976,18557,7381,3260,44173,989,690,181,1860,46033
05-03-2015,1,14501,18109,7413,3168,43191,975,673,190,1838,45029
05-03-2015,2,14385,18188,7384,3154,43110,979,673,186,1838,44948
05-03-2015,3,14572,18201,7387,3387,43549,974,680,180,1834,45383
05-03-2015,4,15237,18671,7531,3430,44870,996,670,178,1844,46714
05-03-2015,5,16900,20364,8054,3431,48748,1148,974,203,2325,51073
05-03-2015,6,20773,21627,8593,3547,54540,1158,976,371,2505,57045
05-03-2015,7,23332,23000,8668,4001,59003,1144,1268,479,2891,61894
05-03-2015,8,23769,22387,8756,4351,59264,1151,1278,673,3102,62366
05-03-2015,9,23830,21842,8713,4089,58474,1148,1262,602,3012,61486
05-03-2015,10,23381,21566,8605,4168,57719,1154,1353,531,3038,60757
05-03-2015,11,23089,20723,8659,4311,56781,1146,1280,398,2824,59605
05-03-2015,12,22482,20375,8359,4251,55467,1145,991,378,2514,57981
05-03-2015,13,22267,20286,8226,4120,54899,1149,984,349,2482,57381
05-03-2015,14,22343,20459,8479,3678,54958,1141,1129,388,2658,57616
05-03-2015,15,22241,20793,8573,3495,55103,1149,972,391,2512,57615
05-03-2015,16,22153,21003,8652,3447,55254,1158,1064,369,2591,57845
05-03-2015,17,22370,20863,8593,3490,55315,1154,1503,687,3344,58659
05-03-2015,18,22711,21522,8766,3483,56482,1150,1599,674,3423,59905
05-03-2015,19,22253,21244,8606,3562,55663,1153,1405,440,2998,58661
05-03-2015,20,21474,20918,8155,3300,53847,1042,1045,212,2299,56146
05-03-2015,21,20326,20262,8023,3281,51892,996,1089,182,2267,54159
05-03-2015,22,19068,19549,7888,3331,49836,1008,848,196,2052,51888
05-03-2015,23,16858,18909,7788,3339,46894,1022,863,174,2059,48953
06-03-2015,0,15410,18169,7731,3168,44478,1029,877,165,2071,46549
06-03-2015,1,14402,17854,7717,3275,43248,1033,873,166,2072,45320
06-03-2015,2,13963,17594,7701,3419,42678,1058,876,169,2103,44781
06-03-2015,3,13982,17462,7731,3550,42725,1076,879,172,2127,44852
06-03-2015,4,14871,17729,7871,3589,44060,1068,892,173,2133,46193
06-03-2015,5,16295,18828,8060,3637,46820,1076,1163,188,2427,49247
06-03-2015,6,19034,20519,8659,3683,51896,1188,1173,202,2563,54459
06-03-2015,7,21972,21671,9000,3861,56504,1218,1166,365,2749,59253
06-03-2015,8,22699,21957,9041,4037,57734,1234,1247,467,2948,60682
06-03-2015,9,22684,21734,9004,4135,57557,1233,1164,485,2882,60439
06-03-2015,10,22262,21810,8906,4090,57068,1240,1164,452,2856,59924
06-03-2015,11,21948,21680,8867,3823,56318,1299,1169,313,2781,59099
06-03-2015,12,21168,21522,8413,3734,54836,1372,1137,249,2758,57594
06-03-2015,13,20301,21256,8276,3620,53453,1368,1145,256,2769,56222
06-03-2015,14,19933,21202,8564,3468,53167,1352,1193,270,2815,55982
06-03-2015,15,19691,21283,8582,3475,53031,1347,1161,253,2761,55792
06-03-2015,16,19924,20988,8780,3255,52948,1342,1189,258,2789,55737
06-03-2015,17,21048,21431,8897,3186,54563,1320,1355,589,3264,57827
06-03-2015,18,22040,21310,8943,3368,55662,1311,1372,677,3360,59022
06-03-2015,19,20982,21168,8412,3269,53831,1265,1317,290,2872,56703
06-03-2015,20,19102,20318,7957,3235,50613,1176,1278,280,2734,53347
06-03-2015,21,17839,19422,7770,3411,48443,1076,1270,257,2603,51046
06-03-2015,22,16838,18513,7599,3728,46680,1058,1261,224,2543,49223
06-03-2015,23,15659,17781,7469,3830,44739,1007,992,210,2209,46948
07-03-2015,0,13906,17936,7519,3569,42930,746,809,260,1815,44745
07-03-2015,1,13207,17723,7407,3870,42207,683,699,259,1641,43848
07-03-2015,2,12800,17283,7331,4046,41459,684,667,254,1605,43064
07-03-2015,3,12304,17323,7341,4239,41208,666,691,251,1608,42816
07-03-2015,4,12153,17574,7400,4557,41684,659,729,238,1626,43310
07-03-2015,5,12145,17700,7495,4728,42068,668,747,176,1591,43659
07-03-2015,6,12593,18356,7718,4753,43420,685,719,181,1585,45005
07-03-2015,7,13216,19122,7895,4782,45014,671,660,183,1514,46528
07-03-2015,8,14005,19803,8011,4826,46645,683,830,196,1709,48354
07-03-2015,9,14511,20614,8148,4983,48255,711,915,200,1826,50081
07-03-2015,10,14703,21214,8212,5161,49291,758,877,217,1852,51143
07-03-2015,11,14476,21317,8199,5348,49341,795,821,225,1841,51182
07-03-2015,12,13878,21120,8114,5371,48484,825,732,241,1798,50282
07-03-2015,13,13635,20880,7895,5224,47634,835,680,262,1777,49411
07-03-2015,14,13406,20563,7888,5049,46906,884,610,275,1769,48675
07-03-2015,15,13400,20508,7929,5000,46838,908,590,261,1759,48597
07-03-2015,16,14076,20890,8154,4948,48069,902,590,274,1766,49835
07-03-2015,17,15133,21815,8517,5036,50501,952,738,296,1986,52487
07-03-2015,18,15655,22435,8630,5038,51758,941,773,329,2043,53801
07-03-2015,19,15118,22066,8364,4952,50499,913,677,337,1927,52426
07-03-2015,20,14096,21203,8190,4813,48303,894,570,338,1802,50105
07-03-2015,21,13561,20319,7963,4693,46536,874,565,402,1841,48377
07-03-2015,22,13339,19733,7800,4629,45499,839,557,405,1801,47300
07-03-2015,23,12502,18993,7504,4354,43355,828,579,395,1802,45157
08-03-2015,0,11062,17190,7424,4224,39901,886,649,398,1933,41834
08-03-2015,1,10095,16323,7205,4073,37697,910,578,334,1822,39519
08-03-2015,2,9639,16037,7147,4043,36865,914,582,336,1832,38697
08-03-2015,3,9583,15846,7121,4005,36554,928,580,335,1843,38397
08-03-2015,4,9673,15820,7277,4017,36787,951,581,347,1879,38666
08-03-2015,5,9932,15817,7305,4059,37114,961,582,351,1894,39008
08-03-2015,6,10015,15898,7472,4173,37559,981,582,343,1906,39465
08-03-2015,7,10623,16018,7613,4151,38405,979,567,341,1887,40292
08-03-2015,8,11379,16463,7759,4373,39973,985,781,325,2091,42064
08-03-2015,9,12086,17439,7868,4663,42057,1021,797,322,2140,44197
08-03-2015,10,12279,17594,7886,4888,42647,943,807,314,2064,44711
08-03-2015,11,12751,17728,7864,4863,43204,967,807,300,2074,45278
08-03-2015,12,12211,17587,7780,4854,42432,928,809,299,2036,44468
08-03-2015,13,12066,17501,7842,4838,42248,937,742,296,1975,44223
08-03-2015,14,12241,17751,7711,4644,42348,952,726,281,1959,44307
08-03-2015,15,12324,17726,7625,4581,42256,970,727,260,1957,44213
08-03-2015,16,12852,18190,7661,4207,42911,942,727,257,1926,44837
08-03-2015,17,14770,20000,7893,3943,46606,916,787,305,2008,48614
08-03-2015,18,16857,21094,8064,3571,49587,1001,1014,367,2382,51969
08-03-2015,19,16737,21346,8133,3311,49527,1001,941,370,2312,51839
08-03-2015,20,16060,20984,8029,3270,48343,961,766,344,2071,50414
08-03-2015,21,15429,20407,7985,3142,46962,952,763,343,2058,49020
08-03-2015,22,14394,19680,7790,3109,44974,936,749,322,2007,46981
08-03-2015,23,13741,18331,7513,3122,42708,888,663,313,1864,44572
09-03-2015,0,13586,17276,7410,2886,41157,772,398,327,1497,42654
09-03-2015,1,13850,16756,7390,2700,40696,762,377,310,1449,42145
09-03-2015,2,14002,16846,7441,2407,40698,724,369,298,1391,42089
09-03-2015,3,14156,17099,7508,2287,41050,729,374,285,1388,42438
09-03-2015,4,14676,17732,7507,2356,42271,735,380,285,1400,43671
09-03-2015,5,16766,18938,7707,2283,45696,731,675,285,1691,47387
09-03-2015,6,19979,20879,7966,2572,51395,765,885,273,1923,53318
09-03-2015,7,21613,22276,8164,2963,55016,851,873,459,2183,57199
09-03-2015,8,22089,22155,8241,3302,55789,854,1022,469,2345,58134
09-03-2015,9,21821,21772,8130,3138,54862,850,1036,492,2378,57240
09-03-2015,10,21585,21402,8099,2789,53874,853,1005,448,2306,56180
09-03-2015,11,20818,21274,8006,2755,52853,848,935,440,2223,55076
09-03-2015,12,20354,21130,7933,2724,52140,821,956,428,2205,54345
09-03-2015,13,20106,21084,7943,2686,51820,813,934,445,2192,54012
09-03-2015,14,20100,20828,7958,2816,51702,830,903,440,2173,53875
09-03-2015,15,19982,20570,7960,2784,51298,825,892,425,2142,53440
09-03-2015,16,20367,20500,8009,2779,51653,822,855,384,2061,53714
09-03-2015,17,21279,21017,8160,2850,53306,821,954,430,2205,55511
09-03-2015,18,21818,21559,8502,3263,55142,819,1056,431,2306,57448
09-03-2015,19,21523,21397,8254,3324,54496,821,952,416,2189,56685
09-03-2015,20,20535,20778,7997,3253,52564,742,833,395,1970,54534
09-03-2015,21,18897,19972,7899,3386,50155,720,825,208,1753,51908
09-03-2015,22,17113,19158,7768,3688,47727,711,611,187,1509,49236
09-03-2015,23,15405,18120,7598,3986,45109,710,509,169,1388,46497
10-03-2015,0,14220,17262,7501,4041,43024,710,485,158,1353,44377
10-03-2015,1,13515,16988,7411,4203,42116,690,498,182,1370,43486
10-03-2015,2,12976,17135,7420,4196,41727,700,500,185,1385,43112
10-03-2015,3,12901,17289,7428,4226,41844,708,502,190,1400,43244
10-03-2015,4,13523,17645,7647,4153,42968,737,533,174,1444,44412
10-03-2015,5,14246,19286,8434,3844,45809,825,831,210,1866,47675
10-03-2015,6,16971,21227,8900,3900,51000,853,975,269,2097,53097
10-03-2015,7,19783,22497,9193,3932,55405,882,1074,488,2444,57849
10-03-2015,8,20424,22845,9274,4001,56544,906,1274,428,2608,59152
10-03-2015,9,20363,22898,9278,4322,56862,917,1198,440,2555,59417
10-03-2015,10,19748,22790,9204,4749,56490,934,1148,402,2484,58974
10-03-2015,11,18889,22482,9065,4870,55307,938,1073,475,2486,57793
10-03-2015,12,18389,21831,8683,4848,53750,953,818,391,2162,55912
10-03-2015,13,18208,21514,8412,4672,52806,953,847,368,2168,54974
10-03-2015,14,17975,21416,8896,4561,52847,986,1003,304,2293,55140
10-03-2015,15,17690,21413,8913,4443,52459,992,1011,242,2245,54704
10-03-2015,16,17716,21722,9053,4284,52777,986,975,239,2200,54977
10-03-2015,17,18874,22055,9207,4187,54323,990,1112,505,2607,56930
10-03-2015,18,20064,22402,9357,3906,55730,1000,1366,512,2878,58608
10-03-2015,19,19632,22460,8893,4053,55039,958,975,270,2203,57242
10-03-2015,20,18300,22156,8304,4207,52966,819,859,243,1921,54887
10-03-2015,21,17071,21913,7936,4138,51057,793,747,229,1769,52826
10-03-2015,22,16004,20646,7716,4135,48501,800,581,231,1612,50113
10-03-2015,23,14906,19179,7488,4126,45700,791,512,196,1499,47199
11-03-2015,0,13513,17971,7361,4248,43094,794,689,185,1668,44762
11-03-2015,1,12766,17574,7333,4282,41956,816,617,173,1606,43562
11-03-2015,2,12712,17404,7368,4290,41774,788,506,184,1478,43252
11-03-2015,3,13176,17300,7384,4190,42050,767,532,197,1496,43546
11-03-2015,4,14159,17530,7486,4052,43227,719,646,265,1630,44857
11-03-2015,5,15169,18767,7901,3800,45638,720,1004,212,1936,47574
11-03-2015,6,18356,20390,8560,3536,50841,773,996,204,1973,52814
11-03-2015,7,21137,22090,9092,3278,55598,792,969,319,2080,57678
11-03-2015,8,22320,22319,9160,3251,57050,766,1096,414,2276,59326
11-03-2015,9,21675,22011,9081,3393,56161,769,1043,413,2225,58386
11-03-2015,10,21487,21430,9090,3302,55309,785,1054,353,2192,57501
11-03-2015,11,21409,21243,8914,3106,54672,788,958,247,1993,56665
11-03-2015,12,20802,20734,8418,3146,53101,799,988,218,2005,55106
11-03-2015,13,20470,20520,8310,2911,52211,798,970,213,1981,54192
11-03-2015,14,20039,20353,8502,2825,51718,794,964,222,1980,53698
11-03-2015,15,20365,20358,8576,2919,52219,800,949,214,1963,54182
11-03-2015,16,20504,20500,8678,2997,52681,808,955,216,1979,54660
11-03-2015,17,21349,20368,8788,3019,53525,829,1203,416,2448,55973
11-03-2015,18,21916,20504,8961,2830,54211,835,1614,463,2912,57123
11-03-2015,19,22012,20553,8889,3373,54827,855,1531,376,2762,57589
11-03-2015,20,21596,20610,8349,3035,53591,846,1010,240,2096,55687
11-03-2015,21,21116,20404,7866,2883,52270,862,979,263,2104,54374
11-03-2015,22,20091,19776,7830,2313,50010,779,680,248,1707,51717
11-03-2015,23,19117,17949,7775,1981,46822,795,680,224,1699,48521
12-03-2015,0,18112,17036,7754,2034,44936,767,712,229,1708,46644
12-03-2015,1,17574,16750,7793,2032,44150,762,717,228,1707,45857
12-03-2015,2,17231,16792,7863,1976,43862,763,719,219,1701,45563
12-03-2015,3,17688,16811,7972,1953,44425,763,727,212,1702,46127
12-03-2015,4,18517,16899,8113,1969,45498,756,738,212,1706,47204
12-03-2015,5,19520,18186,8669,2371,48746,858,1112,224,2194,50940
12-03-2015,6,21400,20013,9103,2999,53515,1050,1080,239,2369,55884
12-03-2015,7,21906,21210,9415,3827,56357,1007,1634,672,3313,59670
12-03-2015,8,22048,20708,9455,3850,56060,1015,1612,710,3337,59397
12-03-2015,9,22044,20414,9181,3638,55278,1019,1548,653,3220,58498
12-03-2015,10,21962,20219,9003,3375,54559,1001,1498,580,3079,57638
12-03-2015,11,21548,19872,9039,3786,54246,996,1113,327,2436,56682
12-03-2015,12,21383,19513,8661,3436,52995,1009,1078,251,2338,55333
12-03-2015,13,21112,19464,8425,3363,52364,1055,1073,246,2374,54738
12-03-2015,14,20988,19547,8607,3308,52450,1051,1073,244,2368,54818
12-03-2015,15,20945,19665,8661,2865,52136,1051,1063,245,2359,54495
12-03-2015,16,20907,19746,8677,2684,52014,1049,1087,226,2362,54376
12-03-2015,17,21228,20075,8962,2815,53081,1025,1216,261,2502,55583
12-03-2015,18,21703,20530,9266,3114,54615,1067,1614,352,3033,57648
12-03-2015,19,22044,20673,8991,3490,55197,1005,1113,436,2554,57751
12-03-2015,20,21193,20820,8383,2887,53284,957,1115,310,2382,55666
12-03-2015,21,20188,20430,8107,2700,51427,886,1095,316,2297,53724
12-03-2015,22,19403,19713,8002,2652,49770,886,724,338,1948,51718
12-03-2015,23,18107,18431,7836,2634,47007,833,715,315,1863,48870
13-03-2015,0,16373,17323,7767,2405,43869,799,719,335,1853,45722
13-03-2015,1,15807,17081,7719,2393,43001,809,723,328,1860,44861
13-03-2015,2,15632,17031,7738,2361,42764,823,724,322,1869,44633
13-03-2015,3,15817,17236,7830,2351,43235,814,711,323,1848,45083
13-03-2015,4,16821,17530,8068,2303,44721,818,713,325,1856,46577
13-03-2015,5,17985,18887,8755,2458,48085,897,1027,375,2299,50384
13-03-2015,6,20083,21023,9341,2686,53135,992,1040,380,2412,55547
13-03-2015,7,22023,22449,9550,3388,57410,988,1062,648,2698,60108
13-03-2015,8,22294,21743,9373,3897,57306,955,1149,831,2935,60241
13-03-2015,9,21872,21361,9286,4109,56628,968,1079,776,2823,59451
13-03-2015,10,21127,21658,8947,3868,55600,976,1050,753,2779,58379
13-03-2015,11,20022,21679,8623,3698,54023,1006,1031,663,2700,56723
13-03-2015,12,18848,20730,8225,3611,51414,1036,1012,412,2460,53874
13-03-2015,13,17863,20499,8113,3573,50049,1043,1011,428,2482,52531
13-03-2015,14,17688,20564,8303,3406,49961,1053,1004,462,2519,52480
13-03-2015,15,17552,20816,8314,3290,49971,1039,841,508,2388,52359
13-03-2015,16,17277,21099,8461,3315,50152,1034,841,468,2343,52495
13-03-2015,17,18435,21193,8718,3256,51603,1031,899,672,2602,54205
13-03-2015,18,19969,21523,8960,2998,53452,1057,1061,729,2847,56299
13-03-2015,19,20298,21589,8738,2977,53602,924,856,344,2124,55726
13-03-2015,20,19159,21356,8243,2957,51716,818,856,328,2002,53718
13-03-2015,21,18556,20350,8002,2898,49808,786,836,334,1956,51764
13-03-2015,22,17937,19782,7927,2953,48599,761,549,303,1613,50212
13-03-2015,23,17118,19085,7772,2864,46840,764,547,284,1595,48435
14-03-2015,0,15908,18161,7772,2899,44741,723,446,275,1444,46185
14-03-2015,1,15506,17694,7700,2925,43825,699,437,260,1396,45221
14-03-2015,2,15225,17426,7701,2896,43248,686,436,255,1377,44625
14-03-2015,3,15148,17366,7707,2933,43154,677,441,264,1382,44536
14-03-2015,4,15292,17505,7763,3059,43619,663,442,248,1353,44972
14-03-2015,5,15457,17678,7873,3239,44250,646,540,231,1417,45667
14-03-2015,6,15689,18129,8043,3351,45213,630,554,226,1410,46623
14-03-2015,7,16663,19212,8045,3483,47405,617,642,232,1491,48896
14-03-2015,8,17350,20486,7882,3588,49307,634,758,227,1619,50926
14-03-2015,9,17644,20969,7774,3894,50282,642,760,222,1624,51906
14-03-2015,10,17266,20732,7621,4254,49874,660,761,230,1651,51525
14-03-2015,11,16599,20272,7511,4314,48696,744,657,228,1629,50325
14-03-2015,12,16005,19801,7494,4270,47569,721,652,230,1603,49172
14-03-2015,13,15580,19367,7444,4166,46556,708,637,236,1581,48137
14-03-2015,14,15235,19386,7386,3949,45956,697,643,237,1577,47533
14-03-2015,15,14960,19405,7392,3972,45730,706,650,245,1601,47331
14-03-2015,16,15355,19550,7615,3982,46501,710,650,229,1589,48090
14-03-2015,17,16696,20172,7986,3766,48621,818,751,245,1814,50435
14-03-2015,18,18362,20679,8243,3618,50901,845,1075,237,2157,53058
14-03-2015,19,18148,21162,8255,3570,51134,849,751,240,1840,52974
14-03-2015,20,17103,20741,8031,3279,49154,848,646,224,1718,50872
14-03-2015,21,16571,20129,7893,3211,47805,821,543,228,1592,49397
14-03-2015,22,16063,19573,7813,3227,46675,761,444,240,1445,48120
14-03-2015,23,15617,18683,7611,3259,45171,730,448,241,1419,46590
15-03-2015,0,15066,17571,7532,3124,43294,732,440,240,1412,44706
15-03-2015,1,14677,17166,7551,3158,42551,731,433,241,1405,43956
15-03-2015,2,14278,17089,7544,3159,42071,731,452,245,1428,43499
15-03-2015,3,14223,16874,7560,3182,41839,711,441,253,1405,43244
15-03-2015,4,14275,16892,7629,3222,42019,711,468,251,1430,43449
15-03-2015,5,14535,17003,7655,3190,42383,717,462,256,1435,43818
15-03-2015,6,14447,17424,7701,3185,42758,701,457,245,1403,44161
15-03-2015,7,14911,17791,7735,3242,43678,687,547,253,1487,45165
15-03-2015,8,15711,18507,7925,3343,45487,694,656,242,1592,47079
15-03-2015,9,16416,19095,7877,3427,46815,697,649,234,1580,48395
15-03-2015,10,16232,19343,7629,3671,46874,685,646,243,1574,48448
15-03-2015,11,15711,19130,7522,3827,46191,687,549,239,1475,47666
15-03-2015,12,15312,18690,7539,3699,45240,650,546,231,1427,46667
15-03-2015,13,14805,18784,7445,4052,45086,650,552,218,1420,46506
15-03-2015,14,13797,18335,7394,4193,43719,664,554,221,1439,45158
15-03-2015,15,14677,18509,7379,4092,44657,686,555,225,1466,46123
15-03-2015,16,15442,19113,7506,3920,45980,709,562,229,1500,47480
15-03-2015,17,16696,19515,7784,3865,47860,763,626,258,1647,49507
15-03-2015,18,18441,19794,8021,3805,50060,828,865,240,1933,51993
15-03-2015,19,18649,19910,8033,3793,50385,827,797,258,1882,52267
15-03-2015,20,17522,19660,7999,3810,48992,867,552,301,1720,50712
15-03-2015,21,16848,19392,8016,3825,48082,804,459,265,1528,49610
15-03-2015,22,15567,18840,7949,3712,46069,790,452,239,1481,47550
15-03-2015,23,13901,17928,7852,3609,43290,773,362,227,1362,44652
16-03-2015,0,12261,16643,7711,3461,40077,809,534,213,1556,41633
16-03-2015,1,12216,16252,7625,3423,39516,802,536,219,1557,41073
16-03-2015,2,11834,16156,7596,3526,39112,784,537,250,1571,40683
16-03-2015,3,12239,16264,7744,3610,39858,763,535,249,1547,41405
16-03-2015,4,13253,16676,8082,3698,41709,754,640,238,1632,43341
16-03-2015,5,16096,17713,8716,3967,46491,857,710,504,2071,48562
16-03-2015,6,18190,19652,9070,4153,51067,902,900,504,2306,53373
16-03-2015,7,20310,21224,9360,4210,55104,892,1004,484,2380,57484
16-03-2015,8,20842,21381,9307,4381,55911,880,1228,461,2569,58480
16-03-2015,9,20192,21054,9196,4469,54912,875,1191,421,2487,57399
16-03-2015,10,20104,20910,8948,4589,54551,871,1131,427,2429,56980
16-03-2015,11,18856,20863,8823,4718,53261,897,1138,461,2496,55757
16-03-2015,12,16972,20697,8329,4962,50958,876,916,388,2180,53138
16-03-2015,13,16737,20468,8192,5072,50469,867,901,375,2143,52612
16-03-2015,14,17182,20462,8529,5081,51254,904,983,391,2278,53532
16-03-2015,15,17616,20701,8447,4918,51682,903,956,407,2266,53948
16-03-2015,16,17430,20764,8531,4892,51618,905,947,387,2239,53857
16-03-2015,17,18145,20974,8846,4725,52691,915,999,402,2316,55007
16-03-2015,18,19138,21253,8972,4549,53911,934,1368,456,2758,56669
16-03-2015,19,19265,21250,8723,4438,53678,922,1028,324,2274,55952
16-03-2015,20,18196,20733,8329,4303,51560,796,896,276,1968,53528
16-03-2015,21,17398,20056,8130,4078,49662,801,648,351,1800,51462
16-03-2015,22,16248,19054,8025,3972,47299,803,610,277,1690,48989
16-03-2015,23,14579,18024,7992,4002,44597,786,619,343,1748,46345
17-03-2015,0,13469,17001,7872,3923,42265,777,567,273,1617,43882
17-03-2015,1,13185,16746,7813,3835,41578,772,561,286,1619,43197
17-03-2015,2,12984,16844,7858,3827,41516,800,560,285,1645,43161
17-03-2015,3,13756,16925,7792,3573,42046,807,562,283,1652,43698
17-03-2015,4,14299,17359,8018,3668,43342,802,562,279,1643,44985
17-03-2015,5,15929,18293,8589,3440,46251,881,880,304,2065,48316
17-03-2015,6,18199,20085,9161,3469,50914,943,897,410,2250,53164
17-03-2015,7,20343,21729,9301,3718,55091,925,1048,481,2454,57545
17-03-2015,8,20946,21672,9083,3943,55644,897,1292,450,2639,58283
17-03-2015,9,20680,21601,8980,3922,55183,899,1169,415,2483,57666
17-03-2015,10,20570,21655,8847,3912,54985,900,1169,284,2353,57338
17-03-2015,11,19932,21261,8591,3930,53716,919,1075,319,2313,56029
17-03-2015,12,19327,20976,8032,3746,52081,879,871,269,2019,54100
17-03-2015,13,19016,20785,7963,3720,51483,768,889,260,1917,53400
17-03-2015,14,19080,20693,8275,3602,51650,853,933,426,2212,53862
17-03-2015,15,19174,20702,8307,3388,51571,877,918,449,2244,53815
17-03-2015,16,19278,20863,8364,3326,51832,859,871,445,2175,54007
17-03-2015,17,19497,21339,8813,3505,53154,883,1099,256,2238,55392
17-03-2015,18,20089,21510,9024,3763,54387,873,1256,499,2628,57015
17-03-2015,19,20388,21587,8699,3535,54210,850,1143,292,2285,56495
17-03-2015,20,19657,21172,8082,2910,51821,738,896,325,1959,53780
17-03-2015,21,19089,20255,7862,2831,50039,727,736,318,1781,51820
17-03-2015,22,17948,19184,7771,2810,47714,740,598,281,1619,49333
17-03-2015,23,16265,18040,7740,2734,44778,787,539,279,1605,46383
18-03-2015,0,15099,16724,7634,2704,42162,804,608,277,1689,43851
18-03-2015,1,14934,16217,7585,2685,41422,826,647,256,1729,43151
18-03-2015,2,14894,16142,7538,2646,41220,843,644,237,1724,42944
18-03-2015,3,15015,16148,7557,2698,41417,821,645,230,1696,43113
18-03-2015,4,16061,16590,7744,2692,43086,823,731,229,1783,44869
18-03-2015,5,17988,17652,8239,2763,46642,980,865,254,2099,48741
18-03-2015,6,19826,19962,8745,3104,51637,1202,968,298,2468,54105
18-03-2015,7,21941,20964,8883,3702,55490,1298,1063,469,2830,58320
18-03-2015,8,22371,20880,8826,3700,55777,1304,1165,467,2936,58713
18-03-2015,9,21688,20380,8676,3385,54129,1300,1150,460,2910,57039
18-03-2015,10,21491,19883,8505,3182,53062,1299,1158,394,2851,55913
18-03-2015,11,20508,19898,8268,3335,52010,1305,1022,421,2748,54758
18-03-2015,12,19711,19756,7724,3219,50410,1311,952,329,2592,53002
18-03-2015,13,19479,19620,7458,3255,49813,1301,945,288,2534,52347
18-03-2015,14,19883,19410,7615,3232,50142,1300,1015,382,2697,52839
18-03-2015,15,20220,19458,7661,3217,50557,1286,979,383,2648,53205
18-03-2015,16,20248,19831,7742,3320,51140,1284,968,364,2616,53756
18-03-2015,17,20443,19992,8169,3643,52247,1296,1132,276,2704,54951
18-03-2015,18,21310,20391,8610,3639,53951,1291,1173,435,2899,56850
18-03-2015,19,21296,20579,8294,3778,53948,1283,1175,214,2672,56620
18-03-2015,20,20019,20412,7912,3606,51950,1282,911,284,2477,54427
18-03-2015,21,19463,19856,7781,3199,50299,1172,718,299,2189,52488
18-03-2015,22,18782,18839,7581,2803,48004,1030,642,185,1857,49861
18-03-2015,23,17910,17723,7467,2424,45525,955,629,177,1761,47286
19-03-2015,0,16521,16797,7524,2346,43189,923,618,171,1712,44901
19-03-2015,1,16054,16726,7558,2272,42611,938,620,167,1725,44336
19-03-2015,2,16007,16622,7565,2268,42461,934,623,164,1721,44182
19-03-2015,3,16198,16776,7673,2265,42912,958,630,171,1759,44671
19-03-2015,4,16898,17102,7769,2278,44049,967,719,178,1864,45913
19-03-2015,5,18312,18362,8064,2649,47389,1095,864,175,2134,49523
19-03-2015,6,19634,20502,8591,3224,51951,1274,1063,176,2513,54464
19-03-2015,7,21246,21425,9071,3671,55412,1308,1148,338,2794,58206
19-03-2015,8,21268,21232,8990,3561,55052,1298,1356,458,3112,58164
19-03-2015,9,21781,20906,8588,3503,54778,1294,1225,364,2883,57661
19-03-2015,10,21589,21021,8353,3568,54532,1306,1203,295,2804,57336
19-03-2015,11,21266,21154,8232,3188,53840,1260,1053,407,2720,56560
19-03-2015,12,20720,20935,7818,3173,52644,1311,1054,186,2551,55195
19-03-2015,13,20339,20898,7706,3132,52074,1300,1057,188,2545,54619
19-03-2015,14,20272,20994,7873,3029,52168,1365,1046,275,2686,54854
19-03-2015,15,20037,20906,7994,3182,52119,1360,1074,238,2672,54791
19-03-2015,16,20463,20943,8052,3319,52778,1348,1077,200,2625,55403
19-03-2015,17,21043,21043,8429,3504,54019,1312,1198,196,2706,56725
19-03-2015,18,21710,21167,8678,3506,55061,1354,1211,304,2869,57930
19-03-2015,19,21591,21132,8402,3456,54581,1274,1205,228,2707,57288
19-03-2015,20,20851,20984,8057,2799,52691,1106,1012,177,2295,54986
19-03-2015,21,20489,20106,8029,2844,51466,1086,774,177,2037,53503
19-03-2015,22,19661,19239,7817,2311,49027,1011,664,171,1846,50873
19-03-2015,23,18257,18332,7699,2127,46416,971,639,174,1784,48200
20-03-2015,0,16809,17121,7714,2317,43960,905,473,177,1555,45515
20-03-2015,1,16319,16692,7639,2234,42883,887,460,177,1524,44407
20-03-2015,2,16128,16444,7666,2005,42244,880,462,185,1527,43771
20-03-2015,3,16405,16264,7706,2044,42420,852,458,189,1499,43919
20-03-2015,4,17441,16668,7766,2174,44050,855,547,192,1594,45644
20-03-2015,5,18567,18087,8394,2405,47454,982,696,276,1954,49408
20-03-2015,6,19805,20421,8802,3137,52166,1038,860,312,2210,54376
20-03-2015,7,21817,21250,9191,3310,55568,1093,925,613,2631,58199
20-03-2015,8,21965,21127,9155,3622,55870,1101,1031,610,2742,58612
20-03-2015,9,21810,20819,9067,3296,54992,1115,1036,431,2582,57574
20-03-2015,10,21846,21043,9134,3790,55813,1137,1274,671,3082,58895
20-03-2015,11,21351,21147,9294,4019,55812,1128,902,498,2528,58340
20-03-2015,12,20064,20968,8596,3360,52989,1061,919,376,2356,55345
20-03-2015,13,20339,20677,8357,2959,52332,1050,902,363,2315,54647
20-03-2015,14,20657,21036,8520,3194,53409,1091,901,423,2415,55824
20-03-2015,15,20211,21441,8504,3586,53742,1111,902,390,2403,56145
20-03-2015,16,19928,21602,8680,3699,53909,1115,902,354,2371,56280
20-03-2015,17,20535,21402,9079,3884,54901,1118,1045,308,2471,57372
20-03-2015,18,20639,21499,9398,4219,55755,1108,1240,671,3019,58774
20-03-2015,19,20387,21546,9124,3735,54792,1110,1023,314,2447,57239
20-03-2015,20,19351,21151,8382,3362,52247,907,832,398,2137,54384
20-03-2015,21,18785,20219,8180,3198,50381,931,603,310,1844,52225
20-03-2015,22,18106,19252,8053,2966,48377,939,472,232,1643,50020
20-03-2015,23,17222,18342,7946,2728,46238,914,447,168,1529,47767
21-03-2015,0,15962,16881,7920,2299,43064,859,429,213,1501,44565
21-03-2015,1,15436,16693,7897,2206,42232,857,427,160,1444,43676
21-03-2015,2,15104,16841,7901,2024,41869,855,428,158,1441,43310
21-03-2015,3,15068,17193,7939,1931,42131,885,433,155,1473,43604
21-03-2015,4,15139,17610,7889,2013,42651,893,437,160,1490,44141
21-03-2015,5,14983,17928,8008,2303,43222,932,514,165,1611,44833
21-03-2015,6,14857,18763,8138,2712,44470,932,556,200,1688,46158
21-03-2015,7,15741,19251,8200,3146,46338,947,729,203,1879,48217
21-03-2015,8,16753,20110,8160,3908,48931,949,844,252,2045,50976
21-03-2015,9,17283,20385,8200,4534,50402,976,880,258,2114,52516
21-03-2015,10,16993,20346,8135,4759,50232,969,894,263,2126,52358
21-03-2015,11,16348,20183,8102,4862,49496,960,859,290,2109,51605
21-03-2015,12,15879,19882,8002,4995,48758,981,855,269,2105,50863
21-03-2015,13,15273,19497,7976,5004,47751,982,775,309,2066,49817
21-03-2015,14,15054,19223,8007,5151,47437,1013,752,305,2070,49507
21-03-2015,15,15300,19246,8127,5123,47797,1020,671,359,2050,49847
21-03-2015,16,15571,19654,8242,4885,48352,1009,671,345,2025,50377
21-03-2015,17,16808,20144,8366,4507,49824,990,752,364,2106,51930
21-03-2015,18,18322,20821,8497,4208,51849,1000,903,378,2281,54130
21-03-2015,19,19043,20882,8378,4184,52488,995,899,380,2274,54762
21-03-2015,20,18367,20509,8280,3957,51113,975,681,380,2036,53149
21-03-2015,21,18243,20045,8225,3706,50219,981,532,354,1867,52086
21-03-2015,22,17747,19478,8075,3202,48502,965,481,292,1738,50240
21-03-2015,23,15795,18544,7921,2799,45059,939,461,278,1678,46737
22-03-2015,0,15710,16599,7809,2419,42540,900,438,241,1579,44119
22-03-2015,1,15332,16159,7778,2148,41419,881,437,238,1556,42975
22-03-2015,2,14932,16138,7780,2046,40895,881,437,221,1539,42434
22-03-2015,3,15044,16346,7803,1957,41149,860,441,226,1527,42676
22-03-2015,4,15102,16446,7887,1905,41341,852,432,223,1507,42848
22-03-2015,5,14990,16784,8018,1966,41759,841,384,216,1441,43200
22-03-2015,6,14059,17421,8136,2016,41632,828,467,207,1502,43134
22-03-2015,7,14696,17929,8054,2217,42898,810,537,219,1566,44464
22-03-2015,8,16571,18671,8242,2456,45941,823,633,266,1722,47663
22-03-2015,9,18003,19513,8470,2819,48806,824,633,333,1790,50596
22-03-2015,10,17568,20313,8414,3374,49670,834,633,352,1819,51489
22-03-2015,11,18411,20433,8418,3400,50662,843,624,360,1827,52489
22-03-2015,12,17869,20474,8465,3370,50179,856,629,358,1843,52022
22-03-2015,13,17145,20495,8445,3376,49462,907,547,431,1885,51347
22-03-2015,14,16608,20357,8367,3222,48555,935,565,442,1942,50497
22-03-2015,15,16698,20158,8337,3005,48197,966,562,392,1920,50117
22-03-2015,16,17432,20385,8421,2811,49049,967,612,422,2001,51050
22-03-2015,17,19663,21726,8448,3080,52917,996,725,429,2150,55067
22-03-2015,18,21414,22203,8693,3072,55383,1009,885,440,2334,57717
22-03-2015,19,21544,22308,8752,3148,55753,1014,852,445,2311,58064
22-03-2015,20,19864,21978,8330,3159,53332,1000,701,477,2178,55510
22-03-2015,21,18921,21210,8258,3009,51398,1002,487,489,1978,53376
22-03-2015,22,17741,20532,8123,2827,49224,999,479,274,1752,50976
22-03-2015,23,16163,19650,7904,3011,46729,984,470,260,1714,48443
23-03-2015,0,14852,18924,7799,3151,44726,943,367,321,1631,46357
23-03-2015,1,14071,18327,7733,3223,43353,914,370,303,1587,44940
23-03-2015,2,13977,17973,7677,3242,42869,904,366,286,1556,44425
23-03-2015,3,14090,18022,7736,3293,43140,908,374,276,1558,44698
23-03-2015,4,15113,18095,7902,3312,44422,932,396,309,1637,46059
23-03-2015,5,16699,19077,8360,3338,47476,1048,644,281,1973,49449
23-03-2015,6,18413,21446,8789,3408,52056,1092,791,483,2366,54422
23-03-2015,7,21532,22435,9035,3677,56680,1095,911,564,2570,59250
23-03-2015,8,22158,22583,9139,3847,57729,1101,1120,574,2795,60524
23-03-2015,9,21776,22547,9078,4183,57585,1112,1116,547,2775,60360
23-03-2015,10,20924,22980,9046,4596,57545,1141,1097,571,2809,60354
23-03-2015,11,20572,22100,9120,4819,56611,1152,999,679,2830,59441
23-03-2015,12,20329,21467,8701,4498,54994,1156,1006,401,2563,57557
23-03-2015,13,19981,21572,8518,4605,54678,1116,1007,410,2533,57211
23-03-2015,14,19074,22153,8962,4566,54754,1161,1004,466,2631,57385
23-03-2015,15,18800,21590,8955,4423,53768,1166,998,396,2560,56328
23-03-2015,16,18971,21676,8769,4199,53615,1163,1016,581,2760,56375
23-03-2015,17,19881,21708,8746,3939,54274,1166,1133,655,2954,57228
23-03-2015,18,20726,22006,8850,3710,55292,1159,1257,779,3195,58487
23-03-2015,19,21406,22237,8443,3374,55461,1152,1116,369,2637,58098
23-03-2015,20,20650,22149,7994,3274,54067,1053,937,332,2322,56389
23-03-2015,21,19989,21629,7814,2886,52317,1013,667,319,1999,54316
23-03-2015,22,18690,20928,7783,2522,49923,990,484,290,1764,51687
23-03-2015,23,16998,19982,7655,2261,46896,996,480,274,1750,48646
24-03-2015,0,16367,18424,7547,2097,44436,995,476,262,1733,46169
24-03-2015,1,15932,18054,7510,2037,43533,991,476,254,1721,45254
24-03-2015,2,15873,18200,7510,1938,43521,998,475,269,1742,45263
24-03-2015,3,16230,18114,7542,1919,43807,978,480,261,1719,45526
24-03-2015,4,17224,18218,7636,1939,45016,1005,478,261,1744,46760
24-03-2015,5,18891,18858,7941,2059,47751,987,834,295,2116,49867
24-03-2015,6,20645,20814,8378,2676,52514,1088,1085,281,2454,54968
24-03-2015,7,22597,21618,8638,3582,56437,1133,1095,483,2711,59148
24-03-2015,8,22691,21535,8705,3828,56760,1136,1294,673,3103,59863
24-03-2015,9,22171,21257,8660,3833,55922,1148,1245,544,2937,58859
24-03-2015,10,21722,21107,8496,3740,55065,1334,1186,484,3004,58069
24-03-2015,11,20874,20918,8476,3513,53779,1268,1074,272,2614,56393
24-03-2015,12,19957,20646,8151,3342,52095,1174,1024,244,2442,54537
24-03-2015,13,19516,20395,8160,3422,51494,1218,986,224,2428,53922
24-03-2015,14,19045,20659,8388,3448,51540,1092,1087,266,2445,53985
24-03-2015,15,19344,20614,8484,3621,52065,1085,1068,229,2382,54447
24-03-2015,16,19359,20694,8453,3675,52180,1150,1063,203,2416,54596
24-03-2015,17,20249,20658,8605,3879,53390,1052,1055,518,2625,56015
24-03-2015,18,21487,20810,8836,4077,55210,1225,1349,641,3215,58425
24-03-2015,19,21405,20821,8978,4006,55209,1153,1156,687,2996,58205
24-03-2015,20,21303,20556,8664,3414,53939,1073,904,184,2161,56100
24-03-2015,21,21068,20303,8432,2709,52514,1018,549,254,1821,54335
24-03-2015,22,20080,19666,8347,2433,50529,840,544,173,1557,52086
24-03-2015,23,18774,18484,8114,2004,47375,819,451,151,1421,48796
25-03-2015,0,18264,16899,7923,1656,44742,834,445,156,1435,46177
25-03-2015,1,17879,16558,7737,1574,43748,830,447,158,1435,45183
25-03-2015,2,17643,16400,7678,1547,43267,826,453,163,1442,44709
25-03-2015,3,17706,16438,7714,1564,43421,816,463,174,1453,44874
25-03-2015,4,18264,17038,7861,1633,44795,858,479,183,1520,46315
25-03-2015,5,18763,18357,8438,1735,47292,1093,906,189,2188,49480
25-03-2015,6,20536,20393,8666,1789,51385,1180,1075,426,2681,54066
25-03-2015,7,22895,21557,8825,2448,55725,1189,1263,602,3054,58779
25-03-2015,8,23168,21900,8810,3043,56921,1188,1373,602,3163,60084
25-03-2015,9,22944,21229,8820,3034,56029,1200,1220,595,3015,59044
25-03-2015,10,22782,21247,8727,3093,55851,1408,1141,398,2947,58798
25-03-2015,11,22110,21115,8571,3380,55176,1401,1080,444,2925,58101
25-03-2015,12,21497,21190,8213,3473,54375,1365,1005,175,2545,56920
25-03-2015,13,21286,21054,8069,3652,54063,1382,1011,165,2558,56621
25-03-2015,14,20744,20922,8247,3664,53576,1413,1111,322,2846,56422
25-03-2015,15,20581,20755,8344,3851,53530,1191,1128,371,2690,56220
25-03-2015,16,20375,20855,8447,4064,53742,1191,1124,289,2604,56346
25-03-2015,17,20580,21049,8726,4310,54666,1208,1120,461,2789,57455
25-03-2015,18,20956,21468,8828,4503,55754,1427,1311,637,3375,59129
25-03-2015,19,20974,21598,8597,4787,55955,1351,1104,277,2732,58687
25-03-2015,20,19659,21479,8324,5068,54531,991,960,286,2237,56768
25-03-2015,21,18909,20799,8265,4944,52917,981,593,269,1843,54760
25-03-2015,22,18299,19747,8200,4581,50825,971,477,249,1697,52522
25-03-2015,23,16939,18993,8179,4159,48271,982,461,258,1701,49972
26-03-2015,0,15263,18567,7989,3996,45816,920,458,268,1646,47462
26-03-2015,1,14395,18603,7914,4020,44932,914,458,270,1642,46574
26-03-2015,2,14500,18527,7923,3756,44707,913,461,291,1665,46372
26-03-2015,3,14875,18678,7939,3470,44963,923,466,278,1667,46630
26-03-2015,4,15723,19021,8022,3340,46107,953,469,288,1710,47817
26-03-2015,5,17769,20021,8409,3223,49422,1053,802,302,2157,51579
26-03-2015,6,20358,21598,8919,3148,54024,1050,1043,317,2410,56434
26-03-2015,7,22454,23147,9010,3470,58082,1041,1133,539,2713,60795
26-03-2015,8,22975,23725,8987,3718,59406,1050,1226,600,2876,62282
26-03-2015,9,22732,23586,8862,3780,58960,1063,1145,524,2732,61692
26-03-2015,10,22990,23285,8743,3942,58960,1276,1152,301,2729,61689
26-03-2015,11,22334,23266,8667,3997,58264,1064,1067,457,2588,60852
26-03-2015,12,21922,22881,8450,3811,57064,1077,1057,252,2386,59450
26-03-2015,13,21792,22830,8281,3767,56670,1065,1053,258,2376,59046
26-03-2015,14,21983,22564,8362,3446,56355,1257,1150,293,2700,59055
26-03-2015,15,22062,22739,8475,3247,56524,1071,1173,293,2537,59061
26-03-2015,16,22441,22957,8814,3496,57706,1028,1174,299,2501,60207
26-03-2015,17,22344,22202,9028,3468,57043,1107,1259,290,2656,59699
26-03-2015,18,22630,22243,9079,3308,57260,1143,1459,635,3237,60497
26-03-2015,19,22703,22106,9125,3275,57209,1262,1498,291,3051,60260
26-03-2015,20,22027,21776,8946,2959,55707,1121,1156,280,2557,58264
26-03-2015,21,21589,20737,8558,2466,53351,985,757,293,2035,55386
26-03-2015,22,20473,19830,8294,2330,50928,994,478,292,1764,52692
26-03-2015,23,18611,18994,8181,2197,47984,1010,468,279,1757,49741
27-03-2015,0,17869,17650,8058,1981,45559,958,344,248,1550,47109
27-03-2015,1,17426,17250,8030,1898,44605,955,345,230,1530,46135
27-03-2015,2,17279,17123,8037,1825,44264,972,343,219,1534,45798
27-03-2015,3,17521,17010,8013,1803,44347,965,344,204,1513,45860
27-03-2015,4,18281,17254,8121,1829,45484,969,353,200,1522,47006
27-03-2015,5,19468,18320,8719,1843,48349,994,653,203,1850,50199
27-03-2015,6,21206,20088,9125,2045,52462,1116,815,223,2154,54616
27-03-2015,7,23099,20718,9115,2887,55820,1347,985,448,2780,58600
27-03-2015,8,23395,20031,9211,3593,56230,1137,1262,607,3006,59236
27-03-2015,9,23640,19791,9077,3545,56053,1256,1203,479,2938,58991
27-03-2015,10,23544,19743,9080,3430,55797,1345,1040,462,2847,58644
27-03-2015,11,23474,19815,9016,3007,55312,1337,849,525,2711,58023
27-03-2015,12,22596,19792,8844,2653,53885,1181,796,483,2460,56345
27-03-2015,13,22195,19617,8461,2642,52917,1340,766,397,2503,55420
27-03-2015,14,21723,19724,8918,2676,53041,1215,905,339,2459,55500
27-03-2015,15,21300,19853,9026,2637,52816,1100,875,297,2272,55088
27-03-2015,16,20873,20195,8965,2677,52710,1088,1003,254,2345,55055
27-03-2015,17,21226,20458,9066,2847,53597,1084,977,372,2433,56030
27-03-2015,18,22194,20639,9155,2964,54954,1078,1079,630,2787,57741
27-03-2015,19,22477,20605,8892,2926,54902,1047,994,285,2326,57228
27-03-2015,20,21317,20110,8326,2836,52590,916,676,373,1965,54555
27-03-2015,21,20454,19562,8049,2872,50938,840,526,252,1618,52556
27-03-2015,22,19435,18760,7826,2789,48811,796,414,180,1390,50201
27-03-2015,23,18342,17979,7622,2773,46714,743,411,197,1351,48065
28-03-2015,0,18465,16001,7573,2713,44753,699,334,196,1229,45982
28-03-2015,1,18254,15331,7492,2557,43635,694,322,202,1218,44853
28-03-2015,2,18164,15123,7410,2425,43123,696,322,185,1203,44326
28-03-2015,3,18344,15033,7333,2347,43057,684,327,178,1189,44246
28-03-2015,4,18419,15429,7320,2396,43563,688,358,175,1221,44784
28-03-2015,5,18326,15817,7400,2424,43968,664,394,183,1241,45209
28-03-2015,6,18638,15794,7549,2305,44286,633,489,285,1407,45693
28-03-2015,7,19391,16906,7697,2393,46387,616,556,393,1565,47952
28-03-2015,8,19367,18581,7831,2648,48426,621,672,393,1686,50112
28-03-2015,9,20162,18638,7847,2810,49458,634,728,389,1751,51209
28-03-2015,10,20038,18364,7747,2752,48902,675,725,405,1805,50707
28-03-2015,11,18980,17687,7639,3149,47455,656,706,385,1747,49202
28-03-2015,12,17995,16864,7577,3584,46020,681,563,414,1658,47678
28-03-2015,13,16881,16675,7496,3982,45036,671,532,430,1633,46669
28-03-2015,14,16176,16860,7497,4250,44783,676,512,408,1596,46379
28-03-2015,15,15654,16866,7508,4396,44424,668,514,422,1604,46028
28-03-2015,16,16435,16834,7785,4513,45567,642,518,406,1566,47133
28-03-2015,17,17569,17836,8064,4768,48236,633,629,401,1663,49899
28-03-2015,18,17662,18944,8185,4783,49574,620,968,407,1995,51569
28-03-2015,19,17201,18918,8179,5123,49422,630,704,437,1771,51193
28-03-2015,20,15940,18505,7681,5286,47412,639,569,434,1642,49054
28-03-2015,21,14469,17849,7738,5468,45525,643,453,315,1411,46936
28-03-2015,22,13481,17705,7516,5261,43966,626,375,152,1153,45119
28-03-2015,23,12636,17354,7201,4861,42053,585,373,151,1109,43162
29-03-2015,0,12469,15672,7136,4228,39505,560,318,152,1030,40535
29-03-2015,1,12126,15277,7106,3710,38219,556,337,148,1041,39260
29-03-2015,2,,,,,,696,,,,
29-03-2015,3,11767,15121,7046,3347,37280,562,340,160,1062,38342
29-03-2015,4,11550,15456,7099,3058,37163,569,344,156,1069,38232
29-03-2015,5,11822,15543,7172,2875,37410,579,350,157,1086,38496
29-03-2015,6,12249,15981,7321,2816,38366,592,342,161,1095,39461
29-03-2015,7,11833,16494,7383,2553,38263,580,396,190,1166,39429
29-03-2015,8,13199,16892,7559,2606,40258,589,496,195,1280,41538
29-03-2015,9,14451,17900,7723,2632,42707,658,519,215,1392,44099
29-03-2015,10,15694,18176,7799,2743,44413,672,587,276,1535,45948
29-03-2015,11,15861,18320,7899,2971,45052,686,538,318,1542,46594
29-03-2015,12,15710,18392,7911,3064,45076,698,520,342,1560,46636
29-03-2015,13,15159,18307,7926,3262,44653,708,456,357,1521,46174
29-03-2015,14,14812,18067,7949,3446,44273,721,456,323,1500,45773
29-03-2015,15,14668,17874,7966,3397,43904,721,449,322,1492,45396
29-03-2015,16,14908,17798,8010,3189,43906,727,449,319,1495,45401
29-03-2015,17,15475,18035,8167,2879,44557,739,533,310,1582,46139
29-03-2015,18,16687,18369,8155,2769,45979,788,506,299,1593,47572
29-03-2015,19,17752,18975,8327,2479,47533,821,646,313,1780,49313
29-03-2015,20,17883,19239,8277,2363,47763,833,584,299,1716,49479
29-03-2015,21,16912,18191,8141,2279,45522,801,403,311,1515,47037
29-03-2015,22,16277,17240,8077,2235,43829,766,338,270,1374,45203
29-03-2015,23,15260,16160,7914,2208,41541,756,348,260,1364,42905
30-03-2015,0,13839,14852,7762,2383,38836,746,298,279,1323,40159
30-03-2015,1,13491,14335,7809,2790,38425,731,297,295,1323,39748
30-03-2015,2,12913,13975,7716,3181,37786,743,298,310,1351,39137
30-03-2015,3,12938,13913,7685,3110,37647,746,274,316,1336,38983
30-03-2015,4,13613,14058,7776,3351,38797,754,294,324,1372,40169
30-03-2015,5,14463,15232,8032,3547,41275,921,431,348,1700,42975
30-03-2015,6,16894,17822,8522,3858,47097,1168,806,437,2411,49508
30-03-2015,7,19862,19114,8976,4239,52190,1179,1128,578,2885,55075
30-03-2015,8,20888,19732,9031,4395,54047,1171,1316,586,3073,57120
30-03-2015,9,20281,19790,8994,4681,53746,1203,1432,572,3207,56953
30-03-2015,10,19459,19760,8978,5154,53350,1204,1428,559,3191,56541
30-03-2015,11,18754,19670,8904,5649,52977,1199,1340,561,3100,56077
30-03-2015,12,17476,19650,8730,5494,51351,1191,1433,575,3199,54550
30-03-2015,13,17387,19212,8579,5524,50701,1189,945,353,2487,53188
30-03-2015,14,16953,18951,8456,5691,50052,1172,939,363,2474,52526
30-03-2015,15,16740,18713,8587,5634,49676,1191,1223,565,2979,52655
30-03-2015,16,16705,18652,8388,5536,49281,1197,1147,617,2961,52242
30-03-2015,17,16425,19129,8335,5647,49538,1199,1056,553,2808,52346
30-03-2015,18,16672,19275,8306,5880,50134,1180,1223,558,2961,53095
30-03-2015,19,17830,19682,8362,5492,51365,1193,1433,478,3104,54469
30-03-2015,20,18171,19990,8136,5181,51479,1071,881,372,2324,53803
30-03-2015,21,18190,19423,7812,5156,50582,929,619,375,1923,52505
30-03-2015,22,17628,18564,7919,4807,48919,891,459,374,1724,50643
30-03-2015,23,15011,17675,7653,4428,44766,882,450,370,1702,46468
31-03-2015,0,13550,16607,7734,4159,42050,884,336,366,1586,43636
31-03-2015,1,13345,15914,7667,3850,40775,928,347,362,1637,42412
31-03-2015,2,12900,15823,7656,4110,40488,942,352,357,1651,42139
31-03-2015,3,12685,15733,7677,3951,40046,941,358,358,1657,41703
31-03-2015,4,13406,15899,7743,3728,40776,957,369,355,1681,42457
31-03-2015,5,14843,16909,7863,3842,43458,1057,542,357,1956,45414
31-03-2015,6,17096,18750,8299,4476,48621,1287,846,360,2493,51114
31-03-2015,7,18846,20100,8594,4790,52332,1298,982,398,2678,55010
31-03-2015,8,20486,20882,8751,4747,54865,1317,1002,376,2695,57560
31-03-2015,9,20204,20972,8750,4728,54654,1349,1065,361,2775,57429
31-03-2015,10,20203,20697,8600,4770,54271,1338,1086,410,2834,57105
31-03-2015,11,19553,20608,8560,4644,53365,1307,958,458,2723,56088
31-03-2015,12,19074,19969,8618,4615,52274,1290,944,368,2602,54876
31-03-2015,13,18785,19617,8183,4499,51083,1273,888,240,2401,53484
31-03-2015,14,18557,19287,8240,4258,50343,1219,884,229,2332,52675
31-03-2015,15,18408,19264,8474,4114,50261,1253,971,249,2473,52734
31-03-2015,16,18078,19261,8438,4460,50237,1270,918,222,2410,52647
31-03-2015,17,18173,19393,8459,4513,50538,1256,929,224,2409,52947
31-03-2015,18,17950,19519,8530,4524,50523,1219,1116,214,2549,53072
31-03-2015,19,17608,19437,8546,4290,49880,1195,1359,302,2856,52736
31-03-2015,20,18004,19640,8389,4340,50373,1000,956,235,2191,52564
31-03-2015,21,17217,19154,8161,4311,48843,879,677,236,1792,50635
31-03-2015,22,16702,17894,7964,3862,46422,855,578,247,1680,48102
31-03-2015,23,15787,16901,7755,3403,43848,860,523,109,1492,45340
01-04-2015,0,14926,15849,7717,3667,42157,793,285,97,1175,43332
01-04-2015,1,14470,15459,7667,3845,41442,783,291,88,1162,42604
01-04-2015,2,13841,15355,7600,3825,40621,786,292,85,1163,41784
01-04-2015,3,13388,15140,7651,3983,40162,809,295,82,1186,41348
01-04-2015,4,13824,15162,7729,4123,40837,857,331,78,1266,42103
01-04-2015,5,14987,16479,8076,4382,43923,971,583,79,1633,45556
01-04-2015,6,16456,18818,8536,4732,48541,1352,956,329,2637,51178
01-04-2015,7,18482,20199,8731,5124,52536,1366,1213,480,3059,55595
01-04-2015,8,19202,20339,8895,5758,54195,1354,1257,523,3134,57329
01-04-2015,9,18603,20355,8930,6062,53949,1359,1247,528,3134,57083
01-04-2015,10,17730,20089,8920,6363,53103,1357,1224,528,3109,56212
01-04-2015,11,17195,19824,8860,6183,52061,1333,1021,533,2887,54948
01-04-2015,12,16446,19376,8702,6147,50669,1281,1073,565,2919,53588
01-04-2015,13,16147,19017,8588,6206,49959,1292,1050,581,2923,52882
01-04-2015,14,15682,18349,8214,6184,48430,1142,710,253,2105,50535
01-04-2015,15,15401,18223,8110,6224,47959,1092,770,232,2094,50053
01-04-2015,16,15130,18510,8212,6157,48008,1268,739,452,2459,50467
01-04-2015,17,15609,18863,8365,6243,49080,1343,769,397,2509,51589
01-04-2015,18,16626,19241,8523,5648,50037,1329,963,332,2624,52661
01-04-2015,19,17115,19623,8575,5183,50496,1309,1207,436,2952,53448
01-04-2015,20,17508,19905,8165,5037,50615,1080,818,134,2032,52647
01-04-2015,21,17070,19249,7983,5001,49302,932,672,107,1711,51013
01-04-2015,22,16390,18378,7903,4690,47361,853,550,93,1496,48857
01-04-2015,23,14013,17504,7775,4406,43699,840,489,90,1419,45118
02-04-2015,0,13574,16935,7625,4097,42231,787,371,82,1240,43471
02-04-2015,1,12339,16412,7536,3785,40073,791,375,81,1247,41320
02-04-2015,2,12263,16072,7474,3765,39574,803,375,125,1303,40877
02-04-2015,3,12796,15991,7477,3676,39940,810,386,118,1314,41254
02-04-2015,4,13405,16502,7468,3642,41018,815,422,87,1324,42342
02-04-2015,5,14771,17773,7787,3602,43935,884,630,96,1610,45545
02-04-2015,6,16443,19816,8394,3807,48462,1216,929,305,2450,50912
02-04-2015,7,17548,21159,8703,4009,51419,1248,1150,375,2773,54192
02-04-2015,8,18248,21396,8857,4377,52878,1243,1244,571,3058,55936
02-04-2015,9,17627,21627,8686,5085,53023,1242,1362,593,3197,56220
02-04-2015,10,17212,21395,8687,5473,52767,1248,1308,504,3060,55827
02-04-2015,11,16700,20857,8788,5289,51634,1258,1072,452,2782,54416
02-04-2015,12,16112,20230,8646,5241,50230,1244,1261,469,2974,53204
02-04-2015,13,15705,19381,8541,5157,48784,1238,1099,428,2765,51549
02-04-2015,14,15135,18786,8142,5018,47082,1114,686,284,2084,49166
02-04-2015,15,14432,18195,7923,5137,45689,1046,856,235,2137,47826
02-04-2015,16,13858,18643,8247,4987,45735,1083,920,367,2370,48105
02-04-2015,17,14784,18944,8349,4963,47040,1052,923,360,2335,49375
02-04-2015,18,15978,19181,8575,4675,48409,1083,935,364,2382,50791
02-04-2015,19,16892,19826,8608,4043,49368,1157,1088,381,2626,51994
02-04-2015,20,17349,20122,8180,3920,49569,839,892,142,1873,51442
02-04-2015,21,16604,19942,7881,3762,48191,718,716,138,1572,49763
02-04-2015,22,15487,19387,7692,3709,46275,610,614,128,1352,47627
02-04-2015,23,13958,18410,7598,3610,43576,702,603,128,1433,45009
03-04-2015,0,12831,16858,7457,3411,40557,607,355,113,1075,41632
03-04-2015,1,11983,16600,7300,3351,39233,577,350,107,1034,40267
03-04-2015,2,11852,16176,7296,3050,38374,574,352,102,1028,39402
03-04-2015,3,12017,16003,7284,3079,38383,569,357,100,1026,39409
03-04-2015,4,12131,16098,7305,3123,38655,574,354,94,1022,39677
03-04-2015,5,12434,16813,7416,3154,39816,576,360,88,1024,40840
03-04-2015,6,12814,17826,7626,3111,41377,594,764,285,1643,43020
03-04-2015,7,13943,18916,7773,3261,43891,719,767,357,1843,45734
03-04-2015,8,14854,19864,7784,3353,45855,819,813,349,1981,47836
03-04-2015,9,14705,19852,7797,3867,46221,818,884,354,2056,48277
03-04-2015,10,14637,19400,7928,3863,45829,803,903,359,2065,47894
03-04-2015,11,14471,19009,7977,3652,45108,794,876,317,1987,47095
03-04-2015,12,14146,18738,7896,3515,44293,807,839,359,2005,46298
03-04-2015,13,13761,18563,7767,3396,43488,813,859,361,2033,45521
03-04-2015,14,13119,18748,7573,3255,42695,766,616,198,1580,44275
03-04-2015,15,12984,18681,7523,3222,42410,732,622,160,1514,43924
03-04-2015,16,13426,18830,7718,3031,43004,791,809,296,1896,44900
03-04-2015,17,14754,19306,7964,3051,45075,761,830,320,1911,46986
03-04-2015,18,16407,19476,8099,2885,46867,800,829,273,1902,48769
03-04-2015,19,17623,19375,8283,2585,47865,796,906,325,2027,49892
03-04-2015,20,17958,19653,7945,2765,48322,706,747,268,1721,50043
03-04-2015,21,17769,19245,7680,2798,47492,695,558,261,1514,49006
03-04-2015,22,17436,18852,7564,2792,46644,699,368,213,1280,47924
03-04-2015,23,16721,17949,7486,2795,44949,724,413,92,1229,46178
04-04-2015,0,16483,16685,7401,2373,42943,723,539,100,1362,44305
04-04-2015,1,15975,16307,7425,2186,41894,726,539,96,1361,43255
04-04-2015,2,15910,16238,7288,2069,41507,745,538,95,1378,42885
04-04-2015,3,15451,15836,7267,2087,40642,752,543,86,1381,42023
04-04-2015,4,14761,15806,7322,2061,39950,767,543,89,1399,41349
04-04-2015,5,15550,16313,7416,2086,41364,781,544,92,1417,42781
04-04-2015,6,15689,17235,7462,2188,42576,784,545,90,1419,43995
04-04-2015,7,16999,17871,7487,2121,44477,757,726,77,1560,46037
04-04-2015,8,18311,18558,7597,2266,46733,742,817,86,1645,48378
04-04-2015,9,18900,19224,7563,2420,48106,765,818,85,1668,49774
04-04-2015,10,18687,19363,7529,2643,48221,776,820,91,1687,49908
04-04-2015,11,18153,18939,7549,2858,47499,812,818,72,1702,49201
04-04-2015,12,16899,18638,7553,2819,45911,807,819,75,1701,47612
04-04-2015,13,15612,18661,7463,2856,44592,781,818,94,1693,46285
04-04-2015,14,14772,18555,7453,2899,43678,759,642,114,1515,45193
04-04-2015,15,14491,18315,7414,2936,43156,785,644,89,1518,44674
04-04-2015,16,14242,18254,7439,2863,42799,810,661,81,1552,44351
04-04-2015,17,15863,18344,7416,3012,44634,843,842,83,1768,46402
04-04-2015,18,16884,18311,7459,2939,45593,826,840,97,1763,47356
04-04-2015,19,17717,18332,7568,2634,46252,790,824,103,1717,47969
04-04-2015,20,18188,18639,7676,2528,47032,780,800,101,1681,48713
04-04-2015,21,18107,18679,7688,2391,46866,783,702,64,1549,48415
04-04-2015,22,17404,18403,7575,2497,45881,784,562,69,1415,47296
04-04-2015,23,16828,17694,7575,2262,44360,767,559,68,1394,45754
05-04-2015,0,16269,16792,7432,2227,42719,728,511,62,1301,44020
05-04-2015,1,15784,15926,7367,2110,41186,722,510,79,1311,42497
05-04-2015,2,15075,15802,7318,2133,40328,705,506,56,1267,41595
05-04-2015,3,14383,15518,7265,1997,39163,701,522,50,1273,40436
05-04-2015,4,13441,15460,7289,1863,38051,701,524,80,1305,39356
05-04-2015,5,13877,15652,7390,1828,38746,707,517,53,1277,40023
05-04-2015,6,13435,16008,7379,1813,38636,709,586,50,1345,39981
05-04-2015,7,13802,16686,7365,1860,39714,706,455,172,1333,41047
05-04-2015,8,15457,17308,7409,2170,42344,704,577,170,1451,43795
05-04-2015,9,15393,17724,7393,2288,42799,754,647,149,1550,44349
05-04-2015,10,15322,17723,7341,2497,42883,764,650,121,1535,44418
05-04-2015,11,14971,17665,7268,2670,42574,768,516,214,1498,44072
05-04-2015,12,14017,17416,7277,2874,41583,751,502,171,1424,43007
05-04-2015,13,13464,17285,7251,2983,40983,745,502,153,1400,42383
05-04-2015,14,13063,16897,7098,3017,40075,760,503,132,1395,41470
05-04-2015,15,13019,16680,7068,2945,39711,743,503,108,1354,41065
05-04-2015,16,13387,16769,7074,2778,40009,738,503,107,1348,41357
05-04-2015,17,14114,17159,7120,2564,40958,738,506,118,1362,42320
05-04-2015,18,16252,17846,7255,2631,43984,706,643,82,1431,45415
05-04-2015,19,17461,18206,7375,2502,45544,780,616,129,1525,47069
05-04-2015,20,18712,18553,7587,2449,47303,795,634,198,1627,48930
05-04-2015,21,18618,18731,7505,2337,47191,745,650,89,1484,48675
05-04-2015,22,17710,18350,7541,2285,45885,738,512,56,1306,47191
05-04-2015,23,16525,17624,7517,2218,43884,725,516,78,1319,45203
06-04-2015,0,16226,16380,7448,1893,41946,787,582,64,1433,43379
06-04-2015,1,14604,15554,7433,1766,39357,771,582,67,1420,40777
06-04-2015,2,13212,15385,7458,1726,37780,761,491,73,1325,39105
06-04-2015,3,13125,15301,7484,1744,37654,761,496,77,1334,38988
06-04-2015,4,13653,15405,7588,1791,38438,755,496,64,1315,39753
06-04-2015,5,13970,15939,7694,1852,39455,775,460,61,1296,40751
06-04-2015,6,14136,16533,7699,1830,40198,789,591,67,1447,41645
06-04-2015,7,14722,17490,7852,1912,41976,880,650,133,1663,43639
06-04-2015,8,15640,18723,7887,2098,44347,878,670,297,1845,46192
06-04-2015,9,16230,18762,7909,2380,45282,878,731,288,1897,47179
06-04-2015,10,17002,19047,7882,2499,46431,873,803,290,1966,48397
06-04-2015,11,17538,19240,7885,2592,47254,857,867,275,1999,49253
06-04-2015,12,16794,19039,7740,2615,46188,859,850,269,1978,48166
06-04-2015,13,14995,18548,7627,2281,43451,871,791,268,1930,45381
06-04-2015,14,14097,18255,7572,2082,42008,881,676,141,1698,43706
06-04-2015,15,13821,18187,7561,1934,41503,889,715,125,1729,43232
06-04-2015,16,14392,18159,7616,1892,42058,884,824,246,1954,44012
06-04-2015,17,15039,18586,7635,1885,43147,870,862,279,2011,45158
06-04-2015,18,17251,19305,7742,1907,46203,855,994,246,2095,48298
06-04-2015,19,18116,19986,7801,2069,47972,871,995,310,2176,50148
06-04-2015,20,18186,20043,7696,2128,48053,871,766,311,1948,50001
06-04-2015,21,17296,20003,7705,2222,47226,829,651,190,1670,48896
06-04-2015,22,16739,19205,7555,2277,45776,801,602,63,1466,47242
06-04-2015,23,15380,18439,7452,2518,43789,798,586,58,1442,45231
07-04-2015,0,13930,17453,7479,2726,41587,817,609,52,1478,43065
07-04-2015,1,13314,17146,7500,2894,40855,811,609,49,1469,42324
07-04-2015,2,12885,17070,7442,2893,40291,851,587,53,1491,41782
07-04-2015,3,12466,17117,7433,3097,40113,878,594,59,1531,41644
07-04-2015,4,12342,17581,7430,3303,40657,906,561,64,1531,42188
07-04-2015,5,13184,18633,7642,3456,42915,988,615,67,1670,44585
07-04-2015,6,15624,19897,8040,3646,47207,1168,1198,320,2686,49893
07-04-2015,7,18151,21177,8120,3848,51297,1310,1264,471,3045,54342
07-04-2015,8,19408,21822,8226,4065,53522,1384,1201,491,3076,56598
07-04-2015,9,19370,21915,8206,4100,53589,1303,1314,494,3111,56700
07-04-2015,10,19128,21642,8152,4179,53101,1300,1214,511,3025,56126
07-04-2015,11,18463,21291,8124,4277,52155,1281,1202,539,3022,55177
07-04-2015,12,17639,20966,8124,4227,50956,1279,1151,590,3020,53976
07-04-2015,13,17243,20602,7993,4335,50173,1255,1148,547,2950,53123
07-04-2015,14,16814,20388,7658,4321,49181,1181,757,301,2239,51420
07-04-2015,15,16815,20302,7495,4378,48990,1137,753,262,2152,51142
07-04-2015,16,15777,19810,7807,4300,47694,1204,944,369,2517,50211
07-04-2015,17,16696,20026,7737,4292,48750,1230,932,357,2519,51269
07-04-2015,18,16972,20181,7849,4184,49187,1203,1015,332,2550,51737
07-04-2015,19,16849,20270,7930,4037,49087,1226,1210,364,2800,51887
07-04-2015,20,17500,20517,7747,3887,49651,1000,825,228,2053,51704
07-04-2015,21,16765,19996,7603,3782,48146,992,782,49,1823,49969
07-04-2015,22,15038,19367,7549,3852,45805,957,617,48,1622,47427
07-04-2015,23,13579,18301,7385,3853,43117,951,619,44,1614,44731
08-04-2015,0,12624,17002,7332,3951,40908,886,620,40,1546,42454
08-04-2015,1,12071,16543,7339,3884,39838,914,619,42,1575,41413
08-04-2015,2,11928,16472,7324,3859,39583,921,619,43,1583,41166
08-04-2015,3,11963,16535,7352,3825,39675,956,612,45,1613,41288
08-04-2015,4,12351,16740,7367,3823,40282,983,616,53,1652,41934
08-04-2015,5,13466,17893,7517,3810,42687,1017,624,210,1851,44538
08-04-2015,6,16348,19183,8001,3783,47314,1159,935,328,2422,49736
08-04-2015,7,19181,20660,8326,3714,51883,1222,1082,448,2752,54635
08-04-2015,8,19732,21302,8321,3704,53061,1301,1030,478,2809,55870
08-04-2015,9,19710,21328,8452,3856,53346,1186,1017,462,2665,56011
08-04-2015,10,19613,21423,8355,3725,53116,1201,977,471,2649,55765
08-04-2015,11,19496,21345,8366,3318,52526,1202,966,421,2589,55115
08-04-2015,12,19528,21218,8236,2942,51924,1164,950,430,2544,54468
08-04-2015,13,19440,21312,8166,2770,51689,1141,934,375,2450,54139
08-04-2015,14,18931,21278,7756,2765,50732,1090,825,158,2073,52805
08-04-2015,15,18319,21159,7661,2670,49809,1069,827,201,2097,51906
08-04-2015,16,17429,21071,8148,3130,49781,1056,890,384,2330,52111
08-04-2015,17,17107,20964,8491,3615,50177,1039,900,373,2312,52489
08-04-2015,18,17111,20932,8517,3067,49628,1129,872,368,2369,51997
08-04-2015,19,17682,21153,8549,2963,50347,1139,951,326,2416,52763
08-04-2015,20,17792,21154,8629,3128,50704,1067,817,184,2068,52772
08-04-2015,21,17489,20639,8527,3152,49807,1034,795,117,1946,51753
08-04-2015,22,17044,19955,8064,2771,47833,1030,661,165,1856,49689
08-04-2015,23,16419,19179,7621,2144,45362,1025,676,109,1810,47172
09-04-2015,0,15992,17351,7569,2104,43016,1043,618,111,1772,44788
09-04-2015,1,15279,17056,7506,2082,41923,1028,621,117,1766,43689
09-04-2015,2,14878,16970,7451,2002,41302,1026,624,122,1772,43074
09-04-2015,3,14787,17071,7470,2008,41336,992,627,127,1746,43082
09-04-2015,4,15179,17534,7429,2110,42252,967,627,145,1739,43991
09-04-2015,5,15986,18852,7590,2385,44815,939,720,147,1806,46621
09-04-2015,6,17353,20923,8083,2913,49273,1010,919,366,2295,51568
09-04-2015,7,18923,22393,8384,3668,53370,1079,993,486,2558,55928
09-04-2015,8,19094,22171,8652,4026,53944,1085,1094,500,2679,56623
09-04-2015,9,19088,21783,8435,3803,53110,1095,1048,495,2638,55748
09-04-2015,10,18869,21563,8309,3834,52575,1147,1000,455,2602,55177
09-04-2015,11,18479,21636,8266,3747,52127,1084,950,442,2476,54603
09-04-2015,12,18227,21588,8037,3621,51473,1077,960,434,2471,53944
09-04-2015,13,17768,21243,7924,3409,50344,1121,943,419,2483,52827
09-04-2015,14,17505,21592,7396,3397,49890,1069,881,272,2222,52112
09-04-2015,15,17231,21425,7542,3486,49685,1002,842,261,2105,51790
09-04-2015,16,17298,21362,7685,3607,49952,966,930,330,2226,52178
09-04-2015,17,17531,21430,7782,3600,50345,988,926,319,2233,52578
09-04-2015,18,17562,21649,7953,3625,50787,1034,919,287,2240,53027
09-04-2015,19,17638,21621,8126,3569,50955,1028,948,357,2333,53288
09-04-2015,20,17578,21463,8004,3422,50465,941,834,196,1971,52436
09-04-2015,21,17469,20977,7743,3357,49547,936,790,163,1889,51436
09-04-2015,22,16681,20739,7543,2962,47923,941,659,158,1758,49681
09-04-2015,23,15847,19332,7361,2392,44932,957,646,162,1765,46697
10-04-2015,0,15302,17449,7350,2127,42229,940,618,175,1733,43962
10-04-2015,1,15122,16573,7330,1892,40918,934,620,152,1706,42624
10-04-2015,2,15021,16075,7265,1849,40210,936,618,134,1688,41898
10-04-2015,3,15003,15998,7212,1848,40063,924,609,117,1650,41713
10-04-2015,4,15278,16641,7258,1933,41110,923,626,108,1657,42767
10-04-2015,5,15756,18097,7753,2388,43995,1035,707,95,1837,45832
10-04-2015,6,16953,20115,8379,2728,48177,1323,919,330,2572,50749
10-04-2015,7,18119,21196,8646,3391,51350,1338,1166,351,2855,54205
10-04-2015,8,18142,20976,8829,3172,51120,1317,1187,353,2857,53977
10-04-2015,9,18495,21008,8715,2879,51098,1317,1215,340,2872,53970
10-04-2015,10,18541,21265,8635,2864,51305,1314,1146,346,2806,54111
10-04-2015,11,18124,21295,8656,3023,51100,1339,1015,340,2694,53794
10-04-2015,12,17528,21517,8577,3006,50629,1381,1007,342,2730,53359
10-04-2015,13,17059,21342,8398,2729,49530,1391,982,364,2737,52267
10-04-2015,14,16648,20989,7916,2402,47955,1323,727,301,2351,50306
10-04-2015,15,16282,20767,7725,2406,47179,1322,684,305,2311,49490
10-04-2015,16,16144,20517,7996,2425,47083,1424,875,295,2594,49677
10-04-2015,17,16346,20508,8074,3147,48074,1428,876,281,2585,50659
10-04-2015,18,16163,20691,8226,2922,48003,1415,865,262,2542,50545
10-04-2015,19,16297,21297,8026,2719,48340,1278,917,253,2448,50788
10-04-2015,20,16597,21052,7856,2152,47658,893,811,214,1918,49576
10-04-2015,21,16418,20282,7550,2059,46309,844,740,225,1809,48118
10-04-2015,22,15577,19314,7315,1861,44066,855,668,105,1628,45694
10-04-2015,23,14651,18430,7071,2045,42195,872,660,109,1641,43836
11-04-2015,0,14984,15759,6920,1956,39619,969,425,100,1494,41113
11-04-2015,1,14664,15041,6836,2031,38571,944,423,94,1461,40032
11-04-2015,2,14436,14676,6846,2101,38060,922,422,83,1427,39487
11-04-2015,3,14274,14368,6879,2151,37672,898,427,69,1394,39066
11-04-2015,4,14167,14283,6950,2263,37664,893,428,60,1381,39045
11-04-2015,5,14266,14330,6967,2267,37831,918,428,55,1401,39232
11-04-2015,6,14634,14907,7021,2251,38812,868,445,68,1381,40193
11-04-2015,7,15538,16114,7219,2322,41194,856,463,110,1429,42623
11-04-2015,8,16256,17048,7465,2417,43187,880,549,114,1543,44730
11-04-2015,9,16866,17439,7619,2525,44449,878,600,109,1587,46036
11-04-2015,10,16145,18458,7558,2786,44947,875,584,114,1573,46520
11-04-2015,11,14863,17992,7403,2890,43148,878,576,108,1562,44710
11-04-2015,12,14056,16333,7271,2918,40578,897,550,88,1535,42113
11-04-2015,13,13702,15681,7152,3088,39624,902,659,91,1652,41276
11-04-2015,14,13293,15497,7160,3411,39361,899,618,103,1620,40981
11-04-2015,15,12747,15458,7179,3629,39013,911,552,158,1621,40634
11-04-2015,16,12740,15381,7302,3856,39280,911,615,85,1611,40891
11-04-2015,17,12958,15471,7426,4281,40136,899,597,116,1612,41748
11-04-2015,18,13372,15628,7567,4403,40970,888,695,38,1621,42591
11-04-2015,19,13385,15953,7307,4574,41219,901,702,92,1695,42914
11-04-2015,20,13926,16295,7110,4778,42110,903,754,84,1741,43851
11-04-2015,21,13544,16155,6897,4713,41309,897,599,133,1629,42938
11-04-2015,22,12385,15399,6810,4991,39585,882,438,116,1436,41021
11-04-2015,23,11199,15281,6776,4927,38182,840,448,146,1434,39616
12-04-2015,0,10381,14357,6852,4276,35866,794,491,145,1430,37296
12-04-2015,1,10183,13896,6810,4054,34943,790,441,178,1409,36352
12-04-2015,2,9996,13926,6755,3976,34652,800,438,166,1404,36056
12-04-2015,3,9807,14101,6788,4315,35013,776,430,177,1383,36396
12-04-2015,4,9948,14258,6808,4333,35348,796,434,169,1399,36747
12-04-2015,5,10018,14344,6905,4196,35464,808,420,170,1398,36862
12-04-2015,6,10188,14121,6988,4019,35316,809,441,224,1474,36790
12-04-2015,7,10574,14766,6939,3991,36270,793,450,246,1489,37759
12-04-2015,8,10644,15653,7014,4205,37517,773,544,252,1569,39086
12-04-2015,9,11676,16140,7097,4688,39600,795,527,254,1576,41176
12-04-2015,10,12558,16653,7127,4882,41220,788,539,255,1582,42802
12-04-2015,11,12285,16843,7066,4598,40790,802,573,255,1630,42420
12-04-2015,12,11793,16748,7071,4396,40008,825,562,273,1660,41668
12-04-2015,13,11313,16649,7009,4329,39300,875,561,273,1709,41009
12-04-2015,14,11081,16890,6940,4180,39092,852,559,273,1684,40776
12-04-2015,15,11177,16894,6951,4105,39127,830,533,273,1636,40763
12-04-2015,16,11524,16830,6954,4039,39345,825,552,253,1630,40975
12-04-2015,17,11912,17387,7281,4441,41022,830,536,250,1616,42638
12-04-2015,18,12756,18232,7469,4151,42607,827,644,243,1714,44321
12-04-2015,19,13827,19039,7628,3852,44345,883,646,234,1763,46108
12-04-2015,20,14631,19563,7687,3184,45066,901,644,224,1769,46835
12-04-2015,21,14666,20179,7326,2841,45014,911,620,204,1735,46749
12-04-2015,22,13866,19401,7087,2828,43181,892,559,207,1658,44839
12-04-2015,23,12069,17487,6850,3035,39443,873,512,189,1574,41017
13-04-2015,0,10893,15142,6764,3269,36066,779,562,185,1526,37592
13-04-2015,1,10862,14649,6690,3747,35948,762,557,138,1457,37405
13-04-2015,2,10375,14786,6545,4059,35767,774,546,134,1454,37221
13-04-2015,3,10273,14639,6498,4181,35590,749,547,123,1419,37009
13-04-2015,4,10574,14982,6772,4205,36533,766,595,148,1509,38042
13-04-2015,5,11260,16311,7037,4424,39033,860,704,176,1740,40773
13-04-2015,6,14199,18510,7608,5198,45515,1015,877,308,2200,47715
13-04-2015,7,16557,20087,7909,5404,49955,1044,1188,458,2690,52645
13-04-2015,8,16882,20301,7979,5641,50804,1024,1316,511,2851,53655
13-04-2015,9,16567,20395,7955,5693,50611,1000,1391,447,2838,53449
13-04-2015,10,16013,20560,7975,5766,50314,974,1355,422,2751,53065
13-04-2015,11,15324,20446,7943,5956,49669,973,1323,447,2743,52412
13-04-2015,12,14499,20584,7822,5917,48822,961,1326,459,2746,51568
13-04-2015,13,14245,20351,7842,6197,48635,957,1220,454,2631,51266
13-04-2015,14,14345,19929,7498,5900,47673,925,943,238,2106,49779
13-04-2015,15,14055,19492,7334,5840,46721,919,879,241,2039,48760
13-04-2015,16,14459,19841,7576,5746,47622,966,995,394,2355,49977
13-04-2015,17,14709,19826,7567,5221,47322,998,990,400,2388,49710
13-04-2015,18,15051,19666,7619,4918,47255,1056,1068,383,2507,49762
13-04-2015,19,15768,20144,7630,4559,48100,1086,979,343,2408,50508
13-04-2015,20,17054,19993,7598,3912,48556,1025,890,153,2068,50624
13-04-2015,21,17633,19691,7323,3499,48145,990,787,173,1950,50095
13-04-2015,22,16436,19174,7188,3213,46012,1024,617,123,1764,47776
13-04-2015,23,15146,18455,7110,3042,43753,1034,633,100,1767,45520
14-04-2015,0,13248,17583,7117,2964,40912,1028,463,96,1587,42499
14-04-2015,1,12818,17437,7135,2849,40239,1035,450,101,1586,41825
14-04-2015,2,12906,17141,7206,2678,39930,1045,420,112,1577,41507
14-04-2015,3,13306,17095,7215,2698,40314,1031,436,111,1578,41892
14-04-2015,4,13616,17230,7282,2717,40845,1027,497,147,1671,42516
14-04-2015,5,14780,18164,7460,2934,43337,1077,673,108,1858,45195
14-04-2015,6,17295,19890,7750,3169,48105,1090,879,337,2306,50411
14-04-2015,7,19101,20434,8171,4127,51834,1100,1072,452,2624,54458
14-04-2015,8,19024,20353,8239,4722,52338,1114,1565,549,3228,55566
14-04-2015,9,18767,20114,8204,4876,51961,1143,1198,490,2831,54792
14-04-2015,10,18661,19868,8182,4874,51586,1145,1049,391,2585,54171
14-04-2015,11,18105,19615,8086,4935,50741,1127,1044,393,2564,53305
14-04-2015,12,17323,19427,8035,5031,49816,1136,1061,392,2589,52405
14-04-2015,13,17088,19226,7941,5214,49469,1146,933,432,2511,51980
14-04-2015,14,16663,19269,7532,5102,48567,1134,707,381,2222,50789
14-04-2015,15,16204,19613,7232,5122,48171,1142,708,363,2213,50384
14-04-2015,16,15651,20044,7527,4983,48205,1113,885,354,2352,50557
14-04-2015,17,16131,20345,7580,5115,49169,1070,890,370,2330,51499
14-04-2015,18,16346,20399,7559,4887,49190,1029,896,368,2293,51483
14-04-2015,19,16409,20342,7636,4461,48847,1012,936,331,2279,51126
14-04-2015,20,16548,20068,7595,4229,48441,973,839,157,1969,50410
14-04-2015,21,16326,19570,7401,4050,47347,961,844,133,1938,49285
14-04-2015,22,14835,19097,7309,3737,44977,946,664,158,1768,46745
14-04-2015,23,13138,18008,7234,3611,41991,924,648,158,1730,43721
15-04-2015,0,11708,17030,7066,3525,39328,885,470,185,1540,40868
15-04-2015,1,11967,16695,7049,3531,39241,876,476,242,1594,40835
15-04-2015,2,11478,16500,7037,3238,38252,857,494,225,1576,39828
15-04-2015,3,11879,16310,7074,3077,38340,818,526,236,1580,39920
15-04-2015,4,12988,16389,7091,2945,39412,811,532,169,1512,40924
15-04-2015,5,14088,17260,7228,3129,41707,847,644,186,1677,43384
15-04-2015,6,16877,18895,7679,3443,46894,953,987,365,2305,49199
15-04-2015,7,19165,19793,7891,3820,50668,995,1277,502,2774,53442
15-04-2015,8,19885,20069,7833,4251,52038,1010,1439,516,2965,55003
15-04-2015,9,19022,19877,7759,4528,51188,1023,1370,507,2900,54088
15-04-2015,10,18489,19875,7846,4745,50956,1020,1301,484,2805,53761
15-04-2015,11,17470,19561,7710,4956,49698,1025,1282,535,2842,52540
15-04-2015,12,16519,19253,7644,5170,48587,1021,1275,483,2779,51366
15-04-2015,13,16095,18990,7525,5232,47844,1014,1193,565,2772,50616
15-04-2015,14,15828,18658,7251,5338,47076,1011,983,311,2305,49381
15-04-2015,15,15675,18371,7165,5462,46672,985,990,323,2298,48970
15-04-2015,16,15538,18639,7379,5366,46920,980,939,412,2331,49251
15-04-2015,17,15363,18676,7453,5497,46989,976,1027,374,2377,49366
15-04-2015,18,15735,18980,7501,5446,47662,983,1120,401,2504,50166
15-04-2015,19,15688,19073,7560,5137,47456,978,1161,475,2614,50070
15-04-2015,20,15957,19274,7254,4639,47124,934,1047,485,2466,49590
15-04-2015,21,15378,18916,7314,4616,46223,917,963,481,2361,48584
15-04-2015,22,14305,18368,7290,4673,44636,889,665,480,2034,46670
15-04-2015,23,12623,17791,7213,4440,42067,877,508,481,1866,43933
16-04-2015,0,11738,16872,7066,4175,39851,763,443,503,1709,41560
16-04-2015,1,11162,16628,6990,4010,38791,770,410,509,1689,40480
16-04-2015,2,10935,16507,7037,3970,38449,777,365,509,1651,40100
16-04-2015,3,11236,16410,7114,3996,38757,792,420,507,1719,40476
16-04-2015,4,11889,16556,7165,4140,39751,869,472,475,1816,41567
16-04-2015,5,13416,17533,7399,4251,42599,908,682,460,2050,44649
16-04-2015,6,16556,18340,7883,4294,47072,981,1042,468,2491,49563
16-04-2015,7,18456,19777,8145,4557,50936,981,1163,633,2777,53713
16-04-2015,8,19131,19750,8308,5002,52190,991,1303,662,2956,55146
16-04-2015,9,18441,19410,8276,5202,51330,963,1346,562,2871,54201
16-04-2015,10,18500,19201,8118,5299,51118,958,1266,571,2795,53913
16-04-2015,11,17849,19043,8045,5167,50104,981,1180,566,2727,52831
16-04-2015,12,17061,18666,8017,5397,49142,1004,1114,635,2753,51895
16-04-2015,13,16681,18469,7978,5423,48549,1009,1149,476,2634,51183
16-04-2015,14,16315,18393,7561,5486,47756,989,973,462,2424,50180
16-04-2015,15,15956,18595,7464,5533,47547,1003,905,465,2373,49920
16-04-2015,16,15415,18638,7805,5528,47387,983,1019,480,2482,49869
16-04-2015,17,15887,18530,7913,5328,47659,969,1041,452,2462,50121
16-04-2015,18,16410,18444,7911,5059,47825,955,1125,439,2519,50344
16-04-2015,19,16727,18379,7928,4509,47543,953,1107,518,2578,50121
16-04-2015,20,17546,18761,7735,4025,48067,995,993,426,2414,50481
16-04-2015,21,17492,18805,7762,3637,47696,942,749,409,2100,49796
16-04-2015,22,16067,18447,7752,3381,45647,938,620,382,1940,47587
16-04-2015,23,14464,17516,7617,3241,42838,911,447,369,1727,44565
17-04-2015,0,13252,16770,7509,3060,40590,855,439,340,1634,42224
17-04-2015,1,12673,16447,7466,3061,39647,862,521,334,1717,41364
17-04-2015,2,12650,16442,7457,2971,39521,832,470,345,1647,41168
17-04-2015,3,12943,16363,7494,2834,39634,833,463,352,1648,41282
17-04-2015,4,13564,16421,7560,2742,40287,865,483,338,1686,41973
17-04-2015,5,15173,17410,7797,2701,43082,855,645,338,1838,44920
17-04-2015,6,17702,19107,8290,2781,47880,854,996,334,2184,50064
17-04-2015,7,20563,20355,8507,3257,52683,860,1091,600,2551,55234
17-04-2015,8,20923,20320,8566,3877,53685,874,1213,618,2705,56390
17-04-2015,9,20627,20169,8512,3957,53265,954,1190,675,2819,56084
17-04-2015,10,19809,19925,8463,4068,52265,986,1095,637,2718,54983
17-04-2015,11,19360,19583,8537,3788,51268,992,1029,651,2672,53940
17-04-2015,12,18829,19707,8329,3763,50627,957,1035,649,2641,53268
17-04-2015,13,18041,19114,8164,4397,49714,960,1036,492,2488,52202
17-04-2015,14,17314,18895,7730,4427,48366,962,941,428,2331,50697
17-04-2015,15,16781,18302,7528,4520,47133,959,956,438,2353,49486
17-04-2015,16,16198,18479,7667,4543,46888,939,1009,433,2381,49269
17-04-2015,17,16384,18488,7639,4214,46724,927,1027,416,2370,49094
17-04-2015,18,16624,18436,7637,3961,46659,918,1040,376,2334,48993
17-04-2015,19,16903,18427,7577,3424,46330,920,1132,403,2455,48785
17-04-2015,20,17312,18527,7437,2795,46073,884,1024,345,2253,48326
17-04-2015,21,17375,18741,7356,2477,45948,881,828,349,2058,48006
17-04-2015,22,16441,18317,7271,2267,44295,889,631,344,1864,46159
17-04-2015,23,15209,17866,7218,2002,42295,911,534,342,1787,44082
18-04-2015,0,13855,17278,7091,1921,40144,876,465,343,1684,41828
18-04-2015,1,13074,17038,7028,1835,38976,847,449,335,1631,40607
18-04-2015,2,12913,17027,7050,1671,38661,839,472,334,1645,40306
18-04-2015,3,13004,16967,7097,1648,38717,823,476,347,1646,40363
18-04-2015,4,13221,17053,7140,1604,39020,818,473,342,1633,40653
18-04-2015,5,13349,17060,7222,1605,39235,809,486,342,1637,40872
18-04-2015,6,13539,17517,7387,1570,40015,779,601,334,1714,41729
18-04-2015,7,14792,18090,7482,1619,41984,797,795,326,1918,43902
18-04-2015,8,15975,18213,7459,2060,43706,774,725,322,1821,45527
18-04-2015,9,16522,18480,7477,2009,44486,774,704,328,1806,46292
18-04-2015,10,16057,18303,7356,2004,43721,797,684,322,1803,45524
18-04-2015,11,15214,18422,7333,2149,43118,811,674,326,1811,44929
18-04-2015,12,14182,18343,7378,2159,42062,816,649,343,1808,43870
18-04-2015,13,13536,18260,7410,2303,41510,815,593,347,1755,43265
18-04-2015,14,12983,18080,7188,2619,40869,821,594,355,1770,42639
18-04-2015,15,12721,18075,7193,2678,40668,844,573,382,1799,42467
18-04-2015,16,12754,18255,7175,2648,40832,847,565,391,1803,42635
18-04-2015,17,13588,18530,7213,2607,41937,833,559,392,1784,43721
18-04-2015,18,14925,18842,7316,2684,43768,802,606,376,1784,45552
18-04-2015,19,15120,18873,7312,2601,43907,799,730,371,1900,45807
18-04-2015,20,15086,18989,7353,2409,43837,835,799,408,2042,45879
18-04-2015,21,15179,18798,7390,2232,43599,838,723,371,1932,45531
18-04-2015,22,14278,18729,7275,2059,42339,818,619,336,1773,44112
18-04-2015,23,13389,18287,7275,1828,40779,832,660,325,1817,42596
19-04-2015,0,12898,16707,7140,1692,38436,830,404,379,1613,40049
19-04-2015,1,11444,16242,7149,1731,36567,842,365,345,1552,38119
19-04-2015,2,10621,15927,7126,1806,35480,757,365,317,1439,36919
19-04-2015,3,9913,15758,7088,1951,34710,753,368,314,1435,36145
19-04-2015,4,9838,15712,7077,2235,34862,751,369,314,1434,36296
19-04-2015,5,9503,15875,7003,2371,34751,773,501,309,1583,36334
19-04-2015,6,9554,16015,7025,2473,35067,767,539,303,1609,36676
19-04-2015,7,10840,16312,7186,2397,36734,756,445,339,1540,38274
19-04-2015,8,12724,17064,7422,2435,39642,799,625,371,1795,41437
19-04-2015,9,13283,17620,7592,2361,40856,818,673,445,1936,42792
19-04-2015,10,13733,17736,7555,2359,41383,835,647,394,1876,43259
19-04-2015,11,13572,17727,7488,2426,41213,856,649,372,1877,43090
19-04-2015,12,13245,17594,7517,2391,40749,849,512,469,1830,42579
19-04-2015,13,12649,17564,7454,2288,39955,856,514,438,1808,41763
19-04-2015,14,12199,17504,7379,2106,39190,884,521,416,1821,41011
19-04-2015,15,11965,17527,7361,2004,38858,881,525,424,1830,40688
19-04-2015,16,11749,18089,7454,1934,39227,884,528,438,1850,41077
19-04-2015,17,12012,18499,7440,1849,39800,926,528,441,1895,41695
19-04-2015,18,13213,19062,7566,2033,41874,920,549,439,1908,43782
19-04-2015,19,13388,19314,7558,1834,42095,927,737,422,2086,44181
19-04-2015,20,13560,19527,7593,1833,42513,933,800,418,2151,44664
19-04-2015,21,13786,19485,7539,2110,42921,966,780,423,2169,45090
19-04-2015,22,12565,19117,7433,2163,41278,977,473,513,1963,43241
19-04-2015,23,11542,18299,7376,2068,39285,914,383,462,1759,41044
20-04-2015,0,10319,17676,7259,2166,37419,841,449,460,1750,39169
20-04-2015,1,9913,17318,7119,2184,36535,846,448,440,1734,38269
20-04-2015,2,9821,17025,7145,2277,36269,868,468,419,1755,38024
20-04-2015,3,10379,16885,7209,2222,36696,883,448,408,1739,38435
20-04-2015,4,10943,16935,7218,2216,37311,909,465,415,1789,39100
20-04-2015,5,12837,17606,7306,2223,39972,941,624,392,1957,41929
20-04-2015,6,16037,18491,7831,2276,44635,1073,992,384,2449,47084
20-04-2015,7,18245,19943,7916,2309,48413,1082,1418,405,2905,51318
20-04-2015,8,19079,20056,7887,2554,49575,1109,1432,592,3133,52708
20-04-2015,9,18634,19932,7840,2533,48939,1136,1371,626,3133,52072
20-04-2015,10,18307,19603,7735,2538,48185,1135,1381,563,3079,51264
20-04-2015,11,18115,19272,7596,2358,47340,1124,1380,683,3187,50527
20-04-2015,12,17762,19113,7545,2191,46611,1108,1380,680,3168,49779
20-04-2015,13,16972,18453,7481,2251,45157,1106,1329,622,3057,48214
20-04-2015,14,16728,18179,7431,2097,44435,1079,1019,431,2529,46964
20-04-2015,15,16864,18174,7318,2165,44521,1045,1017,428,2490,47011
20-04-2015,16,16642,18062,7355,2268,44326,1067,1084,437,2588,46914
20-04-2015,17,16659,18144,7339,2278,44420,1061,1114,422,2597,47017
20-04-2015,18,16250,18317,7360,2350,44277,1043,1101,397,2541,46818
20-04-2015,19,15911,18136,7456,2445,43950,1055,1220,392,2667,46617
20-04-2015,20,16067,18176,7371,2487,44102,874,1081,374,2329,46431
20-04-2015,21,16667,17704,7356,2485,44213,834,828,364,2026,46239
20-04-2015,22,14903,17526,7048,2535,42013,855,674,353,1882,43895
20-04-2015,23,12591,17167,6963,2575,39295,873,648,329,1850,41145
21-04-2015,0,10942,16506,6849,2544,36841,867,548,337,1752,38593
21-04-2015,1,10153,16167,6845,2615,35781,880,553,327,1760,37541
21-04-2015,2,9828,15827,6850,2790,35296,890,555,339,1784,37080
21-04-2015,3,10026,15787,6814,2859,35487,896,554,338,1788,37275
21-04-2015,4,10502,15920,6866,3052,36340,871,585,355,1811,38151
21-04-2015,5,11153,16900,7132,3127,38312,935,701,310,1946,40258
21-04-2015,6,14548,17588,7685,3114,42935,1165,989,308,2462,45397
21-04-2015,7,17582,18305,7696,3234,46816,1165,1298,552,3015,49831
21-04-2015,8,18161,18840,7521,3442,47965,1171,1445,653,3269,51234
21-04-2015,9,18035,18199,7483,3475,47191,1160,1411,628,3199,50390
21-04-2015,10,18216,17913,7390,3669,47188,1145,1321,654,3120,50308
21-04-2015,11,17866,17688,7332,3745,46632,1129,1301,579,3009,49641
21-04-2015,12,17363,17019,7392,3714,45488,1130,1243,594,2967,48455
21-04-2015,13,16693,16864,7340,3462,44360,1144,1201,442,2787,47147
21-04-2015,14,16275,16504,7014,3498,43292,1141,1148,325,2614,45906
21-04-2015,15,15852,16781,6836,3437,42906,1149,1120,328,2597,45503
21-04-2015,16,15400,16881,7139,3764,43184,1102,1125,337,2564,45748
21-04-2015,17,15574,16570,7145,3932,43222,1083,1214,328,2625,45847
21-04-2015,18,15268,16709,7128,4197,43302,1067,1217,337,2621,45923
21-04-2015,19,14791,16764,7301,4246,43103,1031,1164,326,2521,45624
21-04-2015,20,15120,16615,7127,4277,43140,853,1094,321,2268,45408
21-04-2015,21,15494,16599,6977,4121,43192,855,935,333,2123,45315
21-04-2015,22,14215,16594,6769,3977,41555,835,766,334,1935,43490
21-04-2015,23,12287,16227,6612,3802,38928,848,750,315,1913,40841
22-04-2015,0,10718,15667,6759,3492,36636,766,576,339,1681,38317
22-04-2015,1,10448,15512,6744,3023,35726,751,574,303,1628,37354
22-04-2015,2,10576,15441,6803,2608,35429,751,575,291,1617,37046
22-04-2015,3,10654,15541,6978,2418,35590,753,578,351,1682,37272
22-04-2015,4,10920,15860,7081,2261,36123,755,614,289,1658,37781
22-04-2015,5,12337,16856,7434,2157,38784,777,758,292,1827,40611
22-04-2015,6,15384,18042,7808,2136,43370,863,1039,517,2419,45789
22-04-2015,7,17954,19235,7990,2636,47816,857,1262,572,2691,50507
22-04-2015,8,18040,19504,8029,3130,48703,851,1345,599,2795,51498
22-04-2015,9,17973,19342,8003,2970,48288,884,1328,562,2774,51062
22-04-2015,10,17826,19165,8014,3007,48010,899,1248,530,2677,50687
22-04-2015,11,17302,19398,7981,2853,47535,931,1184,477,2592,50127
22-04-2015,12,17171,18789,7958,2656,46576,937,1136,550,2623,49199
22-04-2015,13,17327,18716,7830,2579,46454,969,1048,564,2581,49035
22-04-2015,14,17030,19104,7536,2548,46220,905,982,349,2236,48456
22-04-2015,15,16769,19113,7605,2481,45967,965,1115,367,2447,48414
22-04-2015,16,16396,19299,7596,2520,45811,949,1166,376,2491,48302
22-04-2015,17,16214,19257,7557,2697,45726,954,1148,361,2463,48189
22-04-2015,18,16103,19133,7641,2552,45430,904,1161,346,2411,47841
22-04-2015,19,15650,19026,7565,2435,44676,897,1284,334,2515,47191
22-04-2015,20,15707,19075,7394,2197,44376,860,1148,337,2345,46721
22-04-2015,21,15648,19309,7244,2552,44753,850,968,334,2152,46905
22-04-2015,22,14198,18836,7170,2360,42564,843,686,347,1876,44440
22-04-2015,23,12055,18493,6995,2344,39888,856,534,435,1825,41713
23-04-2015,0,10293,17871,6913,2411,37489,837,465,452,1754,39243
23-04-2015,1,9718,17419,6829,2440,36406,831,522,404,1757,38163
23-04-2015,2,9399,17275,6838,2553,36065,863,567,425,1855,37920
23-04-2015,3,9241,17251,6876,2766,36134,899,570,452,1921,38055
23-04-2015,4,9291,17450,6996,2986,36722,876,602,475,1953,38675
23-04-2015,5,10202,18588,7268,3099,39157,921,757,483,2161,41318
23-04-2015,6,13042,19707,7787,3014,43549,1027,963,462,2452,46001
23-04-2015,7,15856,20842,7979,3223,47899,1028,1148,650,2826,50725
23-04-2015,8,16564,20807,7987,3422,48780,1019,1280,625,2924,51704
23-04-2015,9,16227,20500,7983,3579,48289,1033,1243,628,2904,51193
23-04-2015,10,16138,20248,7990,3721,48098,1059,1146,589,2794,50892
23-04-2015,11,15639,20263,7972,3658,47531,1057,1176,456,2689,50220
23-04-2015,12,15079,20301,7950,3825,47154,1053,1177,489,2719,49873
23-04-2015,13,14591,20372,7866,3870,46700,1032,1177,444,2653,49353
23-04-2015,14,14300,20269,7596,3793,45958,1020,1166,418,2604,48562
23-04-2015,15,14093,20095,7492,3805,45486,1033,1176,396,2605,48091
23-04-2015,16,13931,19982,7583,3658,45154,1003,1118,378,2499,47653
23-04-2015,17,14110,20091,7661,3596,45458,987,1118,358,2463,47921
23-04-2015,18,13945,20126,7599,3640,45311,947,1152,339,2438,47749
23-04-2015,19,14229,19991,7636,3400,45258,933,1217,330,2480,47738
23-04-2015,20,14989,19755,7370,3271,45386,884,1142,353,2379,47765
23-04-2015,21,15875,19711,7265,3075,45925,851,1147,386,2384,48309
23-04-2015,22,14551,19043,7128,2963,43685,826,883,390,2099,45784
23-04-2015,23,13126,18187,6957,2741,41012,841,567,408,1816,42828
24-04-2015,0,12225,17598,7009,2585,39417,820,492,399,1711,41128
24-04-2015,1,11862,17098,7035,2432,38428,819,610,417,1846,40274
24-04-2015,2,11977,16920,7106,2376,38378,802,610,410,1822,40200
24-04-2015,3,12365,16876,7103,2361,38705,786,610,413,1809,40514
24-04-2015,4,12969,17103,7127,2282,39481,775,636,412,1823,41304
24-04-2015,5,13950,17751,7346,2238,41285,820,747,409,1976,43261
24-04-2015,6,15731,18845,8036,2851,45463,938,884,575,2397,47860
24-04-2015,7,17878,19833,8179,3331,49221,882,1282,672,2836,52057
24-04-2015,8,18087,20012,8146,3339,49583,840,1386,638,2864,52447
24-04-2015,9,18023,19753,8161,3187,49124,855,1293,686,2834,51958
24-04-2015,10,17992,19713,8177,3201,49084,867,1098,670,2635,51719
24-04-2015,11,17531,19696,8011,2940,48178,880,1030,647,2557,50735
24-04-2015,12,17132,19533,7915,2697,47279,907,1006,656,2569,49848
24-04-2015,13,16867,19108,7732,2764,46471,888,1053,554,2495,48966
24-04-2015,14,16335,18579,7562,2494,44971,945,1064,501,2510,47481
24-04-2015,15,15965,19065,7669,2474,45173,979,1058,429,2466,47639
24-04-2015,16,15682,19310,7641,2484,45117,956,1036,403,2395,47512
24-04-2015,17,16221,19513,7622,2357,45714,973,980,373,2326,48040
24-04-2015,18,16515,19643,7633,2434,46226,963,1030,346,2339,48565
24-04-2015,19,16215,19427,7738,2337,45718,956,1153,332,2441,48159
24-04-2015,20,16774,19283,7563,2311,45932,791,1074,327,2192,48124
24-04-2015,21,16579,19647,7568,2163,45957,800,780,423,2003,47960
24-04-2015,22,15502,19346,7487,2074,44410,715,726,310,1751,46161
24-04-2015,23,14471,18033,7417,2129,42051,710,620,292,1622,43673
25-04-2015,0,13900,16203,7377,1785,39264,661,514,367,1542,40806
25-04-2015,1,13098,15891,7144,1740,37875,640,511,322,1473,39348
25-04-2015,2,12296,15765,7098,1791,36950,648,510,299,1457,38407
25-04-2015,3,11618,15671,6973,1808,36070,644,514,310,1468,37538
25-04-2015,4,11021,15620,6691,1871,35204,634,513,330,1477,36681
25-04-2015,5,10724,15809,6769,1907,35211,638,601,298,1537,36748
25-04-2015,6,11100,16138,6711,2057,36005,621,759,291,1671,37676
25-04-2015,7,12350,16994,6866,2284,38494,617,865,291,1773,40267
25-04-2015,8,14051,17347,7143,2537,41078,656,1005,291,1952,43030
25-04-2015,9,15130,17904,7182,2670,42885,666,1002,335,2003,44888
25-04-2015,10,15391,18276,7146,2874,43688,671,928,302,1901,45589
25-04-2015,11,14520,18560,7132,3270,43481,672,901,311,1884,45365
25-04-2015,12,13836,18282,7212,3295,42624,654,891,323,1868,44492
25-04-2015,13,13043,17883,7070,3202,41198,638,958,327,1923,43121
25-04-2015,14,12437,17972,6971,3118,40499,646,966,299,1911,42410
25-04-2015,15,12661,18031,7089,3037,40819,654,1057,302,2013,42832
25-04-2015,16,12827,18121,7256,3070,41273,643,938,308,1889,43162
25-04-2015,17,14332,18593,7234,3097,43255,638,941,304,1883,45138
25-04-2015,18,14755,19236,7246,2945,44182,634,937,286,1857,46039
25-04-2015,19,14379,19275,7319,3233,44205,644,996,287,1927,46132
25-04-2015,20,14627,19342,7348,3044,44362,634,981,306,1921,46283
25-04-2015,21,14645,18940,7232,2850,43667,657,850,320,1827,45494
25-04-2015,22,13559,18738,7207,2544,42047,656,699,314,1669,43716
25-04-2015,23,12592,18055,7054,2131,39831,689,564,309,1562,41393
26-04-2015,0,11429,17022,6999,1835,37285,689,466,316,1471,38756
26-04-2015,1,10664,16509,7003,1699,35876,678,468,332,1478,37354
26-04-2015,2,10453,16409,6916,1566,35344,656,452,325,1433,36777
26-04-2015,3,10471,16419,6931,1449,35269,667,456,336,1459,36728
26-04-2015,4,10260,16300,6936,1455,34951,678,500,329,1507,36458
26-04-2015,5,10274,16204,7042,1371,34891,674,506,335,1515,36406
26-04-2015,6,10409,16308,7128,1306,35152,674,642,308,1624,36776
26-04-2015,7,10544,16382,7239,1352,35518,660,642,302,1604,37122
26-04-2015,8,12285,17088,7278,1450,38101,663,783,313,1759,39860
26-04-2015,9,13185,17872,7470,1600,40128,658,873,329,1860,41988
26-04-2015,10,13523,17881,7370,1737,40512,649,921,325,1895,42407
26-04-2015,11,13832,18057,7309,1813,41012,651,840,318,1809,42821
26-04-2015,12,13245,17825,7491,1861,40421,640,787,315,1742,42163
26-04-2015,13,13068,17816,7333,1968,40186,650,790,319,1759,41945
26-04-2015,14,12910,17659,7335,2036,39940,642,755,320,1717,41657
26-04-2015,15,12685,17549,7312,2102,39648,648,836,308,1792,41440
26-04-2015,16,12975,17524,7187,2170,39854,650,850,301,1801,41655
26-04-2015,17,13653,17711,7273,2229,40867,650,791,294,1735,42602
26-04-2015,18,14999,18160,7343,2116,42617,641,819,292,1752,44369
26-04-2015,19,15907,18259,7433,2014,43613,644,824,359,1827,45440
26-04-2015,20,16407,18310,7488,2299,44504,639,954,316,1909,46413
26-04-2015,21,17225,18275,7376,2204,45079,663,848,287,1798,46877
26-04-2015,22,16484,18087,7225,2245,44041,669,669,285,1623,45664
26-04-2015,23,15156,17375,7138,2216,41884,721,565,351,1637,43521
27-04-2015,0,14594,16018,7127,1803,39543,831,436,286,1553,41096
27-04-2015,1,14008,15274,7182,1623,38087,833,417,287,1537,39624
27-04-2015,2,12817,15078,7129,1523,36548,732,413,290,1435,37983
27-04-2015,3,12831,15112,7020,1551,36513,746,430,294,1470,37983
27-04-2015,4,13123,15515,7010,1536,37185,783,474,322,1579,38764
27-04-2015,5,15447,16775,7240,1753,41216,879,684,366,1929,43145
27-04-2015,6,18167,18443,7671,2493,46776,1020,890,541,2451,49227
27-04-2015,7,20245,19405,7942,2695,50287,1045,1088,708,2841,53128
27-04-2015,8,20303,19693,7909,3181,51087,1134,1163,741,3038,54125
27-04-2015,9,19649,19630,7802,3154,50235,1154,1170,833,3157,53392
27-04-2015,10,19385,19251,7710,3329,49675,1113,1119,741,2973,52648
27-04-2015,11,19271,18927,7827,3373,49398,1137,940,754,2831,52229
27-04-2015,12,19189,18795,7789,3645,49420,1143,954,755,2852,52272
27-04-2015,13,18922,18873,7707,3645,49148,1100,943,673,2716,51864
27-04-2015,14,18581,18930,7530,3732,48775,999,900,573,2472,51247
27-04-2015,15,18388,18963,7466,3535,48352,996,879,562,2437,50789
27-04-2015,16,18118,18534,7472,3178,47303,977,876,566,2419,49722
27-04-2015,17,18082,18700,7372,3384,47537,1003,875,553,2431,49968
27-04-2015,18,17748,18600,7277,3308,46933,1028,881,551,2460,49393
27-04-2015,19,18127,18613,7321,3166,47227,1031,908,501,2440,49667
27-04-2015,20,18367,18624,7306,3001,47298,1051,951,391,2393,49691
27-04-2015,21,18424,18515,7339,2840,47117,1019,819,412,2250,49367
27-04-2015,22,17390,18070,7164,2556,45182,945,647,350,1942,47124
27-04-2015,23,15919,16893,7043,2375,42230,942,555,385,1882,44112
28-04-2015,0,14535,15375,7051,2170,39132,877,350,369,1596,40728
28-04-2015,1,14183,15100,7033,2152,38469,853,315,303,1471,39940
28-04-2015,2,14297,15088,7029,2219,38632,843,314,297,1454,40086
28-04-2015,3,14582,15109,7012,2201,38904,872,323,324,1519,40423
28-04-2015,4,15184,15292,7076,2011,39563,864,418,312,1594,41157
28-04-2015,5,16372,16778,7175,2060,42387,926,625,428,1979,44366
28-04-2015,6,18390,18822,7521,2614,47347,922,924,529,2375,49722
28-04-2015,7,20281,20108,7682,3163,51236,965,1041,562,2568,53804
28-04-2015,8,20089,20121,7700,3724,51634,955,1052,641,2648,54282
28-04-2015,9,19922,19741,7748,3287,50699,967,1051,642,2660,53359
28-04-2015,10,19594,19580,7625,3562,50361,965,1028,626,2619,52980
28-04-2015,11,19201,19522,7592,3724,50039,968,875,714,2557,52596
28-04-2015,12,18831,19260,7524,3591,49207,923,930,688,2541,51748
28-04-2015,13,18314,19026,7481,3286,48106,938,1011,566,2515,50621
28-04-2015,14,18338,18818,7218,3102,47477,927,908,537,2372,49849
28-04-2015,15,18227,18560,7216,3020,47024,917,887,492,2296,49320
28-04-2015,16,17978,18487,7155,2922,46541,939,921,482,2342,48883
28-04-2015,17,17902,18485,7150,2934,46471,919,879,510,2308,48779
28-04-2015,18,17662,18332,7243,2933,46171,949,912,472,2333,48504
28-04-2015,19,17709,18207,7322,2906,46144,931,940,443,2314,48458
28-04-2015,20,17704,18064,7385,2872,46026,891,930,395,2216,48242
28-04-2015,21,18088,17987,7310,2995,46379,857,718,463,2038,48417
28-04-2015,22,16857,17467,7170,3036,44531,870,587,401,1858,46389
28-04-2015,23,15119,16429,7002,2979,41528,857,567,421,1845,43373
29-04-2015,0,13070,15371,6994,2908,38343,790,361,358,1509,39852
29-04-2015,1,12383,14905,6947,2965,37200,790,336,368,1494,38694
29-04-2015,2,12314,14857,6930,3083,37185,784,332,358,1474,38659
29-04-2015,3,12479,14850,6924,3015,37269,786,341,382,1509,38778
29-04-2015,4,13183,15010,6954,2897,38044,805,379,382,1566,39610
29-04-2015,5,14472,16187,7078,2827,40564,858,595,364,1817,42381
29-04-2015,6,17647,17886,7431,2750,45712,886,997,329,2212,47924
29-04-2015,7,20260,19367,7804,3086,50516,918,1256,318,2492,53008
29-04-2015,8,20287,19717,7791,3625,51420,937,1338,305,2580,54000
29-04-2015,9,19763,19604,7846,3438,50650,988,1306,334,2628,53278
29-04-2015,10,19041,19476,7808,3673,49998,999,1279,362,2640,52638
29-04-2015,11,18620,19133,7808,3797,49358,1016,1162,422,2600,51958
29-04-2015,12,18164,18864,7785,3952,48765,1065,1158,440,2663,51428
29-04-2015,13,17701,18778,7827,4033,48339,1069,1083,472,2624,50963
29-04-2015,14,17644,18831,7743,3958,48178,1061,961,447,2469,50647
29-04-2015,15,17667,18881,7663,3888,48100,1048,919,417,2384,50484
29-04-2015,16,17222,18851,7674,3797,47545,1063,975,435,2473,50018
29-04-2015,17,17588,18625,7724,3647,47585,1062,976,421,2459,50044
29-04-2015,18,17718,18721,7773,3486,47699,1032,958,402,2392,50091
29-04-2015,19,17955,18646,7812,3303,47715,1039,938,379,2356,50071
29-04-2015,20,17955,19009,7687,3096,47748,1034,933,359,2326,50074
29-04-2015,21,17648,18526,7629,3244,47047,1006,844,353,2203,49250
29-04-2015,22,16235,17758,7517,3413,44921,960,639,337,1936,46857
29-04-2015,23,14522,16766,7386,3416,42093,941,492,331,1764,43857
30-04-2015,0,12453,15607,7335,3467,38861,1023,343,315,1681,40542
30-04-2015,1,12102,15432,7332,3307,38173,973,300,314,1587,39760
30-04-2015,2,12008,15557,7317,3117,38000,942,297,311,1550,39550
30-04-2015,3,12192,15662,7299,2950,38104,957,302,315,1574,39678
30-04-2015,4,12400,16210,7400,2735,38745,953,375,319,1647,40392
30-04-2015,5,14045,17202,7501,2646,41395,1073,661,301,2035,43430
30-04-2015,6,17336,18658,7946,2471,46412,1434,912,297,2643,49055
30-04-2015,7,19763,20141,8044,2897,50845,1443,1091,486,3020,53865
30-04-2015,8,20166,20490,8132,3060,51847,1451,1249,500,3200,55047
30-04-2015,9,19777,20164,8121,2993,51055,1450,1232,473,3155,54210
30-04-2015,10,19521,19878,8011,2677,50087,1457,1251,345,3053,53140
30-04-2015,11,19202,19952,8075,2585,49814,1464,1216,287,2967,52781
30-04-2015,12,18689,19954,8037,2596,49276,1460,1122,314,2896,52172
30-04-2015,13,17924,19803,7851,2785,48363,1454,945,481,2880,51243
30-04-2015,14,17189,19517,7660,2831,47197,1457,817,483,2757,49954
30-04-2015,15,17040,18899,7656,2805,46401,1458,876,302,2636,49037
30-04-2015,16,16984,18732,7610,2808,46134,1453,804,372,2629,48763
30-04-2015,17,17292,18782,7503,2498,46075,1450,744,368,2562,48637
30-04-2015,18,16939,18764,7481,2344,45529,1437,720,364,2521,48050
30-04-2015,19,16904,18804,7502,2368,45579,1445,622,288,2355,47934
30-04-2015,20,16660,18778,7418,2348,45205,1465,689,309,2463,47668
30-04-2015,21,16833,18611,7732,2370,45548,1209,728,339,2276,47824
30-04-2015,22,16237,18010,7553,1902,43701,1257,599,369,2225,45926
30-04-2015,23,14780,16913,7514,1900,41108,981,485,367,1833,42941
01-05-2015,0,12773,15881,7439,1664,37757,820,556,368,1744,39501
01-05-2015,1,11629,15132,7498,1690,35950,784,449,371,1604,37554
01-05-2015,2,11064,15164,7393,1675,35298,767,440,373,1580,36878
01-05-2015,3,10791,15067,7326,1657,34841,759,439,358,1556,36397
01-05-2015,4,10702,14832,7302,1483,34320,741,436,355,1532,35852
01-05-2015,5,10946,14862,7365,1399,34573,784,517,353,1654,36227
01-05-2015,6,11181,15246,7532,1515,35474,701,610,356,1667,37141
01-05-2015,7,12102,15799,7568,1560,37029,701,701,542,1944,38973
01-05-2015,8,13914,16589,7643,1675,39820,756,784,519,2059,41879
01-05-2015,9,14943,16950,7619,1714,41225,762,703,474,1939,43164
01-05-2015,10,15251,17123,7515,1853,41742,760,724,486,1970,43712
01-05-2015,11,15270,17075,7558,1749,41652,757,687,514,1958,43610
01-05-2015,12,15106,16937,7603,1758,41406,726,686,498,1910,43316
01-05-2015,13,14507,17015,7520,1866,40908,765,722,364,1851,42759
01-05-2015,14,13898,17102,7446,1932,40378,760,735,359,1854,42232
01-05-2015,15,13596,17125,7241,2014,39977,740,721,357,1818,41795
01-05-2015,16,13478,17122,7263,2114,39977,749,740,388,1877,41854
01-05-2015,17,13875,17239,7285,2111,40510,721,778,326,1825,42335
01-05-2015,18,14311,17377,7310,2026,41024,714,687,546,1947,42971
01-05-2015,19,14832,17479,7219,1828,41359,708,713,521,1942,43301
01-05-2015,20,15186,17271,7171,1631,41260,755,774,296,1825,43085
01-05-2015,21,15618,17236,7258,1672,41784,686,999,304,1989,43773
01-05-2015,22,14933,17297,7186,1702,41118,768,812,322,1902,43020
01-05-2015,23,13618,16735,7117,1673,39144,778,676,329,1783,40927
02-05-2015,0,11714,15665,7153,1618,36151,747,422,329,1498,37649
02-05-2015,1,10315,15265,7125,1604,34309,738,425,406,1569,35878
02-05-2015,2,9940,15096,7000,1711,33748,724,425,397,1546,35294
02-05-2015,3,9938,15134,6900,1766,33738,718,430,405,1553,35291
02-05-2015,4,10091,15437,6940,1813,34281,726,436,379,1541,35822
02-05-2015,5,9970,15670,6943,1852,34436,734,432,428,1594,36030
02-05-2015,6,10587,16591,7122,1976,36277,723,520,398,1641,37918
02-05-2015,7,11708,17120,7277,2178,38282,724,735,417,1876,40158
02-05-2015,8,13715,17468,7285,2306,40773,708,931,434,2073,42846
02-05-2015,9,14246,17894,7382,2434,41957,686,796,441,1923,43880
02-05-2015,10,14331,17913,7464,2375,42084,729,813,455,1997,44081
02-05-2015,11,14123,17694,7504,2384,41704,746,776,465,1987,43691
02-05-2015,12,13325,17805,7481,2417,41029,771,760,475,2006,43035
02-05-2015,13,12488,17484,7397,2296,39666,770,782,471,2023,41689
02-05-2015,14,12464,17339,7476,2195,39474,770,774,472,2016,41490
02-05-2015,15,12741,17456,7623,2294,40114,762,759,472,1993,42107
02-05-2015,16,13223,17527,7658,2325,40732,755,673,464,1892,42624
02-05-2015,17,14479,17972,7603,2248,42305,742,673,445,1860,44165
02-05-2015,18,15376,18004,7621,2232,43232,717,744,431,1892,45124
02-05-2015,19,15285,18013,7630,2155,43084,720,766,413,1899,44983
02-05-2015,20,15281,18020,7589,2252,43142,713,935,371,2019,45161
02-05-2015,21,15778,17805,7568,2365,43516,694,790,367,1851,45367
02-05-2015,22,15217,17533,7633,1760,42143,656,676,360,1692,43835
02-05-2015,23,14509,16561,7602,1552,40224,615,569,333,1517,41741
03-05-2015,0,12207,15052,7245,1332,35835,645,412,316,1373,37208
03-05-2015,1,11359,14423,7090,1231,34102,668,415,308,1391,35493
03-05-2015,2,10828,14205,7091,1144,33269,770,328,302,1400,34669
03-05-2015,3,10603,14151,7092,1125,32972,765,327,296,1388,34360
03-05-2015,4,10489,14091,7112,1127,32820,798,317,294,1409,34229
03-05-2015,5,10178,13995,7012,1114,32299,810,402,334,1546,33845
03-05-2015,6,9908,14239,7044,1183,32374,814,403,289,1506,33880
03-05-2015,7,10869,14439,7182,1419,33909,824,599,288,1711,35620
03-05-2015,8,12284,14933,7268,1681,36165,830,811,289,1930,38095
03-05-2015,9,13051,15089,7298,1904,37343,847,851,313,2011,39354
03-05-2015,10,13380,15183,7298,2178,38039,843,856,304,2003,40042
03-05-2015,11,13349,14933,7360,2437,38080,933,746,306,1985,40065
03-05-2015,12,12966,15025,7342,2721,38054,941,696,306,1943,39997
03-05-2015,13,12080,14927,7165,3108,37279,949,663,310,1922,39201
03-05-2015,14,11600,14674,7178,3511,36963,967,654,310,1931,38894
03-05-2015,15,11482,14643,6893,3833,36851,966,613,313,1892,38743
03-05-2015,16,11455,14777,6567,4041,36840,959,654,309,1922,38762
03-05-2015,17,11909,15014,6437,3962,37322,941,716,302,1959,39281
03-05-2015,18,12517,15346,6489,3953,38305,941,753,299,1993,40298
03-05-2015,19,12565,15653,6562,4280,39060,946,804,296,2046,41106
03-05-2015,20,12543,15674,6641,4271,39128,934,943,288,2165,41293
03-05-2015,21,12638,15769,6734,4413,39554,901,881,288,2070,41624
03-05-2015,22,12156,15796,6672,4587,39211,923,605,293,1821,41032
03-05-2015,23,10908,15262,6514,4629,37314,898,474,304,1676,38990
04-05-2015,0,10239,14775,6334,4452,35801,968,307,312,1587,37388
04-05-2015,1,10078,14697,6343,4234,35351,985,304,363,1652,37003
04-05-2015,2,9875,14738,6450,3679,34740,995,305,365,1665,36405
04-05-2015,3,9650,14780,6523,3199,34153,994,334,385,1713,35866
04-05-2015,4,9887,15134,6639,2888,34546,1011,401,369,1781,36327
04-05-2015,5,11242,16001,6682,2683,36608,1109,391,380,1880,38488
04-05-2015,6,15666,17525,6804,2711,42707,1231,477,363,2071,44778
04-05-2015,7,18244,19108,6956,3038,47346,1246,765,352,2363,49709
04-05-2015,8,19178,19428,7127,3113,48847,1268,846,334,2448,51295
04-05-2015,9,18968,19349,7014,3470,48800,1331,764,330,2425,51225
04-05-2015,10,18618,19409,6948,3413,48388,1397,804,401,2602,50990
04-05-2015,11,18508,19346,6848,3408,48111,1457,670,479,2606,50717
04-05-2015,12,17754,19406,6821,3641,47621,1452,775,498,2725,50346
04-05-2015,13,17549,19018,6835,3828,47230,1432,648,511,2591,49821
04-05-2015,14,17456,18992,6860,3669,46979,1444,565,554,2563,49542
04-05-2015,15,17648,18929,6730,3814,47122,1412,533,455,2400,49522
04-05-2015,16,17553,19030,6665,3617,46864,1447,557,399,2403,49267
04-05-2015,17,18024,19028,6705,3549,47306,1432,561,390,2383,49689
04-05-2015,18,18162,19271,6721,3698,47852,1413,586,393,2392,50244
04-05-2015,19,18287,19313,6786,3208,47595,1322,684,373,2379,49974
04-05-2015,20,18269,19316,6825,2510,46920,1161,836,349,2346,49266
04-05-2015,21,18344,19237,6944,2555,47081,1165,839,354,2358,49439
04-05-2015,22,17202,18446,6948,2094,44690,1172,682,322,2176,46866
04-05-2015,23,15290,16846,6852,1582,40572,1147,457,307,1911,42483
05-05-2015,0,13003,14752,6734,1487,35977,1030,319,308,1657,37634
05-05-2015,1,11114,14459,6748,1659,33980,1044,308,307,1659,35639
05-05-2015,2,10787,14184,6768,1874,33614,1040,306,307,1653,35267
05-05-2015,3,10551,13804,6775,2129,33260,1043,326,300,1669,34929
05-05-2015,4,10672,13748,6860,2385,33665,1054,331,292,1677,35342
05-05-2015,5,11915,14135,6894,2840,35784,1111,428,289,1828,37612
05-05-2015,6,15003,15503,6987,3516,41010,1343,685,310,2338,43348
05-05-2015,7,18548,17265,6951,4321,47086,1485,736,504,2725,49811
05-05-2015,8,19157,17801,7015,4613,48586,1569,873,461,2903,51489
05-05-2015,9,18643,18038,7025,4829,48536,1513,888,503,2904,51440
05-05-2015,10,18078,17879,7280,4953,48189,1543,885,462,2890,51079
05-05-2015,11,17557,17872,7189,5022,47641,1647,773,502,2922,50563
05-05-2015,12,17308,17683,7058,4947,46995,1655,811,501,2967,49962
05-05-2015,13,16626,17566,6959,4632,45784,1626,801,473,2900,48684
05-05-2015,14,15736,17498,6998,4202,44435,1549,721,475,2745,47180
05-05-2015,15,15769,17516,6843,4294,44423,1483,585,316,2384,46807
05-05-2015,16,15285,17671,6732,4099,43789,1444,568,317,2329,46118
05-05-2015,17,15635,18282,6827,3922,44666,1422,572,313,2307,46973
05-05-2015,18,16272,18544,6791,3757,45366,1414,671,327,2412,47778
05-05-2015,19,15929,18150,6894,3906,44881,1367,636,349,2352,47233
05-05-2015,20,15344,17881,6869,4391,44484,1194,773,367,2334,46818
05-05-2015,21,14902,17463,6839,4818,44021,1092,790,386,2268,46289
05-05-2015,22,13260,16870,6801,4603,41534,1119,621,404,2144,43678
05-05-2015,23,11538,16243,6722,4358,38864,1134,387,408,1929,40793
06-05-2015,0,10201,15518,6778,3988,36484,1092,314,435,1841,38325
06-05-2015,1,9668,15217,6868,3530,35282,1074,305,435,1814,37096
06-05-2015,2,9404,15148,6876,3120,34548,1060,309,422,1791,36339
06-05-2015,3,8981,15016,6829,2935,33762,1035,326,407,1768,35530
06-05-2015,4,8962,15039,6874,2901,33778,1061,408,410,1879,35657
06-05-2015,5,10627,15875,6926,2959,36387,1143,614,380,2137,38524
06-05-2015,6,14135,16978,7059,3239,41412,1253,742,328,2323,43735
06-05-2015,7,16909,18258,7109,3407,45683,1378,819,499,2696,48379
06-05-2015,8,17375,18490,7090,3789,46744,1441,847,510,2798,49542
06-05-2015,9,17270,18127,7142,4253,46793,1460,898,514,2872,49665
06-05-2015,10,17327,17929,7132,4405,46792,1504,876,496,2876,49668
06-05-2015,11,16952,17679,7165,4329,46126,1493,856,488,2837,48963
06-05-2015,12,16049,17588,7050,4448,45136,1484,886,487,2857,47993
06-05-2015,13,15093,17134,7073,4321,43620,1484,856,498,2838,46458
06-05-2015,14,14952,17213,7150,4131,43447,1459,817,499,2775,46222
06-05-2015,15,14231,17113,7123,4026,42493,1419,727,489,2635,45128
06-05-2015,16,14056,16759,7193,4021,42028,1384,623,506,2513,44541
06-05-2015,17,14826,16680,7163,3855,42524,1356,680,452,2488,45012
06-05-2015,18,16445,16750,7104,3363,43663,1299,698,503,2500,46163
06-05-2015,19,16412,16996,7082,3401,43892,1279,708,466,2453,46345
06-05-2015,20,15954,16749,7050,3092,42846,1210,736,429,2375,45221
06-05-2015,21,16799,15952,7031,2847,42629,1119,770,329,2218,44847
06-05-2015,22,15809,15263,6895,3035,41003,1050,642,298,1990,42993
06-05-2015,23,11641,14913,6808,3609,36970,1056,298,320,1674,38644
07-05-2015,0,10129,14220,6673,3491,34514,1040,307,298,1645,36159
07-05-2015,1,9301,13413,6718,3774,33207,1032,324,295,1651,34858
07-05-2015,2,8906,13347,6669,3894,32815,1034,307,295,1636,34451
07-05-2015,3,8798,13314,6647,4028,32789,1017,309,311,1637,34426
07-05-2015,4,8943,13462,6705,4045,33157,1030,314,302,1646,34803
07-05-2015,5,9956,14647,6853,4186,35641,1136,472,283,1891,37532
07-05-2015,6,13858,15855,7088,4083,40886,1351,700,325,2376,43262
07-05-2015,7,16602,17215,7245,4157,45219,1455,748,503,2706,47925
07-05-2015,8,16978,17437,7462,4486,46363,1484,992,461,2937,49300
07-05-2015,9,16983,17372,7421,4518,46294,1475,886,559,2920,49214
07-05-2015,10,16583,17192,7348,4652,45776,1469,845,527,2841,48617
07-05-2015,11,15883,16917,7334,4729,44864,1464,801,571,2836,47700
07-05-2015,12,15924,17378,7361,4768,45432,1469,879,524,2872,48304
07-05-2015,13,15693,17849,7399,4775,45716,1494,796,572,2862,48578
07-05-2015,14,14652,17906,7356,4768,44683,1471,753,546,2770,47453
07-05-2015,15,15136,17870,7260,4734,45000,1555,751,545,2851,47851
07-05-2015,16,15637,17535,7054,4482,44708,1519,648,425,2592,47300
07-05-2015,17,16397,17189,6985,4205,44777,1509,733,333,2575,47352
07-05-2015,18,16632,17299,6881,3732,44545,1404,650,395,2449,46994
07-05-2015,19,16918,17359,6875,3195,44348,1401,668,350,2419,46767
07-05-2015,20,16982,17463,6920,2731,44095,1290,800,348,2438,46533
07-05-2015,21,17443,17610,6894,2516,44464,1230,711,310,2251,46715
07-05-2015,22,16614,16948,6851,2338,42750,1178,570,323,2071,44821
07-05-2015,23,14914,16127,6799,2605,40445,1128,360,368,1856,42301
08-05-2015,0,13379,15438,6782,2517,38116,1105,341,348,1794,39910
08-05-2015,1,12958,14970,6779,2431,37138,1124,337,351,1812,38950
08-05-2015,2,12858,14937,6761,2348,36905,1120,331,345,1796,38701
08-05-2015,3,12998,14915,6784,2186,36883,1108,332,336,1776,38659
08-05-2015,4,13330,15039,6751,2192,37312,1116,328,334,1778,39090
08-05-2015,5,14856,15829,6680,2038,39402,1164,413,320,1897,41299
08-05-2015,6,17432,17569,6834,2497,44331,1432,615,325,2372,46703
08-05-2015,7,18757,19238,7019,2543,47558,1488,799,483,2770,50328
08-05-2015,8,18933,19825,7048,2922,48730,1520,975,531,3026,51756
08-05-2015,9,18672,19679,7052,2862,48265,1526,976,490,2992,51257
08-05-2015,10,18565,19196,7075,2876,47712,1538,840,580,2958,50670
08-05-2015,11,18754,19143,7068,2736,47700,1559,769,553,2881,50581
08-05-2015,12,18295,19683,6959,2480,47417,1576,771,427,2774,50191
08-05-2015,13,17717,19043,6860,2462,46081,1578,766,372,2716,48797
08-05-2015,14,17503,18038,6799,2326,44664,1578,700,356,2634,47298
08-05-2015,15,17075,17958,6690,2256,43979,1468,540,355,2363,46342
08-05-2015,16,16940,17476,6750,2201,43369,1553,569,349,2471,45840
08-05-2015,17,17435,18162,6796,2188,44584,1479,591,338,2408,46992
08-05-2015,18,17161,18232,6762,2490,44645,1480,530,323,2333,46978
08-05-2015,19,17159,17869,6726,2207,43960,1463,547,306,2316,46276
08-05-2015,20,16959,17499,6691,1915,43064,1178,797,372,2347,45411
08-05-2015,21,17030,17405,6744,1499,42678,1171,703,309,2183,44861
08-05-2015,22,16806,16836,6750,1512,41905,1110,525,309,1944,43849
08-05-2015,23,15114,16349,6689,1516,39667,1129,423,312,1864,41531
09-05-2015,0,13432,15764,6703,1461,37361,1082,288,310,1680,39041
09-05-2015,1,12215,15283,6703,1518,35720,1052,291,309,1652,37372
09-05-2015,2,11624,15245,6708,1633,35211,1054,290,309,1653,36864
09-05-2015,3,10952,15161,6743,1821,34676,1043,303,303,1649,36325
09-05-2015,4,10930,15123,6763,1927,34744,1043,304,331,1678,36422
09-05-2015,5,10554,14796,6779,2123,34253,1026,379,307,1712,35965
09-05-2015,6,11118,15317,6801,2551,35788,1032,422,292,1746,37534
09-05-2015,7,11722,15925,6820,2978,37446,1112,542,289,1943,39389
09-05-2015,8,13139,16259,6884,3397,39678,1193,608,297,2098,41776
09-05-2015,9,13383,16694,6854,3632,40564,1168,679,289,2136,42700
09-05-2015,10,12878,16700,6822,3731,40130,1113,749,293,2155,42285
09-05-2015,11,12734,16325,6819,3713,39592,1188,573,304,2065,41657
09-05-2015,12,12803,16380,6818,3653,39653,1168,570,294,2032,41685
09-05-2015,13,12330,16365,6794,3571,39060,1153,601,292,2046,41106
09-05-2015,14,11844,16301,6772,3640,38556,1156,566,290,2012,40568
09-05-2015,15,11921,16108,6783,3607,38419,1137,567,296,2000,40419
09-05-2015,16,12269,15997,6796,3560,38621,1101,587,297,1985,40606
09-05-2015,17,12391,16232,6734,3639,38998,1136,567,302,2005,41003
09-05-2015,18,12580,16383,6697,3727,39386,1039,693,299,2031,41417
09-05-2015,19,13011,16639,6719,3674,40043,1076,609,303,1988,42031
09-05-2015,20,13114,16605,6715,3116,39549,1079,637,318,2034,41583
09-05-2015,21,13158,16574,6775,2924,39432,1092,634,336,2062,41494
09-05-2015,22,12820,16434,6759,2775,38788,1025,501,353,1879,40667
09-05-2015,23,11903,15596,6696,2738,36933,986,400,376,1762,38695
10-05-2015,0,10411,14951,6676,2373,34412,942,279,398,1619,36031
10-05-2015,1,9691,14843,6628,2472,33634,933,262,400,1595,35229
10-05-2015,2,9461,14377,6569,2601,33009,945,261,413,1619,34628
10-05-2015,3,9201,14288,6555,2641,32686,965,269,419,1653,34339
10-05-2015,4,8821,14183,6516,2745,32265,899,267,417,1583,33848
10-05-2015,5,8449,14071,6453,3203,32176,903,319,432,1654,33830
10-05-2015,6,8889,14218,6467,3717,33292,896,370,394,1660,34952
10-05-2015,7,9545,14771,6497,3902,34715,942,514,343,1799,36514
10-05-2015,8,10378,15125,6509,4153,36165,1132,546,324,2002,38167
10-05-2015,9,11209,15287,6493,4347,37336,1186,591,318,2095,39431
10-05-2015,10,11780,15874,6549,4534,38738,1187,590,307,2084,40822
10-05-2015,11,11782,15708,6501,4658,38650,1200,549,312,2061,40711
10-05-2015,12,11810,15593,6505,4647,38555,1174,508,319,2001,40556
10-05-2015,13,11667,15852,6491,4584,38594,1174,540,317,2031,40625
10-05-2015,14,11714,15891,6519,4404,38528,1139,500,320,1959,40487
10-05-2015,15,11551,16038,6501,4270,38360,1105,508,326,1939,40299
10-05-2015,16,11939,16302,6513,3905,38662,1138,494,309,1941,40603
10-05-2015,17,12680,16438,6521,3615,39254,1140,550,326,2016,41270
10-05-2015,18,13836,16784,6462,3275,40359,1092,640,330,2062,42421
10-05-2015,19,16045,17210,6503,2768,42527,1099,661,318,2078,44605
10-05-2015,20,17062,17169,6539,2545,43314,1110,707,303,2120,45434
10-05-2015,21,17245,17380,6519,2389,43533,1106,750,302,2158,45691
10-05-2015,22,16736,17219,6549,2271,42775,1088,456,311,1855,44630
10-05-2015,23,15294,16028,6510,1995,39828,992,268,306,1566,41394
11-05-2015,0,13360,14650,6505,1864,36378,924,264,299,1487,37865
11-05-2015,1,11439,14204,6522,1894,34059,869,246,292,1407,35466
11-05-2015,2,10768,13914,6520,2062,33264,853,244,288,1385,34649
11-05-2015,3,10926,13778,6561,2274,33540,881,248,285,1414,34954
11-05-2015,4,11039,13850,6554,2597,34041,893,353,287,1533,35574
11-05-2015,5,12478,14845,6663,2852,36839,1118,417,301,1836,38675
11-05-2015,6,16021,16588,6811,3208,42629,1273,606,305,2184,44813
11-05-2015,7,18026,17788,6825,3551,46188,1446,612,412,2470,48658
11-05-2015,8,18115,17894,6813,3794,46615,1582,738,349,2669,49284
11-05-2015,9,17709,17642,6659,3986,45995,1574,737,347,2658,48653
11-05-2015,10,17723,17588,6709,4203,46223,1613,734,316,2663,48886
11-05-2015,11,17432,17984,6692,4303,46412,1563,663,335,2561,48973
11-05-2015,12,16905,18111,6664,4256,45937,1551,664,340,2555,48492
11-05-2015,13,16565,18430,6619,4280,45894,1599,659,345,2603,48497
11-05-2015,14,16079,18328,6584,4256,45248,1570,551,437,2558,47806
11-05-2015,15,15731,18269,6628,4336,44965,1574,523,421,2518,47483
11-05-2015,16,15356,18329,6612,4366,44661,1517,496,379,2392,47053
11-05-2015,17,15277,18279,6655,4271,44482,1489,455,372,2316,46798
11-05-2015,18,15483,18257,6680,4148,44569,1469,451,352,2272,46841
11-05-2015,19,15577,18595,6729,3775,44677,1462,535,293,2290,46967
11-05-2015,20,15494,18462,6808,3369,44133,1361,680,340,2381,46514
11-05-2015,21,15737,18145,6847,3085,43812,1411,576,337,2324,46136
11-05-2015,22,14649,17704,6832,2667,41852,1290,453,288,2031,43883
11-05-2015,23,12901,17111,6677,2376,39065,1137,376,287,1800,40865
12-05-2015,0,11409,16419,6715,2207,36750,1149,258,299,1706,38456
12-05-2015,1,11426,15907,6796,1886,36016,1170,259,332,1761,37777
12-05-2015,2,11263,15930,6810,1695,35698,1191,256,385,1832,37530
12-05-2015,3,10979,15747,6793,1819,35339,1211,262,382,1855,37194
12-05-2015,4,11188,15794,6767,1565,35317,1155,276,371,1802,37119
12-05-2015,5,13142,16387,6763,1638,37930,1221,407,359,1987,39917
12-05-2015,6,15935,17482,6843,2031,42291,1518,521,346,2385,44676
12-05-2015,7,17615,18283,6949,2463,45310,1667,733,331,2731,48041
12-05-2015,8,17378,18361,6985,2595,45320,1703,1024,570,3297,48617
12-05-2015,9,17438,18410,7036,2515,45400,1718,841,551,3110,48510
12-05-2015,10,17279,18645,7050,2845,45818,1725,782,417,2924,48742
12-05-2015,11,17305,18629,7040,2927,45899,1717,734,423,2874,48773
12-05-2015,12,17576,18596,6871,2924,45966,1695,699,472,2866,48832
12-05-2015,13,17450,18567,6832,2726,45575,1533,714,621,2868,48443
12-05-2015,14,17130,18289,6827,2861,45108,1429,692,592,2713,47821
12-05-2015,15,16731,18245,6748,3216,44940,1401,638,407,2446,47386
12-05-2015,16,16402,18316,6594,3660,44972,1352,599,409,2360,47332
12-05-2015,17,16292,18142,6575,3985,44994,1304,588,410,2302,47296
12-05-2015,18,16319,18210,6585,4071,45185,1287,551,411,2249,47434
12-05-2015,19,16144,18203,6575,4034,44955,1441,502,429,2372,47327
12-05-2015,20,15392,18166,6500,4020,44079,1314,541,442,2297,46376
12-05-2015,21,15563,17842,6487,3747,43639,1218,560,456,2234,45873
12-05-2015,22,14742,17257,6459,3814,42271,1033,522,462,2017,44288
12-05-2015,23,13242,16565,6438,3751,39996,1003,291,465,1759,41755
13-05-2015,0,11562,15962,6486,3549,37557,1083,279,461,1823,39380
13-05-2015,1,10596,15753,6427,3657,36434,1067,276,447,1790,38224
13-05-2015,2,9940,15692,6426,3789,35847,1067,275,446,1788,37635
13-05-2015,3,9971,15700,6451,3877,35998,1082,268,454,1804,37802
13-05-2015,4,10177,15895,6479,3766,36318,1108,278,461,1847,38165
13-05-2015,5,11066,16729,6620,3736,38152,1149,430,453,2032,40184
13-05-2015,6,13959,17842,6749,3826,42378,1410,545,438,2393,44771
13-05-2015,7,16296,19140,6828,4089,46352,1537,880,679,3096,49448
13-05-2015,8,17211,19382,6924,4286,47803,1574,990,807,3371,51174
13-05-2015,9,16579,19380,6924,4551,47434,1576,933,819,3328,50762
13-05-2015,10,16290,19338,6900,4734,47263,1585,843,801,3229,50492
13-05-2015,11,15930,19137,6942,4677,46687,1559,730,776,3065,49752
13-05-2015,12,15275,19111,6939,5043,46367,1569,721,802,3092,49459
13-05-2015,13,14947,19284,6824,5160,46214,1584,834,687,3105,49319
13-05-2015,14,14679,19254,6848,5091,45870,1596,726,552,2874,48744
13-05-2015,15,14698,18987,6908,4752,45345,1497,621,479,2597,47942
13-05-2015,16,14632,18379,6975,4625,44612,1464,602,477,2543,47155
13-05-2015,17,14964,18275,6933,4620,44792,1443,593,459,2495,47287
13-05-2015,18,15043,18691,6996,4284,45015,1412,595,445,2452,47467
13-05-2015,19,14998,18671,7072,4020,44762,1437,570,434,2441,47203
13-05-2015,20,14681,18486,7021,3635,43824,1352,575,415,2342,46166
13-05-2015,21,14833,18487,6861,3265,43448,1341,567,412,2320,45768
13-05-2015,22,14265,18310,6755,2935,42265,1147,502,399,2048,44313
13-05-2015,23,13279,17298,6768,2677,40021,1077,274,396,1747,41768
14-05-2015,0,11908,16780,6767,2420,37874,1068,302,395,1765,39639
14-05-2015,1,11371,16309,6713,2173,36568,1058,299,383,1740,38308
14-05-2015,2,11213,16118,6684,2117,36132,1047,313,373,1733,37865
14-05-2015,3,11430,16125,6712,1913,36181,1071,326,358,1755,37936
14-05-2015,4,11297,16125,6672,1830,35924,1091,348,341,1780,37704
14-05-2015,5,11414,16567,6669,1751,36401,1204,401,335,1940,38341
14-05-2015,6,11900,16992,6815,1634,37341,1401,546,401,2348,39689
14-05-2015,7,12584,17338,7013,1454,38389,1439,770,539,2748,41137
14-05-2015,8,13106,17770,7298,1455,39629,1459,756,628,2843,42472
14-05-2015,9,13513,17892,7323,1561,40290,1500,775,599,2874,43164
14-05-2015,10,13571,18044,7286,1612,40513,1492,775,573,2840,43353
14-05-2015,11,13626,17991,7284,1624,40525,1496,739,496,2731,43256
14-05-2015,12,13318,18082,7222,1707,40328,1505,776,508,2789,43117
14-05-2015,13,13048,17843,7223,1742,39855,1470,785,537,2792,42647
14-05-2015,14,12692,17561,7243,1774,39271,1474,694,559,2727,41998
14-05-2015,15,12448,17604,7293,1777,39122,1425,669,458,2552,41674
14-05-2015,16,12678,17534,7294,1738,39244,1408,653,324,2385,41629
14-05-2015,17,13262,17744,7319,1716,40042,1385,664,300,2349,42391
14-05-2015,18,14298,17896,7391,1746,41332,1362,672,321,2355,43687
14-05-2015,19,14770,18225,7364,1796,42155,1362,635,413,2410,44565
14-05-2015,20,14729,18124,7391,2210,42454,1352,641,354,2347,44801
14-05-2015,21,15345,17996,7437,1989,42768,1380,636,287,2303,45071
14-05-2015,22,15172,18080,7432,2010,42695,1295,459,286,2040,44735
14-05-2015,23,14006,17796,7462,1571,40837,1185,327,290,1802,42639
15-05-2015,0,12502,16963,7467,1289,38221,1088,241,285,1614,39835
15-05-2015,1,12132,16444,7470,1210,37257,1069,196,282,1547,38804
15-05-2015,2,11929,16468,7475,1118,36990,1057,195,278,1530,38520
15-05-2015,3,11915,16484,7507,1101,37007,1073,198,280,1551,38558
15-05-2015,4,11996,16538,7506,1156,37196,1034,228,277,1539,38735
15-05-2015,5,12478,17173,7529,1239,38419,1164,449,275,1888,40307
15-05-2015,6,14745,17964,7531,2130,42369,1220,733,309,2262,44631
15-05-2015,7,16528,18495,7614,1391,44029,1214,876,521,2611,46640
15-05-2015,8,17509,18998,7572,1579,45657,1246,877,670,2793,48450
15-05-2015,9,17780,19082,7564,1926,46353,1377,844,569,2790,49143
15-05-2015,10,18106,18997,7575,1594,46271,1429,816,544,2789,49060
15-05-2015,11,17708,19034,7619,1546,45906,1443,726,551,2720,48626
15-05-2015,12,17260,18694,7561,1646,45162,1460,780,538,2778,47940
15-05-2015,13,17013,18216,7478,1671,44379,1447,801,521,2769,47148
15-05-2015,14,16692,18057,7652,1700,44099,1457,697,551,2705,46804
15-05-2015,15,16580,17799,7623,1778,43780,1455,658,478,2591,46371
15-05-2015,16,16383,17520,7619,1776,43296,1418,623,419,2460,45756
15-05-2015,17,16821,17383,7620,1833,43659,1447,551,390,2388,46047
15-05-2015,18,17403,17098,7610,1651,43761,1419,576,378,2373,46134
15-05-2015,19,17232,16926,7570,1543,43270,1385,653,357,2395,45665
15-05-2015,20,17091,16701,7617,1488,42899,1255,662,343,2260,45159
15-05-2015,21,17084,16532,7608,1548,42771,1260,626,336,2222,44993
15-05-2015,22,16795,16435,7618,1669,42516,1255,380,320,1955,44471
15-05-2015,23,15231,16138,7573,1647,40589,1149,319,319,1787,42376
16-05-2015,0,13918,15286,7578,1595,38376,1157,188,305,1650,40026
16-05-2015,1,13401,14740,7571,1607,37319,1050,177,351,1578,38897
16-05-2015,2,13370,14683,7563,1511,37126,1037,174,342,1553,38679
16-05-2015,3,12677,14541,7535,1414,36168,997,180,342,1519,37687
16-05-2015,4,12607,14578,7530,1444,36160,965,194,321,1480,37640
16-05-2015,5,12468,14593,7455,1489,36005,1044,193,310,1547,37552
16-05-2015,6,12209,15246,7423,1611,36490,1112,310,298,1720,38210
16-05-2015,7,12757,15840,7309,1578,37486,1207,493,293,1993,39479
16-05-2015,8,13797,16028,7319,1809,38953,1224,539,294,2057,41010
16-05-2015,9,14184,16226,7279,2123,39812,1230,588,302,2120,41932
16-05-2015,10,13815,16136,7218,2401,39571,1235,553,314,2102,41673
16-05-2015,11,13636,16223,7198,2629,39686,1241,530,316,2087,41773
16-05-2015,12,12998,16097,7221,2856,39170,1252,442,314,2008,41178
16-05-2015,13,12822,15946,7150,3013,38932,1248,442,308,1998,40930
16-05-2015,14,12231,16241,7143,3116,38730,1255,447,313,2015,40745
16-05-2015,15,11529,16658,7114,3331,38632,1274,445,321,2040,40672
16-05-2015,16,11636,16362,7129,3733,38860,1282,454,312,2048,40908
16-05-2015,17,11930,16954,7113,4204,40202,1275,454,295,2024,42226
16-05-2015,18,12825,16655,7113,4519,41112,1262,463,288,2013,43125
16-05-2015,19,13236,16741,7202,4702,41881,1245,481,285,2011,43892
16-05-2015,20,12771,16503,7258,4295,40827,1241,512,289,2042,42869
16-05-2015,21,12990,16548,7294,4125,40958,1237,511,285,2033,42991
16-05-2015,22,12691,16929,7221,3951,40792,1128,397,306,1831,42623
16-05-2015,23,11512,16727,7143,3773,39156,1130,168,316,1614,40770
17-05-2015,0,9925,16203,7084,3507,36718,1037,174,306,1517,38235
17-05-2015,1,9343,16109,7048,3455,35955,1015,140,303,1458,37413
17-05-2015,2,9007,16174,7109,3514,35805,965,141,306,1412,37217
17-05-2015,3,8795,16103,7128,3503,35531,941,146,313,1400,36931
17-05-2015,4,8595,16147,7118,3476,35336,904,145,316,1365,36701
17-05-2015,5,7734,15707,7024,3498,33964,939,148,343,1430,35394
17-05-2015,6,7937,15666,6916,3574,34092,997,169,383,1549,35641
17-05-2015,7,9344,16701,6930,3784,36758,1011,246,432,1689,38447
17-05-2015,8,9864,17322,6896,4107,38190,1015,397,463,1875,40065
17-05-2015,9,10232,17605,6888,4418,39144,1019,466,463,1948,41092
17-05-2015,10,10345,17784,6820,4687,39636,1019,474,483,1976,41612
17-05-2015,11,9843,17681,6814,4783,39120,1025,486,492,2003,41123
17-05-2015,12,9418,17233,6833,4685,38170,1002,474,490,1966,40136
17-05-2015,13,9409,17202,6849,4844,38305,1001,454,490,1945,40250
17-05-2015,14,9263,16855,6719,4618,37454,981,453,489,1923,39377
17-05-2015,15,9745,16753,6286,4563,37348,968,457,492,1917,39265
17-05-2015,16,10379,17061,6019,4779,38238,1025,422,493,1940,40178
17-05-2015,17,10799,17422,6016,4606,38844,1018,417,491,1926,40770
17-05-2015,18,11666,17897,6044,4288,39896,1024,413,486,1923,41819
17-05-2015,19,13066,18208,6146,4091,41510,1024,545,462,2031,43541
17-05-2015,20,12899,18408,6209,3770,41287,1022,600,431,2053,43340
17-05-2015,21,13526,17956,6293,3571,41345,1006,595,436,2037,43382
17-05-2015,22,13369,17821,6321,3473,40985,927,424,469,1820,42805
17-05-2015,23,12586,17371,6260,3043,39260,874,303,444,1621,40881
18-05-2015,0,11245,16439,6267,2972,36924,844,158,447,1449,38373
18-05-2015,1,11084,15948,6219,2767,36020,828,154,454,1436,37456
18-05-2015,2,11091,15815,6211,2504,35619,809,162,457,1428,37047
18-05-2015,3,11079,15741,6174,2182,35176,869,161,460,1490,36666
18-05-2015,4,11038,15765,6236,2035,35074,894,177,454,1525,36599
18-05-2015,5,13364,16278,6430,1792,37864,1047,335,452,1834,39698
18-05-2015,6,17632,18079,6719,1795,44226,1313,541,451,2305,46531
18-05-2015,7,20064,18540,6852,2284,47740,1348,732,674,2754,50494
18-05-2015,8,20187,18374,6933,2512,48006,1353,905,622,2880,50886
18-05-2015,9,19940,18257,6947,2354,47498,1351,911,691,2953,50451
18-05-2015,10,19867,17929,6971,2375,47141,1358,839,628,2825,49966
18-05-2015,11,19586,17888,6983,2498,46954,1362,767,650,2779,49733
18-05-2015,12,19223,17672,6899,2258,46054,1368,769,648,2785,48839
18-05-2015,13,19116,17574,6793,2352,45836,1377,672,710,2759,48595
18-05-2015,14,18701,17463,6736,2671,45570,1394,666,673,2733,48303
18-05-2015,15,18184,17117,6666,2544,44511,1412,531,442,2385,46896
18-05-2015,16,18250,16972,6627,2606,44453,1419,469,448,2336,46789
18-05-2015,17,18321,16971,6673,2620,44585,1427,459,402,2288,46873
18-05-2015,18,18525,17299,6634,2815,45275,1411,456,365,2232,47507
18-05-2015,19,18097,17336,6572,2961,44964,1409,520,416,2345,47309
18-05-2015,20,17462,17179,6535,3244,44419,1354,509,462,2325,46744
18-05-2015,21,17138,16850,6439,3596,44023,1354,500,385,2239,46262
18-05-2015,22,15951,16401,6382,3861,42595,1222,437,286,1945,44540
18-05-2015,23,13925,15835,6334,3916,40009,1134,182,277,1593,41602
19-05-2015,0,11877,15363,6428,3318,36988,1088,239,271,1598,38586
19-05-2015,1,11075,15338,6304,3402,36121,1017,267,270,1554,37675
19-05-2015,2,10769,15408,6293,3160,35631,1018,227,303,1548,37179
19-05-2015,3,10465,15494,6278,3097,35334,1004,181,282,1467,36801
19-05-2015,4,11183,15630,6370,3030,36215,1024,185,293,1502,37717
19-05-2015,5,12987,16010,6442,2574,38014,1198,340,375,1913,39927
19-05-2015,6,16644,16956,6663,2410,42673,1367,535,412,2314,44987
19-05-2015,7,18877,18450,6941,3052,47320,1372,773,532,2677,49997
19-05-2015,8,19231,18718,7155,3353,48457,1382,739,489,2610,51067
19-05-2015,9,19391,18249,7230,3361,48233,1379,738,507,2624,50857
19-05-2015,10,19190,18420,7054,3717,48380,1382,785,485,2652,51032
19-05-2015,11,19046,18521,6975,3500,48041,1383,729,497,2609,50650
19-05-2015,12,18635,18335,6932,3549,47452,1362,779,517,2658,50110
19-05-2015,13,18588,17713,6946,3595,46840,1238,699,575,2512,49352
19-05-2015,14,17692,17686,6892,3506,45775,1244,699,521,2464,48239
19-05-2015,15,16989,17444,6791,3466,44689,1227,602,405,2234,46923
19-05-2015,16,16896,17454,6729,3298,44377,1255,599,401,2255,46632
19-05-2015,17,17488,17817,6677,3380,45362,1235,601,351,2187,47549
19-05-2015,18,17740,17625,6627,3327,45318,1253,616,396,2265,47583
19-05-2015,19,17719,17600,6606,3395,45319,1298,569,401,2268,47587
19-05-2015,20,17494,17227,6682,3249,44652,1169,554,388,2111,46763
19-05-2015,21,17601,17153,6615,2912,44281,1231,529,328,2088,46369
19-05-2015,22,17198,16915,6614,2461,43190,1066,386,287,1739,44929
19-05-2015,23,15374,16033,6595,2356,40359,1059,195,291,1545,41904
20-05-2015,0,13565,15253,6677,2122,37618,819,196,273,1288,38906
20-05-2015,1,13128,15074,6618,2000,36820,769,198,272,1239,38059
20-05-2015,2,13049,14979,6635,1889,36553,746,197,273,1216,37769
20-05-2015,3,12893,14733,6625,1759,36011,727,202,273,1202,37213
20-05-2015,4,13160,14582,6628,1880,36250,732,216,290,1238,37488
20-05-2015,5,15425,14944,6751,1722,38841,729,261,277,1267,40108
20-05-2015,6,18086,16162,7104,2068,43419,852,434,469,1755,45174
20-05-2015,7,19493,17211,7353,3110,47167,1058,697,469,2224,49391
20-05-2015,8,19800,16921,7584,3317,47622,1067,734,739,2540,50162
20-05-2015,9,19533,16838,7652,3059,47082,1061,864,678,2603,49685
20-05-2015,10,19571,16678,7580,2997,46828,1059,778,468,2305,49133
20-05-2015,11,19340,16633,7530,3118,46620,1073,799,574,2446,49066
20-05-2015,12,19309,16471,7339,3112,46232,1044,787,613,2444,48676
20-05-2015,13,19202,16542,7171,3229,46144,1044,764,481,2289,48433
20-05-2015,14,19043,16497,7095,3627,46262,1002,643,592,2237,48499
20-05-2015,15,18717,16360,6943,2982,45003,856,617,379,1852,46855
20-05-2015,16,18608,16309,6897,2458,44271,798,617,316,1731,46002
20-05-2015,17,18970,16739,6982,2678,45368,791,586,338,1715,47083
20-05-2015,18,18500,16975,7060,2807,45341,972,588,341,1901,47242
20-05-2015,19,18652,16814,6956,2460,44882,972,590,472,2034,46916
20-05-2015,20,18654,16667,6854,2179,44353,825,536,346,1707,46060
20-05-2015,21,18884,16709,6745,1916,44254,790,465,362,1617,45871
20-05-2015,22,18683,16613,6679,1653,43628,787,388,360,1535,45163
20-05-2015,23,17434,15735,6609,1532,41308,746,201,353,1300,42608
21-05-2015,0,15104,14792,6535,1242,37674,700,235,352,1287,38961
21-05-2015,1,14471,14261,6525,1185,36443,654,236,347,1237,37680
21-05-2015,2,14102,14262,6535,1124,36024,662,242,375,1279,37303
21-05-2015,3,13925,14256,6580,1110,35871,680,249,384,1313,37184
21-05-2015,4,14095,14407,6613,1092,36208,715,256,382,1353,37561
21-05-2015,5,15813,14985,6668,1227,38692,824,265,369,1458,40150
21-05-2015,6,18439,16260,6988,1774,43461,885,400,583,1868,45329
21-05-2015,7,19706,17205,7213,2404,46528,1084,600,550,2234,48762
21-05-2015,8,19690,17560,7228,2614,47094,1078,773,490,2341,49435
21-05-2015,9,19577,16939,7239,2709,46466,1067,776,495,2338,48804
21-05-2015,10,19604,16619,7260,2725,46210,1067,777,498,2342,48552
21-05-2015,11,19532,16760,7324,2832,46448,1071,700,537,2308,48756
21-05-2015,12,19285,16719,7248,2819,46072,1068,715,519,2302,48374
21-05-2015,13,19089,16515,7211,2635,45450,1063,663,540,2266,47716
21-05-2015,14,19315,16456,7100,2486,45356,1072,606,543,2221,47577
21-05-2015,15,18727,16401,6873,2635,44637,942,582,418,1942,46579
21-05-2015,16,18534,16026,6780,2599,43939,872,570,356,1798,45737
21-05-2015,17,18749,16158,6826,2362,44094,889,534,366,1789,45883
21-05-2015,18,18793,16379,6851,2681,44705,985,530,304,1819,46524
21-05-2015,19,18830,16364,6869,2700,44763,967,529,406,1902,46665
21-05-2015,20,18635,16280,6899,2463,44278,850,545,447,1842,46120
21-05-2015,21,18582,16109,6803,2353,43846,804,494,373,1671,45517
21-05-2015,22,18102,15652,6724,1910,42386,822,457,280,1559,43945
21-05-2015,23,16550,15058,6691,1660,39959,817,232,277,1326,41285
22-05-2015,0,15300,14284,6717,1607,37909,691,204,278,1173,39082
22-05-2015,1,13527,14275,6698,1524,36026,732,200,276,1208,37234
22-05-2015,2,12878,14166,6732,1577,35354,741,200,278,1219,36573
22-05-2015,3,12741,14231,6748,1567,35287,733,202,278,1213,36500
22-05-2015,4,12850,14312,6730,1613,35505,722,213,279,1214,36719
22-05-2015,5,14422,15090,6784,1590,37887,771,273,282,1326,39213
22-05-2015,6,17206,16455,7026,1965,42652,992,431,539,1962,44614
22-05-2015,7,19106,17747,7282,2041,46175,1046,679,565,2290,48465
22-05-2015,8,19522,17837,7311,2457,47126,1077,784,576,2437,49563
22-05-2015,9,19193,18021,7267,2717,47198,1080,741,555,2376,49574
22-05-2015,10,19035,18093,7214,2796,47139,1085,799,529,2413,49552
22-05-2015,11,18714,18045,7162,3123,47045,1108,743,533,2384,49429
22-05-2015,12,17776,18118,7160,3332,46386,930,742,552,2224,48610
22-05-2015,13,17000,17854,7224,3558,45637,880,718,520,2118,47755
22-05-2015,14,16636,17754,7076,3649,45116,927,642,537,2106,47222
22-05-2015,15,15915,17726,6948,3621,44209,837,638,481,1956,46165
22-05-2015,16,16032,17619,6935,3580,44165,726,646,449,1821,45986
22-05-2015,17,16688,17653,6961,3611,44912,702,576,450,1728,46640
22-05-2015,18,16467,17735,6839,3699,44740,742,494,466,1702,46442
22-05-2015,19,15927,17858,6762,3612,44160,693,477,464,1634,45794
22-05-2015,20,15227,17774,6780,3242,43022,682,428,464,1574,44596
22-05-2015,21,15267,17456,6740,2690,42154,687,380,406,1473,43627
22-05-2015,22,14859,17309,6696,2449,41313,648,369,290,1307,42620
22-05-2015,23,13595,16931,6676,2222,39424,610,201,306,1117,40541
23-05-2015,0,12058,16024,6670,2133,36885,635,153,324,1112,37997
23-05-2015,1,11212,15766,6630,2139,35748,661,153,331,1145,36893
23-05-2015,2,10990,15610,6628,2064,35293,664,233,332,1229,36522
23-05-2015,3,10806,15504,6577,2025,34912,676,158,349,1183,36095
23-05-2015,4,10141,15336,6613,2088,34180,665,187,363,1215,35395
23-05-2015,5,10229,15170,6644,2092,34135,659,240,360,1259,35394
23-05-2015,6,10940,15683,6702,2203,35529,677,341,333,1351,36880
23-05-2015,7,12035,16149,6737,2482,37403,687,488,314,1489,38892
23-05-2015,8,13047,16559,6758,2811,39176,680,542,317,1539,40715
23-05-2015,9,13888,16842,6786,3024,40542,666,531,330,1527,42069
23-05-2015,10,14645,16993,6794,3113,41545,686,487,327,1500,43045
23-05-2015,11,14561,16977,6773,3040,41352,684,464,335,1483,42835
23-05-2015,12,14277,17121,6751,3031,41181,685,479,311,1475,42656
23-05-2015,13,13479,17105,6686,2981,40250,675,465,301,1441,41691
23-05-2015,14,13159,17034,6667,2986,39847,675,453,297,1425,41272
23-05-2015,15,12997,16842,6645,2996,39479,700,319,298,1317,40796
23-05-2015,16,12783,16850,6652,2977,39264,703,317,299,1319,40583
23-05-2015,17,13184,17046,6727,2909,39865,618,405,295,1318,41183
23-05-2015,18,14054,17156,6788,2680,40678,618,405,287,1310,41988
23-05-2015,19,14147,17311,6679,2445,40582,670,406,285,1361,41943
23-05-2015,20,14112,16862,6675,2286,39937,621,407,283,1311,41248
23-05-2015,21,14262,16516,6694,2014,39486,620,461,282,1363,40849
23-05-2015,22,14740,16592,6678,2036,40046,659,302,284,1245,41291
23-05-2015,23,13940,16174,6653,1930,38697,547,137,287,971,39668
24-05-2015,0,13406,14632,6668,1887,36592,548,135,288,971,37563
24-05-2015,1,12797,14237,6612,1809,35454,521,135,286,942,36396
24-05-2015,2,12465,14218,6600,1696,34979,514,135,286,935,35914
24-05-2015,3,11730,13815,6548,1689,33782,495,138,283,916,34698
24-05-2015,4,11691,13548,6545,1693,33477,463,138,281,882,34359
24-05-2015,5,11189,13360,6442,1659,32650,506,175,281,962,33612
24-05-2015,6,11008,13250,6458,1636,32351,501,309,281,1091,33442
24-05-2015,7,11057,13644,6470,1692,32862,528,318,281,1127,33989
24-05-2015,8,12383,14162,6479,1801,34823,565,466,283,1314,36137
24-05-2015,9,13730,14719,6521,1888,36856,587,539,284,1410,38266
24-05-2015,10,14259,14911,6532,2035,37736,599,527,288,1414,39150
24-05-2015,11,14417,14911,6548,2202,38078,594,484,294,1372,39450
24-05-2015,12,14016,14842,6523,2302,37684,595,461,301,1357,39041
24-05-2015,13,13313,14668,6445,2417,36844,582,435,300,1317,38161
24-05-2015,14,12962,14482,6418,2497,36360,546,433,300,1279,37639
24-05-2015,15,12849,14473,6463,2455,36240,526,413,301,1240,37480
24-05-2015,16,12953,14545,6440,2596,36534,528,428,299,1255,37789
24-05-2015,17,13876,14902,6385,2616,37777,539,489,298,1326,39103
24-05-2015,18,14639,15537,6436,2470,39081,524,503,339,1366,40447
24-05-2015,19,16730,15888,6466,2307,41389,508,581,285,1374,42763
24-05-2015,20,16741,15942,6521,2149,41353,499,485,410,1394,42747
24-05-2015,21,16721,15818,6519,2040,41098,503,508,347,1358,42456
24-05-2015,22,16390,15824,6485,1899,40597,500,353,285,1138,41735
24-05-2015,23,15134,15245,6542,1608,38530,506,216,289,1011,39541
25-05-2015,0,13233,14025,6510,1413,35182,509,198,298,1005,36187
25-05-2015,1,11969,13539,6495,1339,33344,500,201,305,1006,34350
25-05-2015,2,11295,13256,6490,1311,32351,541,203,307,1051,33402
25-05-2015,3,10887,13123,6483,1253,31747,522,206,302,1030,32777
25-05-2015,4,10758,13079,6541,1331,31709,522,216,311,1049,32758
25-05-2015,5,11503,13403,6710,1356,32973,619,391,317,1327,34300
25-05-2015,6,13228,14791,7022,1381,36422,776,529,460,1765,38187
25-05-2015,7,15537,15867,7251,1455,40110,819,683,542,2044,42154
25-05-2015,8,17227,16027,7382,1739,42375,830,711,670,2211,44586
25-05-2015,9,17580,16282,7334,1833,43030,839,816,673,2328,45358
25-05-2015,10,17648,16352,7301,1839,43140,843,898,672,2413,45553
25-05-2015,11,17864,16435,7217,2028,43544,838,757,668,2263,45807
25-05-2015,12,17915,15873,7233,2103,43125,835,791,650,2276,45401
25-05-2015,13,17098,15789,7164,2205,42256,820,606,673,2099,44355
25-05-2015,14,16759,15706,7127,2196,41787,816,597,687,2100,43887
25-05-2015,15,16418,15634,6937,2204,41193,811,517,673,2001,43194
25-05-2015,16,16437,15613,6873,2162,41085,816,459,641,1916,43001
25-05-2015,17,17047,15663,6852,2158,41721,759,401,674,1834,43555
25-05-2015,18,17663,15882,6800,2305,42650,779,387,545,1711,44361
25-05-2015,19,17460,15796,6826,2293,42376,764,391,536,1691,44067
25-05-2015,20,17301,15332,6780,2116,41528,720,549,371,1640,43168
25-05-2015,21,17724,15202,6723,2004,41652,686,501,369,1556,43208
25-05-2015,22,17370,14776,6597,2005,40749,624,361,307,1292,42041
25-05-2015,23,15978,14453,6490,1748,38670,587,196,319,1102,39772
26-05-2015,0,14957,13818,6498,1709,36982,570,195,322,1087,38069
26-05-2015,1,14627,13045,6496,1711,35879,583,198,344,1125,37004
26-05-2015,2,14587,12712,6491,1699,35489,601,197,365,1163,36652
26-05-2015,3,14520,12785,6500,1725,35530,618,204,344,1166,36696
26-05-2015,4,14537,12875,6491,1755,35657,648,223,332,1203,36860
26-05-2015,5,15665,13651,6681,1885,37883,687,333,320,1340,39223
26-05-2015,6,17902,15003,6930,2306,42142,822,591,336,1749,43891
26-05-2015,7,19145,15717,7232,2839,44933,873,683,474,2030,46963
26-05-2015,8,19403,15801,7357,3559,46120,882,777,520,2179,48299
26-05-2015,9,19299,15747,7319,3676,46041,874,769,515,2158,48199
26-05-2015,10,19215,15732,7329,3606,45881,884,774,473,2131,48012
26-05-2015,11,18923,15755,7189,3699,45566,897,748,555,2200,47766
26-05-2015,12,18497,15840,7125,3747,45209,903,742,551,2196,47405
26-05-2015,13,18402,15773,6967,3792,44933,890,690,627,2207,47140
26-05-2015,14,18139,15798,6902,3934,44773,883,709,544,2136,46909
26-05-2015,15,17521,15812,6755,4002,44091,869,477,491,1837,45928
26-05-2015,16,17359,15815,6620,4065,43859,847,433,439,1719,45578
26-05-2015,17,17183,15562,6572,4142,43459,851,410,463,1724,45183
26-05-2015,18,17344,15306,6711,4143,43506,841,403,567,1811,45317
26-05-2015,19,17349,15011,6841,4067,43267,802,489,477,1768,45035
26-05-2015,20,17117,14804,6729,3863,42514,772,425,508,1705,44219
26-05-2015,21,17228,14680,6637,3610,42155,766,422,350,1538,43693
26-05-2015,22,16671,14241,6560,3350,40823,770,321,342,1433,42256
26-05-2015,23,15311,13988,6430,3176,38904,661,197,335,1193,40097
27-05-2015,0,13091,13480,6261,3295,36126,642,192,330,1164,37290
27-05-2015,1,12093,13390,6188,3308,34982,629,216,331,1176,36158
27-05-2015,2,11722,13352,6197,3235,34506,622,275,326,1223,35729
27-05-2015,3,11343,13310,6234,3291,34178,686,279,322,1287,35465
27-05-2015,4,11586,13253,6310,3311,34461,703,197,321,1221,35682
27-05-2015,5,13157,13960,6393,3328,36839,703,217,319,1239,38078
27-05-2015,6,16345,14900,6801,3357,41403,791,550,315,1656,43059
27-05-2015,7,18198,15903,7033,3799,44932,865,681,419,1965,46897
27-05-2015,8,18665,16261,7194,3971,46090,861,744,489,2094,48184
27-05-2015,9,18398,16358,7296,4273,46324,878,765,477,2120,48444
27-05-2015,10,18269,16334,7257,4446,46307,883,775,451,2109,48416
27-05-2015,11,18140,16369,7289,4326,46123,890,708,504,2102,48225
27-05-2015,12,18012,16344,7184,4188,45727,897,644,570,2111,47838
27-05-2015,13,17930,16497,7090,3908,45425,893,646,581,2120,47545
27-05-2015,14,17670,16543,7029,3953,45195,896,548,597,2041,47236
27-05-2015,15,17170,16570,6731,3955,44427,886,500,595,1981,46408
27-05-2015,16,16920,16480,6575,3635,43609,854,433,567,1854,45463
27-05-2015,17,17154,16513,6623,3301,43590,845,432,551,1828,45418
27-05-2015,18,17241,16386,6742,3387,43756,877,434,522,1833,45589
27-05-2015,19,17455,16307,6641,3128,43531,882,426,486,1794,45325
27-05-2015,20,17691,16104,6591,2935,43323,834,442,454,1730,45053
27-05-2015,21,17393,15882,6537,2069,41881,807,438,377,1622,43503
27-05-2015,22,17419,15674,6538,1610,41241,728,282,329,1339,42580
27-05-2015,23,15821,15085,6523,1296,38726,719,207,314,1240,39966
28-05-2015,0,14749,14044,6514,1309,36614,729,190,310,1229,37843
28-05-2015,1,13591,13773,6422,1407,35194,737,190,304,1231,36425
28-05-2015,2,12978,13701,6409,1612,34700,737,194,301,1232,35932
28-05-2015,3,12612,13715,6390,1856,34573,738,200,299,1237,35810
28-05-2015,4,12546,13619,6430,2069,34664,734,210,300,1244,35908
28-05-2015,5,14253,13784,6599,2377,37013,733,377,301,1411,38424
28-05-2015,6,16706,14844,7125,2874,41549,847,631,308,1786,43335
28-05-2015,7,18924,15791,7217,3343,45274,957,801,333,2091,47365
28-05-2015,8,19517,15671,7256,3332,45776,964,778,479,2221,47997
28-05-2015,9,19120,15604,7216,3539,45480,963,776,495,2234,47714
28-05-2015,10,19010,16015,7313,3711,46051,961,784,448,2193,48244
28-05-2015,11,18642,15956,7211,3926,45735,957,736,440,2133,47868
28-05-2015,12,18435,15780,7064,4081,45360,957,704,495,2156,47516
28-05-2015,13,18469,15582,6964,4122,45136,958,724,458,2140,47276
28-05-2015,14,18275,15721,6948,4054,44997,939,680,471,2090,47087
28-05-2015,15,18246,15969,7025,4024,45265,868,675,406,1949,47214
28-05-2015,16,17864,16374,6947,3895,45080,844,600,416,1860,46940
28-05-2015,17,17850,16056,6769,3986,44661,853,535,451,1839,46500
28-05-2015,18,17863,15816,6776,3834,44289,855,537,416,1808,46097
28-05-2015,19,17792,15837,6735,3735,44099,842,551,416,1809,45908
28-05-2015,20,17720,15658,6626,3421,43425,828,596,412,1836,45261
28-05-2015,21,17687,15425,6511,2958,42582,853,482,417,1752,44334
28-05-2015,22,17101,15579,6467,2705,41851,719,390,311,1420,43271
28-05-2015,23,15388,15208,6444,2609,39650,712,207,330,1249,40899
29-05-2015,0,12965,14553,6351,2730,36600,714,204,354,1272,37872
29-05-2015,1,12017,14372,6338,2828,35556,727,202,433,1362,36918
29-05-2015,2,11634,14194,6241,2871,34941,737,204,441,1382,36323
29-05-2015,3,11532,14119,6219,2886,34758,742,206,424,1372,36130
29-05-2015,4,11554,14037,6276,2908,34777,766,211,369,1346,36123
29-05-2015,5,13676,14524,6429,2866,37495,804,243,338,1385,38880
29-05-2015,6,17296,15179,6848,2889,42211,927,424,470,1821,44032
29-05-2015,7,19182,16680,7141,3207,46212,991,761,352,2104,48316
29-05-2015,8,19501,16941,7223,3528,47194,989,749,480,2218,49412
29-05-2015,9,18938,16624,7207,3567,46336,999,763,479,2241,48577
29-05-2015,10,18857,16462,7229,3562,46111,998,726,462,2186,48297
29-05-2015,11,18424,16474,7197,3691,45785,995,782,371,2148,47933
29-05-2015,12,18237,16446,7123,3497,45302,1008,654,532,2194,47496
29-05-2015,13,18038,16269,7038,3404,44748,1009,640,524,2173,46921
29-05-2015,14,18311,16267,6961,3061,44601,955,593,464,2012,46613
29-05-2015,15,18200,16176,6886,2609,43872,983,547,439,1969,45841
29-05-2015,16,18314,16107,6835,2240,43497,992,452,486,1930,45427
29-05-2015,17,18323,16321,6872,2192,43708,990,473,446,1909,45617
29-05-2015,18,18347,16271,6801,2258,43677,950,464,474,1888,45565
29-05-2015,19,18201,16051,6648,2224,43123,846,498,421,1765,44888
29-05-2015,20,17796,15616,6736,2175,42323,716,518,429,1663,43986
29-05-2015,21,17489,14990,6594,2234,41308,762,515,384,1661,42969
29-05-2015,22,17390,14654,6413,1936,40393,615,418,295,1328,41721
29-05-2015,23,16275,14329,6328,1806,38738,591,189,303,1083,39821
30-05-2015,0,13485,14615,6338,1945,36382,557,145,328,1030,37412
30-05-2015,1,12173,14425,6243,2382,35224,544,139,364,1047,36271
30-05-2015,2,11310,14059,6243,2679,34291,546,143,379,1068,35359
30-05-2015,3,10802,14050,6193,2971,34016,560,148,392,1100,35116
30-05-2015,4,10605,14062,6075,3207,33950,557,166,409,1132,35082
30-05-2015,5,10652,14110,6104,3155,34020,563,167,408,1138,35158
30-05-2015,6,11173,14364,6079,3267,34884,565,257,426,1248,36132
30-05-2015,7,12315,14806,6167,3459,36748,673,424,386,1483,38231
30-05-2015,8,14161,15076,6344,3580,39163,680,538,370,1588,40751
30-05-2015,9,15200,15425,6427,3987,41040,677,544,402,1623,42663
30-05-2015,10,14781,15790,6465,4337,41374,681,554,410,1645,43019
30-05-2015,11,14428,16060,6454,4395,41338,686,556,402,1644,42982
30-05-2015,12,13572,15917,6409,4518,40415,702,561,406,1669,42084
30-05-2015,13,12806,16008,6316,4522,39653,670,559,388,1617,41270
30-05-2015,14,12489,16055,6255,4467,39266,664,559,431,1654,40920
30-05-2015,15,12274,16148,6186,4550,39160,666,552,449,1667,40827
30-05-2015,16,12190,16231,6225,4577,39224,684,540,418,1642,40866
30-05-2015,17,13533,16530,6240,4496,40800,750,489,370,1609,42409
30-05-2015,18,13894,16556,6338,4344,41132,738,439,369,1546,42678
30-05-2015,19,13645,16597,6379,4225,40846,661,437,373,1471,42317
30-05-2015,20,13452,16407,6392,4143,40393,627,348,354,1329,41722
30-05-2015,21,13290,16453,6415,3891,40049,670,551,329,1550,41599
30-05-2015,22,13466,16294,6435,3788,39982,705,296,344,1345,41327
30-05-2015,23,12525,16099,6299,3805,38727,704,180,342,1226,39953
31-05-2015,0,11349,15548,6274,3854,37025,601,158,352,1111,38136
31-05-2015,1,10180,15188,6278,4011,35656,592,163,355,1110,36766
31-05-2015,2,9458,14765,6205,3986,34414,579,157,369,1105,35519
31-05-2015,3,9208,14764,5988,3781,33742,578,154,377,1109,34851
31-05-2015,4,9214,14882,6017,3517,33629,567,161,368,1096,34725
31-05-2015,5,9559,15086,6029,3242,33916,575,167,360,1102,35018
31-05-2015,6,10139,15391,5947,3006,34484,569,283,369,1221,35705
31-05-2015,7,9819,15836,5972,2975,34602,584,445,343,1372,35974
31-05-2015,8,11060,16371,6035,3156,36622,601,517,364,1482,38104
31-05-2015,9,11707,16671,6186,3387,37952,597,625,384,1606,39558
31-05-2015,10,11928,16860,6291,3448,38526,593,621,409,1623,40149
31-05-2015,11,12206,16974,6285,3500,38966,561,539,405,1505,40471
31-05-2015,12,11924,17046,6252,3308,38531,585,537,409,1531,40062
31-05-2015,13,11463,17003,6225,3257,37948,619,538,408,1565,39513
31-05-2015,14,10800,16887,6025,3236,36947,628,527,385,1540,38487
31-05-2015,15,10565,16805,5925,3203,36498,651,535,368,1554,38052
31-05-2015,16,10703,16628,5954,3135,36420,637,524,339,1500,37920
31-05-2015,17,12211,16688,6109,3079,38088,634,525,310,1469,39557
31-05-2015,18,13140,16675,6290,3097,39202,615,501,298,1414,40616
31-05-2015,19,13925,16660,6470,3433,40489,681,499,292,1472,41961
31-05-2015,20,13681,16420,6539,3618,40260,680,505,287,1472,41732
31-05-2015,21,13605,16133,6498,3816,40052,647,478,297,1422,41474
31-05-2015,22,13146,16047,6443,3999,39634,645,337,302,1284,40918
31-05-2015,23,11778,15683,6184,3959,37603,633,207,324,1164,38767
01-06-2015,0,10434,15181,6099,3819,35536,646,156,366,1168,36704
01-06-2015,1,9586,14797,6097,3842,34321,649,154,404,1207,35528
01-06-2015,2,9326,14695,6119,3909,34051,635,155,403,1193,35244
01-06-2015,3,9247,14534,6099,3812,33692,631,152,417,1200,34892
01-06-2015,4,9880,14676,6174,3584,34313,635,162,414,1211,35524
01-06-2015,5,11311,15459,6547,3620,36937,703,179,413,1295,38232
01-06-2015,6,14332,16442,6784,3770,41328,869,444,512,1825,43153
01-06-2015,7,17339,17063,7100,3987,45490,1043,634,543,2220,47710
01-06-2015,8,17542,17267,7145,4410,46364,1101,721,553,2375,48739
01-06-2015,9,17228,17281,7138,4538,46185,1139,721,558,2418,48603
01-06-2015,10,17208,17314,7208,4707,46439,1173,692,534,2399,48838
01-06-2015,11,17182,17354,7179,4571,46287,1186,563,569,2318,48605
01-06-2015,12,17250,17330,7087,4412,46080,1194,659,527,2380,48460
01-06-2015,13,17028,17322,6975,4382,45707,1148,695,540,2383,48090
01-06-2015,14,17516,17352,6945,4593,46407,1099,562,548,2209,48616
01-06-2015,15,17618,17591,6928,4399,46536,1022,558,510,2090,48626
01-06-2015,16,17110,17636,6954,4248,45949,876,608,474,1958,47907
01-06-2015,17,17166,17516,6899,3789,45371,841,618,463,1922,47293
01-06-2015,18,17401,17406,6819,3442,45069,814,581,462,1857,46926
01-06-2015,19,17416,17427,6937,3344,45126,747,557,471,1775,46901
01-06-2015,20,17547,17260,6903,2793,44504,666,542,469,1677,46181
01-06-2015,21,17645,16999,6836,2409,43889,635,432,478,1545,45434
01-06-2015,22,17343,16513,6795,2305,42956,624,389,307,1320,44276
01-06-2015,23,15434,16090,6685,2232,40442,609,198,286,1093,41535
02-06-2015,0,13402,15484,6676,2194,37755,594,197,287,1078,38833
02-06-2015,1,12158,15361,6496,2466,36480,590,212,290,1092,37572
02-06-2015,2,11516,15261,6411,2745,35933,588,206,283,1077,37010
02-06-2015,3,10981,14783,6347,3083,35195,602,186,283,1071,36266
02-06-2015,4,10945,14866,6303,3401,35515,608,211,282,1101,36616
02-06-2015,5,11796,15256,6569,3676,37298,683,252,280,1215,38513
02-06-2015,6,14985,15977,7051,3880,41891,821,400,502,1723,43614
02-06-2015,7,17763,17216,7141,4092,46213,958,473,568,1999,48212
02-06-2015,8,18056,17667,7301,4411,47436,974,637,524,2135,49571
02-06-2015,9,17368,17714,7296,4742,47121,973,653,528,2154,49275
02-06-2015,10,16521,17334,7241,4965,46062,976,678,526,2180,48242
02-06-2015,11,16190,16805,7228,5017,45239,982,680,524,2186,47425
02-06-2015,12,15441,16600,7168,5013,44223,984,711,528,2223,46446
02-06-2015,13,14999,16723,7090,5051,43863,986,650,534,2170,46033
02-06-2015,14,14687,17008,7033,4930,43659,989,649,539,2177,45836
02-06-2015,15,14570,17249,6956,4869,43645,982,541,536,2059,45704
02-06-2015,16,14595,17451,6862,4690,43599,857,511,526,1894,45493
02-06-2015,17,15345,17724,6779,4578,44427,825,482,550,1857,46284
02-06-2015,18,15897,18069,6845,4456,45266,883,451,546,1880,47146
02-06-2015,19,15736,17829,6919,4501,44986,883,456,521,1860,46846
02-06-2015,20,15141,17813,6832,4540,44326,763,493,480,1736,46062
02-06-2015,21,14341,17749,6654,4509,43253,763,447,483,1693,44946
02-06-2015,22,13526,17413,6498,4478,41918,767,414,377,1558,43476
02-06-2015,23,12096,17213,6284,4542,40134,755,207,366,1328,41462
03-06-2015,0,10120,16480,6202,4649,37451,703,199,390,1292,38743
03-06-2015,1,9659,15921,6097,4652,36328,712,200,436,1348,37676
03-06-2015,2,9490,15741,6035,4597,35864,716,199,434,1349,37213
03-06-2015,3,8919,15499,6048,4350,34817,738,195,446,1379,36196
03-06-2015,4,9366,15536,6236,4265,35405,745,217,441,1403,36808
03-06-2015,5,10403,16122,6456,4335,37315,803,246,441,1490,38805
03-06-2015,6,13365,16844,6735,4457,41401,1074,428,594,2096,43497
03-06-2015,7,16498,17227,6949,4501,45176,1185,598,591,2374,47550
03-06-2015,8,17311,17682,7073,4602,46667,1190,765,581,2536,49203
03-06-2015,9,17246,17710,7195,4695,46846,1190,792,545,2527,49373
03-06-2015,10,17180,17850,7168,4683,46881,1185,752,617,2554,49435
03-06-2015,11,16900,17738,7341,4620,46601,1190,725,622,2537,49138
03-06-2015,12,16753,17633,7291,4627,46304,1177,713,609,2499,48803
03-06-2015,13,16407,17406,7213,4647,45674,1184,607,606,2397,48071
03-06-2015,14,16058,17362,7067,4687,45173,1201,575,607,2383,47556
03-06-2015,15,15300,17425,7037,4793,44555,1192,577,655,2424,46979
03-06-2015,16,15027,17479,7017,4790,44314,1100,435,423,1958,46272
03-06-2015,17,14921,17618,7116,4644,44298,1085,445,428,1958,46256
03-06-2015,18,14937,17479,6913,4565,43894,894,425,449,1768,45662
03-06-2015,19,15063,17492,6810,4371,43737,983,461,619,2063,45800
03-06-2015,20,14828,17501,6815,4076,43220,863,408,432,1703,44923
03-06-2015,21,14818,17461,6718,3599,42596,821,373,437,1631,44227
03-06-2015,22,14618,17576,6561,3158,41912,845,394,439,1678,43590
03-06-2015,23,13204,17389,6456,3022,40071,832,224,434,1490,41561
04-06-2015,0,11961,16926,6362,2826,38077,792,209,425,1426,39503
04-06-2015,1,11541,16570,6317,2630,37058,776,211,428,1415,38473
04-06-2015,2,11477,16274,6226,2499,36476,767,214,414,1395,37871
04-06-2015,3,11589,16063,6296,2476,36424,773,215,418,1406,37830
04-06-2015,4,12246,16099,6323,2389,37057,773,221,420,1414,38471
04-06-2015,5,13719,16672,6475,2314,39180,797,234,416,1447,40627
04-06-2015,6,16502,17309,6789,2280,42881,930,379,583,1892,44773
04-06-2015,7,18821,18054,6967,2632,46475,935,589,607,2131,48606
04-06-2015,8,18533,18540,7200,2740,47014,946,699,702,2347,49361
04-06-2015,9,18233,18308,7263,2606,46411,942,715,691,2348,48759
04-06-2015,10,18148,18272,7398,2629,46447,970,716,625,2311,48758
04-06-2015,11,17915,18051,7482,2519,45966,980,573,654,2207,48173
04-06-2015,12,17861,17861,7349,2533,45603,998,621,672,2291,47894
04-06-2015,13,17688,17712,7258,2441,45100,999,621,615,2235,47335
04-06-2015,14,17440,17504,7235,2366,44546,912,546,603,2061,46607
04-06-2015,15,17386,17490,7259,2334,44469,856,507,583,1946,46415
04-06-2015,16,17387,17470,7300,2348,44506,798,496,460,1754,46260
04-06-2015,17,17060,17314,7317,2284,43976,762,404,500,1666,45642
04-06-2015,18,17570,17029,7299,2068,43967,743,413,506,1662,45629
04-06-2015,19,17875,16717,7249,1905,43747,709,483,497,1689,45436
04-06-2015,20,17657,16301,7285,1616,42860,677,442,490,1609,44469
04-06-2015,21,17452,16019,7313,1472,42257,663,420,462,1545,43802
04-06-2015,22,16633,15884,7293,1293,41104,647,354,312,1313,42417
04-06-2015,23,15449,15386,7290,1216,39342,647,191,314,1152,40494
05-06-2015,0,13942,14759,7277,1144,37122,644,195,299,1138,38260
05-06-2015,1,13066,14497,7181,1060,35804,628,266,295,1189,36993
05-06-2015,2,12669,14364,7100,1135,35268,625,307,291,1223,36491
05-06-2015,3,12576,14268,7077,1201,35124,620,235,290,1145,36269
05-06-2015,4,12612,14239,7072,1256,35180,607,248,292,1147,36327
05-06-2015,5,13660,14768,7065,1359,36854,601,244,316,1161,38015
05-06-2015,6,16568,15313,7340,1630,40851,668,269,552,1489,42340
05-06-2015,7,19021,15851,7577,1979,44429,720,450,577,1747,46176
05-06-2015,8,19222,16359,7632,2132,45345,731,633,626,1990,47335
05-06-2015,9,19025,16336,7629,2276,45267,742,665,547,1954,47221
05-06-2015,10,19071,16369,7606,2585,45633,747,658,531,1936,47569
05-06-2015,11,18679,16200,7584,2844,45308,736,569,550,1855,47163
05-06-2015,12,18461,15665,7595,2982,44703,744,588,596,1928,46631
05-06-2015,13,17874,15658,7473,3049,44053,760,571,543,1874,45927
05-06-2015,14,17273,15426,7519,3131,43349,743,569,499,1811,45160
05-06-2015,15,16814,15160,7397,3146,42518,744,490,528,1762,44280
05-06-2015,16,16769,15240,7363,2965,42337,712,486,355,1553,43890
05-06-2015,17,16952,15199,7295,2958,42404,682,497,385,1564,43968
05-06-2015,18,16862,15067,7249,3209,42388,633,491,300,1424,43812
05-06-2015,19,15972,14935,7224,3114,41245,601,468,470,1539,42784
05-06-2015,20,15365,14469,7198,3027,40059,594,448,301,1343,41402
05-06-2015,21,14781,14447,7176,2804,39208,640,386,274,1300,40508
05-06-2015,22,14591,14346,7027,2831,38795,638,344,273,1255,40050
05-06-2015,23,13805,14472,6299,2945,37521,606,185,275,1066,38587
06-06-2015,0,11989,14023,6238,2810,35058,532,146,280,958,36016
06-06-2015,1,11457,13904,6136,2592,34089,517,126,289,932,35021
06-06-2015,2,11268,13830,6098,2229,33425,508,126,308,942,34367
06-06-2015,3,10662,13728,6075,2194,32658,504,128,347,979,33637
06-06-2015,4,10470,13589,6034,2201,32295,499,141,361,1001,33296
06-06-2015,5,10691,13821,5980,2053,32546,497,146,371,1014,33560
06-06-2015,6,11395,14120,6037,1925,33477,511,215,335,1061,34538
06-06-2015,7,12568,14856,6165,2100,35689,517,346,411,1274,36963
06-06-2015,8,13936,15533,6328,2468,38265,515,446,409,1370,39635
06-06-2015,9,14651,15940,6378,2682,39651,524,467,417,1408,41059
06-06-2015,10,15132,16215,6441,2703,40491,524,486,430,1440,41931
06-06-2015,11,14677,16398,6356,2966,40396,530,458,452,1440,41836
06-06-2015,12,13372,16012,6388,3565,39337,520,474,473,1467,40804
06-06-2015,13,12452,15632,6409,4025,38519,509,460,494,1463,39982
06-06-2015,14,11666,15582,6310,4482,38040,538,458,457,1453,39493
06-06-2015,15,11288,15394,6391,4595,37668,549,435,447,1431,39099
06-06-2015,16,11693,15609,6382,4500,38184,584,383,504,1471,39655
06-06-2015,17,11871,16045,6505,4343,38762,587,371,481,1439,40201
06-06-2015,18,12006,16141,6590,4084,38823,519,361,454,1334,40157
06-06-2015,19,12019,16096,6580,3753,38447,528,408,341,1277,39724
06-06-2015,20,11876,16012,6555,3433,37877,529,372,356,1257,39134
06-06-2015,21,11652,16073,6612,3164,37500,564,370,337,1271,38771
06-06-2015,22,11537,15915,6668,3128,37247,587,281,345,1213,38460
06-06-2015,23,10917,15808,6578,3307,36612,581,145,346,1072,37684
07-06-2015,0,9891,15012,6554,3398,34855,557,170,302,1029,35884
07-06-2015,1,9486,14265,6436,3344,33531,575,135,312,1022,34553
07-06-2015,2,9297,13890,6345,3185,32716,632,157,347,1136,33852
07-06-2015,3,9073,13695,6368,3213,32349,521,129,308,958,33307
07-06-2015,4,8781,13664,6290,3226,31960,499,138,309,946,32906
07-06-2015,5,9029,13844,6288,3213,32374,501,141,309,951,33325
07-06-2015,6,9380,14073,6356,3259,33069,527,264,301,1092,34161
07-06-2015,7,9746,14586,6337,3591,34262,534,387,293,1214,35476
07-06-2015,8,11203,15324,6518,3851,36898,546,514,301,1361,38259
07-06-2015,9,11743,15884,6646,3968,38243,563,567,304,1434,39677
07-06-2015,10,12360,16130,6749,4017,39255,568,554,312,1434,40689
07-06-2015,11,12634,16395,6835,3935,39799,565,513,328,1406,41205
07-06-2015,12,12591,16783,6759,3998,40131,560,489,347,1396,41527
07-06-2015,13,12253,16438,6623,3865,39180,547,454,353,1354,40534
07-06-2015,14,12011,16458,6662,3726,38858,533,437,361,1331,40189
07-06-2015,15,12156,16624,6680,3576,39035,538,433,365,1336,40371
07-06-2015,16,12563,16729,6648,3485,39425,513,450,355,1318,40743
07-06-2015,17,12872,17029,6763,3290,39954,522,476,347,1345,41299
07-06-2015,18,13545,17080,6801,3182,40608,518,459,347,1324,41932
07-06-2015,19,13899,16981,6890,2863,40635,517,479,416,1412,42047
07-06-2015,20,14228,16875,7052,2636,40792,523,493,406,1422,42214
07-06-2015,21,14155,16871,7084,2449,40560,490,493,409,1392,41952
07-06-2015,22,14240,16623,7086,2330,40279,481,384,344,1209,41488
07-06-2015,23,13598,16002,6992,2305,38898,515,196,324,1035,39933
08-06-2015,0,12490,15227,6754,2311,36782,503,195,320,1018,37800
08-06-2015,1,11952,14647,6639,2285,35524,486,194,318,998,36522
08-06-2015,2,11706,14508,6572,2228,35014,467,190,324,981,35995
08-06-2015,3,11597,14496,6589,2202,34883,451,192,331,974,35857
08-06-2015,4,11617,14579,6619,2233,35048,493,244,343,1080,36128
08-06-2015,5,13119,15201,6873,2258,37453,525,282,300,1107,38560
08-06-2015,6,16949,16391,7218,2454,43012,579,307,460,1346,44358
08-06-2015,7,18659,17699,7379,2861,46600,697,639,495,1831,48431
08-06-2015,8,19230,18210,7522,3109,48072,731,867,499,2097,50169
08-06-2015,9,18851,18282,7505,2935,47573,740,831,502,2073,49646
08-06-2015,10,18978,17831,7540,2718,47067,732,769,509,2010,49077
08-06-2015,11,18834,17781,7510,2828,46954,744,806,505,2055,49009
08-06-2015,12,18743,17782,7424,2826,46775,750,849,538,2137,48912
08-06-2015,13,18239,17752,7367,2977,46335,756,809,529,2094,48429
08-06-2015,14,17718,17698,7454,2754,45624,766,819,532,2117,47741
08-06-2015,15,17472,17492,7440,2667,45073,759,781,503,2043,47116
08-06-2015,16,17176,17041,7299,2500,44016,677,674,465,1816,45832
08-06-2015,17,17251,16573,7417,2379,43622,661,633,437,1731,45353
08-06-2015,18,16918,16492,7390,2317,43116,637,653,427,1717,44833
08-06-2015,19,16966,16165,7354,2131,42616,624,732,411,1767,44383
08-06-2015,20,16995,15723,7318,1813,41849,626,630,396,1652,43501
08-06-2015,21,16881,15494,7223,1619,41218,644,500,391,1535,42753
08-06-2015,22,16918,15400,7190,1488,40997,646,493,287,1426,42423
08-06-2015,23,15939,14784,7151,1336,39209,642,309,285,1236,40445
09-06-2015,0,14372,14147,7168,1276,36964,642,303,303,1248,38212
09-06-2015,1,13822,13930,7191,1190,36134,629,302,291,1222,37356
09-06-2015,2,13740,13931,7210,1131,36012,647,302,294,1243,37255
09-06-2015,3,13652,13859,7218,1126,35858,664,304,298,1266,37124
09-06-2015,4,13881,13913,7231,1114,36139,669,313,309,1291,37430
09-06-2015,5,15306,14458,7232,1095,38090,762,321,312,1395,39485
09-06-2015,6,17659,15566,7254,1325,41804,986,480,441,1907,43711
09-06-2015,7,19462,16606,7272,2039,45379,1037,712,464,2213,47592
09-06-2015,8,19414,17010,7305,2311,46042,1060,862,481,2403,48445
09-06-2015,9,19055,16890,7388,2378,45711,1064,889,464,2417,48128
09-06-2015,10,18735,16789,7392,2403,45320,1052,865,476,2393,47713
09-06-2015,11,18561,16834,7382,2629,45406,1018,799,466,2283,47689
09-06-2015,12,18424,17112,7364,2540,45438,1018,814,471,2303,47741
09-06-2015,13,18368,16786,7359,2520,45033,1016,799,469,2284,47317
09-06-2015,14,18777,16855,7373,2486,45492,1013,689,458,2160,47652
09-06-2015,15,18458,16600,7364,2361,44786,997,623,461,2081,46867
09-06-2015,16,18077,16385,7369,2258,44087,871,630,465,1966,46053
09-06-2015,17,17886,16025,7406,2276,43593,827,622,475,1924,45517
09-06-2015,18,17482,15903,7358,2124,42866,822,594,468,1884,44750
09-06-2015,19,17165,16115,7293,1579,42153,857,616,466,1939,44092
09-06-2015,20,16667,16262,7277,1463,41668,890,366,448,1704,43372
09-06-2015,21,16438,16152,7244,1296,41130,878,316,430,1624,42754
09-06-2015,22,16017,16047,7220,1250,40535,894,314,320,1528,42063
09-06-2015,23,14554,15723,7171,1191,38640,812,305,339,1456,40096
10-06-2015,0,13915,15018,7181,1174,37289,758,301,339,1398,38687
10-06-2015,1,12789,14882,7133,1130,35932,728,297,323,1348,37280
10-06-2015,2,12287,14797,7159,1141,35383,756,304,317,1377,36760
10-06-2015,3,12297,14788,7147,1166,35399,752,296,345,1393,36792
10-06-2015,4,12158,14929,7140,1190,35418,745,309,294,1348,36766
10-06-2015,5,13334,15411,7171,1283,37200,821,313,290,1424,38624
10-06-2015,6,16190,16393,7235,1676,41493,1016,433,443,1892,43385
10-06-2015,7,18134,17577,7377,2324,45411,1055,700,451,2206,47617
10-06-2015,8,18575,18014,7353,2481,46422,1035,833,463,2331,48753
10-06-2015,9,18501,17887,7326,2572,46286,1035,844,449,2328,48614
10-06-2015,10,18363,18108,7339,2696,46505,1037,827,448,2312,48817
10-06-2015,11,18219,18021,7270,2679,46188,1073,777,443,2293,48481
10-06-2015,12,18188,18152,7254,2719,46314,1107,834,453,2394,48708
10-06-2015,13,17866,18170,7215,2769,46019,1122,819,400,2341,48360
10-06-2015,14,17270,18063,7164,2950,45447,1104,722,461,2287,47734
10-06-2015,15,16607,17565,7243,3111,44526,1030,743,419,2192,46718
10-06-2015,16,15859,17471,7249,3084,43663,1004,723,313,2040,45703
10-06-2015,17,15496,17457,7229,2926,43109,1020,624,315,1959,45068
10-06-2015,18,15146,17172,7228,2883,42429,977,614,307,1898,44327
10-06-2015,19,14930,16993,7182,2756,41861,979,714,318,2011,43872
10-06-2015,20,14834,16820,7220,2524,41397,976,620,295,1891,43288
10-06-2015,21,14458,16658,7226,2301,40644,1018,406,300,1724,42368
10-06-2015,22,13861,16673,7251,2277,40063,944,322,297,1563,41626
10-06-2015,23,12912,16127,7164,2233,38436,895,313,303,1511,39947
11-06-2015,0,11429,15561,7133,2234,36357,812,309,317,1438,37795
11-06-2015,1,10867,15103,7000,2175,35145,753,306,331,1390,36535
11-06-2015,2,10836,14907,6930,2095,34767,734,305,377,1416,36183
11-06-2015,3,11223,14850,6981,2048,35102,734,303,362,1399,36501
11-06-2015,4,11420,14780,6953,1974,35126,731,313,370,1414,36540
11-06-2015,5,12716,15441,7012,1875,37045,760,319,354,1433,38478
11-06-2015,6,15844,16201,7179,2035,41258,944,684,352,1980,43238
11-06-2015,7,17884,17191,7382,2397,44852,1003,820,353,2176,47028
11-06-2015,8,18283,17533,7442,2582,45840,1012,968,348,2328,48168
11-06-2015,9,18029,17613,7403,2884,45929,1023,986,346,2355,48284
11-06-2015,10,17512,17428,7372,2611,44923,1037,951,338,2326,47249
11-06-2015,11,17469,17440,7313,2667,44889,1064,900,337,2301,47190
11-06-2015,12,17345,17370,7345,2605,44664,1104,887,352,2343,47007
11-06-2015,13,17488,17162,7411,2636,44696,1072,915,324,2311,47007
11-06-2015,14,17918,17229,7274,2768,45189,1102,845,316,2263,47452
11-06-2015,15,17848,17302,7399,2587,45137,1117,721,308,2146,47283
11-06-2015,16,17477,17237,7438,2435,44587,1105,619,308,2032,46619
11-06-2015,17,17435,16839,7399,2313,43988,1112,517,373,2002,45990
11-06-2015,18,17402,16658,7316,2234,43609,1095,518,306,1919,45528
11-06-2015,19,17171,16544,7305,1810,42829,1071,605,313,1989,44818
11-06-2015,20,16838,16413,7332,1718,42302,961,475,284,1720,44022
11-06-2015,21,16640,16185,7249,1710,41784,1011,319,282,1612,43396
11-06-2015,22,15710,16081,7255,1385,40431,912,314,281,1507,41938
11-06-2015,23,14665,15619,7246,1328,38859,801,306,278,1385,40244
12-06-2015,0,13786,15120,7148,1254,37308,695,305,280,1280,38588
12-06-2015,1,13112,14839,7017,1204,36171,683,305,281,1269,37440
12-06-2015,2,12784,14754,6992,1156,35688,687,305,282,1274,36962
12-06-2015,3,12465,14449,6916,1116,34948,703,306,282,1291,36239
12-06-2015,4,12669,14581,6854,1187,35291,702,315,280,1297,36588
12-06-2015,5,14248,15010,6915,1166,37338,807,347,280,1434,38772
12-06-2015,6,16800,15874,6959,1827,41461,907,500,309,1716,43177
12-06-2015,7,18625,16851,7033,2186,44694,865,808,284,1957,46651
12-06-2015,8,19360,17128,7058,2355,45901,917,822,352,2091,47992
12-06-2015,9,19263,17155,7089,2422,45930,952,851,332,2135,48065
12-06-2015,10,19185,17298,7077,2424,45983,975,833,305,2113,48096
12-06-2015,11,18694,17342,7029,2432,45498,977,832,286,2095,47593
12-06-2015,12,18268,16959,7064,2408,44698,971,823,288,2082,46780
12-06-2015,13,18241,16795,7073,2417,44525,986,728,321,2035,46560
12-06-2015,14,17963,16843,7059,2365,44230,994,673,329,1996,46226
12-06-2015,15,17430,16834,7089,2298,43652,1008,654,293,1955,45607
12-06-2015,16,16884,16953,7091,2443,43373,966,535,320,1821,45194
12-06-2015,17,16730,16818,7141,2344,43034,950,530,331,1811,44845
12-06-2015,18,16372,16904,7066,2249,42593,914,492,319,1725,44318
12-06-2015,19,16155,16703,7065,2151,42074,870,505,278,1653,43727
12-06-2015,20,15748,16331,7057,1983,41118,853,463,333,1649,42767
12-06-2015,21,15284,15982,7038,1643,39947,853,411,304,1568,41515
12-06-2015,22,15258,15860,7013,1506,39639,610,319,342,1271,40910
12-06-2015,23,14632,15428,6990,1211,38259,528,320,341,1189,39448
13-06-2015,0,12886,15031,6950,1228,36094,549,126,341,1016,37110
13-06-2015,1,12144,14834,6830,1101,34909,530,125,346,1001,35910
13-06-2015,2,11818,14764,6742,950,34274,510,124,320,954,35228
13-06-2015,3,11498,14727,6637,906,33767,488,124,302,914,34681
13-06-2015,4,11131,14631,6572,847,33180,492,134,281,907,34087
13-06-2015,5,11420,14719,6601,856,33595,513,138,278,929,34524
13-06-2015,6,12537,14919,6691,1016,35163,450,228,348,1026,36189
13-06-2015,7,13907,15155,6692,1012,36766,512,269,463,1244,38010
13-06-2015,8,15612,15650,6724,1215,39201,560,364,517,1441,40642
13-06-2015,9,16202,15863,6866,1492,40423,737,427,626,1790,42213
13-06-2015,10,16585,15873,6929,1573,40961,749,429,653,1831,42792
13-06-2015,11,16623,15901,6938,1556,41020,728,478,660,1866,42886
13-06-2015,12,16435,16021,6906,1361,40723,692,594,528,1814,42537
13-06-2015,13,15857,15963,6876,1262,39957,697,560,528,1785,41742
13-06-2015,14,15546,15952,6924,1307,39730,692,507,544,1743,41473
13-06-2015,15,15398,15905,6877,1259,39438,506,452,552,1510,40948
13-06-2015,16,15423,15840,6890,1195,39348,459,445,545,1449,40797
13-06-2015,17,15869,15940,6868,1233,39910,481,442,544,1467,41377
13-06-2015,18,16116,16116,6854,1334,40420,532,332,496,1360,41780
13-06-2015,19,15185,15747,6834,1912,39677,544,336,498,1378,41055
13-06-2015,20,14392,15462,6840,1897,38590,535,332,483,1350,39940
13-06-2015,21,14191,15258,6833,1935,38218,536,233,477,1246,39464
13-06-2015,22,13983,15020,6821,2022,37846,522,141,434,1097,38943
13-06-2015,23,13367,14685,6815,1776,36643,528,132,278,938,37581
14-06-2015,0,12056,14396,6778,1530,34760,491,131,282,904,35664
14-06-2015,1,11349,14122,6657,1430,33559,490,130,340,960,34519
14-06-2015,2,10889,13906,6606,1592,32993,498,129,312,939,33932
14-06-2015,3,10495,13834,6524,1768,32621,474,134,334,942,33563
14-06-2015,4,10133,13667,6356,2057,32213,473,145,367,985,33198
14-06-2015,5,10032,13563,6228,2249,32072,486,142,380,1008,33080
14-06-2015,6,10546,13779,6336,2405,33067,449,157,362,968,34035
14-06-2015,7,11096,14149,6472,2723,34441,455,159,358,972,35413
14-06-2015,8,12147,14599,6584,3170,36501,507,250,410,1167,37668
14-06-2015,9,13218,15094,6679,3306,38296,506,305,444,1255,39551
14-06-2015,10,13772,15545,6715,3615,39647,528,303,466,1297,40944
14-06-2015,11,13921,16155,6701,3624,40402,528,308,443,1279,41681
14-06-2015,12,13540,16436,6705,3474,40155,547,344,440,1331,41486
14-06-2015,13,13080,16888,6727,3467,40162,567,310,409,1286,41448
14-06-2015,14,12627,16621,6671,3643,39562,566,296,419,1281,40843
14-06-2015,15,12593,16379,6656,3647,39276,524,299,551,1374,40650
14-06-2015,16,12387,16392,6622,3728,39129,518,300,579,1397,40526
14-06-2015,17,12832,16377,6636,3770,39614,529,281,583,1393,41007
14-06-2015,18,13121,17262,6698,3871,40951,587,188,557,1332,42283
14-06-2015,19,12955,17124,6753,3875,40707,588,250,529,1367,42074
14-06-2015,20,12887,17116,6811,3694,40508,573,284,453,1310,41818
14-06-2015,21,12848,16786,6683,3369,39686,598,277,352,1227,40913
14-06-2015,22,12701,16397,6681,3165,38943,590,139,382,1111,40054
14-06-2015,23,11675,16197,6679,3015,37566,533,135,357,1025,38591
15-06-2015,0,10631,15929,6696,3009,36266,518,133,360,1011,37277
15-06-2015,1,10091,15909,6584,2990,35576,504,128,367,999,36575
15-06-2015,2,9978,15723,6622,2854,35178,535,129,375,1039,36217
15-06-2015,3,9885,15733,6618,2732,34969,574,132,357,1063,36032
15-06-2015,4,10115,15705,6683,2634,35137,565,161,342,1068,36205
15-06-2015,5,11686,16191,6785,2655,37318,579,173,337,1089,38407
15-06-2015,6,14907,16895,7043,2723,41569,750,488,393,1631,43200
15-06-2015,7,18449,17581,7226,3186,46443,898,647,522,2067,48510
15-06-2015,8,18590,18273,7367,3716,47947,937,803,568,2308,50255
15-06-2015,9,18420,18248,7418,3709,47796,947,810,570,2327,50123
15-06-2015,10,18438,18269,7426,3634,47767,955,831,557,2343,50110
15-06-2015,11,18384,18213,7429,3561,47589,960,814,577,2351,49940
15-06-2015,12,18012,18190,7394,3346,46942,979,846,549,2374,49316
15-06-2015,13,17839,18270,7350,3410,46869,971,747,546,2264,49133
15-06-2015,14,17509,18329,7257,3289,46384,982,727,542,2251,48635
15-06-2015,15,17169,18295,7233,3320,46017,944,709,358,2011,48028
15-06-2015,16,16450,18127,7223,3280,45082,776,639,339,1754,46836
15-06-2015,17,16210,17994,7198,3371,44774,698,578,328,1604,46378
15-06-2015,18,15969,17724,7158,3337,44187,732,477,321,1530,45717
15-06-2015,19,15904,17594,7123,3266,43887,734,458,491,1683,45570
15-06-2015,20,15207,17573,7137,3048,42966,725,403,422,1550,44516
15-06-2015,21,15262,17473,7030,2836,42601,692,373,374,1439,44040
15-06-2015,22,14692,17195,7050,2698,41636,672,318,311,1301,42937
15-06-2015,23,13475,17038,6997,2579,40088,642,297,304,1243,41331
16-06-2015,0,12391,16330,6942,2397,38061,742,296,306,1344,39405
16-06-2015,1,11679,15955,6898,2275,36808,755,297,301,1353,38161
16-06-2015,2,11318,15785,6815,2193,36112,699,294,292,1285,37397
16-06-2015,3,11109,15702,6787,2132,35729,710,294,288,1292,37021
16-06-2015,4,11281,15647,6841,2019,35788,707,319,285,1311,37099
16-06-2015,5,12513,16502,6914,2018,37948,718,344,281,1343,39291
16-06-2015,6,15516,17086,7073,2269,41945,726,458,472,1656,43601
16-06-2015,7,17497,17677,7324,3083,45580,861,736,442,2039,47619
16-06-2015,8,17475,18276,7464,3350,46565,887,758,603,2248,48813
16-06-2015,9,17059,18033,7495,2931,45518,911,739,491,2141,47659
16-06-2015,10,17351,18311,7534,2712,45910,911,740,523,2174,48084
16-06-2015,11,17253,18486,7510,2790,46040,907,708,478,2093,48133
16-06-2015,12,17185,18623,7453,3052,46313,921,712,485,2118,48431
16-06-2015,13,17079,18721,7406,2985,46190,931,707,477,2115,48305
16-06-2015,14,17139,18715,7320,2746,45919,923,647,493,2063,47982
16-06-2015,15,16889,18564,7292,2436,45182,811,609,502,1922,47104
16-06-2015,16,16703,18431,7239,2236,44609,768,540,326,1634,46243
16-06-2015,17,16974,18165,7044,2061,44244,762,544,304,1610,45854
16-06-2015,18,16597,18136,7065,1912,43710,762,525,394,1681,45391
16-06-2015,19,16375,17960,7081,1764,43179,755,494,501,1750,44929
16-06-2015,20,16071,17808,7034,1945,42859,662,427,400,1489,44348
16-06-2015,21,15813,17546,7030,1850,42240,708,410,354,1472,43712
16-06-2015,22,15490,17367,7032,1998,41888,719,354,291,1364,43252
16-06-2015,23,14506,16852,6943,1763,40065,722,298,288,1308,41373
17-06-2015,0,12849,16005,7021,1578,37452,737,291,286,1314,38766
17-06-2015,1,12353,15814,6844,1575,36585,746,290,283,1319,37904
17-06-2015,2,11941,15814,6830,1505,36091,763,287,280,1330,37421
17-06-2015,3,12163,15863,6807,1495,36329,743,289,278,1310,37639
17-06-2015,4,12480,15837,6849,1614,36780,721,301,278,1300,38080
17-06-2015,5,13536,15983,6916,1678,38114,704,303,276,1283,39397
17-06-2015,6,16437,16846,6965,1999,42246,711,458,340,1509,43755
17-06-2015,7,18284,17464,7016,2803,45567,764,564,419,1747,47314
17-06-2015,8,18865,17639,7045,3059,46608,782,673,472,1927,48535
17-06-2015,9,18416,17675,7115,3071,46276,853,695,540,2088,48364
17-06-2015,10,18601,17605,7088,3200,46495,899,595,561,2055,48550
17-06-2015,11,18378,17643,7080,3410,46511,814,562,569,1945,48456
17-06-2015,12,18151,17490,7071,3603,46316,818,583,609,2010,48326
17-06-2015,13,18062,17486,7019,3767,46335,812,580,606,1998,48333
17-06-2015,14,17718,17534,6942,3922,46115,806,538,646,1990,48105
17-06-2015,15,17254,17616,6855,3824,45549,805,465,570,1840,47389
17-06-2015,16,17003,17702,6872,3638,45216,780,430,467,1677,46893
17-06-2015,17,17146,17659,6850,3363,45019,770,403,467,1640,46659
17-06-2015,18,16676,17651,6745,3219,44291,754,369,471,1594,45885
17-06-2015,19,16020,17853,6746,3125,43743,697,280,566,1543,45286
17-06-2015,20,15202,17729,6712,3008,42651,684,279,473,1436,44087
17-06-2015,21,15012,17328,6658,2905,41903,687,277,422,1386,43289
17-06-2015,22,14396,16995,6600,2689,40680,698,273,299,1270,41950
17-06-2015,23,13350,16494,6535,2429,38810,695,264,298,1257,40067
18-06-2015,0,12381,15695,6474,2250,36800,595,260,306,1161,37961
18-06-2015,1,11982,15394,6404,2097,35878,570,258,306,1134,37012
18-06-2015,2,11568,15278,6409,1986,35240,581,254,300,1135,36375
18-06-2015,3,11349,15206,6415,1928,34898,597,260,293,1150,36048
18-06-2015,4,11356,15105,6506,2011,34977,611,279,308,1198,36175
18-06-2015,5,12311,15520,6546,2162,36541,631,286,316,1233,37774
18-06-2015,6,15171,16578,6661,2288,40698,683,380,370,1433,42131
18-06-2015,7,18170,17445,6790,2608,45014,862,581,429,1872,46886
18-06-2015,8,18514,18457,6800,3124,46896,1068,603,530,2201,49097
18-06-2015,9,18084,18039,6784,3590,46497,1072,666,545,2283,48780
18-06-2015,10,18141,18052,6833,3507,46534,1053,660,560,2273,48807
18-06-2015,11,17784,18057,6858,3754,46451,1067,590,543,2200,48651
18-06-2015,12,17344,17899,6842,3839,45925,1080,636,531,2247,48172
18-06-2015,13,16548,17535,6802,3996,44882,1079,642,532,2253,47135
18-06-2015,14,16112,17398,6791,4076,44377,1064,565,536,2165,46542
18-06-2015,15,15552,17293,6815,4093,43753,1060,526,515,2101,45854
18-06-2015,16,14981,17197,6781,4071,43031,1056,471,341,1868,44899
18-06-2015,17,15590,17084,6855,4078,43609,746,469,331,1546,45155
18-06-2015,18,15633,17059,6813,3975,43480,733,423,321,1477,44957
18-06-2015,19,15075,16841,6828,3925,42669,708,356,478,1542,44211
18-06-2015,20,14572,16330,6868,3671,41441,659,332,300,1291,42732
18-06-2015,21,14321,16037,6775,3391,40524,639,265,297,1201,41725
18-06-2015,22,13699,15909,6695,3280,39583,647,136,373,1156,40739
18-06-2015,23,12580,15438,6632,3336,37986,598,126,291,1015,39001
19-06-2015,0,11209,14494,6437,3314,35454,567,122,292,981,36435
19-06-2015,1,10767,13903,6285,3225,34179,585,121,291,997,35176
19-06-2015,2,10320,13646,6163,3128,33257,592,120,293,1005,34262
19-06-2015,3,9978,13466,6101,3124,32668,597,118,294,1009,33677
19-06-2015,4,10030,13217,6070,3096,32414,566,126,295,987,33401
19-06-2015,5,10557,13633,6170,3069,33428,638,136,293,1067,34495
19-06-2015,6,12674,14571,6311,2954,36509,719,292,488,1499,38008
19-06-2015,7,14983,15573,6446,2999,40001,766,540,489,1795,41796
19-06-2015,8,16039,16199,6537,2797,41573,781,621,592,1994,43567
19-06-2015,9,16184,16515,6605,2743,42048,790,615,592,1997,44045
19-06-2015,10,16405,16688,6620,2839,42551,815,593,624,2032,44583
19-06-2015,11,16252,16507,6614,2871,42246,768,517,626,1911,44157
19-06-2015,12,16079,16574,6597,2920,42171,789,565,627,1981,44152
19-06-2015,13,15608,16253,6553,2802,41217,804,493,626,1923,43140
19-06-2015,14,15525,16055,6528,2734,40842,765,531,543,1839,42681
19-06-2015,15,15087,15838,6526,2601,40051,700,444,609,1753,41804
19-06-2015,16,15062,15752,6509,2498,39820,694,361,499,1554,41374
19-06-2015,17,15135,15686,6485,2467,39773,685,357,492,1534,41307
19-06-2015,18,14808,15629,6482,2498,39417,673,320,491,1484,40901
19-06-2015,19,14585,15403,6430,2398,38817,678,348,485,1511,40328
19-06-2015,20,14303,15078,6423,2050,37855,677,256,479,1412,39267
19-06-2015,21,14221,15135,6398,1928,37683,639,261,479,1379,39062
19-06-2015,22,14091,15250,6391,1881,37613,582,135,447,1164,38777
19-06-2015,23,13620,15051,6385,1886,36943,555,124,312,991,37934
20-06-2015,0,12271,14453,6399,1879,35001,533,122,297,952,35953
20-06-2015,1,11745,14199,6289,1688,33921,522,122,296,940,34861
20-06-2015,2,11289,14010,6292,1564,33154,532,123,304,959,34113
20-06-2015,3,10744,13957,6315,1562,32578,527,122,304,953,33531
20-06-2015,4,10359,13881,6250,1633,32122,529,129,306,964,33086
20-06-2015,5,10475,13833,6272,1623,32202,536,131,297,964,33166
20-06-2015,6,11264,14120,6309,1656,33350,556,140,287,983,34333
20-06-2015,7,12207,14538,6453,1705,34904,605,285,284,1174,36078
20-06-2015,8,13730,14782,6511,1742,36764,640,143,485,1268,38032
20-06-2015,9,14503,15229,6547,1696,37976,665,183,483,1331,39307
20-06-2015,10,15323,15827,6151,1914,39215,670,242,451,1363,40578
20-06-2015,11,15113,16112,6189,2140,39554,648,180,484,1312,40866
20-06-2015,12,14348,15970,6103,2266,38688,677,159,482,1318,40006
20-06-2015,13,13731,15855,6075,2448,38110,602,246,465,1313,39423
20-06-2015,14,13346,15681,6064,2539,37632,596,234,448,1278,38910
20-06-2015,15,13165,15572,6063,2338,37138,576,155,473,1204,38342
20-06-2015,16,13215,15525,6106,2393,37238,580,152,480,1212,38450
20-06-2015,17,13687,15453,6176,2301,37616,560,144,477,1181,38797
20-06-2015,18,14081,15389,6178,2158,37806,557,150,464,1171,38977
20-06-2015,19,13966,15320,6187,2220,37693,532,151,460,1143,38836
20-06-2015,20,13652,15184,6201,2118,37155,503,165,459,1127,38282
20-06-2015,21,13706,15201,6200,2006,37112,493,302,301,1096,38208
20-06-2015,22,13762,15308,6202,1893,37164,551,130,389,1070,38234
20-06-2015,23,13333,15484,6182,1798,36798,554,120,279,953,37751
21-06-2015,0,12489,14526,6178,1632,34824,537,117,278,932,35756
21-06-2015,1,12183,13854,6085,1515,33637,497,117,278,892,34529
21-06-2015,2,11926,13713,6025,1497,33160,481,116,279,876,34036
21-06-2015,3,11675,13701,6027,1459,32863,505,117,281,903,33766
21-06-2015,4,11318,13757,6067,1355,32497,498,128,282,908,33405
21-06-2015,5,11564,13704,6139,1257,32664,506,129,280,915,33579
21-06-2015,6,12011,13854,6175,1403,33443,525,129,278,932,34375
21-06-2015,7,13111,14075,6172,1324,34683,572,135,324,1031,35714
21-06-2015,8,14472,14607,6212,1422,36713,579,186,466,1231,37944
21-06-2015,9,15360,15168,6232,1441,38203,607,186,405,1198,39401
21-06-2015,10,15958,15480,6256,1472,39167,617,167,438,1222,40389
21-06-2015,11,16180,15596,6251,1549,39577,621,169,413,1203,40780
21-06-2015,12,16108,15484,6223,1505,39321,597,204,458,1259,40580
21-06-2015,13,16074,15438,6206,1523,39242,599,164,448,1211,40453
21-06-2015,14,15858,15247,6202,1518,38825,600,135,407,1142,39967
21-06-2015,15,15838,15083,6088,1529,38538,605,135,387,1127,39665
21-06-2015,16,15928,15167,5789,1441,38326,623,152,392,1167,39493
21-06-2015,17,16227,15303,5785,1432,38747,619,198,401,1218,39965
21-06-2015,18,16326,15280,6018,1489,39113,621,172,415,1208,40321
21-06-2015,19,16373,15282,6129,1636,39420,621,225,415,1261,40681
21-06-2015,20,16232,15232,6272,1750,39486,579,268,368,1215,40701
21-06-2015,21,16249,15240,6350,1721,39559,559,191,405,1155,40714
21-06-2015,22,15844,15085,6309,1356,38594,579,127,356,1062,39656
21-06-2015,23,14754,14579,6296,1389,37017,542,117,282,941,37958
22-06-2015,0,13107,13772,6156,1465,34499,501,123,282,906,35405
22-06-2015,1,12393,13559,6123,1417,33492,495,122,280,897,34389
22-06-2015,2,12074,13512,6095,1397,33078,500,123,278,901,33979
22-06-2015,3,12182,13475,6065,1328,33050,506,123,277,906,33956
22-06-2015,4,12409,13450,6137,1135,33130,503,138,277,918,34048
22-06-2015,5,13374,14283,6219,1389,35265,515,210,276,1001,36266
22-06-2015,6,16202,15610,6480,1622,39914,572,231,372,1175,41089
22-06-2015,7,17719,17224,6690,2102,43735,590,393,437,1420,45155
22-06-2015,8,17422,17914,6745,2414,44494,597,652,476,1725,46219
22-06-2015,9,17454,17874,6911,2392,44632,575,767,441,1783,46415
22-06-2015,10,17473,17911,6964,2361,44709,602,733,445,1780,46489
22-06-2015,11,17426,18149,6982,2503,45060,608,651,445,1704,46764
22-06-2015,12,17022,18176,7003,2560,44763,617,595,450,1662,46425
22-06-2015,13,16877,18021,6927,2569,44394,626,639,454,1719,46113
22-06-2015,14,16951,17831,6901,2216,43899,614,570,443,1627,45526
22-06-2015,15,16911,17828,6816,2010,43566,595,480,444,1519,45085
22-06-2015,16,16992,17878,6712,1942,43526,589,330,285,1204,44730
22-06-2015,17,16728,17769,6714,2122,43333,597,320,280,1197,44530
22-06-2015,18,16782,17456,6728,1995,42961,621,318,281,1220,44181
22-06-2015,19,16822,17185,6760,1928,42695,621,335,445,1401,44096
22-06-2015,20,16996,16937,6640,1716,42289,591,355,284,1230,43519
22-06-2015,21,16973,16673,6552,1672,41870,524,317,308,1149,43019
22-06-2015,22,16847,16294,6536,1501,41179,536,142,324,1002,42181
22-06-2015,23,16186,15622,6479,1412,39701,537,126,357,1020,40721
23-06-2015,0,14862,14359,6480,911,36613,522,126,376,1024,37637
23-06-2015,1,14018,14337,6367,787,35510,516,126,361,1003,36513
23-06-2015,2,13596,14221,6334,772,34924,516,126,346,988,35912
23-06-2015,3,13414,14096,6327,787,34624,519,128,349,996,35620
23-06-2015,4,13374,14134,6382,721,34611,524,139,342,1005,35616
23-06-2015,5,14070,14824,6582,843,36320,523,143,343,1009,37329
23-06-2015,6,15588,16076,6856,1510,40030,572,147,389,1108,41138
23-06-2015,7,16844,17181,6979,2009,43012,623,229,512,1364,44376
23-06-2015,8,17104,17645,7100,2211,44059,627,355,517,1499,45558
23-06-2015,9,17210,17753,7072,2125,44160,630,478,525,1633,45793
23-06-2015,10,17042,17734,7060,2107,43942,634,590,547,1771,45713
23-06-2015,11,17159,17692,7070,2110,44031,641,545,518,1704,45735
23-06-2015,12,16900,17689,7088,2209,43886,651,527,533,1711,45597
23-06-2015,13,17189,17768,7027,2290,44273,654,441,517,1612,45885
23-06-2015,14,16967,17760,6933,2395,44056,650,353,520,1523,45579
23-06-2015,15,16888,17648,6857,1975,43368,645,336,489,1470,44838
23-06-2015,16,16634,17646,6752,1929,42961,653,320,321,1294,44255
23-06-2015,17,16365,17712,6713,2019,42808,651,336,308,1295,44103
23-06-2015,18,16121,17285,6734,1758,41898,689,314,312,1315,43213
23-06-2015,19,16074,16967,6794,1700,41536,621,284,459,1364,42900
23-06-2015,20,16136,16316,6778,1693,40924,555,199,297,1051,41975
23-06-2015,21,16143,15546,6633,1691,40013,549,198,300,1047,41060
23-06-2015,22,15456,15478,6608,1796,39339,555,184,305,1044,40383
23-06-2015,23,14068,14984,6585,2020,37658,553,123,305,981,38639
24-06-2015,0,11826,14550,6456,2543,35375,549,120,307,976,36351
24-06-2015,1,10966,14140,6371,2677,34155,540,119,309,968,35123
24-06-2015,2,10446,13829,6368,2851,33494,561,192,311,1064,34558
24-06-2015,3,10173,13686,6305,2687,32850,560,170,311,1041,33891
24-06-2015,4,10182,13759,6294,2762,32996,562,180,321,1063,34059
24-06-2015,5,10618,14390,6386,2900,34293,581,159,327,1067,35360
24-06-2015,6,12744,15378,6707,3202,38031,608,136,335,1079,39110
24-06-2015,7,15453,16484,6923,3338,42199,718,147,392,1257,43456
24-06-2015,8,16457,16736,7064,3573,43831,748,164,599,1511,45342
24-06-2015,9,16435,16980,7101,3737,44254,773,287,633,1693,45947
24-06-2015,10,16515,17090,7089,4086,44780,778,321,584,1683,46463
24-06-2015,11,16297,17160,7159,4142,44758,786,291,588,1665,46423
24-06-2015,12,16098,17311,7167,4100,44676,792,270,601,1663,46339
24-06-2015,13,16121,17112,7203,4289,44723,790,183,522,1495,46218
24-06-2015,14,15995,17049,7149,4171,44362,817,207,438,1462,45824
24-06-2015,15,15411,16915,7080,4125,43531,845,270,393,1508,45039
24-06-2015,16,14853,16821,6981,4020,42674,786,266,381,1433,44107
24-06-2015,17,14857,17097,7051,3879,42883,725,293,356,1374,44257
24-06-2015,18,14963,17237,7047,3606,42854,749,298,389,1436,44290
24-06-2015,19,15168,17500,6811,3243,42721,822,236,432,1490,44211
24-06-2015,20,14936,17465,6751,2861,42014,721,302,339,1362,43376
24-06-2015,21,14679,17493,6653,2677,41503,678,284,337,1299,42802
24-06-2015,22,14358,17507,6677,2493,41034,678,209,340,1227,42261
24-06-2015,23,13216,17275,6534,2462,39488,699,174,345,1218,40706
25-06-2015,0,12191,16119,6593,2468,37371,641,160,338,1139,38510
25-06-2015,1,11090,14981,6538,2592,35202,629,159,339,1127,36329
25-06-2015,2,10519,14749,6550,2597,34415,624,246,348,1218,35633
25-06-2015,3,10620,14412,6737,2444,34214,632,242,343,1217,35431
25-06-2015,4,10737,14495,6814,2361,34407,624,167,344,1135,35542
25-06-2015,5,11896,15365,6934,2317,36512,636,193,336,1165,37677
25-06-2015,6,15078,16192,7226,2280,40777,702,236,458,1396,42173
25-06-2015,7,17516,17138,7409,2564,44627,921,390,457,1768,46395
25-06-2015,8,17488,18066,7504,2701,45757,952,627,670,2249,48006
25-06-2015,9,17470,18171,7572,2930,46142,955,710,674,2339,48481
25-06-2015,10,17634,18281,7586,3115,46615,960,614,719,2293,48908
25-06-2015,11,17575,18119,7606,3002,46301,975,575,740,2290,48591
25-06-2015,12,17585,17954,7630,2848,46017,948,676,689,2313,48330
25-06-2015,13,17940,17843,7708,2610,46102,958,509,701,2168,48270
25-06-2015,14,17728,17887,7662,2394,45672,937,353,708,1998,47670
25-06-2015,15,17593,17690,7595,2323,45202,924,336,694,1954,47156
25-06-2015,16,17406,17308,7549,2330,44592,873,238,625,1736,46328
25-06-2015,17,17392,17189,7518,2293,44392,862,250,627,1739,46131
25-06-2015,18,17443,17149,7496,2303,44389,825,252,594,1671,46060
25-06-2015,19,17201,17096,7473,2198,43969,848,376,521,1745,45714
25-06-2015,20,16943,16736,7330,1796,42805,772,364,367,1503,44308
25-06-2015,21,17044,16241,7090,1666,42042,814,350,397,1561,43603
25-06-2015,22,16512,16216,7040,1538,41305,784,199,436,1419,42724
25-06-2015,23,15632,16032,6880,1455,39997,692,146,331,1169,41166
26-06-2015,0,14814,14771,6745,1432,37763,624,145,337,1106,38869
26-06-2015,1,14262,14253,6598,1401,36513,633,143,351,1127,37640
26-06-2015,2,13876,14133,6600,1388,35997,635,143,363,1141,37138
26-06-2015,3,13644,14123,6581,1338,35686,641,147,368,1156,36842
26-06-2015,4,13487,14011,6626,1271,35396,661,155,351,1167,36563
26-06-2015,5,14540,14501,6785,1263,37089,762,157,339,1258,38347
26-06-2015,6,16333,16046,6995,1572,40946,1130,295,496,1921,42867
26-06-2015,7,17399,17341,7061,2266,44068,1169,562,551,2282,46350
26-06-2015,8,17615,17798,7114,2478,45006,1178,676,718,2572,47578
26-06-2015,9,17590,17595,7265,2526,44978,1193,730,714,2637,47615
26-06-2015,10,17796,17710,7312,2658,45475,1236,712,665,2613,48088
26-06-2015,11,17727,17788,7223,2654,45391,1307,675,658,2640,48031
26-06-2015,12,17136,17693,7169,2368,44366,1323,625,657,2605,46971
26-06-2015,13,17227,17415,7220,2082,43944,1315,353,665,2333,46277
26-06-2015,14,17161,17167,7143,2192,43662,1299,342,639,2280,45942
26-06-2015,15,17168,17005,7030,2077,43279,1263,362,542,2167,45446
26-06-2015,16,17222,17125,6951,2094,43391,995,350,427,1772,45163
26-06-2015,17,17498,16702,6823,2080,43102,966,394,384,1744,44846
26-06-2015,18,17632,16724,6781,2183,43321,975,392,340,1707,45028
26-06-2015,19,17332,16608,6692,2083,42715,901,306,491,1698,44413
26-06-2015,20,17463,15975,6671,1768,41877,711,306,335,1352,43229
26-06-2015,21,17207,15700,6619,1176,40702,611,298,316,1225,41927
26-06-2015,22,16899,15442,6598,1023,39962,554,279,352,1185,41147
26-06-2015,23,16016,15191,6570,836,38614,517,148,303,968,39582
27-06-2015,0,14865,14510,6575,748,36699,517,145,291,953,37652
27-06-2015,1,14154,14046,6470,748,35418,510,145,292,947,36365
27-06-2015,2,13604,13624,6428,761,34417,518,144,298,960,35377
27-06-2015,3,13147,13282,6385,776,33591,507,144,303,954,34545
27-06-2015,4,12985,12976,6386,872,33220,499,158,303,960,34180
27-06-2015,5,13331,13396,6497,847,34072,492,161,306,959,35031
27-06-2015,6,13400,14231,6510,953,35094,538,166,295,999,36093
27-06-2015,7,13967,14559,6586,987,36098,618,168,375,1161,37259
27-06-2015,8,14515,15071,6648,1223,37460,648,208,370,1226,38686
27-06-2015,9,15628,15635,6676,1494,39434,643,415,302,1360,40794
27-06-2015,10,16101,15905,6662,1611,40279,643,366,303,1312,41591
27-06-2015,11,16013,15596,6684,1507,39800,643,229,368,1240,41040
27-06-2015,12,15998,15660,6706,1198,39561,635,250,369,1254,40815
27-06-2015,13,15661,15441,6685,1097,38885,658,362,345,1365,40250
27-06-2015,14,15190,15139,6694,1139,38162,673,178,401,1252,39414
27-06-2015,15,14949,14748,6713,1378,37789,700,178,334,1212,39001
27-06-2015,16,14899,14656,6696,1438,37690,674,263,313,1250,38940
27-06-2015,17,15651,14674,6636,1737,38698,623,181,389,1193,39891
27-06-2015,18,15919,15024,6633,1952,39529,604,250,295,1149,40678
27-06-2015,19,15795,14754,6613,1986,39149,630,181,283,1094,40243
27-06-2015,20,15354,14309,6566,2076,38307,648,180,281,1109,39416
27-06-2015,21,15024,14092,6575,1853,37542,628,164,281,1073,38615
27-06-2015,22,14496,14138,6647,1871,37152,545,157,329,1031,38183
27-06-2015,23,13778,13766,6561,2084,36189,572,127,282,981,37170
28-06-2015,0,12771,12755,6405,2026,33958,545,154,281,980,34938
28-06-2015,1,12076,12254,6314,1969,32612,557,177,280,1014,33626
28-06-2015,2,11915,12030,6315,1851,32111,543,172,281,996,33107
28-06-2015,3,11574,11955,6265,1654,31448,521,125,282,928,32376
28-06-2015,4,11449,11948,6269,1497,31163,533,136,283,952,32115
28-06-2015,5,11613,12180,6364,1256,31413,508,136,281,925,32338
28-06-2015,6,12401,12795,6376,1142,32716,504,138,280,922,33638
28-06-2015,7,13411,13000,6354,1199,33964,530,141,277,948,34912
28-06-2015,8,15013,13565,6506,1237,36320,539,147,277,963,37283
28-06-2015,9,15848,14280,6594,1362,38084,608,181,276,1065,39149
28-06-2015,10,15726,14551,6632,1396,38305,643,230,276,1149,39454
28-06-2015,11,15986,14691,6667,1444,38787,634,212,277,1123,39910
28-06-2015,12,15460,14486,6664,1551,38161,597,211,283,1091,39252
28-06-2015,13,15243,14232,6690,1620,37785,627,194,286,1107,38892
28-06-2015,14,14452,14320,6728,1784,37282,629,179,292,1100,38382
28-06-2015,15,15083,14306,6679,1854,37922,642,162,294,1098,39020
28-06-2015,16,15819,14409,6685,1823,38737,562,251,291,1104,39841
28-06-2015,17,16363,14727,6697,1791,39579,550,265,289,1104,40683
28-06-2015,18,16497,15393,6693,1784,40368,550,273,290,1113,41481
28-06-2015,19,16682,15706,6708,1507,40603,571,249,290,1110,41713
28-06-2015,20,16786,15404,6703,1415,40307,548,317,289,1154,41461
28-06-2015,21,16682,15313,6714,1289,39999,531,276,294,1101,41100
28-06-2015,22,16258,15088,6674,1332,39351,558,196,298,1052,40403
28-06-2015,23,14758,14171,6620,1449,36998,529,127,307,963,37961
29-06-2015,0,12959,14227,6704,1464,35353,583,126,302,1011,36364
29-06-2015,1,12347,13958,6646,1480,34431,592,125,292,1009,35440
29-06-2015,2,11716,13853,6647,1477,33692,598,124,286,1008,34700
29-06-2015,3,11532,13803,6646,1419,33400,631,125,284,1040,34440
29-06-2015,4,11489,13780,6606,1386,33261,680,157,281,1118,34379
29-06-2015,5,13187,14081,6623,1406,35296,723,160,281,1164,36460
29-06-2015,6,15732,15521,6706,1584,39543,812,281,441,1534,41077
29-06-2015,7,17096,17488,6851,2118,43553,892,501,441,1834,45387
29-06-2015,8,17680,18197,6898,2322,45096,895,626,604,2125,47221
29-06-2015,9,17732,18523,6942,2375,45572,897,758,575,2230,47802
29-06-2015,10,17865,18768,6962,2412,46006,857,799,564,2220,48226
29-06-2015,11,17611,19047,6995,2351,46005,778,809,510,2097,48102
29-06-2015,12,17200,18763,7052,2387,45403,785,809,551,2145,47548
29-06-2015,13,17334,18507,7080,2397,45319,783,728,578,2089,47408
29-06-2015,14,17320,18343,7070,2316,45049,781,696,462,1939,46988
29-06-2015,15,17186,18479,6945,2294,44903,783,599,474,1856,46759
29-06-2015,16,17024,18119,6860,2306,44311,717,440,467,1624,45935
29-06-2015,17,17005,18016,6801,2390,44213,779,413,462,1654,45867
29-06-2015,18,16712,17886,6795,2219,43611,729,393,463,1585,45196
29-06-2015,19,16493,17794,6751,2113,43152,732,554,457,1743,44895
29-06-2015,20,16340,17479,6716,1890,42424,641,321,452,1414,43838
29-06-2015,21,16366,17015,6634,1611,41626,671,246,453,1370,42996
29-06-2015,22,15704,16733,6596,1641,40675,634,138,361,1133,41808
29-06-2015,23,14585,16113,6628,1508,38834,611,127,290,1028,39862
30-06-2015,0,13337,15183,6615,1539,36674,529,125,293,947,37621
30-06-2015,1,12518,14915,6543,1514,35490,524,123,290,937,36427
30-06-2015,2,12106,14739,6532,1515,34892,512,121,290,923,35815
30-06-2015,3,11732,14571,6550,1507,34358,520,121,292,933,35291
30-06-2015,4,11782,14517,6567,1413,34279,530,159,293,982,35261
30-06-2015,5,13247,14731,6558,1446,35981,576,171,289,1036,37017
30-06-2015,6,15450,15852,6720,2122,40142,709,534,286,1529,41671
30-06-2015,7,16580,17668,6854,2585,43687,736,593,487,1816,45503
30-06-2015,8,16940,18335,6937,2674,44885,735,646,615,1996,46881
30-06-2015,9,17075,18516,7064,2771,45427,733,645,582,1960,47387
30-06-2015,10,17208,18575,7073,2925,45781,742,739,572,2053,47834
30-06-2015,11,17340,18734,7129,2965,46169,740,717,522,1979,48148
30-06-2015,12,17113,18261,7120,2955,45449,741,731,551,2023,47472
30-06-2015,13,17088,17901,7201,2737,44927,759,684,503,1946,46873
30-06-2015,14,17078,17744,7223,2532,44578,798,586,505,1889,46467
30-06-2015,15,17180,17670,7032,2323,44205,803,564,511,1878,46083
30-06-2015,16,17022,17435,7040,2302,43799,791,371,500,1662,45461
30-06-2015,17,16760,17581,7054,2483,43880,724,395,505,1624,45504
30-06-2015,18,16670,17452,7031,2391,43544,710,344,497,1551,45095
30-06-2015,19,16662,17403,6967,2100,43132,708,483,490,1681,44813
30-06-2015,20,16533,16977,6964,1865,42340,621,269,485,1375,43715
30-06-2015,21,16282,16695,6875,1424,41277,555,463,289,1307,42584
30-06-2015,22,16106,16090,6888,1059,40143,584,333,289,1206,41349
30-06-2015,23,15026,15482,6852,959,38320,581,181,288,1050,39370
01-07-2015,0,14222,14279,6794,749,36043,553,179,290,1022,37065
01-07-2015,1,13582,14000,6654,700,34937,551,184,293,1028,35965
01-07-2015,2,12907,13875,6639,707,34129,587,179,291,1057,35186
01-07-2015,3,12506,13741,6550,789,33585,599,189,290,1078,34663
01-07-2015,4,12480,13669,6550,759,33457,581,238,294,1113,34570
01-07-2015,5,13802,14017,6565,844,35228,583,255,297,1135,36363
01-07-2015,6,15315,15553,6804,1117,38790,706,544,290,1540,40330
01-07-2015,7,16411,17399,7105,1296,42211,783,727,323,1833,44044
01-07-2015,8,17026,17963,7264,1855,44109,794,783,413,1990,46099
01-07-2015,9,17031,18476,7248,2028,44783,786,850,400,2036,46819
01-07-2015,10,17059,18446,7199,1915,44622,781,916,360,2057,46679
01-07-2015,11,16965,18372,7223,1749,44312,781,834,356,1971,46283
01-07-2015,12,16698,18349,7183,1756,43985,804,824,447,2075,46060
01-07-2015,13,16406,18294,7161,1692,43554,850,711,463,2024,45578
01-07-2015,14,16321,18216,7061,1657,43255,847,687,484,2018,45273
01-07-2015,15,16554,17482,6986,1593,42617,828,659,417,1904,44521
01-07-2015,16,16718,17151,6906,1762,42537,782,582,350,1714,44251
01-07-2015,17,16519,17010,6794,1823,42145,751,543,357,1651,43796
01-07-2015,18,16215,16657,6783,1797,41453,714,505,352,1571,43024
01-07-2015,19,16067,16087,6808,1761,40722,700,643,338,1681,42403
01-07-2015,20,15500,15848,6726,1786,39860,623,436,330,1389,41249
01-07-2015,21,14795,15551,6569,1812,38727,569,399,333,1301,40028
01-07-2015,22,14136,15069,6568,1972,37745,562,249,352,1163,38908
01-07-2015,23,13159,14858,6574,2052,36644,551,191,353,1095,37739
02-07-2015,0,11690,13649,6614,2027,33981,590,183,346,1119,35100
02-07-2015,1,10687,13412,6536,2103,32737,607,180,337,1124,33861
02-07-2015,2,10123,13072,6493,2178,31867,610,181,337,1128,32995
02-07-2015,3,9904,12616,6503,2193,31216,599,183,334,1116,32332
02-07-2015,4,9881,12677,6474,2182,31214,575,230,313,1118,32332
02-07-2015,5,10804,13405,6522,2146,32877,571,319,314,1204,34081
02-07-2015,6,12622,14975,6756,2201,36554,638,376,494,1508,38062
02-07-2015,7,14629,16198,6995,2187,40008,732,537,482,1751,41759
02-07-2015,8,15829,16747,7085,2208,41868,737,731,483,1951,43819
02-07-2015,9,15992,16921,7086,2425,42424,648,707,519,1874,44298
02-07-2015,10,15834,16983,7136,2893,42848,604,773,552,1929,44777
02-07-2015,11,15416,17099,7118,3032,42665,604,743,548,1895,44560
02-07-2015,12,14909,17037,7183,3209,42338,607,805,549,1961,44299
02-07-2015,13,14699,16970,7048,3592,42308,603,750,558,1911,44219
02-07-2015,14,14434,16681,7070,3535,41720,634,679,499,1812,43532
02-07-2015,15,13923,16839,6894,3728,41384,724,601,502,1827,43211
02-07-2015,16,13786,16530,6839,3726,40883,742,368,507,1617,42500
02-07-2015,17,14055,16393,6779,3499,40727,712,328,512,1552,42279
02-07-2015,18,14391,16459,6830,3331,41013,663,321,508,1492,42505
02-07-2015,19,14348,16535,6806,2972,40663,633,461,511,1605,42268
02-07-2015,20,14246,16375,6770,2947,40338,575,303,468,1346,41684
02-07-2015,21,13478,16393,6697,2810,39378,553,246,471,1270,40648
02-07-2015,22,12641,15971,6689,2772,38073,556,234,366,1156,39229
02-07-2015,23,11638,15521,6711,2630,36499,538,191,325,1054,37553
03-07-2015,0,10542,14635,6694,2286,34157,565,174,322,1061,35218
03-07-2015,1,10562,14455,6574,2079,33670,557,195,313,1065,34735
03-07-2015,2,10493,14125,6473,1854,32945,569,197,309,1075,34020
03-07-2015,3,10387,14118,6481,1702,32688,576,199,300,1075,33763
03-07-2015,4,10060,13748,6520,1617,31946,577,221,298,1096,33042
03-07-2015,5,10492,14498,6629,1636,33255,573,265,298,1136,34391
03-07-2015,6,13229,16195,6853,1540,37819,573,355,490,1418,39237
03-07-2015,7,15748,17430,7068,1936,42183,587,523,609,1719,43902
03-07-2015,8,16470,17785,7180,2467,43902,594,777,606,1977,45879
03-07-2015,9,16486,18055,7233,2569,44343,606,852,604,2062,46405
03-07-2015,10,16978,18258,7285,2194,44715,638,834,603,2075,46790
03-07-2015,11,16704,18332,7275,2141,44454,652,807,493,1952,46406
03-07-2015,12,16280,17710,7300,1881,43170,665,760,506,1931,45101
03-07-2015,13,16246,17773,7235,1556,42811,654,783,493,1930,44741
03-07-2015,14,16200,17682,7044,1490,42416,628,762,495,1885,44301
03-07-2015,15,15909,17430,6893,1636,41868,613,633,494,1740,43608
03-07-2015,16,15366,17702,6848,1525,41442,602,483,493,1578,43020
03-07-2015,17,15533,17604,6772,1637,41546,605,438,494,1537,43083
03-07-2015,18,15522,17543,6732,1651,41448,585,433,490,1508,42956
03-07-2015,19,15333,17291,6576,1777,40978,594,505,489,1588,42566
03-07-2015,20,14668,16723,6681,1820,39894,535,286,492,1313,41207
03-07-2015,21,13942,16357,6674,1681,38653,551,270,491,1312,39965
03-07-2015,22,13830,16073,6726,1350,37979,594,271,325,1190,39169
03-07-2015,23,12953,16116,6649,1216,36935,589,239,301,1129,38064
04-07-2015,0,12313,15200,6597,1312,35422,614,214,293,1121,36543
04-07-2015,1,12018,14183,6634,1087,33921,603,212,305,1120,35041
04-07-2015,2,11767,14062,6576,1045,33451,573,210,319,1102,34553
04-07-2015,3,11323,13911,6651,1002,32888,562,209,331,1102,33990
04-07-2015,4,10992,13697,6598,910,32197,542,229,326,1097,33294
04-07-2015,5,11104,13721,6549,816,32189,566,241,312,1119,33308
04-07-2015,6,11228,14220,6502,803,32754,527,275,303,1105,33859
04-07-2015,7,12422,14981,6485,989,34879,561,325,292,1178,36057
04-07-2015,8,13354,15826,6415,1218,36813,627,396,287,1310,38123
04-07-2015,9,14029,16187,6457,1381,38054,544,619,287,1450,39504
04-07-2015,10,14473,16436,6510,1429,38850,561,664,289,1514,40364
04-07-2015,11,14742,16550,6511,1469,39271,563,585,288,1436,40707
04-07-2015,12,14593,16608,6476,1414,39090,580,455,288,1323,40413
04-07-2015,13,14225,16565,6478,1420,38689,619,450,293,1362,40051
04-07-2015,14,13978,16430,6494,1465,38367,683,450,295,1428,39795
04-07-2015,15,13811,16455,6447,1568,38282,706,449,293,1448,39730
04-07-2015,16,14062,16329,6450,1631,38471,687,514,292,1493,39964
04-07-2015,17,14212,16235,6527,1676,38650,642,514,291,1447,40097
04-07-2015,18,14175,16278,6552,1672,38678,639,487,288,1414,40092
04-07-2015,19,14188,16146,6560,1527,38422,618,482,286,1386,39808
04-07-2015,20,13992,15942,6545,1408,37887,558,467,286,1311,39198
04-07-2015,21,13809,15730,6522,1273,37335,535,448,284,1267,38602
04-07-2015,22,13808,15354,6567,1212,36941,562,271,282,1115,38056
04-07-2015,23,13394,14685,6630,1007,35717,554,220,281,1055,36772
05-07-2015,0,12552,13858,6514,839,33763,552,183,282,1017,34780
05-07-2015,1,12125,13329,6497,793,32743,568,173,282,1023,33766
05-07-2015,2,12101,13087,6441,852,32481,549,172,282,1003,33484
05-07-2015,3,12259,13144,6414,785,32602,518,174,283,975,33577
05-07-2015,4,12084,12307,6325,691,31408,522,190,280,992,32400
05-07-2015,5,11633,12384,6305,690,31013,497,195,280,972,31985
05-07-2015,6,11959,13158,6334,740,32192,532,206,280,1018,33210
05-07-2015,7,12615,13722,6278,898,33514,509,213,280,1002,34516
05-07-2015,8,13444,14368,6267,957,35036,503,238,280,1021,36057
05-07-2015,9,14460,14800,6315,1054,36631,512,314,279,1105,37736
05-07-2015,10,14955,15417,6414,1043,37831,511,326,279,1116,38947
05-07-2015,11,15084,15566,6423,1015,38089,516,329,279,1124,39213
05-07-2015,12,15081,15308,6454,1013,37857,517,284,280,1081,38938
05-07-2015,13,14967,15300,6404,1014,37687,471,475,281,1227,38914
05-07-2015,14,14881,15287,6390,998,37557,463,449,286,1198,38755
05-07-2015,15,14922,15232,6383,1059,37596,469,417,282,1168,38764
05-07-2015,16,14917,15522,6358,1215,38013,471,423,282,1176,39189
05-07-2015,17,15016,15662,6409,1247,38335,491,428,281,1200,39535
05-07-2015,18,15017,15728,6436,1323,38504,493,434,280,1207,39711
05-07-2015,19,14924,15825,6479,1376,38605,523,300,281,1104,39709
05-07-2015,20,14748,15726,6448,1192,38113,522,299,284,1105,39218
05-07-2015,21,14349,15949,6497,871,37667,525,282,290,1097,38764
05-07-2015,22,14174,15587,6581,802,37144,523,260,302,1085,38229
05-07-2015,23,13299,15306,6285,970,35860,495,193,320,1008,36868
06-07-2015,0,11958,14146,6104,1382,33590,440,181,332,953,34543
06-07-2015,1,10841,13417,6001,1946,32207,441,179,329,949,33156
06-07-2015,2,10363,12973,6055,2210,31602,459,182,331,972,32574
06-07-2015,3,9698,12792,6034,2728,31253,490,187,326,1003,32256
06-07-2015,4,9095,12769,5983,2945,30792,477,228,319,1024,31816
06-07-2015,5,9545,13118,6303,3034,31999,558,279,323,1160,33159
06-07-2015,6,11446,13906,6672,3082,35106,686,473,477,1636,36742
06-07-2015,7,12787,15188,6934,3436,38345,774,656,486,1916,40261
06-07-2015,8,13640,16085,7012,3669,40406,782,664,615,2061,42467
06-07-2015,9,13821,16330,7059,3849,41060,819,730,599,2148,43208
06-07-2015,10,14461,16786,7037,3788,42072,831,759,587,2177,44249
06-07-2015,11,14235,16898,7011,3747,41888,804,710,594,2108,43996
06-07-2015,12,13780,17107,7050,3768,41707,814,640,588,2042,43749
06-07-2015,13,13590,17042,7084,3862,41578,815,657,526,1998,43576
06-07-2015,14,13365,17090,6996,3958,41410,845,630,560,2035,43445
06-07-2015,15,13063,17279,6954,3949,41246,847,574,566,1987,43233
06-07-2015,16,12732,17274,6931,4072,41009,758,314,599,1671,42680
06-07-2015,17,12791,17023,6976,3816,40607,723,291,596,1610,42217
06-07-2015,18,12902,17175,7000,3580,40658,730,295,560,1585,42243
06-07-2015,19,12952,17252,7001,3307,40512,730,402,596,1728,42240
06-07-2015,20,13018,17297,6902,2864,40080,653,289,439,1381,41461
06-07-2015,21,12965,17150,6936,2454,39505,611,249,434,1294,40799
06-07-2015,22,12918,16834,6791,2250,38793,557,232,430,1219,40012
06-07-2015,23,12043,16446,6517,2114,37120,522,202,455,1179,38299
07-07-2015,0,10578,15487,6478,1906,34449,570,184,441,1195,35644
07-07-2015,1,10886,15111,6484,1846,34327,586,172,409,1167,35494
07-07-2015,2,10758,14899,6423,1799,33879,593,174,400,1167,35046
07-07-2015,3,10724,14806,6379,1689,33598,616,175,385,1176,34774
07-07-2015,4,10438,14665,6266,1576,32945,597,199,401,1197,34142
07-07-2015,5,11379,14913,6422,1542,34257,612,292,402,1306,35563
07-07-2015,6,12762,16509,6788,1623,37683,760,366,460,1586,39269
07-07-2015,7,13935,17394,6884,2340,40552,959,550,572,2081,42633
07-07-2015,8,14701,18009,6903,2751,42365,1046,646,575,2267,44632
07-07-2015,9,15143,18236,7065,2725,43168,978,655,590,2223,45391
07-07-2015,10,15299,18117,7027,2911,43354,999,650,609,2258,45612
07-07-2015,11,15090,18025,6970,2857,42943,1034,629,587,2250,45193
07-07-2015,12,15071,17772,6937,2709,42490,1052,627,684,2363,44853
07-07-2015,13,15112,17709,6792,2677,42290,1053,621,646,2320,44610
07-07-2015,14,15173,17734,6767,2666,42340,1046,619,606,2271,44611
07-07-2015,15,15893,17553,6705,2282,42434,1047,605,578,2230,44664
07-07-2015,16,16178,17426,6633,2105,42342,1037,430,565,2032,44374
07-07-2015,17,16205,17204,6633,2246,42288,1025,422,530,1977,44265
07-07-2015,18,16064,16937,6605,2268,41874,1011,418,490,1919,43793
07-07-2015,19,15935,16876,6711,1877,41400,995,460,463,1918,43318
07-07-2015,20,15956,16877,6610,1312,40756,912,217,443,1572,42328
07-07-2015,21,15644,16570,6527,1255,39997,913,234,440,1587,41584
07-07-2015,22,14918,16408,6512,1166,39005,878,210,293,1381,40386
07-07-2015,23,14035,15945,6317,1088,37385,707,175,288,1170,38555
08-07-2015,0,12982,14712,6182,1068,34942,651,166,287,1104,36046
08-07-2015,1,12302,14292,6036,1444,34074,642,163,285,1090,35164
08-07-2015,2,11899,13794,5944,1868,33504,621,175,294,1090,34594
08-07-2015,3,11578,13494,5927,2079,33079,601,182,312,1095,34174
08-07-2015,4,11486,13460,5960,2162,33069,600,186,344,1130,34199
08-07-2015,5,11666,13774,6279,2364,34082,638,237,366,1241,35323
08-07-2015,6,12747,15074,6520,2621,36962,928,402,533,1863,38825
08-07-2015,7,14395,15823,6687,2820,39725,1219,605,527,2351,42076
08-07-2015,8,15373,15957,6723,3264,41317,1237,691,577,2505,43822
08-07-2015,9,15741,16105,6692,3458,41995,1255,790,536,2581,44576
08-07-2015,10,15903,16237,6670,3528,42337,1256,695,685,2636,44973
08-07-2015,11,15796,16492,6699,3617,42604,1260,756,576,2592,45196
08-07-2015,12,15249,16700,6659,3708,42316,1257,877,541,2675,44991
08-07-2015,13,14971,16595,6608,3875,42048,1248,774,540,2562,44610
08-07-2015,14,14750,16604,6568,3824,41745,1243,667,603,2513,44258
08-07-2015,15,14456,16606,6571,3661,41295,1242,609,594,2445,43740
08-07-2015,16,14232,16630,6594,3430,40888,1246,260,529,2035,42923
08-07-2015,17,14227,16466,6609,3528,40829,1226,236,483,1945,42774
08-07-2015,18,14273,16326,6728,3543,40870,1153,278,443,1874,42744
08-07-2015,19,13800,16291,6714,3528,40334,1093,437,519,2049,42383
08-07-2015,20,13286,15936,6687,3448,39358,874,279,475,1628,40986
08-07-2015,21,12766,15628,6644,3595,38634,845,247,442,1534,40168
08-07-2015,22,12444,15497,6535,3626,38102,862,228,343,1433,39535
08-07-2015,23,11636,14946,6318,3693,36593,764,218,366,1348,37941
09-07-2015,0,10898,13834,6028,3692,34451,702,190,371,1263,35714
09-07-2015,1,10249,13074,5924,3861,33109,718,186,358,1262,34371
09-07-2015,2,9866,12636,5838,3886,32227,729,185,369,1283,33510
09-07-2015,3,9659,12417,5775,3873,31724,725,197,372,1294,33018
09-07-2015,4,9458,12453,5793,3869,31573,710,219,361,1290,32863
09-07-2015,5,9977,12967,6131,3819,32894,702,336,372,1410,34304
09-07-2015,6,11448,14294,6542,3831,36115,884,368,568,1820,37935
09-07-2015,7,12592,15613,6606,3913,38724,1144,501,589,2234,40958
09-07-2015,8,13314,16185,6729,4053,40281,1248,613,588,2449,42730
09-07-2015,9,13742,16360,6734,4137,40974,1228,657,593,2478,43452
09-07-2015,10,14521,16663,6796,4149,42130,1259,656,595,2510,44640
09-07-2015,11,14600,16685,6821,4164,42271,1261,619,591,2471,44742
09-07-2015,12,14331,16832,6853,4168,42185,1250,661,602,2513,44698
09-07-2015,13,14212,16615,6848,4215,41889,1182,625,609,2416,44305
09-07-2015,14,13908,16593,6866,4257,41624,1139,588,624,2351,43975
09-07-2015,15,13355,16547,6817,4279,40998,1063,512,626,2201,43199
09-07-2015,16,12841,16348,6765,4394,40349,1068,347,577,1992,42341
09-07-2015,17,12868,16310,6700,4340,40218,978,353,494,1825,42043
09-07-2015,18,12900,15848,6814,4333,39895,953,289,395,1637,41532
09-07-2015,19,12749,15865,6804,4236,39656,998,325,570,1893,41549
09-07-2015,20,12358,15763,6683,4364,39168,848,274,436,1558,40726
09-07-2015,21,11892,15401,6648,4235,38175,839,267,436,1542,39717
09-07-2015,22,11437,15196,6625,4193,37452,759,255,463,1477,38929
09-07-2015,23,10808,14800,6297,4170,36075,674,216,481,1371,37446
10-07-2015,0,9744,14248,5913,4180,34086,638,181,460,1279,35365
10-07-2015,1,9372,13855,5689,4126,33042,632,178,457,1267,34309
10-07-2015,2,9282,13583,5611,4087,32564,619,187,457,1263,33827
10-07-2015,3,9238,13598,5572,4082,32489,613,192,427,1232,33721
10-07-2015,4,8985,13753,5740,3974,32453,603,203,431,1237,33690
10-07-2015,5,9432,14033,6209,3918,33593,644,252,450,1346,34939
10-07-2015,6,11041,15127,6681,3994,36844,879,348,515,1742,38586
10-07-2015,7,11964,16646,6842,4122,39574,1185,402,634,2221,41795
10-07-2015,8,12602,17212,6890,4170,40875,1214,432,804,2450,43325
10-07-2015,9,13144,17301,6874,4324,41642,1221,548,830,2599,44241
10-07-2015,10,13451,17521,6909,4352,42233,1216,575,864,2655,44888
10-07-2015,11,13220,17674,6972,4313,42179,1193,502,825,2520,44699
10-07-2015,12,12951,17783,6967,4368,42067,1211,331,825,2367,44434
10-07-2015,13,12785,17298,6962,4295,41341,1204,314,815,2333,43674
10-07-2015,14,12568,17138,6835,4220,40760,1205,427,623,2255,43015
10-07-2015,15,12430,17025,6738,4097,40291,1181,362,635,2178,42469
10-07-2015,16,12442,16721,6733,4006,39902,1110,265,471,1846,41748
10-07-2015,17,12762,16604,6778,3802,39946,976,232,451,1659,41605
10-07-2015,18,12982,16701,6736,3445,39866,969,231,392,1592,41458
10-07-2015,19,13099,16688,6674,2904,39366,957,231,555,1743,41109
10-07-2015,20,13416,16817,6500,2314,39048,808,232,448,1488,40536
10-07-2015,21,13468,16733,6485,1828,38513,764,232,457,1453,39966
10-07-2015,22,13918,16516,6493,1598,38525,771,226,415,1412,39937
10-07-2015,23,13491,16211,6144,1525,37371,685,201,276,1162,38533
11-07-2015,0,12067,16278,5918,1444,35708,572,198,267,1037,36745
11-07-2015,1,11640,15896,5828,1228,34591,592,201,265,1058,35649
11-07-2015,2,11581,15296,5904,1106,33886,593,198,285,1076,34962
11-07-2015,3,11395,15014,5881,1030,33320,602,195,268,1065,34385
11-07-2015,4,11065,14924,5868,1008,32864,592,208,258,1058,33922
11-07-2015,5,11366,14865,5910,949,33091,597,224,272,1093,34184
11-07-2015,6,11577,15540,5970,976,34063,588,233,267,1088,35151
11-07-2015,7,12615,15906,6275,1095,35892,601,240,270,1111,37003
11-07-2015,8,13672,16087,6480,1451,37690,646,260,261,1167,38857
11-07-2015,9,14502,16372,6628,1303,38806,670,260,273,1203,40009
11-07-2015,10,15052,16368,6713,1292,39425,693,256,290,1239,40664
11-07-2015,11,15267,16192,6675,1287,39421,695,316,297,1308,40729
11-07-2015,12,15097,16066,6538,1242,38943,706,313,304,1323,40266
11-07-2015,13,14849,16029,6562,1158,38597,715,238,315,1268,39865
11-07-2015,14,14529,15982,6541,1109,38161,722,232,319,1273,39434
11-07-2015,15,14455,15890,6463,1150,37958,713,324,315,1352,39310
11-07-2015,16,14360,15987,6427,1238,38013,695,274,309,1278,39291
11-07-2015,17,14666,15969,6526,1357,38518,642,255,305,1202,39720
11-07-2015,18,14722,16162,6596,1447,38928,599,229,289,1117,40045
11-07-2015,19,14702,16126,6558,1644,39031,581,227,271,1079,40110
11-07-2015,20,14596,15764,6501,1416,38278,562,226,244,1032,39310
11-07-2015,21,14522,15583,6514,884,37505,591,225,237,1053,38558
11-07-2015,22,14386,15404,6543,787,37119,625,236,244,1105,38224
11-07-2015,23,13789,15313,6272,762,36136,594,205,249,1048,37184
12-07-2015,0,12651,14991,5921,752,34314,509,192,248,949,35263
12-07-2015,1,12012,14713,5770,745,33240,521,192,242,955,34195
12-07-2015,2,11604,14493,5784,769,32649,502,196,234,932,33581
12-07-2015,3,11263,14302,5771,747,32082,473,192,234,899,32981
12-07-2015,4,10916,14229,5752,708,31605,412,247,245,904,32509
12-07-2015,5,11003,14193,5735,715,31644,531,209,237,977,32621
12-07-2015,6,11213,14332,5781,750,32076,538,218,223,979,33055
12-07-2015,7,11812,14638,5795,785,33030,543,224,219,986,34016
12-07-2015,8,12512,15156,6075,751,34494,595,229,220,1044,35538
12-07-2015,9,13399,15960,6276,865,36501,621,241,308,1170,37671
12-07-2015,10,14030,16186,6407,901,37526,621,231,360,1212,38738
12-07-2015,11,14160,16508,6410,1071,38149,632,226,337,1195,39344
12-07-2015,12,13862,16311,6449,1116,37739,596,221,387,1204,38943
12-07-2015,13,13589,16181,6451,1237,37458,489,239,401,1129,38587
12-07-2015,14,13295,16062,6404,1300,37060,509,329,243,1081,38141
12-07-2015,15,13262,16074,6399,1252,36987,495,246,356,1097,38084
12-07-2015,16,13504,16063,6460,1213,37239,487,247,362,1096,38335
12-07-2015,17,13877,16184,6454,1200,37715,528,271,353,1152,38867
12-07-2015,18,14143,16299,6477,1134,38052,588,281,227,1096,39148
12-07-2015,19,14214,16308,6538,994,38054,579,326,221,1126,39180
12-07-2015,20,13988,16171,6493,975,37628,569,312,214,1095,38723
12-07-2015,21,13790,16153,6552,969,37465,564,320,215,1099,38564
12-07-2015,22,13560,15851,6571,900,36882,559,248,217,1024,37906
12-07-2015,23,13130,15318,6278,890,35616,491,206,213,910,36526
13-07-2015,0,12154,14595,6033,848,33630,478,183,210,871,34501
13-07-2015,1,11708,14554,5746,785,32792,447,179,207,833,33625
13-07-2015,2,11564,14554,5724,798,32640,466,180,206,852,33492
13-07-2015,3,11430,14517,5708,753,32410,532,202,205,939,33349
13-07-2015,4,11359,14535,5802,731,32427,576,241,203,1020,33447
13-07-2015,5,11892,14647,6304,818,33660,608,289,200,1097,34757
13-07-2015,6,13591,15133,6645,990,36360,792,484,358,1634,37994
13-07-2015,7,15084,15875,6692,1628,39279,1014,756,364,2134,41413
13-07-2015,8,15853,16204,6858,1884,40797,1040,841,388,2269,43066
13-07-2015,9,16398,16509,7034,2152,42092,1044,851,404,2299,44391
13-07-2015,10,16901,16748,6978,2269,42898,1050,845,384,2279,45177
13-07-2015,11,16573,16699,7064,2279,42614,1053,828,344,2225,44839
13-07-2015,12,16590,16822,6967,1883,42263,1049,873,263,2185,44448
13-07-2015,13,16483,16772,6949,1905,42110,1040,671,393,2104,44214
13-07-2015,14,16341,16658,6919,1756,41673,1037,670,389,2096,43769
13-07-2015,15,16132,16760,6790,1683,41367,1076,641,364,2081,43448
13-07-2015,16,16198,16796,6764,1526,41284,1068,354,368,1790,43074
13-07-2015,17,15952,16884,6726,1671,41234,1079,357,370,1806,43040
13-07-2015,18,15699,16584,6700,1674,40660,1040,338,368,1746,42406
13-07-2015,19,15510,16407,6641,1502,40059,1051,513,366,1930,41989
13-07-2015,20,15219,16283,6526,1289,39317,1073,287,364,1724,41041
13-07-2015,21,15083,16089,6501,1105,38779,1063,257,359,1679,40458
13-07-2015,22,14809,15978,6398,1095,38280,1044,231,348,1623,39903
13-07-2015,23,13825,15790,6133,1093,36842,866,199,200,1265,38107
14-07-2015,0,12368,15256,6102,964,34689,616,188,197,1001,35690
14-07-2015,1,11820,14854,5972,954,33600,591,186,197,974,34574
14-07-2015,2,11502,14828,5909,933,33170,591,185,194,970,34140
14-07-2015,3,11269,14782,5885,927,32864,595,188,193,976,33840
14-07-2015,4,11544,14692,5990,951,33177,612,215,193,1020,34197
14-07-2015,5,11995,15021,6298,1043,34357,746,267,192,1205,35562
14-07-2015,6,13518,15772,6673,1357,37321,851,463,353,1667,38988
14-07-2015,7,14762,16457,6837,1701,39758,1088,638,362,2088,41846
14-07-2015,8,15582,16666,6898,1788,40934,1111,762,372,2245,43179
14-07-2015,9,16187,16901,6940,1852,41881,1108,798,387,2293,44174
14-07-2015,10,16479,17235,7019,2030,42764,1131,784,338,2253,45017
14-07-2015,11,16559,17222,7024,2078,42884,1093,763,308,2164,45048
14-07-2015,12,16310,17203,7056,2071,42640,1115,782,308,2205,44845
14-07-2015,13,16260,17147,6971,2008,42386,1104,692,386,2182,44568
14-07-2015,14,16044,17001,6956,1983,41983,1091,667,392,2150,44133
14-07-2015,15,15912,16834,6867,2061,41674,1112,634,384,2130,43804
14-07-2015,16,15548,16756,6785,2037,41126,1073,247,373,1693,42819
14-07-2015,17,15574,16711,6683,2113,41081,1079,221,345,1645,42726
14-07-2015,18,15431,16711,6653,2022,40818,1062,224,325,1611,42429
14-07-2015,19,15112,16696,6835,1913,40557,891,501,373,1765,42322
14-07-2015,20,14619,16580,6662,1933,39794,864,227,313,1404,41198
14-07-2015,21,14108,16561,6589,1897,39155,880,228,281,1389,40544
14-07-2015,22,13561,16400,6543,1837,38341,889,201,336,1426,39767
14-07-2015,23,12416,16162,6281,1914,36773,722,192,206,1120,37893
15-07-2015,0,11110,15426,5892,2174,34604,678,164,206,1048,35652
15-07-2015,1,10455,14948,5703,2420,33526,676,161,206,1043,34569
15-07-2015,2,10132,14697,5638,2414,32881,673,161,204,1038,33919
15-07-2015,3,9996,14496,5650,2389,32530,684,164,201,1049,33579
15-07-2015,4,9787,14428,5711,2364,32290,685,190,206,1081,33371
15-07-2015,5,10079,14727,6283,2435,33524,685,235,202,1122,34646
15-07-2015,6,11759,15614,6619,2477,36468,798,436,366,1600,38068
15-07-2015,7,13760,16454,6753,2702,39669,1079,626,365,2070,41739
15-07-2015,8,14666,17182,6830,3016,41695,1105,769,372,2246,43941
15-07-2015,9,14969,17372,6900,3159,42400,1064,777,377,2218,44618
15-07-2015,10,14927,17260,6928,3213,42328,1072,695,398,2165,44493
15-07-2015,11,15000,17204,6941,3264,42409,1096,751,388,2235,44644
15-07-2015,12,14897,17034,6916,3271,42118,1090,698,405,2193,44311
15-07-2015,13,14696,16900,6800,3211,41609,1104,781,436,2321,43930
15-07-2015,14,14523,16835,6648,3193,41198,1099,682,434,2215,43413
15-07-2015,15,14207,16910,6578,3109,40803,1099,704,419,2222,43025
15-07-2015,16,14271,16742,6514,2893,40421,1062,273,406,1741,42162
15-07-2015,17,14632,16669,6539,2623,40463,1006,225,408,1639,42102
15-07-2015,18,14841,17045,6566,2393,40847,994,224,395,1613,42460
15-07-2015,19,14729,17128,6766,2130,40755,811,492,387,1690,42445
15-07-2015,20,14469,17088,6616,2142,40317,816,230,233,1279,41596
15-07-2015,21,14250,16987,6531,2023,39792,832,230,303,1365,41157
15-07-2015,22,13654,16877,6541,1805,38877,820,226,377,1423,40300
15-07-2015,23,13042,16431,6243,1619,37335,687,198,217,1102,38437
16-07-2015,0,11811,15649,5977,1604,35040,582,187,213,982,36022
16-07-2015,1,11315,15349,5812,1603,34079,559,186,214,959,35038
16-07-2015,2,11010,15395,5730,1559,33694,552,191,215,958,34652
16-07-2015,3,10729,15415,5727,1545,33416,563,195,214,972,34388
16-07-2015,4,10339,15399,5868,1582,33187,569,220,214,1003,34190
16-07-2015,5,10987,15603,6144,1613,34347,581,268,222,1071,35418
16-07-2015,6,12749,16296,6615,1627,37287,793,402,384,1579,38866
16-07-2015,7,14316,16911,6761,1960,39949,989,630,369,1988,41937
16-07-2015,8,15238,17313,6864,2305,41721,1002,705,430,2137,43858
16-07-2015,9,15719,17581,6850,2599,42750,1006,802,437,2245,44995
16-07-2015,10,15954,17798,6824,2687,43263,1011,790,435,2236,45499
16-07-2015,11,15961,17876,6761,2576,43175,1021,775,435,2231,45406
16-07-2015,12,15595,17913,6759,2620,42887,1021,791,451,2263,45150
16-07-2015,13,15374,17752,6718,2668,42513,1026,792,442,2260,44773
16-07-2015,14,14980,17580,6690,2748,41999,1028,676,458,2162,44161
16-07-2015,15,14725,17354,6614,2721,41415,1022,661,441,2124,43539
16-07-2015,16,14846,17104,6514,2582,41048,1006,345,435,1786,42834
16-07-2015,17,14825,17147,6509,2468,40948,1010,317,421,1748,42696
16-07-2015,18,14749,17132,6486,2324,40692,990,344,399,1733,42425
16-07-2015,19,14492,17290,6655,2067,40505,917,491,392,1800,42305
16-07-2015,20,14116,17458,6478,1814,39867,921,224,334,1479,41346
16-07-2015,21,13794,17377,6410,1231,38811,924,248,231,1403,40214
16-07-2015,22,13555,17019,6397,1149,38118,946,239,382,1567,39685
16-07-2015,23,12668,16655,6215,1052,36589,802,204,226,1232,37821
17-07-2015,0,11889,15810,5768,971,34438,619,212,235,1066,35504
17-07-2015,1,11314,15472,5637,853,33277,590,191,240,1021,34298
17-07-2015,2,10686,15271,5537,762,32254,598,193,255,1046,33300
17-07-2015,3,10553,15058,5549,721,31881,596,194,263,1053,32934
17-07-2015,4,10415,15034,5529,670,31647,585,219,263,1067,32714
17-07-2015,5,10780,15265,6039,668,32752,761,269,266,1296,34048
17-07-2015,6,12215,16218,6348,716,35496,923,382,436,1741,37237
17-07-2015,7,14208,16941,6594,797,38542,1083,569,440,2092,40634
17-07-2015,8,14981,17461,6667,1012,40121,1120,705,440,2265,42386
17-07-2015,9,15489,17378,6805,1143,40816,1143,732,456,2331,43147
17-07-2015,10,15685,17268,6770,1389,41113,1156,710,459,2325,43438
17-07-2015,11,15380,17136,6751,1579,40845,1110,690,480,2280,43125
17-07-2015,12,14911,16846,6728,1656,40142,1106,694,528,2328,42470
17-07-2015,13,14190,16631,6711,1912,39443,1116,598,583,2297,41740
17-07-2015,14,13711,16275,6630,2164,38781,1114,595,578,2287,41068
17-07-2015,15,13301,15993,6489,2419,38201,1088,526,559,2173,40374
17-07-2015,16,13395,15689,6545,2457,38085,1000,268,399,1667,39752
17-07-2015,17,13829,15645,6610,2283,38366,890,260,288,1438,39804
17-07-2015,18,13761,15894,6538,2254,38447,872,259,258,1389,39836
17-07-2015,19,13291,15770,6494,2343,37899,839,469,398,1706,39605
17-07-2015,20,12660,15894,6255,2348,37158,691,249,209,1149,38307
17-07-2015,21,12358,15885,6042,2464,36749,778,229,199,1206,37955
17-07-2015,22,12069,15723,5945,2491,36229,828,260,332,1420,37649
17-07-2015,23,11536,15296,5827,2461,35120,614,205,190,1009,36129
18-07-2015,0,10525,14648,5563,2374,33110,526,183,188,897,34007
18-07-2015,1,10163,14299,5340,2104,31907,493,174,189,856,32763
18-07-2015,2,9915,14454,5217,1775,31361,502,173,188,863,32224
18-07-2015,3,9772,14641,5201,1440,31054,495,176,189,860,31914
18-07-2015,4,9565,14716,5289,1107,30678,482,194,199,875,31553
18-07-2015,5,9581,14837,5318,1072,30809,495,205,211,911,31720
18-07-2015,6,9888,15057,5458,1249,31652,513,217,229,959,32611
18-07-2015,7,10506,15595,5756,1348,33205,518,226,302,1046,34251
18-07-2015,8,11124,16423,6007,1662,35216,547,231,287,1065,36281
18-07-2015,9,11356,17006,6136,2253,36750,527,233,418,1178,37928
18-07-2015,10,11200,17176,6197,2998,37573,533,229,402,1164,38737
18-07-2015,11,10875,17167,6216,3421,37679,562,223,366,1151,38830
18-07-2015,12,10548,17031,6156,3499,37236,568,215,346,1129,38365
18-07-2015,13,10040,16778,6110,3554,36481,569,214,355,1138,37619
18-07-2015,14,9850,16499,6161,3627,36137,583,216,383,1182,37319
18-07-2015,15,9876,16455,6162,3737,36230,559,215,368,1142,37372
18-07-2015,16,9675,16577,6335,3817,36405,563,217,386,1166,37571
18-07-2015,17,9735,16628,6435,3588,36387,553,219,391,1163,37550
18-07-2015,18,10126,16716,6423,3739,37005,540,225,410,1175,38180
18-07-2015,19,10063,16641,6316,3465,36485,533,233,418,1184,37669
18-07-2015,20,10076,16471,6184,3405,36136,533,233,422,1188,37324
18-07-2015,21,10239,16382,6165,2997,35784,524,232,413,1169,36953
18-07-2015,22,10649,16317,6242,2729,35936,591,217,372,1180,37116
18-07-2015,23,10374,16146,5927,2524,34969,509,183,237,929,35898
19-07-2015,0,10035,15612,5473,2394,33515,482,173,248,903,34418
19-07-2015,1,9743,15173,5212,2202,32331,481,175,247,903,33234
19-07-2015,2,9634,14891,5169,2049,31744,481,174,256,911,32655
19-07-2015,3,9562,14753,5145,1830,31290,505,176,267,948,32238
19-07-2015,4,9466,14706,5048,1685,30906,483,195,267,945,31851
19-07-2015,5,9428,14704,5046,1509,30687,482,201,262,945,31632
19-07-2015,6,9922,14887,5116,1373,31298,507,213,246,966,32264
19-07-2015,7,10407,15509,5347,1130,32393,503,223,238,964,33357
19-07-2015,8,11503,15938,5617,1053,34110,507,231,255,993,35103
19-07-2015,9,12463,16445,5830,1072,35810,527,292,256,1075,36885
19-07-2015,10,12853,17110,5930,1118,37012,536,285,261,1082,38094
19-07-2015,11,13116,17374,5997,1200,37687,558,235,251,1044,38731
19-07-2015,12,13157,17384,5951,1146,37638,578,227,240,1045,38683
19-07-2015,13,13197,17379,5903,1216,37695,575,249,233,1057,38752
19-07-2015,14,13243,17245,5860,1201,37549,565,315,217,1097,38646
19-07-2015,15,13278,17196,5898,1291,37662,560,241,204,1005,38667
19-07-2015,16,13352,17181,5967,1258,37758,576,283,195,1054,38812
19-07-2015,17,13849,17065,5972,1042,37928,559,282,192,1033,38961
19-07-2015,18,14198,17036,6019,907,38159,525,243,362,1130,39289
19-07-2015,19,14075,17024,6109,689,37896,577,330,211,1118,39014
19-07-2015,20,13919,17039,6069,620,37649,538,367,246,1151,38800
19-07-2015,21,13531,17038,6185,575,37330,538,359,265,1162,38492
19-07-2015,22,13291,16685,6212,661,36851,561,212,251,1024,37875
19-07-2015,23,12331,16292,5906,847,35378,458,183,229,870,36248
20-07-2015,0,11392,14822,5494,932,32641,455,171,248,874,33515
20-07-2015,1,11165,14167,5312,1082,31726,484,172,263,919,32645
20-07-2015,2,10524,13940,5159,1117,30739,521,169,259,949,31688
20-07-2015,3,10185,13746,5260,1151,30343,587,178,270,1035,31378
20-07-2015,4,10040,13679,5456,1196,30371,678,195,257,1130,31501
20-07-2015,5,10157,13824,5983,1349,31314,928,255,254,1437,32751
20-07-2015,6,11372,14297,6454,1367,33492,1072,658,497,2227,35719
20-07-2015,7,13086,15166,6690,1357,36300,1102,768,697,2567,38867
20-07-2015,8,13965,16248,6852,1278,38344,1126,984,723,2833,41177
20-07-2015,9,14034,16531,6919,1362,38847,1138,894,733,2765,41612
20-07-2015,10,14432,16806,6897,1532,39667,1193,819,750,2762,42429
20-07-2015,11,14165,16935,6903,1611,39613,1249,769,736,2754,42367
20-07-2015,12,13870,16675,6968,1636,39149,1270,764,760,2794,41943
20-07-2015,13,13807,16335,6988,1610,38741,1281,665,779,2725,41466
20-07-2015,14,13505,16057,6986,1636,38184,1281,636,807,2724,40908
20-07-2015,15,13738,15971,6947,1538,38195,1288,704,631,2623,40818
20-07-2015,16,13849,16141,6824,1482,38295,1254,375,610,2239,40534
20-07-2015,17,14481,16956,7019,1364,39818,1181,226,534,1941,41759
20-07-2015,18,15307,17129,6728,1322,40487,909,231,541,1681,42168
20-07-2015,19,15220,17109,6518,1432,40280,702,265,574,1541,41821
20-07-2015,20,15154,16744,6268,1276,39442,704,233,537,1474,40916
20-07-2015,21,14996,16334,6247,893,38471,700,229,388,1317,39788
20-07-2015,22,14965,16120,6234,766,38086,704,212,397,1313,39399
20-07-2015,23,14176,15722,5944,652,36494,628,182,335,1145,37639
21-07-2015,0,12561,14999,5527,678,33766,580,173,330,1083,34849
21-07-2015,1,11853,14539,5394,874,32660,579,171,316,1066,33726
21-07-2015,2,11183,14232,5393,1131,31940,590,169,469,1228,33168
21-07-2015,3,10651,14137,5350,1406,31543,593,169,471,1233,32776
21-07-2015,4,10214,13769,5358,1792,31133,584,223,468,1275,32408
21-07-2015,5,10592,13653,5781,1979,32006,590,315,467,1372,33378
21-07-2015,6,11688,14200,6229,2295,34414,639,348,459,1446,35860
21-07-2015,7,12945,14967,6489,2490,36890,827,357,635,1819,38709
21-07-2015,8,13368,15685,6857,2630,38539,847,462,641,1950,40489
21-07-2015,9,13864,16068,6867,2846,39645,851,497,649,1997,41642
21-07-2015,10,13994,16323,6829,3093,40238,853,571,653,2077,42315
21-07-2015,11,13818,16598,6764,3262,40444,864,563,660,2087,42531
21-07-2015,12,13725,16776,6760,3330,40589,850,581,656,2087,42676
21-07-2015,13,13271,16793,6691,3508,40265,867,563,652,2082,42347
21-07-2015,14,13189,16577,6645,3468,39879,858,530,648,2036,41915
21-07-2015,15,12899,16746,6682,3283,39607,762,490,655,1907,41514
21-07-2015,16,12875,16713,6510,3169,39267,831,251,623,1705,40972
21-07-2015,17,13186,16792,6502,2896,39376,793,398,640,1831,41207
21-07-2015,18,13488,16803,6378,2672,39339,773,317,641,1731,41070
21-07-2015,19,13687,16745,6396,2217,39045,772,303,655,1730,40775
21-07-2015,20,13840,16636,6314,1795,38585,715,233,679,1627,40212
21-07-2015,21,13803,16587,6351,1535,38276,654,227,548,1429,39705
21-07-2015,22,13832,16718,6233,1437,38221,625,209,519,1353,39574
21-07-2015,23,13101,16346,6019,1272,36739,545,184,517,1246,37985
22-07-2015,0,11536,15784,5417,1255,33992,534,179,511,1224,35216
22-07-2015,1,11139,15051,5298,1266,32753,535,184,521,1240,33993
22-07-2015,2,10917,14806,5150,1250,32123,544,195,521,1260,33383
22-07-2015,3,10628,14959,5185,1210,31982,550,188,519,1257,33239
22-07-2015,4,10378,14959,5184,1201,31722,542,215,522,1279,33001
22-07-2015,5,10794,14900,5726,1156,32575,582,242,502,1326,33901
22-07-2015,6,12026,15923,6326,1078,35354,730,402,489,1621,36975
22-07-2015,7,14145,16736,6607,1130,38617,891,450,499,1840,40457
22-07-2015,8,15310,17099,6835,1251,40495,910,349,712,1971,42466
22-07-2015,9,16004,17205,6892,1212,41314,906,371,675,1952,43266
22-07-2015,10,16449,17446,6802,1307,42003,919,434,516,1869,43872
22-07-2015,11,16151,17476,6846,1306,41779,929,409,749,2087,43866
22-07-2015,12,15892,17610,6864,1298,41664,928,448,654,2030,43694
22-07-2015,13,15621,17618,6804,1325,41369,917,475,634,2026,43395
22-07-2015,14,15168,17683,6697,1270,40818,922,450,663,2035,42853
22-07-2015,15,15079,17461,6658,1191,40388,918,406,657,1981,42369
22-07-2015,16,15060,17324,6562,1197,40144,897,332,579,1808,41952
22-07-2015,17,15486,17232,6518,1375,40612,884,301,554,1739,42351
22-07-2015,18,15372,16839,6502,1406,40119,889,297,515,1701,41820
22-07-2015,19,15418,16418,6558,1366,39760,873,316,476,1665,41425
22-07-2015,20,15001,16205,6436,1465,39107,833,326,271,1430,40537
22-07-2015,21,14779,16032,6429,1476,38716,708,362,240,1310,40026
22-07-2015,22,14674,15820,6343,1549,38386,725,249,321,1295,39681
22-07-2015,23,13795,15560,5878,1705,36937,673,203,290,1166,38103
23-07-2015,0,11700,15013,5496,1706,33912,575,244,291,1110,35022
23-07-2015,1,10925,14489,5268,2152,32835,566,239,293,1098,33933
23-07-2015,2,10447,14117,5203,2348,32116,563,240,302,1105,33221
23-07-2015,3,10057,14143,5171,2292,31663,0,243,301,544,32207
23-07-2015,4,10106,14130,5228,2283,31746,0,260,310,570,32316
23-07-2015,5,10506,14380,5743,2123,32752,0,387,326,713,33465
23-07-2015,6,11504,15505,6216,1985,35211,0,536,511,1047,36258
23-07-2015,7,12463,16783,6400,2093,37740,736,743,516,1995,39735
23-07-2015,8,13685,17158,6522,2479,39843,703,922,497,2122,41965
23-07-2015,9,14359,17151,6622,2522,40653,701,978,479,2158,42811
23-07-2015,10,14742,17366,6706,2585,41398,659,963,479,2101,43499
23-07-2015,11,14718,17444,6711,2634,41507,634,949,480,2063,43570
23-07-2015,12,14250,17700,6777,2764,41494,620,973,495,2088,43582
23-07-2015,13,13739,17650,6746,2854,40989,620,933,515,2068,43057
23-07-2015,14,13288,17623,6693,2931,40534,616,854,548,2018,42552
23-07-2015,15,12932,17602,6582,2968,40085,661,801,594,2056,42141
23-07-2015,16,12856,17451,6596,2913,39817,690,724,611,2025,41842
23-07-2015,17,13272,17235,6461,2710,39677,712,620,568,1900,41577
23-07-2015,18,13618,17276,6471,2348,39713,710,573,573,1856,41569
23-07-2015,19,13720,17241,6391,2099,39452,724,564,546,1834,41286
23-07-2015,20,13579,17089,6233,1715,38615,699,521,513,1733,40348
23-07-2015,21,13942,17108,6174,1337,38562,709,505,518,1732,40294
23-07-2015,22,13913,17264,6058,1202,38438,714,390,513,1617,40055
23-07-2015,23,12984,17091,5647,1182,36905,638,214,433,1285,38190
24-07-2015,0,11983,16170,5378,1120,34651,579,202,355,1136,35787
24-07-2015,1,11606,15513,5280,1123,33522,594,201,359,1154,34676
24-07-2015,2,11154,15346,5254,1070,32823,596,200,359,1155,33978
24-07-2015,3,11042,15265,5247,1006,32559,619,224,352,1195,33754
24-07-2015,4,11053,15002,5306,961,32321,657,357,350,1364,33685
24-07-2015,5,11323,15251,5886,837,33298,844,497,349,1690,34988
24-07-2015,6,12463,15946,6471,862,35744,1195,687,343,2225,37969
24-07-2015,7,13484,16914,6912,991,38301,1239,903,353,2495,40796
24-07-2015,8,14310,17326,7114,1309,40059,1248,928,531,2707,42766
24-07-2015,9,14854,17442,7155,1480,40931,1240,995,527,2762,43693
24-07-2015,10,15373,17244,7105,1491,41213,1201,949,517,2667,43880
24-07-2015,11,15315,17222,7138,1449,41124,1217,881,507,2605,43729
24-07-2015,12,15062,17461,7094,1336,40954,1243,910,496,2649,43603
24-07-2015,13,14839,17519,6984,1267,40609,1260,877,485,2622,43231
24-07-2015,14,14653,17348,6916,1229,40146,1257,837,474,2568,42714
24-07-2015,15,14391,17282,6897,1200,39769,1238,774,463,2475,42244
24-07-2015,16,14237,17390,6714,1090,39431,1222,500,454,2176,41607
24-07-2015,17,14150,17731,6525,1343,39748,1203,576,382,2161,41909
24-07-2015,18,14479,17702,6395,1130,39707,959,447,374,1780,41487
24-07-2015,19,14532,17460,6499,925,39415,596,694,367,1657,41072
24-07-2015,20,14225,17165,6218,786,38394,550,537,288,1375,39769
24-07-2015,21,13538,16899,6198,858,37492,616,503,284,1403,38895
24-07-2015,22,13340,16579,6165,1010,37095,625,315,284,1224,38319
24-07-2015,23,12665,15992,5820,1217,35694,542,212,250,1004,36698
25-07-2015,0,11249,15263,5549,1158,33219,569,198,223,990,34209
25-07-2015,1,10628,14936,5258,1228,32050,615,194,205,1014,33064
25-07-2015,2,10162,14895,5123,1434,31614,623,193,209,1025,32639
25-07-2015,3,9739,14762,5000,1642,31144,620,195,287,1102,32246
25-07-2015,4,9548,14430,4974,1816,30769,622,219,308,1149,31918
25-07-2015,5,9281,14130,5096,2162,30668,606,232,333,1171,31839
25-07-2015,6,9226,14195,5257,2470,31148,568,332,355,1255,32403
25-07-2015,7,9553,15039,5541,2541,32675,575,519,320,1414,34089
25-07-2015,8,10245,15786,5873,2687,34593,583,563,338,1484,36077
25-07-2015,9,10704,16394,5973,2907,35978,603,777,346,1726,37704
25-07-2015,10,11117,16747,6044,2985,36893,631,691,352,1674,38567
25-07-2015,11,10979,16695,5999,2746,36418,630,699,344,1673,38091
25-07-2015,12,10837,16578,5985,2528,35929,627,639,354,1620,37549
25-07-2015,13,10566,16684,5977,2460,35689,638,617,382,1637,37326
25-07-2015,14,10290,16444,5996,2382,35111,652,573,360,1585,36696
25-07-2015,15,9907,16394,6005,2341,34647,588,541,376,1505,36152
25-07-2015,16,10896,16874,6059,2005,35833,608,539,409,1556,37389
25-07-2015,17,11429,16912,6111,2176,36628,599,546,431,1576,38204
25-07-2015,18,11663,17313,6057,1863,36898,635,507,419,1561,38459
25-07-2015,19,11545,17689,5940,2142,37317,625,515,411,1551,38868
25-07-2015,20,11171,17208,5836,2117,36333,647,508,400,1555,37888
25-07-2015,21,11002,16878,5960,2370,36209,676,353,360,1389,37598
25-07-2015,22,10447,16641,5921,2579,35589,638,261,366,1265,36854
25-07-2015,23,9749,15135,5642,2746,33272,630,235,345,1210,34482
26-07-2015,0,9088,13902,5300,2670,30958,643,215,321,1179,32137
26-07-2015,1,8292,13220,4995,2854,29362,634,210,342,1186,30548
26-07-2015,2,7917,12412,4905,3411,28646,659,208,366,1233,29879
26-07-2015,3,7874,12048,4893,3702,28518,676,208,367,1251,29769
26-07-2015,4,7906,11682,4858,3772,28218,680,225,362,1267,29485
26-07-2015,5,7830,11618,4950,3775,28174,696,235,349,1280,29454
26-07-2015,6,8151,12771,5130,3891,29942,677,265,317,1259,31201
26-07-2015,7,8386,13892,5370,4029,31678,722,347,338,1407,33085
26-07-2015,8,8710,14762,5475,4219,33166,734,441,375,1550,34716
26-07-2015,9,8848,15380,5621,4352,34200,741,397,400,1538,35738
26-07-2015,10,9010,15694,5610,4561,34875,793,423,419,1635,36510
26-07-2015,11,9016,16038,5757,4720,35531,797,415,428,1640,37171
26-07-2015,12,8967,16320,5750,4805,35841,763,378,410,1551,37392
26-07-2015,13,8917,16244,5759,4718,35638,650,341,416,1407,37045
26-07-2015,14,8886,16470,5873,4534,35764,639,340,438,1417,37181
26-07-2015,15,9295,17321,5846,4181,36643,631,332,426,1389,38032
26-07-2015,16,9691,17625,5882,4049,37248,599,302,431,1332,38580
26-07-2015,17,10243,17888,5829,3653,37615,597,305,426,1328,38943
26-07-2015,18,10938,18079,5865,3223,38105,676,356,403,1435,39540
26-07-2015,19,11755,18196,5940,2628,38518,690,357,395,1442,39960
26-07-2015,20,11800,18253,5915,1973,37942,703,371,378,1452,39394
26-07-2015,21,12158,18171,6069,1577,37974,668,367,363,1398,39372
26-07-2015,22,12146,18351,5836,1295,37628,666,268,354,1288,38916
26-07-2015,23,11410,17619,5561,1139,35730,662,227,355,1244,36974
27-07-2015,0,10338,16698,5404,966,33408,581,214,357,1152,34560
27-07-2015,1,10051,16213,5247,904,32416,550,212,357,1119,33535
27-07-2015,2,9957,15695,5304,884,31840,558,208,356,1122,32962
27-07-2015,3,9846,15561,5302,877,31584,563,240,346,1149,32733
27-07-2015,4,9817,15305,5355,846,31321,578,293,331,1202,32523
27-07-2015,5,10232,15668,5710,989,32600,641,392,317,1350,33950
27-07-2015,6,11243,16694,6132,1175,35243,695,478,438,1611,36854
27-07-2015,7,13171,17505,6497,1404,38577,790,655,480,1925,40502
27-07-2015,8,14581,17916,6691,1761,40950,805,645,652,2102,43052
27-07-2015,9,15189,17974,6754,1793,41710,797,769,655,2221,43931
27-07-2015,10,15516,18090,6798,1870,42274,791,778,666,2235,44509
27-07-2015,11,15335,18109,6801,2026,42271,797,748,657,2202,44473
27-07-2015,12,15123,17961,6768,2065,41918,790,773,658,2221,44139
27-07-2015,13,15256,17634,6694,2074,41656,802,781,638,2221,43877
27-07-2015,14,14788,18009,6624,2096,41519,819,735,642,2196,43715
27-07-2015,15,14592,17891,6556,1939,40980,748,761,541,2050,43030
27-07-2015,16,14418,17862,6522,1722,40526,698,440,520,1658,42184
27-07-2015,17,14931,17765,6458,1537,40691,666,547,420,1633,42324
27-07-2015,18,14922,17850,6476,1488,40736,646,636,419,1701,42437
27-07-2015,19,14504,17712,6381,1404,40003,654,776,383,1813,41816
27-07-2015,20,14005,17535,6240,1360,39140,634,644,383,1661,40801
27-07-2015,21,13781,17218,6386,1431,38816,572,427,386,1385,40201
27-07-2015,22,13075,17067,6315,1313,37771,569,429,396,1394,39165
27-07-2015,23,12054,16333,5934,1376,35698,553,327,327,1207,36905
28-07-2015,0,11190,15587,5683,1285,33745,536,196,325,1057,34802
28-07-2015,1,10926,15193,5421,1278,32818,577,194,323,1094,33912
28-07-2015,2,10713,15130,5337,1218,32397,583,193,324,1100,33497
28-07-2015,3,10684,15068,5229,1068,32049,608,221,314,1143,33192
28-07-2015,4,10563,14945,5312,1101,31921,646,330,302,1278,33199
28-07-2015,5,10565,15180,5879,1140,32764,650,399,304,1353,34117
28-07-2015,6,11490,16011,6359,1210,35069,668,518,466,1652,36721
28-07-2015,7,13268,17064,6569,1325,38227,787,690,485,1962,40189
28-07-2015,8,14829,17571,6757,1469,40627,793,674,629,2096,42723
28-07-2015,9,15535,17669,6822,1559,41585,819,802,640,2261,43846
28-07-2015,10,16039,17761,6854,1683,42338,830,795,650,2275,44613
28-07-2015,11,15988,17868,6839,1734,42429,813,788,653,2254,44683
28-07-2015,12,15525,18123,6822,1724,42195,815,798,659,2272,44467
28-07-2015,13,14604,18093,6717,1905,41320,849,852,602,2303,43623
28-07-2015,14,14199,17885,6696,2013,40793,844,912,478,2234,43027
28-07-2015,15,13789,17915,6586,2133,40422,823,907,422,2152,42574
28-07-2015,16,13447,17939,6516,2045,39947,798,669,414,1881,41828
28-07-2015,17,13578,17881,6412,1977,39848,790,614,394,1798,41646
28-07-2015,18,13627,17400,6409,1823,39259,807,464,387,1658,40917
28-07-2015,19,13416,17522,6364,1651,38955,789,643,405,1837,40792
28-07-2015,20,12881,17540,6256,1687,38365,725,660,221,1606,39971
28-07-2015,21,12598,17378,6359,1896,38231,661,586,228,1475,39706
28-07-2015,22,12286,17396,6297,1824,37803,643,368,239,1250,39053
28-07-2015,23,11414,16699,5907,1779,35798,552,197,247,996,36794
29-07-2015,0,10042,15877,5591,1794,33302,707,188,313,1208,34510
29-07-2015,1,9553,15521,5330,1825,32229,712,184,313,1209,33438
29-07-2015,2,9354,15367,5135,1878,31733,711,183,326,1220,32953
29-07-2015,3,9264,15231,5107,1948,31550,705,228,335,1268,32818
29-07-2015,4,9154,15216,5111,1981,31461,703,351,338,1392,32853
29-07-2015,5,9260,15663,5621,2090,32634,704,392,343,1439,34073
29-07-2015,6,10043,16380,6095,2289,34807,755,477,501,1733,36540
29-07-2015,7,11124,17982,6476,2467,38050,829,636,523,1988,40038
29-07-2015,8,12457,18274,6616,2720,40066,830,610,695,2135,42201
29-07-2015,9,13244,18302,6681,2904,41131,828,693,720,2241,43372
29-07-2015,10,13748,18450,6741,3123,42062,829,705,745,2279,44341
29-07-2015,11,13555,18559,6539,3197,41850,817,762,742,2321,44171
29-07-2015,12,13074,18620,6531,3404,41629,837,780,737,2354,43983
29-07-2015,13,12999,18532,6591,3323,41446,834,770,701,2305,43751
29-07-2015,14,12359,18763,6556,3184,40861,838,796,559,2193,43054
29-07-2015,15,12130,18760,6548,3196,40633,767,836,466,2069,42702
29-07-2015,16,12268,18971,6490,2730,40459,766,494,428,1688,42147
29-07-2015,17,12501,19325,6407,2429,40661,740,474,402,1616,42277
29-07-2015,18,12747,19076,6423,2026,40272,814,382,389,1585,41857
29-07-2015,19,13020,18642,6348,1772,39781,835,625,386,1846,41627
29-07-2015,20,12623,18612,6232,1748,39216,795,499,213,1507,40723
29-07-2015,21,12392,18323,6215,1751,38681,781,527,228,1536,40217
29-07-2015,22,12036,18055,6198,1607,37896,761,279,208,1248,39144
29-07-2015,23,11187,17107,5991,1439,35723,748,203,70,1021,36744
30-07-2015,0,10113,16382,5828,1362,33685,671,196,129,996,34681
30-07-2015,1,9465,16003,5592,1326,32386,623,190,78,891,33277
30-07-2015,2,9138,15649,5436,1291,31514,609,193,49,851,32365
30-07-2015,3,9099,15470,5400,1050,31018,616,219,146,981,31999
30-07-2015,4,9070,15373,5407,1281,31133,631,347,282,1260,32393
30-07-2015,5,9110,15996,5727,1346,32179,624,393,344,1361,33540
30-07-2015,6,10054,16931,6162,1359,34506,643,429,467,1539,36045
30-07-2015,7,11659,18099,6477,1466,37701,794,579,504,1877,39578
30-07-2015,8,12397,18874,6642,1585,39498,900,694,527,2121,41619
30-07-2015,9,13031,18759,6726,1774,40290,904,736,568,2208,42498
30-07-2015,10,13642,18676,6735,1876,40928,884,732,584,2200,43128
30-07-2015,11,13631,18726,6640,2014,41011,909,696,592,2197,43208
30-07-2015,12,13155,18897,6600,2035,40687,907,702,585,2194,42881
30-07-2015,13,12733,18857,6573,2001,40164,912,683,573,2168,42332
30-07-2015,14,12460,18742,6498,2124,39824,872,647,583,2102,41926
30-07-2015,15,11999,18585,6581,2210,39375,879,549,632,2060,41435
30-07-2015,16,11512,18526,6495,2407,38941,853,272,518,1643,40584
30-07-2015,17,11444,18669,6471,2543,39127,802,292,521,1615,40742
30-07-2015,18,11227,18241,6434,2705,38607,807,324,481,1612,40219
30-07-2015,19,11056,18080,6449,2931,38516,696,458,607,1761,40277
30-07-2015,20,10858,17792,6350,3101,38102,704,338,420,1462,39564
30-07-2015,21,10808,17290,6371,3330,37799,823,339,353,1515,39314
30-07-2015,22,10280,17252,6249,3433,37214,802,246,355,1403,38617
30-07-2015,23,9384,17050,5838,3508,35781,765,210,350,1325,37106
31-07-2015,0,8506,15345,5768,3527,33147,599,194,345,1138,34285
31-07-2015,1,7930,15188,5558,3593,32269,573,194,350,1117,33386
31-07-2015,2,7681,14991,5476,3561,31707,589,193,371,1153,32860
31-07-2015,3,7568,14930,5473,3506,31477,565,220,385,1170,32647
31-07-2015,4,7574,14913,5494,3470,31452,560,322,389,1271,32723
31-07-2015,5,7999,15212,5817,3439,32468,605,403,393,1401,33869
31-07-2015,6,9084,16250,6344,3409,35088,635,436,568,1639,36727
31-07-2015,7,10507,17814,6422,3507,38251,845,496,710,2051,40302
31-07-2015,8,11168,19094,6523,3784,40571,889,621,698,2208,42779
31-07-2015,9,11484,19143,6564,4006,41198,914,687,712,2313,43511
31-07-2015,10,11704,19057,6542,4086,41390,925,762,710,2397,43787
31-07-2015,11,11740,18932,6544,4021,41237,953,712,688,2353,43590
31-07-2015,12,11681,18305,6523,4084,40593,965,744,716,2425,43018
31-07-2015,13,11493,18218,6479,3986,40177,884,729,712,2325,42502
31-07-2015,14,11283,18137,6558,3912,39892,724,682,689,2095,41987
31-07-2015,15,11131,18217,6512,3644,39505,665,613,657,1935,41440
31-07-2015,16,10985,18363,6434,3535,39316,668,459,667,1794,41110
31-07-2015,17,11295,18312,6432,3399,39439,596,364,661,1621,41060
31-07-2015,18,11700,18761,6462,3081,40005,585,242,540,1367,41372
31-07-2015,19,11618,18968,6493,2664,39742,573,366,714,1653,41395
31-07-2015,20,11370,18805,6359,2157,38692,563,236,607,1406,40098
31-07-2015,21,11932,18872,6430,1827,39062,593,237,500,1330,40392
31-07-2015,22,11742,19018,6404,1638,38802,556,238,428,1222,40024
31-07-2015,23,11006,18294,6198,1488,36985,526,225,347,1098,38083
01-08-2015,0,9735,17204,6135,1341,34417,509,202,346,1057,35474
01-08-2015,1,9352,16855,6028,1234,33469,459,199,337,995,34464
01-08-2015,2,9209,16646,6017,1048,32920,447,198,342,987,33907
01-08-2015,3,9148,16577,5885,922,32531,450,199,344,993,33524
01-08-2015,4,9061,16463,5944,882,32349,449,225,343,1017,33366
01-08-2015,5,9068,16388,6032,822,32311,452,240,336,1028,33339
01-08-2015,6,9203,16863,6155,892,33113,447,251,332,1030,34143
01-08-2015,7,10126,17307,6238,953,34625,440,269,341,1050,35675
01-08-2015,8,11234,17907,6278,1085,36504,487,278,352,1117,37621
01-08-2015,9,12208,18691,6314,1254,38465,539,270,371,1180,39645
01-08-2015,10,12674,19054,6317,1423,39469,544,249,378,1171,40640
01-08-2015,11,12658,18861,6338,1383,39238,537,243,378,1158,40396
01-08-2015,12,12570,18660,6391,1379,38997,523,262,374,1159,40156
01-08-2015,13,12225,18453,6407,1388,38472,466,346,361,1173,39645
01-08-2015,14,11887,18416,6397,1386,38085,461,342,356,1159,39244
01-08-2015,15,12006,18187,6394,1351,37937,467,324,338,1129,39066
01-08-2015,16,12215,18201,6408,1245,38070,474,315,342,1131,39201
01-08-2015,17,12301,18227,6368,1154,38050,507,336,322,1165,39215
01-08-2015,18,12530,18057,6420,1142,38149,552,408,313,1273,39422
01-08-2015,19,12605,18159,6431,1071,38266,545,317,289,1151,39417
01-08-2015,20,12593,18179,6471,986,38230,544,339,280,1163,39393
01-08-2015,21,12668,18177,6422,896,38163,544,382,277,1203,39366
01-08-2015,22,12164,18241,6394,905,37705,556,239,276,1071,38776
01-08-2015,23,11265,17779,6352,931,36328,557,207,275,1039,37367
02-08-2015,0,10520,16702,6319,963,34503,478,198,282,958,35461
02-08-2015,1,9728,16582,6256,1001,33568,459,196,288,943,34511
02-08-2015,2,9265,16732,6249,961,33209,454,196,299,949,34158
02-08-2015,3,9136,16747,6210,965,33060,458,198,307,963,34023
02-08-2015,4,9014,16729,6196,919,32858,454,223,319,996,33854
02-08-2015,5,8946,16312,6194,921,32373,454,233,337,1024,33397
02-08-2015,6,9129,16323,6255,903,32610,450,242,330,1022,33632
02-08-2015,7,9720,16597,6253,938,33508,468,250,293,1011,34519
02-08-2015,8,11041,17265,6266,989,35562,447,263,293,1003,36565
02-08-2015,9,11801,18207,6278,1085,37372,457,297,297,1051,38423
02-08-2015,10,12229,18302,6325,1206,38062,476,385,308,1169,39231
02-08-2015,11,12336,18526,6337,1351,38548,479,376,311,1166,39714
02-08-2015,12,12120,18390,6347,1429,38285,501,364,307,1172,39457
02-08-2015,13,11840,18555,6341,1388,38125,506,365,309,1180,39305
02-08-2015,14,11132,18344,6333,1305,37113,516,352,311,1179,38292
02-08-2015,15,11220,17985,6340,1221,36767,497,347,299,1143,37910
02-08-2015,16,11476,17988,6374,1182,37021,503,384,296,1183,38204
02-08-2015,17,11739,18499,6375,1090,37702,522,393,292,1207,38909
02-08-2015,18,12054,18785,6361,973,38173,509,397,289,1195,39368
02-08-2015,19,12524,18883,6343,956,38705,490,359,295,1144,39849
02-08-2015,20,12613,18941,6333,1000,38887,473,358,315,1146,40033
02-08-2015,21,12838,18700,6344,985,38867,476,370,335,1181,40048
02-08-2015,22,12605,18752,6350,737,38444,482,235,341,1058,39502
02-08-2015,23,11746,17951,6307,602,36604,507,198,348,1053,37657
03-08-2015,0,10586,16541,6290,426,33844,477,190,352,1019,34863
03-08-2015,1,9955,16136,6257,410,32758,462,189,373,1024,33782
03-08-2015,2,9550,15943,6271,394,32158,465,189,372,1026,33184
03-08-2015,3,9438,15926,6285,473,32122,464,190,361,1015,33137
03-08-2015,4,9342,15866,6328,578,32114,489,219,342,1050,33164
03-08-2015,5,10292,16480,6294,670,33736,502,240,311,1053,34789
03-08-2015,6,12172,17371,6577,899,37019,561,418,302,1281,38300
03-08-2015,7,15178,17670,6749,1114,40712,671,532,500,1703,42415
03-08-2015,8,17074,17549,6855,1407,42885,716,672,516,1904,44789
03-08-2015,9,17488,17650,6917,1825,43880,720,781,627,2128,46008
03-08-2015,10,17519,17561,6946,2131,44157,737,812,636,2185,46342
03-08-2015,11,17367,17486,6910,2336,44099,743,805,601,2149,46248
03-08-2015,12,17182,17310,6930,2192,43616,743,740,687,2170,45786
03-08-2015,13,17009,17134,6932,2112,43186,748,720,522,1990,45176
03-08-2015,14,16648,17102,6820,2248,42817,738,710,506,1954,44771
03-08-2015,15,15912,17135,6829,2343,42220,725,705,490,1920,44140
03-08-2015,16,15071,17345,6752,2559,41728,617,705,491,1813,43541
03-08-2015,17,14857,17463,6654,2832,41807,523,679,486,1688,43495
03-08-2015,18,14633,17578,6646,2730,41586,500,633,487,1620,43206
03-08-2015,19,14381,17302,6729,2438,40852,528,481,486,1495,42347
03-08-2015,20,13595,17435,6630,2308,39968,471,462,493,1426,41394
03-08-2015,21,13137,17257,6606,2350,39351,499,433,510,1442,40793
03-08-2015,22,12440,17203,6597,2487,38727,534,243,423,1200,39927
03-08-2015,23,11268,16226,6510,2387,36390,492,196,304,992,37382
04-08-2015,0,9747,15658,6384,2318,34107,455,189,330,974,35081
04-08-2015,1,9255,15564,6301,2168,33288,449,188,347,984,34272
04-08-2015,2,9082,15497,6238,1858,32674,448,187,346,981,33655
04-08-2015,3,9070,15634,6237,1793,32734,448,190,342,980,33714
04-08-2015,4,9263,15791,6275,1755,33084,458,237,339,1034,34118
04-08-2015,5,9869,16268,6311,1806,34255,484,328,332,1144,35399
04-08-2015,6,11538,17125,6578,1854,37095,603,392,454,1449,38544
04-08-2015,7,13987,18203,6748,1918,40857,746,662,468,1876,42733
04-08-2015,8,15471,18264,6773,2150,42659,840,864,475,2179,44838
04-08-2015,9,15783,18124,6821,2403,43130,760,1079,474,2313,45443
04-08-2015,10,16117,18062,6826,2382,43386,759,1013,474,2246,45632
04-08-2015,11,16317,18275,6818,2345,43754,757,971,476,2204,45958
04-08-2015,12,16210,18331,6851,2007,43400,752,979,475,2206,45606
04-08-2015,13,16255,18414,6822,1966,43457,752,804,473,2029,45486
04-08-2015,14,16113,18558,6772,1874,43316,760,713,472,1945,45261
04-08-2015,15,15811,18768,6642,1759,42980,742,665,471,1878,44858
04-08-2015,16,15641,18709,6565,1723,42637,618,664,470,1752,44389
04-08-2015,17,15663,19063,6503,1523,42753,570,649,471,1690,44443
04-08-2015,18,15156,19459,6470,1539,42624,589,606,475,1670,44294
04-08-2015,19,14746,18895,6551,1638,41829,619,529,483,1631,43460
04-08-2015,20,14273,18619,6459,1486,40838,625,507,500,1632,42470
04-08-2015,21,14153,18211,6508,1315,40187,654,410,513,1577,41764
04-08-2015,22,13488,18303,6484,1228,39503,683,220,462,1365,40868
04-08-2015,23,12096,17555,6387,1186,37225,666,190,389,1245,38470
05-08-2015,0,10572,16759,6241,953,34525,687,210,381,1278,35803
05-08-2015,1,9817,16640,6083,1060,33601,665,207,367,1239,34840
05-08-2015,2,9611,16468,6062,1052,33192,648,203,361,1212,34404
05-08-2015,3,9585,16033,6042,1255,32915,645,205,362,1212,34127
05-08-2015,4,9826,15878,6120,1221,33046,656,218,357,1231,34277
05-08-2015,5,10438,16475,6316,1164,34393,652,264,351,1267,35660
05-08-2015,6,12622,17295,6602,1247,37765,663,568,325,1556,39321
05-08-2015,7,15099,18217,6853,1463,41632,725,771,300,1796,43428
05-08-2015,8,15967,18915,6873,1819,43575,756,845,454,2055,45630
05-08-2015,9,16185,18905,6916,2245,44252,827,781,452,2060,46312
05-08-2015,10,16399,18819,6999,2258,44476,775,724,470,1969,46445
05-08-2015,11,16469,18647,6967,2276,44360,771,912,459,2142,46502
05-08-2015,12,16505,18587,6896,2132,44120,763,1017,464,2244,46364
05-08-2015,13,16427,18736,6901,2174,44239,752,884,467,2103,46342
05-08-2015,14,16199,18838,6823,2153,44013,731,842,471,2044,46057
05-08-2015,15,16252,18780,6771,1983,43787,620,748,476,1844,45631
05-08-2015,16,16074,18623,6717,1858,43272,720,743,455,1918,45190
05-08-2015,17,15703,18901,6730,2106,43441,660,737,452,1849,45290
05-08-2015,18,15781,18554,6550,1931,42816,733,685,446,1864,44680
05-08-2015,19,15697,18317,6542,1743,42299,790,701,391,1882,44181
05-08-2015,20,15453,18113,6458,1524,41546,714,682,276,1672,43218
05-08-2015,21,15334,18026,6454,1138,40952,698,665,286,1649,42601
05-08-2015,22,14716,17865,6393,960,39935,747,445,288,1480,41415
05-08-2015,23,12869,17256,6437,778,37340,661,215,286,1162,38502
06-08-2015,0,11525,15894,6380,677,34475,617,242,284,1143,35618
06-08-2015,1,10812,15629,6323,661,33424,618,173,285,1076,34500
06-08-2015,2,10497,15355,6299,545,32696,597,181,290,1068,33764
06-08-2015,3,10408,15081,6261,546,32295,579,271,291,1141,33436
06-08-2015,4,10505,14981,6209,613,32310,553,379,286,1218,33528
06-08-2015,5,11114,15713,6277,745,33850,564,402,279,1245,35095
06-08-2015,6,13130,17026,6481,837,37474,609,723,275,1607,39081
06-08-2015,7,15548,18156,6641,1016,41362,795,708,402,1905,43267
06-08-2015,8,16260,18922,6788,1410,43382,878,883,399,2160,45542
06-08-2015,9,16267,18950,6938,1641,43798,774,990,393,2157,45955
06-08-2015,10,16398,19127,6941,1848,44315,771,954,471,2196,46511
06-08-2015,11,16453,18871,6994,2025,44343,776,917,471,2164,46507
06-08-2015,12,16360,18688,6938,2134,44120,781,1045,403,2229,46349
06-08-2015,13,16547,18569,6887,1999,44003,779,1030,409,2218,46221
06-08-2015,14,16523,18660,6707,1914,43806,774,933,482,2189,45995
06-08-2015,15,16283,18720,6601,1868,43471,777,908,424,2109,45580
06-08-2015,16,16103,18400,6633,1675,42811,774,790,475,2039,44850
06-08-2015,17,16134,18054,6551,1662,42400,768,742,473,1983,44383
06-08-2015,18,16216,18073,6521,1552,42362,739,719,443,1901,44263
06-08-2015,19,15795,18011,6566,1156,41527,722,648,416,1786,43313
06-08-2015,20,14973,17890,6616,1129,40609,695,650,339,1684,42293
06-08-2015,21,14543,17811,6485,1302,40139,682,684,284,1650,41789
06-08-2015,22,14048,17620,6355,1400,39424,618,383,281,1282,40706
06-08-2015,23,12397,16935,6223,1381,36936,536,238,278,1052,37988
07-08-2015,0,10987,16032,6128,1321,34468,553,248,275,1076,35544
07-08-2015,1,10538,15794,6084,1199,33615,562,193,274,1029,34644
07-08-2015,2,10306,15645,6078,1077,33105,546,191,273,1010,34115
07-08-2015,3,10228,15645,6028,1003,32903,579,214,272,1065,33968
07-08-2015,4,10321,15614,6155,826,32917,580,280,273,1133,34050
07-08-2015,5,11170,16321,6177,848,34515,578,424,273,1275,35790
07-08-2015,6,12961,17408,6541,1117,38027,639,635,273,1547,39574
07-08-2015,7,14443,18035,6789,1438,40705,703,949,278,1930,42635
07-08-2015,8,15115,18640,7044,1708,42507,693,1068,278,2039,44546
07-08-2015,9,15669,18600,7110,1643,43021,664,1205,305,2174,45195
07-08-2015,10,15834,19142,7023,1799,43799,678,1235,277,2190,45989
07-08-2015,11,15576,18952,7039,1871,43438,681,1176,276,2133,45571
07-08-2015,12,15432,18708,6974,1733,42846,685,1211,285,2181,45027
07-08-2015,13,14996,18615,6948,1782,42340,684,1203,278,2165,44505
07-08-2015,14,14639,18560,6870,1501,41571,683,1163,278,2124,43695
07-08-2015,15,14383,18572,6710,1468,41133,627,1061,298,1986,43119
07-08-2015,16,14762,18515,6645,1459,41381,555,1053,280,1888,43269
07-08-2015,17,15045,18729,6610,1476,41860,537,994,275,1806,43666
07-08-2015,18,14778,18754,6490,1406,41428,635,928,276,1839,43267
07-08-2015,19,14602,18460,6391,1194,40646,661,772,279,1712,42358
07-08-2015,20,14045,18330,6419,912,39707,601,683,290,1574,41281
07-08-2015,21,14098,17882,6384,943,39307,684,626,305,1615,40922
07-08-2015,22,13984,17774,6232,863,38853,557,398,319,1274,40127
07-08-2015,23,12782,17284,6076,598,36741,540,221,338,1099,37840
08-08-2015,0,11474,15937,6032,500,33942,513,208,351,1072,35014
08-08-2015,1,10814,15299,6026,411,32550,462,207,369,1038,33588
08-08-2015,2,10511,15172,6035,449,32168,416,205,370,991,33159
08-08-2015,3,10334,15094,5977,539,31943,413,220,368,1001,32944
08-08-2015,4,10017,14948,5914,623,31501,453,250,361,1064,32565
08-08-2015,5,10099,14695,5711,669,31174,476,390,356,1222,32396
08-08-2015,6,10640,14692,5773,794,31899,449,387,366,1202,33101
08-08-2015,7,11207,15329,5924,851,33312,465,381,344,1190,34502
08-08-2015,8,12394,15853,6026,934,35207,492,508,306,1306,36513
08-08-2015,9,13529,16249,6054,1027,36860,485,652,298,1435,38295
08-08-2015,10,13939,16433,6087,1185,37645,486,713,295,1494,39139
08-08-2015,11,13892,16456,6085,1397,37829,502,708,304,1514,39343
08-08-2015,12,13433,16372,6061,1463,37331,499,734,283,1516,38847
08-08-2015,13,12931,16298,6059,1423,36710,465,690,283,1438,38148
08-08-2015,14,12542,16338,5986,1516,36382,449,772,288,1509,37891
08-08-2015,15,12094,16415,5944,1486,35939,478,788,301,1567,37506
08-08-2015,16,12027,16245,6000,1552,35824,567,789,304,1660,37484
08-08-2015,17,12210,16068,5981,1583,35842,489,752,300,1541,37383
08-08-2015,18,12388,16433,6007,1560,36388,448,718,302,1468,37856
08-08-2015,19,12330,16539,6072,1303,36244,420,706,309,1435,37679
08-08-2015,20,12427,16520,6136,1181,36264,423,706,299,1428,37692
08-08-2015,21,12666,16570,6180,1119,36535,462,724,308,1494,38029
08-08-2015,22,12319,16605,6091,1097,36112,434,327,329,1090,37202
08-08-2015,23,11416,16172,6066,1092,34745,407,207,353,967,35712
09-08-2015,0,10359,15121,5926,1197,32604,401,188,351,940,33544
09-08-2015,1,10142,14420,5935,1056,31554,394,188,341,923,32477
09-08-2015,2,10100,14122,5832,877,30930,385,187,329,901,31831
09-08-2015,3,10407,14051,5761,825,31045,385,188,299,872,31917
09-08-2015,4,10386,13992,5642,822,30843,399,205,302,906,31749
09-08-2015,5,10614,13940,5632,682,30870,395,283,294,972,31842
09-08-2015,6,10831,13951,5569,663,31015,401,390,299,1090,32105
09-08-2015,7,11107,14847,5712,719,32385,390,386,303,1079,33464
09-08-2015,8,12324,15408,5750,697,34179,388,440,285,1113,35292
09-08-2015,9,13010,15644,5802,827,35283,395,593,285,1273,36556
09-08-2015,10,13559,15919,5718,1069,36263,471,727,277,1475,37738
09-08-2015,11,13698,16019,5616,1158,36491,502,752,275,1529,38020
09-08-2015,12,13432,16124,5613,1090,36259,478,707,289,1474,37733
09-08-2015,13,13158,16056,5654,1063,35932,465,663,294,1422,37354
09-08-2015,14,13049,15981,5689,1016,35734,465,634,294,1393,37127
09-08-2015,15,13334,16015,5761,988,36098,505,578,287,1370,37468
09-08-2015,16,13642,16320,5806,965,36734,490,578,291,1359,38093
09-08-2015,17,14415,16726,5854,923,37918,486,577,291,1354,39272
09-08-2015,18,14754,17209,5836,824,38623,530,595,289,1414,40037
09-08-2015,19,14885,17501,5857,718,38961,536,581,291,1408,40369
09-08-2015,20,14927,17326,5869,704,38827,541,579,294,1414,40241
09-08-2015,21,15041,17135,5831,574,38582,548,841,297,1686,40268
09-08-2015,22,14658,17366,5745,540,38308,545,567,295,1407,39715
09-08-2015,23,13643,16619,5620,534,36417,512,213,292,1017,37434
10-08-2015,0,12446,15662,5348,534,33992,508,189,292,989,34981
10-08-2015,1,11996,15265,5172,651,33083,535,186,283,1004,34087
10-08-2015,2,11804,15135,5114,694,32746,552,186,280,1018,33764
10-08-2015,3,11790,15065,5173,755,32783,581,186,268,1035,33818
10-08-2015,4,11774,15020,5246,720,32761,657,320,270,1247,34008
10-08-2015,5,12113,15592,5576,795,34076,808,398,267,1473,35549
10-08-2015,6,13438,16699,5839,1152,37130,1040,672,444,2156,39286
10-08-2015,7,14234,18082,6132,1739,40186,1085,1062,454,2601,42787
10-08-2015,8,15108,18203,6326,1959,41597,1092,1090,465,2647,44244
10-08-2015,9,15444,18318,6430,2064,42256,1092,967,564,2623,44879
10-08-2015,10,15729,18606,6483,2222,43041,1103,950,548,2601,45642
10-08-2015,11,15655,18772,6515,2245,43188,1101,960,460,2521,45709
10-08-2015,12,15434,18689,6471,2201,42796,1105,974,574,2653,45449
10-08-2015,13,15615,18474,6486,2201,42776,1105,976,485,2566,45342
10-08-2015,14,15457,18480,6416,2209,42563,1104,991,453,2548,45111
10-08-2015,15,15312,18381,6326,2089,42109,1105,940,456,2501,44610
10-08-2015,16,15042,18359,6111,1974,41486,1100,870,461,2431,43917
10-08-2015,17,15319,18447,6035,2190,41989,1102,830,463,2395,44384
10-08-2015,18,15215,18298,6264,2165,41942,1094,777,467,2338,44280
10-08-2015,19,15064,18255,6221,2116,41657,1094,660,467,2221,43878
10-08-2015,20,14775,18231,6191,1779,40978,879,596,475,1950,42928
10-08-2015,21,14891,18130,6004,1632,40656,903,466,470,1839,42495
10-08-2015,22,14266,18017,5728,1521,39534,814,271,477,1562,41096
10-08-2015,23,13207,17341,5569,1225,37343,595,227,341,1163,38506
11-08-2015,0,12359,15966,5345,1105,34777,535,227,353,1115,35892
11-08-2015,1,11654,15665,5264,1249,33834,533,208,358,1099,34933
11-08-2015,2,11484,15481,5319,1213,33497,514,206,355,1075,34572
11-08-2015,3,11395,15402,5335,1190,33322,515,194,356,1065,34387
11-08-2015,4,11426,15415,5383,1114,33339,536,313,347,1196,34535
11-08-2015,5,11481,15774,5731,1262,34248,695,420,339,1454,35702
11-08-2015,6,12723,16414,6120,1815,37072,1010,654,325,1989,39061
11-08-2015,7,14429,17896,6315,1891,40530,1086,928,296,2310,42840
11-08-2015,8,15162,18122,6485,2059,41830,1091,937,442,2470,44300
11-08-2015,9,15741,18038,6583,2134,42495,1093,973,473,2539,45034
11-08-2015,10,15883,18376,6557,2482,43297,1093,983,523,2599,45896
11-08-2015,11,15715,18330,6538,2487,43071,1094,990,485,2569,45640
11-08-2015,12,15475,18414,6495,2562,42946,1090,1030,557,2677,45623
11-08-2015,13,15359,18536,6480,2380,42755,1091,944,510,2545,45300
11-08-2015,14,15139,18564,6401,2233,42338,1096,939,480,2515,44853
11-08-2015,15,15322,18176,6231,2199,41929,1099,940,439,2478,44407
11-08-2015,16,14635,18352,6204,2095,41286,1092,939,402,2433,43719
11-08-2015,17,14012,18885,6143,2003,41043,1083,942,364,2389,43432
11-08-2015,18,13854,18484,6123,1887,40347,1079,942,312,2333,42680
11-08-2015,19,14040,18109,6144,1762,40055,1074,862,281,2217,42272
11-08-2015,20,13993,17905,6188,1725,39811,743,821,293,1857,41668
11-08-2015,21,13840,17779,6088,1854,39562,803,743,305,1851,41413
11-08-2015,22,13167,17534,5909,1763,38372,650,419,323,1392,39764
11-08-2015,23,12129,16625,5634,1417,35804,569,297,318,1184,36988
12-08-2015,0,11339,15807,5490,1461,34096,564,338,312,1214,35310
12-08-2015,1,11033,15297,5455,1256,33042,531,269,304,1104,34146
12-08-2015,2,11208,14872,5416,1244,32740,527,237,295,1059,33799
12-08-2015,3,11141,14588,5515,1281,32525,520,248,289,1057,33582
12-08-2015,4,11205,14530,5664,1134,32534,503,364,285,1152,33686
12-08-2015,5,11601,15135,5934,1442,34113,679,482,279,1440,35553
12-08-2015,6,13029,16253,6296,1786,37365,989,772,277,2038,39403
12-08-2015,7,14871,17793,6527,2129,41321,1108,977,275,2360,43681
12-08-2015,8,15732,18306,6741,2171,42950,1131,985,471,2587,45537
12-08-2015,9,15814,18078,6751,2215,42858,1191,973,563,2727,45585
12-08-2015,10,15654,18198,6746,2342,42941,1191,947,598,2736,45677
12-08-2015,11,15737,18266,6695,2481,43179,1194,959,597,2750,45929
12-08-2015,12,15578,18217,6640,2492,42926,1192,1052,597,2841,45767
12-08-2015,13,15494,18263,6607,2549,42913,1191,1072,594,2857,45770
12-08-2015,14,15424,18026,6537,2546,42534,1197,1094,508,2799,45333
12-08-2015,15,15595,18024,6372,2515,42506,1177,1000,439,2616,45122
12-08-2015,16,15383,17751,6272,2188,41594,1188,949,355,2492,44086
12-08-2015,17,15407,18208,6201,2042,41860,1176,948,303,2427,44287
12-08-2015,18,15444,18547,6225,2046,42263,1214,948,310,2472,44735
12-08-2015,19,15535,18579,6200,2064,42380,1062,945,304,2311,44691
12-08-2015,20,15442,18427,6142,1818,41827,701,811,304,1816,43643
12-08-2015,21,15259,18343,6053,1625,41281,661,742,297,1700,42981
12-08-2015,22,14766,17837,5837,1410,39849,638,433,303,1374,41223
12-08-2015,23,13162,17032,5737,1236,37166,613,255,299,1167,38333
13-08-2015,0,11710,16401,5596,1194,34901,634,315,301,1250,36151
13-08-2015,1,11241,15972,5481,1157,33850,647,299,301,1247,35097
13-08-2015,2,11255,15809,5466,1127,33658,634,281,295,1210,34868
13-08-2015,3,11289,15590,5576,1053,33507,643,280,296,1219,34726
13-08-2015,4,11394,15639,5742,947,33722,624,374,294,1292,35014
13-08-2015,5,12043,15994,6167,1023,35227,726,486,295,1507,36734
13-08-2015,6,13462,16622,6233,1562,37879,1126,687,295,2108,39987
13-08-2015,7,14818,17076,6662,1987,40544,1251,963,285,2499,43043
13-08-2015,8,15215,17081,6880,2249,41425,1280,969,444,2693,44118
13-08-2015,9,15209,16838,7104,2251,41402,1286,1023,448,2757,44159
13-08-2015,10,15581,16686,6928,2286,41482,1290,1043,525,2858,44340
13-08-2015,11,15720,16629,6899,2319,41567,1301,1032,523,2856,44423
13-08-2015,12,15559,16649,6933,2342,41482,1308,1036,457,2801,44283
13-08-2015,13,15451,16762,6910,2327,41450,1294,990,446,2730,44180
13-08-2015,14,15144,16700,6884,2381,41110,1286,957,441,2684,43794
13-08-2015,15,15184,16150,6765,2228,40327,1325,951,297,2573,42900
13-08-2015,16,15533,16371,6503,1748,40155,1259,948,293,2500,42655
13-08-2015,17,15652,16449,6346,1843,40291,1323,937,285,2545,42836
13-08-2015,18,15018,16933,6186,2032,40170,1303,891,294,2488,42658
13-08-2015,19,15040,16852,6020,1864,39775,1275,835,297,2407,42182
13-08-2015,20,14915,16829,5829,1767,39340,973,937,338,2248,41588
13-08-2015,21,15028,16753,5857,1578,39217,790,848,346,1984,41201
13-08-2015,22,13954,16627,5741,1925,38247,765,519,349,1633,39880
13-08-2015,23,12503,15740,5723,2226,36192,712,237,324,1273,37465
14-08-2015,0,11068,15053,5604,2181,33906,712,288,314,1314,35220
14-08-2015,1,10324,14662,5438,2262,32686,698,302,305,1305,33991
14-08-2015,2,10085,14770,5451,2191,32497,679,298,318,1295,33792
14-08-2015,3,10014,14776,5431,2440,32660,672,249,331,1252,33912
14-08-2015,4,10115,14842,5407,2556,32921,649,359,345,1353,34274
14-08-2015,5,10346,15548,5868,2708,34469,740,480,349,1569,36038
14-08-2015,6,11841,16486,6304,3009,37641,1132,677,324,2133,39774
14-08-2015,7,13888,17309,6609,3310,41116,1218,876,295,2389,43505
14-08-2015,8,14447,18032,6739,3621,42840,1245,1053,265,2563,45403
14-08-2015,9,14598,17768,6776,3796,42939,1277,1106,357,2740,45679
14-08-2015,10,14824,17738,6685,3901,43148,1324,1124,361,2809,45957
14-08-2015,11,14501,17726,6661,4019,42907,1283,1124,309,2716,45623
14-08-2015,12,14114,17747,6549,4237,42647,1290,1120,353,2763,45410
14-08-2015,13,13562,17238,6515,4338,41653,1261,1112,263,2636,44289
14-08-2015,14,13257,17016,6480,4345,41098,1262,1017,258,2537,43635
14-08-2015,15,12774,16967,6343,4248,40331,1225,995,257,2477,42808
14-08-2015,16,12646,16748,6161,4444,39999,1201,955,257,2413,42412
14-08-2015,17,12629,16771,6157,4195,39752,1173,906,283,2362,42114
14-08-2015,18,12533,17096,6087,3881,39597,1155,847,277,2279,41876
14-08-2015,19,12607,17165,6056,3318,39147,1110,810,266,2186,41333
14-08-2015,20,12315,17145,5919,2940,38320,728,844,291,1863,40183
14-08-2015,21,12354,17238,5914,2804,38310,660,764,336,1760,40070
14-08-2015,22,11656,17140,5778,2694,37266,643,440,362,1445,38711
14-08-2015,23,10728,16603,5725,2717,35774,630,217,358,1205,36979
15-08-2015,0,10401,15579,5669,2658,34307,610,284,355,1249,35556
15-08-2015,1,9980,15079,5587,2533,33179,607,283,343,1233,34412
15-08-2015,2,10087,14789,5454,2347,32677,597,279,331,1207,33884
15-08-2015,3,10075,14664,5445,2157,32340,590,281,342,1213,33553
15-08-2015,4,10074,14802,5526,1891,32293,586,290,346,1222,33515
15-08-2015,5,10249,15140,5551,1746,32686,589,299,343,1231,33917
15-08-2015,6,10482,14957,5566,1846,32853,577,339,310,1226,34079
15-08-2015,7,11573,15389,5685,1797,34442,572,337,287,1196,35638
15-08-2015,8,12747,16379,5808,1798,36732,608,485,288,1381,38113
15-08-2015,9,13332,17447,5824,1929,38532,695,577,286,1558,40090
15-08-2015,10,13595,17924,5860,1896,39274,689,578,292,1559,40833
15-08-2015,11,13575,17760,5863,2024,39221,684,549,276,1509,40730
15-08-2015,12,13400,17303,5878,1719,38298,677,539,292,1508,39806
15-08-2015,13,13330,17251,5866,1593,38041,671,498,288,1457,39498
15-08-2015,14,13206,17097,5856,1615,37776,674,497,285,1456,39232
15-08-2015,15,13028,17084,5886,1576,37573,655,478,288,1421,38994
15-08-2015,16,13015,17113,5916,1392,37435,687,479,290,1456,38891
15-08-2015,17,13065,17366,5932,1382,37746,695,459,288,1442,39188
15-08-2015,18,12806,17714,5942,1343,37806,689,437,287,1413,39219
15-08-2015,19,12696,17681,5900,1316,37592,657,432,310,1399,38991
15-08-2015,20,12593,17202,5909,1221,36926,658,449,337,1444,38370
15-08-2015,21,12652,16986,6077,1248,36962,721,431,370,1522,38484
15-08-2015,22,12263,16614,6006,1166,36048,722,241,375,1338,37386
15-08-2015,23,11613,15978,5689,1109,34389,672,183,371,1226,35615
16-08-2015,0,11152,14687,5623,914,32376,636,178,366,1180,33556
16-08-2015,1,10955,14189,5550,823,31517,626,179,356,1161,32678
16-08-2015,2,10891,13864,5538,858,31152,608,179,354,1141,32293
16-08-2015,3,10919,13631,5545,914,31010,607,178,367,1152,32162
16-08-2015,4,10913,13480,5531,862,30786,620,186,369,1175,31961
16-08-2015,5,10777,13438,5514,815,30545,626,243,380,1249,31794
16-08-2015,6,10886,13301,5510,855,30551,632,338,353,1323,31874
16-08-2015,7,11502,13487,5602,878,31469,646,338,303,1287,32756
16-08-2015,8,12581,14455,5570,1022,33629,656,390,296,1342,34971
16-08-2015,9,13214,15619,5572,1223,35627,655,483,303,1441,37068
16-08-2015,10,13699,16118,5651,1365,36832,678,524,322,1524,38356
16-08-2015,11,13744,16310,5618,1459,37132,696,503,339,1538,38670
16-08-2015,12,13528,16559,5590,1355,37034,706,482,334,1522,38556
16-08-2015,13,13347,16478,5612,1283,36719,713,472,322,1507,38226
16-08-2015,14,12974,16193,5613,1495,36275,725,527,319,1571,37846
16-08-2015,15,12766,16113,5593,1590,36061,702,480,320,1502,37563
16-08-2015,16,12887,16253,5643,1423,36206,703,452,320,1475,37681
16-08-2015,17,12933,16887,5596,1501,36916,738,455,327,1520,38436
16-08-2015,18,12983,16869,5642,1503,36998,704,457,329,1490,38488
16-08-2015,19,13716,17144,5661,1518,38039,683,475,346,1504,39543
16-08-2015,20,13625,17206,5651,1603,38087,671,516,370,1557,39644
16-08-2015,21,13568,17217,5855,1746,38387,687,447,361,1495,39882
16-08-2015,22,12891,16366,5742,1888,36888,680,192,357,1229,38117
16-08-2015,23,11781,15395,5596,2105,34876,634,184,387,1205,36081
17-08-2015,0,10567,14655,5335,2273,32830,645,183,385,1213,34043
17-08-2015,1,10141,14396,5234,2345,32117,643,183,383,1209,33326
17-08-2015,2,9991,14169,5244,2372,31776,673,187,392,1252,33028
17-08-2015,3,10042,14060,5321,2261,31683,690,194,381,1265,32948
17-08-2015,4,10129,14123,5399,2363,32014,752,241,377,1370,33384
17-08-2015,5,10668,14707,5839,2583,33798,947,377,369,1693,35491
17-08-2015,6,12490,16214,6184,2787,37676,1226,556,348,2130,39806
17-08-2015,7,14483,17946,6361,2894,41684,1286,1022,329,2637,44321
17-08-2015,8,16004,18314,6539,3067,43922,1303,1072,330,2705,46627
17-08-2015,9,15864,18563,6502,3312,44242,1317,1082,417,2816,47058
17-08-2015,10,15507,18426,6523,3336,43792,1354,1064,539,2957,46749
17-08-2015,11,15130,18636,6514,3615,43895,1337,1064,416,2817,46712
17-08-2015,12,14778,18446,6540,3851,43615,1364,1061,387,2812,46427
17-08-2015,13,14577,18224,6438,3916,43157,1374,997,355,2726,45883
17-08-2015,14,14312,18184,6460,3908,42866,1260,892,372,2524,45390
17-08-2015,15,13952,18140,6429,3822,42343,1136,883,390,2409,44752
17-08-2015,16,13717,17837,6424,3775,41753,1131,810,365,2306,44059
17-08-2015,17,13964,17857,6275,3606,41701,1129,830,372,2331,44032
17-08-2015,18,13803,17599,6212,3450,41064,1121,790,354,2265,43329
17-08-2015,19,13639,17550,6180,3262,40631,1122,830,341,2293,42924
17-08-2015,20,13430,17286,5912,3293,39922,946,724,341,2011,41933
17-08-2015,21,13570,16845,5776,3109,39298,997,574,352,1923,41221
17-08-2015,22,12813,16379,5543,3123,37858,857,315,356,1528,39386
17-08-2015,23,11412,15617,5591,3144,35765,786,205,353,1344,37109
18-08-2015,0,10816,13657,5359,3117,32949,801,199,352,1352,34301
18-08-2015,1,10529,13131,5224,3224,32109,886,198,355,1439,33548
18-08-2015,2,10283,12995,5201,3157,31637,798,194,370,1362,32999
18-08-2015,3,10427,12838,5241,3117,31624,783,194,374,1351,32975
18-08-2015,4,10635,12946,5271,3169,32021,788,316,380,1484,33505
18-08-2015,5,11040,13890,5663,3172,33765,867,478,388,1733,35498
18-08-2015,6,12736,15418,6355,3419,37928,1116,414,540,2070,39998
18-08-2015,7,15253,16502,6732,3579,42067,1122,619,498,2239,44306
18-08-2015,8,15638,16813,6768,3727,42947,1131,945,485,2561,45508
18-08-2015,9,15565,16304,6933,3950,42750,1159,974,488,2621,45371
18-08-2015,10,15693,16644,6964,4098,43400,1137,985,486,2608,46008
18-08-2015,11,15384,16787,6904,4194,43268,1164,1003,492,2659,45927
18-08-2015,12,15430,16429,6873,4227,42958,1169,1006,508,2683,45641
18-08-2015,13,15304,16471,6823,4294,42893,1174,940,516,2630,45523
18-08-2015,14,15072,16491,6897,4210,42669,1180,826,527,2533,45202
18-08-2015,15,14693,16418,6676,4143,41930,1170,758,527,2455,44385
18-08-2015,16,14786,16648,6586,3957,41977,1157,689,518,2364,44341
18-08-2015,17,15350,17007,6564,3708,42627,1158,580,507,2245,44872
18-08-2015,18,15146,17031,6525,3420,42123,1154,560,509,2223,44346
18-08-2015,19,15105,16819,6524,3008,41456,1157,589,514,2260,43716
18-08-2015,20,14866,17004,6253,2563,40687,876,497,524,1897,42584
18-08-2015,21,15230,16641,6039,2338,40249,825,377,549,1751,42000
18-08-2015,22,14242,16474,5709,2197,38621,826,226,498,1550,40171
18-08-2015,23,12829,15378,5644,2146,35997,785,205,370,1360,37357
19-08-2015,0,12979,13972,5390,2067,34409,694,197,362,1253,35662
19-08-2015,1,12657,13751,5256,1970,33634,684,192,352,1228,34862
19-08-2015,2,12490,13746,5280,1926,33442,664,168,353,1185,34627
19-08-2015,3,12621,13904,5309,1824,33659,663,172,364,1199,34858
19-08-2015,4,12565,14052,5445,1904,33966,675,314,361,1350,35316
19-08-2015,5,12767,14555,5984,2033,35340,877,457,352,1686,37026
19-08-2015,6,14583,15915,6465,2023,38986,1106,562,346,2014,41000
19-08-2015,7,16020,17193,6785,2824,42823,1121,792,498,2411,45234
19-08-2015,8,15981,17003,6835,3216,43034,1119,1049,484,2652,45686
19-08-2015,9,16009,16966,6814,3058,42848,1158,1113,486,2757,45605
19-08-2015,10,16059,16956,6891,2961,42868,1170,1177,605,2952,45820
19-08-2015,11,15838,16766,6883,3033,42520,1223,1186,547,2956,45476
19-08-2015,12,15821,16503,6878,3011,42213,1253,1164,578,2995,45208
19-08-2015,13,15854,16753,6850,3469,42926,1229,1087,469,2785,45711
19-08-2015,14,15713,16890,6867,3704,43174,1274,879,465,2618,45792
19-08-2015,15,15822,16751,6820,3501,42894,1276,701,489,2466,45360
19-08-2015,16,15864,16795,6716,3251,42625,1228,601,488,2317,44942
19-08-2015,17,15803,17293,6662,2899,42657,1240,566,489,2295,44952
19-08-2015,18,15546,17305,6651,2501,42004,1236,543,467,2246,44250
19-08-2015,19,15694,17254,6728,2227,41903,1198,495,459,2152,44055
19-08-2015,20,15369,17353,6428,2219,41370,931,509,492,1932,43302
19-08-2015,21,15515,17110,6251,1863,40738,945,384,516,1845,42583
19-08-2015,22,15110,16377,5943,1398,38827,889,214,478,1581,40408
19-08-2015,23,14395,14713,5811,1253,36173,844,192,335,1371,37544
20-08-2015,0,13633,14231,5567,1166,34597,790,172,333,1295,35892
20-08-2015,1,13194,13882,5458,1181,33718,778,171,328,1277,34995
20-08-2015,2,13041,13735,5479,1214,33469,763,170,327,1260,34729
20-08-2015,3,13286,13535,5480,1210,33511,760,168,323,1251,34762
20-08-2015,4,13544,13586,5634,1110,33875,765,250,315,1330,35205
20-08-2015,5,13609,14451,6102,1085,35247,945,417,316,1678,36925
20-08-2015,6,14504,15873,6660,1418,38457,1206,518,351,2075,40532
20-08-2015,7,15602,17176,6894,1671,41344,1320,606,474,2400,43744
20-08-2015,8,15888,17375,6896,1757,41916,1322,877,459,2658,44574
20-08-2015,9,16014,17177,6857,1864,41911,1353,1005,459,2817,44728
20-08-2015,10,16171,17062,6923,1940,42096,1355,984,459,2798,44894
20-08-2015,11,15929,17129,6907,1934,41900,1355,962,448,2765,44665
20-08-2015,12,15995,17087,6883,1975,41940,1351,924,437,2712,44652
20-08-2015,13,16095,16980,6873,2027,41975,1363,846,435,2644,44619
20-08-2015,14,15871,16857,6842,2147,41718,1357,755,456,2568,44286
20-08-2015,15,15837,16820,6735,2227,41617,1236,694,459,2389,44006
20-08-2015,16,15784,16740,6617,2265,41405,1201,637,460,2298,43703
20-08-2015,17,16536,16807,6518,2231,42093,1336,619,461,2416,44509
20-08-2015,18,16379,16854,6466,2165,41863,1336,566,465,2367,44230
20-08-2015,19,16125,16662,6517,1925,41231,1334,506,467,2307,43538
20-08-2015,20,15929,16449,6523,1656,40558,1273,479,468,2220,42778
20-08-2015,21,15902,16395,6359,1685,40342,1277,362,470,2109,42451
20-08-2015,22,15609,15452,6073,1540,38676,912,191,450,1553,40229
20-08-2015,23,14812,14450,5695,1471,36429,817,172,291,1280,37709
21-08-2015,0,14021,13104,5532,1434,34091,886,166,295,1347,35438
21-08-2015,1,13629,13171,5325,1486,33611,916,166,292,1374,34985
21-08-2015,2,13346,13049,5288,1508,33192,899,164,293,1356,34548
21-08-2015,3,13396,13043,5245,1572,33257,897,163,290,1350,34607
21-08-2015,4,13660,13035,5359,1490,33544,906,262,287,1455,34999
21-08-2015,5,13969,13771,5940,1473,35151,1075,388,288,1751,36902
21-08-2015,6,15113,15326,6745,1552,38736,1345,513,455,2313,41049
21-08-2015,7,16398,17035,7027,1809,42270,1345,910,493,2748,45018
21-08-2015,8,16348,17219,7043,2009,42619,1321,1152,483,2956,45575
21-08-2015,9,16368,17209,7075,2014,42668,1322,1211,472,3005,45673
21-08-2015,10,16480,17156,7065,2034,42734,1339,1207,472,3018,45752
21-08-2015,11,16220,17174,6935,2150,42478,1356,1101,453,2910,45388
21-08-2015,12,16115,17092,6961,2002,42169,1360,1109,470,2939,45108
21-08-2015,13,16041,16983,7015,1937,41975,1346,900,458,2704,44679
21-08-2015,14,16048,16912,6983,1977,41920,1329,747,463,2539,44459
21-08-2015,15,16042,16821,6958,1942,41762,1325,599,476,2400,44162
21-08-2015,16,15848,16613,6825,1770,41057,1265,675,478,2418,43475
21-08-2015,17,16022,16733,6750,1734,41240,1205,659,482,2346,43586
21-08-2015,18,16336,16565,6689,1654,41243,1224,611,487,2322,43565
21-08-2015,19,16455,16131,6615,1503,40704,1309,437,497,2243,42947
21-08-2015,20,16160,15921,6405,1292,39778,887,349,511,1747,41525
21-08-2015,21,16106,15693,6231,1166,39196,1085,200,510,1795,40991
21-08-2015,22,15018,14940,6178,1242,37378,1051,196,479,1726,39104
21-08-2015,23,14073,13868,5876,1346,35165,840,174,335,1349,36514
22-08-2015,0,13496,13034,5392,1348,33270,790,175,346,1311,34581
22-08-2015,1,13377,12494,5179,1298,32348,782,176,343,1301,33649
22-08-2015,2,13466,12505,5043,1241,32255,773,174,349,1296,33551
22-08-2015,3,13445,12530,4946,1208,32131,770,179,347,1296,33427
22-08-2015,4,13461,12494,4922,1206,32084,777,194,334,1305,33389
22-08-2015,5,13355,12615,5156,1232,32358,763,295,326,1384,33742
22-08-2015,6,13357,12919,5467,1145,32888,726,390,315,1431,34319
22-08-2015,7,14001,13908,5691,1170,34770,744,415,301,1460,36230
22-08-2015,8,15015,14971,5854,1147,36986,798,419,284,1501,38487
22-08-2015,9,15673,15829,6063,1195,38760,790,396,275,1461,40221
22-08-2015,10,15863,15931,6058,1483,39335,831,390,278,1499,40834
22-08-2015,11,15229,15397,6008,1571,38204,865,348,282,1495,39699
22-08-2015,12,14383,14659,5911,1575,36528,909,356,278,1543,38071
22-08-2015,13,13795,14132,5760,1668,35355,788,466,276,1530,36885
22-08-2015,14,13583,13998,5749,1672,35002,757,505,278,1540,36542
22-08-2015,15,13882,14065,5782,1575,35304,812,556,278,1646,36950
22-08-2015,16,14265,14383,5907,1495,36051,840,605,281,1726,37777
22-08-2015,17,15209,15032,5988,1384,37613,769,624,280,1673,39286
22-08-2015,18,15267,15153,6016,1239,37676,723,607,279,1609,39285
22-08-2015,19,15216,15077,6076,1203,37573,738,480,287,1505,39078
22-08-2015,20,14973,14848,6130,1336,37289,737,439,306,1482,38771
22-08-2015,21,15011,14642,6109,1510,37272,925,379,326,1630,38902
22-08-2015,22,14596,14165,5986,1508,36255,932,249,355,1536,37791
22-08-2015,23,13484,13313,5499,1523,33817,815,215,349,1379,35196
23-08-2015,0,13501,12247,5090,1569,32406,877,207,369,1453,33859
23-08-2015,1,13242,11776,4894,1289,31202,805,206,359,1370,32572
23-08-2015,2,13030,11491,4837,1178,30537,808,204,366,1378,31915
23-08-2015,3,12959,11339,4811,1276,30384,798,202,361,1361,31745
23-08-2015,4,12940,11310,4682,1230,30163,786,219,360,1365,31528
23-08-2015,5,12289,11178,4734,1232,29433,795,266,359,1420,30853
23-08-2015,6,12493,11239,4905,1487,30123,816,375,344,1535,31658
23-08-2015,7,12725,11633,5182,1766,31306,790,416,321,1527,32833
23-08-2015,8,13249,12065,5395,1947,32656,909,531,291,1731,34387
23-08-2015,9,13663,12338,5479,2058,33538,1000,600,290,1890,35428
23-08-2015,10,13807,12195,5672,2402,34077,998,638,305,1941,36018
23-08-2015,11,13429,12358,5743,2756,34285,889,640,311,1840,36125
23-08-2015,12,12746,12440,5761,2916,33863,875,635,302,1812,35675
23-08-2015,13,12206,12446,5680,3125,33457,863,683,297,1843,35300
23-08-2015,14,11858,12409,5703,3282,33252,864,669,301,1834,35086
23-08-2015,15,11786,12333,5680,3314,33114,924,668,298,1890,35004
23-08-2015,16,12539,12479,5735,3383,34138,946,679,299,1924,36062
23-08-2015,17,13620,13058,5737,3070,35484,889,684,293,1866,37350
23-08-2015,18,14510,13987,5845,2812,37153,879,680,295,1854,39007
23-08-2015,19,14715,14400,5876,2533,37524,994,660,302,1956,39480
23-08-2015,20,14874,14522,5877,2351,37623,1006,620,343,1969,39592
23-08-2015,21,14803,14553,5953,2439,37749,1070,526,369,1965,39714
23-08-2015,22,13988,13842,5724,2648,36203,1064,230,369,1663,37866
23-08-2015,23,12833,12982,5420,2509,33745,1030,215,380,1625,35370
24-08-2015,0,11829,12505,5195,2482,32012,1001,207,365,1573,33585
24-08-2015,1,11457,12254,4856,2533,31101,977,205,349,1531,32632
24-08-2015,2,11260,12200,4830,2575,30866,904,206,345,1455,32321
24-08-2015,3,11188,12167,4892,2639,30886,934,250,350,1534,32420
24-08-2015,4,11406,12202,5156,2772,31537,959,423,343,1725,33262
24-08-2015,5,12282,12820,5716,2836,33655,1149,578,343,2070,35725
24-08-2015,6,13861,14371,6113,2614,36960,1368,761,500,2629,39589
24-08-2015,7,16431,15857,6523,2537,41347,1373,1163,476,3012,44359
24-08-2015,8,16828,16845,6742,2949,43364,1378,1124,520,3022,46386
24-08-2015,9,16284,17283,6730,3210,43508,1359,1128,482,2969,46477
24-08-2015,10,16270,17426,6690,3633,44020,1393,1179,464,3036,47056
24-08-2015,11,16042,17333,6672,3518,43565,1419,1148,474,3041,46606
24-08-2015,12,16118,17284,6655,3284,43342,1408,1229,483,3120,46462
24-08-2015,13,16395,17380,6663,3358,43795,1410,1224,489,3123,46918
24-08-2015,14,16032,17282,6617,3508,43439,1434,1157,510,3101,46540
24-08-2015,15,15996,17148,6538,3055,42738,1436,985,500,2921,45659
24-08-2015,16,16196,17139,6520,2907,42762,1394,880,471,2745,45507
24-08-2015,17,15738,17298,6314,3011,42360,1364,805,455,2624,44984
24-08-2015,18,15613,17210,6341,2771,41934,1298,825,459,2582,44516
24-08-2015,19,15368,17179,6323,2781,41651,1264,742,474,2480,44131
24-08-2015,20,15205,16800,6046,2543,40593,1151,643,494,2288,42881
24-08-2015,21,14945,16480,5878,2297,39600,1257,400,523,2180,41780
24-08-2015,22,13968,15023,5598,2375,36963,1070,397,388,1855,38818
24-08-2015,23,13028,13947,5201,2471,34645,1008,372,391,1771,36416
25-08-2015,0,12747,12813,4902,2456,32919,1027,182,388,1597,34516
25-08-2015,1,12161,12426,4701,2395,31684,1068,178,383,1629,33313
25-08-2015,2,11813,12166,4778,2363,31121,1048,178,372,1598,32719
25-08-2015,3,11224,12078,4775,2237,30314,1040,273,370,1683,31997
25-08-2015,4,11492,12170,4883,2036,30581,1029,422,368,1819,32400
25-08-2015,5,12858,12796,5745,2025,33425,1106,535,370,2011,35436
25-08-2015,6,14291,14690,6357,1865,37204,1281,585,374,2240,39444
25-08-2015,7,15747,16694,6699,2223,41363,1367,859,351,2577,43940
25-08-2015,8,16022,17039,6735,2430,42226,1378,1057,375,2810,45036
25-08-2015,9,15995,16759,6702,2600,42057,1393,1165,473,3031,45088
25-08-2015,10,15962,16361,6780,2395,41499,1384,1176,359,2919,44418
25-08-2015,11,16006,16513,6730,2689,41939,1383,1182,382,2947,44886
25-08-2015,12,15719,16162,6628,2801,41309,1368,1195,376,2939,44248
25-08-2015,13,15626,15965,6434,2972,40997,1383,1056,380,2819,43816
25-08-2015,14,15737,15869,6336,3107,41048,1376,968,408,2752,43800
25-08-2015,15,15785,16001,6250,3475,41512,1342,929,396,2667,44179
25-08-2015,16,16010,15721,6123,3783,41638,1345,929,381,2655,44293
25-08-2015,17,16329,15545,6009,3978,41860,1272,927,324,2523,44383
25-08-2015,18,15700,15537,5921,4041,41200,1214,905,331,2450,43650
25-08-2015,19,15728,15664,6041,3714,41149,1340,709,351,2400,43549
25-08-2015,20,15901,15627,5996,3550,41074,1010,777,318,2105,43179
25-08-2015,21,15790,15472,5769,3232,40263,1009,548,298,1855,42118
25-08-2015,22,15115,14404,5385,3081,37985,917,406,301,1624,39609
25-08-2015,23,14088,13549,5093,2652,35382,886,350,302,1538,36920
26-08-2015,0,12919,12944,4917,2404,33185,868,165,304,1337,34522
26-08-2015,1,12267,12673,4820,2294,32055,879,162,304,1345,33400
26-08-2015,2,12069,12649,4793,2126,31637,873,162,306,1341,32978
26-08-2015,3,12257,12625,4803,1959,31644,862,164,312,1338,32982
26-08-2015,4,12605,12572,4960,1666,31804,879,265,320,1464,33268
26-08-2015,5,13147,13246,5574,1729,33697,1050,462,332,1844,35541
26-08-2015,6,14355,15069,6076,1942,37441,1354,569,321,2244,39685
26-08-2015,7,16146,17040,6549,2349,42084,1300,596,476,2372,44456
26-08-2015,8,16657,17095,6709,2812,43275,1280,918,496,2694,45969
26-08-2015,9,16681,16985,6671,2767,43104,1295,998,510,2803,45907
26-08-2015,10,16660,16628,6693,2881,42862,1329,998,632,2959,45821
26-08-2015,11,16602,16398,6699,2972,42673,1345,900,505,2750,45423
26-08-2015,12,16308,16226,6697,2996,42226,1370,957,486,2813,45039
26-08-2015,13,16515,15666,6691,2858,41731,1370,785,559,2714,44445
26-08-2015,14,16638,15697,6622,2627,41586,1407,730,508,2645,44231
26-08-2015,15,16532,16238,6446,2888,42104,1408,694,483,2585,44689
26-08-2015,16,16602,16607,6321,2817,42345,1386,619,471,2476,44821
26-08-2015,17,16633,16801,6191,2811,42436,1435,601,463,2499,44935
26-08-2015,18,16535,16877,6176,2766,42355,1455,580,453,2488,44843
26-08-2015,19,16572,16858,6204,2691,42326,1459,501,448,2408,44734
26-08-2015,20,16579,16861,5985,2513,41937,1138,498,450,2086,44023
26-08-2015,21,16147,16478,5763,2537,40925,1061,300,451,1812,42737
26-08-2015,22,15670,14366,5385,2692,38113,1001,211,437,1649,39762
26-08-2015,23,14311,13205,5009,2591,35117,975,193,321,1489,36606
27-08-2015,0,13036,12113,4846,2784,32778,971,174,343,1488,34266
27-08-2015,1,12493,11672,4720,2844,31729,961,168,343,1472,33201
27-08-2015,2,12417,11717,4667,2731,31532,960,169,336,1465,32997
27-08-2015,3,12559,11869,4686,2120,31235,940,211,332,1483,32718
27-08-2015,4,13160,12150,4943,1794,32047,917,466,335,1718,33765
27-08-2015,5,13197,13133,5713,1815,33858,1144,549,324,2017,35875
27-08-2015,6,14522,15564,6223,1863,38173,1404,490,325,2219,40392
27-08-2015,7,16700,17085,6614,2026,42424,1414,620,496,2530,44954
27-08-2015,8,17213,17691,6756,2453,44113,1394,819,490,2703,46816
27-08-2015,9,17287,17642,6762,2526,44217,1402,915,492,2809,47026
27-08-2015,10,16990,17593,6783,2768,44133,1427,962,498,2887,47020
27-08-2015,11,16772,17584,6754,3122,44232,1398,875,514,2787,47019
27-08-2015,12,16323,17337,6652,3371,43683,1416,905,530,2851,46534
27-08-2015,13,16298,16972,6589,3591,43450,1440,890,523,2853,46303
27-08-2015,14,16331,16620,6567,3584,43103,1386,769,548,2703,45806
27-08-2015,15,16362,16537,6543,3371,42814,1373,690,563,2626,45440
27-08-2015,16,16592,16803,6411,2884,42691,1359,738,551,2648,45339
27-08-2015,17,16687,17151,6286,2736,42859,1352,737,525,2614,45473
27-08-2015,18,16368,17403,6295,2472,42539,1367,721,509,2597,45136
27-08-2015,19,16349,17418,6447,2222,42435,1384,650,517,2551,44986
27-08-2015,20,16612,17477,6229,1933,42251,1143,529,538,2210,44461
27-08-2015,21,16468,17385,6083,1647,41582,1084,272,546,1902,43484
27-08-2015,22,15698,16429,5688,1630,39444,1061,219,449,1729,41173
27-08-2015,23,14683,15145,5431,1653,36912,935,202,317,1454,38366
28-08-2015,0,14089,13684,5221,1633,34626,883,191,310,1384,36010
28-08-2015,1,13792,13113,5034,1572,33511,907,190,301,1398,34909
28-08-2015,2,13588,12936,4991,1573,33088,930,195,306,1431,34519
28-08-2015,3,13501,12901,4922,1629,32954,933,201,353,1487,34441
28-08-2015,4,13583,12962,5201,1749,33495,930,273,358,1561,35056
28-08-2015,5,13570,14335,5826,1700,35430,1152,444,334,1930,37360
28-08-2015,6,15172,16162,6490,1624,39450,1386,576,340,2302,41752
28-08-2015,7,17070,17826,6861,1884,43641,1441,644,501,2586,46227
28-08-2015,8,17334,18304,7059,2292,44989,1439,759,517,2715,47704
28-08-2015,9,17323,17968,7033,2363,44687,1367,873,540,2780,47467
28-08-2015,10,17285,17612,7093,2517,44509,1378,878,510,2766,47275
28-08-2015,11,17255,17012,7066,2767,44100,1375,843,513,2731,46831
28-08-2015,12,16970,17071,6985,2706,43733,1408,875,528,2811,46544
28-08-2015,13,16608,16973,6890,2670,43140,1411,846,538,2795,45935
28-08-2015,14,16427,16819,6718,2676,42641,1437,753,555,2745,45386
28-08-2015,15,16191,16785,6629,2517,42124,1412,688,560,2660,44784
28-08-2015,16,16098,16127,6540,2546,41309,1307,698,549,2554,43863
28-08-2015,17,16260,15950,6346,2495,41051,1278,662,541,2481,43532
28-08-2015,18,16097,16721,6370,2372,41560,1288,643,510,2441,44001
28-08-2015,19,16141,16491,6350,2402,41384,1427,547,500,2474,43858
28-08-2015,20,16042,16611,6261,2038,40951,1270,480,506,2256,43207
28-08-2015,21,15958,16314,5873,2032,40178,1399,279,528,2206,42384
28-08-2015,22,14843,15488,5897,2060,38288,1082,237,450,1769,40057
28-08-2015,23,13611,14352,5469,1910,35342,958,213,365,1536,36878
29-08-2015,0,13127,12794,5088,1939,32947,793,214,385,1392,34339
29-08-2015,1,13104,12571,4797,1949,32421,825,211,374,1410,33831
29-08-2015,2,13217,12447,4634,1798,32095,826,208,363,1397,33492
29-08-2015,3,13245,12400,4638,1699,31982,811,208,357,1376,33358
29-08-2015,4,13447,12429,4759,1582,32219,812,221,344,1377,33596
29-08-2015,5,13362,12895,4987,1484,32729,808,261,347,1416,34145
29-08-2015,6,13482,13441,5233,1427,33583,796,395,341,1532,35115
29-08-2015,7,14287,14434,5632,1437,35791,806,416,341,1563,37354
29-08-2015,8,14931,15970,5754,1416,38070,819,433,331,1583,39653
29-08-2015,9,15466,16590,5825,1523,39404,848,617,343,1808,41212
29-08-2015,10,15735,16563,5606,1806,39711,863,629,348,1840,41551
29-08-2015,11,15652,16070,5556,2007,39286,875,576,376,1827,41113
29-08-2015,12,15501,15750,5476,2163,38890,875,547,401,1823,40713
29-08-2015,13,15112,15459,5298,2375,38244,878,439,389,1706,39950
29-08-2015,14,14937,15231,5365,2393,37927,896,412,378,1686,39613
29-08-2015,15,15125,15352,5422,2218,38117,892,409,383,1684,39801
29-08-2015,16,15181,15488,5497,2103,38270,851,422,362,1635,39905
29-08-2015,17,15516,15726,5395,2003,38641,859,450,325,1634,40275
29-08-2015,18,15978,15841,5437,1776,39033,818,461,296,1575,40608
29-08-2015,19,15892,15980,5523,1641,39037,770,418,288,1476,40513
29-08-2015,20,15773,15974,5777,1597,39122,788,507,304,1599,40721
29-08-2015,21,15596,15911,5719,1361,38585,798,387,308,1493,40078
29-08-2015,22,15060,15134,5638,1228,37058,787,220,305,1312,38370
29-08-2015,23,14711,14346,5154,1037,35249,780,205,299,1284,36533
30-08-2015,0,15004,13266,4822,948,34040,868,197,293,1358,35398
30-08-2015,1,14726,13006,4642,863,33239,885,197,293,1375,34614
30-08-2015,2,14595,12869,4526,859,32849,874,195,295,1364,34213
30-08-2015,3,14475,12959,4479,763,32677,857,195,298,1350,34027
30-08-2015,4,14457,12909,4569,707,32643,827,211,301,1339,33982
30-08-2015,5,14291,13001,4499,652,32444,822,262,297,1381,33825
30-08-2015,6,14173,13017,4769,561,32518,855,377,291,1523,34041
30-08-2015,7,14231,13731,5133,530,33626,809,403,289,1501,35127
30-08-2015,8,15191,14422,5308,601,35521,859,501,287,1647,37168
30-08-2015,9,15862,15279,5443,600,37183,830,499,281,1610,38793
30-08-2015,10,16276,15622,5446,655,37998,798,510,278,1586,39584
30-08-2015,11,16290,16061,5411,760,38521,855,571,279,1705,40226
30-08-2015,12,15853,15579,5325,689,37446,836,580,279,1695,39141
30-08-2015,13,15434,14772,5362,672,36241,822,578,280,1680,37921
30-08-2015,14,15285,14502,5379,695,35861,843,579,279,1701,37562
30-08-2015,15,16075,14863,5410,821,37170,803,561,280,1644,38814
30-08-2015,16,16061,15488,5444,846,37840,805,558,279,1642,39482
30-08-2015,17,15966,15918,5503,864,38251,812,536,276,1624,39875
30-08-2015,18,16101,15893,5652,968,38613,788,591,254,1633,40246
30-08-2015,19,16370,16222,5741,1179,39512,828,505,259,1592,41104
30-08-2015,20,16524,16555,5980,1255,40315,795,592,279,1666,41981
30-08-2015,21,16207,16492,5884,1340,39924,870,429,280,1579,41503
30-08-2015,22,15635,15790,5787,1173,38385,847,230,277,1354,39739
30-08-2015,23,14977,14804,5270,934,35985,856,199,276,1331,37316
31-08-2015,0,14665,13370,4929,788,33751,848,194,280,1322,35073
31-08-2015,1,14502,13154,4750,727,33133,798,193,282,1273,34406
31-08-2015,2,14316,13423,4744,765,33248,819,193,283,1295,34543
31-08-2015,3,14258,13416,4803,830,33306,886,224,290,1400,34706
31-08-2015,4,14314,13362,4986,862,33522,988,394,295,1677,35199
31-08-2015,5,14631,14033,5553,949,35168,1222,543,303,2068,37236
31-08-2015,6,15884,15522,6171,1502,39078,1370,821,302,2493,41571
31-08-2015,7,16559,16471,6525,1911,41466,1421,1048,296,2765,44231
31-08-2015,8,16528,16668,6676,2084,41956,1435,1109,432,2976,44932
31-08-2015,9,16688,16575,6910,2083,42257,1431,1160,468,3059,45316
31-08-2015,10,17201,16659,6970,2109,42938,1409,1248,470,3127,46065
31-08-2015,11,16899,16786,6953,2104,42742,1416,1121,436,2973,45715
31-08-2015,12,16975,16658,6912,2248,42792,1417,1133,345,2895,45687
31-08-2015,13,16955,16640,6841,2115,42551,1433,1131,276,2840,45391
31-08-2015,14,16806,16505,6756,2367,42433,1424,1051,277,2752,45185
31-08-2015,15,16671,16325,6657,2247,41900,1411,1026,280,2717,44617
31-08-2015,16,16820,16310,6688,2283,42103,1349,967,283,2599,44702
31-08-2015,17,17179,16557,6766,2465,42967,1247,945,284,2476,45443
31-08-2015,18,16875,16931,6723,2653,43183,1221,868,291,2380,45563
31-08-2015,19,16732,16804,6670,2685,42891,1208,734,335,2277,45168
31-08-2015,20,16781,16644,6317,2568,42310,1290,700,344,2334,44644
31-08-2015,21,16414,16342,6047,2480,41281,1146,441,355,1942,43223
31-08-2015,22,15084,15658,5612,2400,38754,1066,217,370,1653,40407
31-08-2015,23,14010,14263,5187,2333,35793,948,212,376,1536,37329
01-09-2015,0,13797,13354,5074,1861,34087,930,207,382,1519,35606
01-09-2015,1,13214,13283,4833,1763,33093,921,200,391,1512,34605
01-09-2015,2,13201,13203,4782,1707,32893,928,205,409,1542,34435
01-09-2015,3,13248,13245,4777,1663,32933,920,281,393,1594,34527
01-09-2015,4,13313,13431,5111,1405,33260,943,465,407,1815,35075
01-09-2015,5,13314,14482,5843,1275,34912,1114,567,419,2100,37012
01-09-2015,6,15018,16299,6398,1350,39066,1324,624,401,2349,41415
01-09-2015,7,16383,17810,6706,1487,42386,1398,835,365,2598,44984
01-09-2015,8,16635,18292,7021,2031,43979,1306,1008,511,2825,46804
01-09-2015,9,16450,18117,7008,1959,43534,1341,1052,473,2866,46400
01-09-2015,10,16327,17821,7043,1975,43166,1343,1123,548,3014,46180
01-09-2015,11,16642,17912,7042,2024,43620,1349,1110,552,3011,46631
01-09-2015,12,16616,17898,7127,2244,43887,1360,1142,475,2977,46864
01-09-2015,13,16602,17750,7086,2263,43701,1372,1086,294,2752,46453
01-09-2015,14,16487,17390,6986,2248,43112,1380,768,293,2441,45553
01-09-2015,15,16770,17262,6986,2392,43411,1392,749,285,2426,45837
01-09-2015,16,16904,17274,6695,2408,43281,1386,879,279,2544,45825
01-09-2015,17,16693,17445,6540,2507,43185,1368,863,277,2508,45693
01-09-2015,18,16448,17266,6540,2406,42660,1402,828,276,2506,45166
01-09-2015,19,15767,17319,6831,2787,42704,1407,734,269,2410,45114
01-09-2015,20,16043,16956,6718,2873,42591,1200,623,284,2107,44698
01-09-2015,21,15453,16532,6192,2977,41155,1138,409,287,1834,42989
01-09-2015,22,14499,15392,5664,3037,38592,1090,231,282,1603,40195
01-09-2015,23,12905,14186,5317,2977,35386,1002,203,286,1491,36877
02-09-2015,0,12091,13041,5366,3042,33539,975,191,277,1443,34982
02-09-2015,1,11663,12609,5335,3140,32747,982,186,269,1437,34184
02-09-2015,2,11641,12311,5341,3073,32366,988,187,268,1443,33809
02-09-2015,3,11790,12446,5359,2942,32537,986,281,294,1561,34098
02-09-2015,4,11858,12879,5559,2850,33147,990,460,332,1782,34929
02-09-2015,5,11980,13949,5990,2840,34759,1113,561,310,1984,36743
02-09-2015,6,13964,15723,6635,2757,39079,1270,630,289,2189,41268
02-09-2015,7,16121,17318,7098,2895,43432,1358,645,437,2440,45872
02-09-2015,8,16804,18018,7118,2990,44932,1415,714,486,2615,47547
02-09-2015,9,16275,17717,7257,3307,44556,1273,760,522,2555,47111
02-09-2015,10,16290,17295,7250,3606,44441,1280,728,509,2517,46958
02-09-2015,11,16108,17168,7177,3495,43947,1406,699,559,2664,46611
02-09-2015,12,15943,17445,7077,3950,44416,1421,698,544,2663,47079
02-09-2015,13,16009,17354,6956,3638,43958,1425,695,536,2656,46614
02-09-2015,14,15877,17168,6770,3570,43384,1325,484,523,2332,45716
02-09-2015,15,15571,17169,6879,3558,43177,1277,505,549,2331,45508
02-09-2015,16,15366,17087,6893,3482,42828,1239,531,529,2299,45127
02-09-2015,17,15893,17203,6871,3248,43216,1307,522,518,2347,45563
02-09-2015,18,15710,17206,6995,3169,43080,1345,525,509,2379,45459
02-09-2015,19,16093,16917,7108,2867,42985,1382,617,492,2491,45476
02-09-2015,20,16314,16874,6816,2695,42699,1157,663,496,2316,45015
02-09-2015,21,15987,16331,6317,2573,41208,1061,408,502,1971,43179
02-09-2015,22,14992,15505,5841,2578,38918,998,247,334,1579,40497
02-09-2015,23,13377,14554,5563,2543,36036,988,211,328,1527,37563
03-09-2015,0,12768,13579,5477,2507,34330,944,197,322,1463,35793
03-09-2015,1,12678,13193,5383,2363,33619,952,190,306,1448,35067
03-09-2015,2,12657,13179,5437,2272,33544,934,198,295,1427,34971
03-09-2015,3,13038,13040,5474,2137,33690,941,243,290,1474,35164
03-09-2015,4,13206,13386,5674,2036,34303,951,398,285,1634,35937
03-09-2015,5,13666,14424,6228,2031,36350,1114,426,280,1820,38170
03-09-2015,6,14556,15717,6808,2077,39159,1430,444,331,2205,41364
03-09-2015,7,15744,16774,7320,2186,42024,1540,497,596,2633,44657
03-09-2015,8,15899,16960,7407,2677,42943,1522,682,590,2794,45737
03-09-2015,9,15889,16826,7441,2587,42742,1515,715,651,2881,45623
03-09-2015,10,15645,16670,7434,2740,42489,1522,920,637,3079,45568
03-09-2015,11,15539,16632,7397,2513,42080,1549,837,577,2963,45043
03-09-2015,12,15312,16644,7344,2660,41959,1567,941,564,3072,45031
03-09-2015,13,15279,16506,7293,2441,41519,1548,901,660,3109,44628
03-09-2015,14,15259,16408,7183,2317,41168,1531,555,657,2743,43911
03-09-2015,15,14945,16514,7027,2294,40779,1536,509,650,2695,43474
03-09-2015,16,15040,16822,6765,2289,40917,1467,566,644,2677,43594
03-09-2015,17,15082,16819,6758,2196,40854,1387,576,600,2563,43417
03-09-2015,18,14994,16818,6709,1951,40473,1336,566,591,2493,42966
03-09-2015,19,14934,16787,6890,1846,40458,1406,487,590,2483,42941
03-09-2015,20,15491,16867,6812,1806,40976,1173,303,593,2069,43045
03-09-2015,21,15400,16505,6410,1785,40102,1041,259,406,1706,41808
03-09-2015,22,14749,15794,5992,1550,38084,1004,232,355,1591,39675
03-09-2015,23,13773,14912,5702,1660,36048,1037,203,269,1509,37557
04-09-2015,0,13467,13794,5649,1556,34466,1040,192,269,1501,35967
04-09-2015,1,12968,13467,5567,1493,33494,1037,192,270,1499,34993
04-09-2015,2,12877,13333,5514,1403,33128,1035,194,272,1501,34629
04-09-2015,3,12991,13335,5521,1363,33210,1029,266,279,1574,34784
04-09-2015,4,13164,13652,5699,1345,33861,1038,381,287,1706,35567
04-09-2015,5,13640,14492,6377,1431,35940,1192,397,296,1885,37825
04-09-2015,6,14521,15829,6826,1713,38890,1459,458,488,2405,41295
04-09-2015,7,15552,16991,7115,1946,41603,1465,751,487,2703,44306
04-09-2015,8,16180,17481,7135,1979,42776,1467,849,474,2790,45566
04-09-2015,9,16121,17442,7137,2089,42788,1448,926,443,2817,45605
04-09-2015,10,16120,17417,6988,2163,42687,1447,779,629,2855,45542
04-09-2015,11,16106,17333,6918,2161,42518,1431,784,614,2829,45347
04-09-2015,12,15819,17198,6848,2052,41918,1435,796,615,2846,44764
04-09-2015,13,15643,16846,6745,2096,41329,1406,918,457,2781,44110
04-09-2015,14,15568,16843,6501,1951,40863,1352,600,460,2412,43275
04-09-2015,15,15298,16837,6510,1838,40483,1374,584,474,2432,42915
04-09-2015,16,15308,16716,6615,1756,40396,1189,647,484,2320,42716
04-09-2015,17,15052,16795,6673,1871,40390,1242,621,480,2343,42733
04-09-2015,18,15846,16697,6563,1762,40870,1363,602,482,2447,43317
04-09-2015,19,16361,16712,6727,1768,41569,1307,691,480,2478,44047
04-09-2015,20,16414,16694,6577,1992,41676,1065,512,489,2066,43742
04-09-2015,21,16092,16094,6247,2037,40471,883,298,472,1653,42124
04-09-2015,22,15508,15052,5841,1758,38159,863,238,294,1395,39554
04-09-2015,23,14184,14536,5367,1525,35613,859,220,290,1369,36982
05-09-2015,0,13367,13385,5213,1707,33674,821,204,287,1312,34986
05-09-2015,1,13091,12872,5106,1684,32752,814,203,285,1302,34054
05-09-2015,2,12660,12328,4895,1656,31539,803,201,295,1299,32838
05-09-2015,3,12455,12095,4838,1690,31079,805,252,294,1351,32430
05-09-2015,4,12402,12039,4930,1771,31142,819,377,290,1486,32628
05-09-2015,5,12157,12609,5149,1914,31829,811,377,305,1493,33322
05-09-2015,6,11887,13439,5226,2288,32840,811,402,301,1514,34354
05-09-2015,7,12441,14010,5355,2476,34282,783,383,301,1467,35749
05-09-2015,8,13238,14528,5683,2720,36168,764,452,297,1513,37681
05-09-2015,9,13843,15484,5912,2990,38228,783,376,319,1478,39706
05-09-2015,10,13666,15428,5934,3439,38467,777,423,336,1536,40003
05-09-2015,11,13087,14828,5910,3639,37465,838,410,364,1612,39077
05-09-2015,12,12753,14387,5857,4047,37046,856,338,384,1578,38624
05-09-2015,13,12687,14075,5858,4006,36626,871,315,379,1565,38191
05-09-2015,14,12280,14042,5728,3799,35848,845,378,384,1607,37455
05-09-2015,15,12056,13925,5998,3859,35837,809,303,390,1502,37339
05-09-2015,16,12339,13756,5998,3835,35927,842,241,389,1472,37399
05-09-2015,17,13166,14785,6053,3528,37533,857,233,374,1464,38997
05-09-2015,18,13765,15513,6127,3376,38780,866,257,361,1484,40264
05-09-2015,19,13806,15698,6149,3186,38838,898,301,354,1553,40391
05-09-2015,20,13866,15783,6149,3114,38912,911,411,321,1643,40555
05-09-2015,21,13620,15378,5963,3052,38013,916,283,327,1526,39539
05-09-2015,22,12703,14578,5680,3100,36061,869,232,347,1448,37509
05-09-2015,23,11964,13569,5265,3343,34140,815,208,323,1346,35486
06-09-2015,0,10771,12171,5161,3326,31428,811,211,324,1346,32774
06-09-2015,1,10392,11764,5023,3079,30258,817,213,331,1361,31619
06-09-2015,2,10264,11321,4862,3121,29568,797,205,325,1327,30895
06-09-2015,3,10208,11416,4793,3190,29608,793,208,323,1324,30932
06-09-2015,4,10230,11496,4796,3213,29736,815,222,310,1347,31083
06-09-2015,5,10207,11644,4816,3151,29818,814,222,318,1354,31172
06-09-2015,6,10091,11913,4745,3001,29750,798,229,322,1349,31099
06-09-2015,7,10404,12460,5059,3168,31091,771,296,327,1394,32485
06-09-2015,8,10908,13465,5323,3370,33067,783,349,322,1454,34521
06-09-2015,9,11338,14195,5532,3470,34535,782,407,333,1522,36057
06-09-2015,10,11535,14647,5629,3621,35432,778,408,341,1527,36959
06-09-2015,11,11490,14941,5706,3634,35770,779,390,349,1518,37288
06-09-2015,12,11822,14826,5709,3595,35953,772,377,353,1502,37455
06-09-2015,13,11844,14668,5697,3514,35725,762,364,346,1472,37197
06-09-2015,14,11755,14672,5684,3526,35636,764,363,336,1463,37099
06-09-2015,15,11593,14520,5691,3530,35334,774,368,326,1468,36802
06-09-2015,16,11943,14575,5657,3303,35477,772,456,314,1542,37019
06-09-2015,17,12549,14808,5839,3013,36211,764,457,296,1517,37728
06-09-2015,18,13293,15696,5944,2886,37818,771,504,283,1558,39376
06-09-2015,19,14461,16676,6221,2137,39497,786,592,279,1657,41154
06-09-2015,20,15153,16700,6309,2049,40212,824,589,276,1689,41901
06-09-2015,21,15483,16423,6191,1880,39977,840,290,274,1404,41381
06-09-2015,22,15017,15739,5819,1780,38354,864,226,272,1362,39716
06-09-2015,23,14303,14716,5470,1671,36160,784,203,268,1255,37415
07-09-2015,0,13963,14001,5303,1532,34799,796,200,267,1263,36062
07-09-2015,1,13943,13333,5250,1369,33897,828,199,267,1294,35191
07-09-2015,2,13765,13251,5322,1307,33645,851,199,266,1316,34961
07-09-2015,3,13851,13172,5405,1320,33748,892,199,267,1358,35106
07-09-2015,4,13290,13261,5597,1268,33415,950,236,268,1454,34869
07-09-2015,5,14605,14817,6276,1443,37142,1120,285,269,1674,38816
07-09-2015,6,16048,16960,6847,1634,41489,1219,448,494,2161,43650
07-09-2015,7,17812,18560,7198,2030,45599,1211,507,736,2454,48053
07-09-2015,8,18091,18943,7375,2357,46767,1288,722,649,2659,49426
07-09-2015,9,17750,18878,7360,2462,46450,1341,707,633,2681,49131
07-09-2015,10,17368,18644,7327,2569,45907,1353,679,641,2673,48580
07-09-2015,11,17154,18512,7238,2651,45555,1374,628,653,2655,48210
07-09-2015,12,17321,18565,7218,2652,45756,1404,629,662,2695,48451
07-09-2015,13,17035,18603,7059,2896,45593,1461,630,681,2772,48365
07-09-2015,14,16785,18625,6806,2635,44852,1439,355,712,2506,47358
07-09-2015,15,16730,18116,6841,2561,44249,1480,339,750,2569,46818
07-09-2015,16,16783,18046,6716,2489,44035,1486,400,729,2615,46650
07-09-2015,17,16805,18125,6756,2338,44023,1483,288,707,2478,46501
07-09-2015,18,16793,18124,6875,2051,43843,1480,282,707,2469,46312
07-09-2015,19,16780,18344,7053,1629,43806,1488,353,730,2571,46377
07-09-2015,20,16972,18779,6920,1724,44395,1211,268,654,2133,46528
07-09-2015,21,16602,17919,6532,1617,42670,1229,261,390,1880,44550
07-09-2015,22,15908,16900,6138,1404,40352,1098,238,335,1671,42023
07-09-2015,23,14650,15636,5892,1390,37568,1075,215,331,1621,39189
08-09-2015,0,13896,14677,5937,1401,35911,1051,210,329,1590,37501
08-09-2015,1,13716,14079,5846,1344,34984,1024,210,336,1570,36554
08-09-2015,2,13548,13940,5782,1244,34514,1047,205,348,1600,36114
08-09-2015,3,13613,13899,5895,1184,34591,1056,204,330,1590,36181
08-09-2015,4,13761,14267,6080,1216,35324,1065,268,321,1654,36978
08-09-2015,5,14381,15637,6433,1307,37759,1148,358,332,1838,39597
08-09-2015,6,16024,17229,7131,1500,41884,1290,433,474,2197,44081
08-09-2015,7,17119,17887,7670,1947,44623,1523,586,511,2620,47243
08-09-2015,8,17572,17774,8138,2060,45544,1616,760,497,2873,48417
08-09-2015,9,17313,17710,8149,2371,45544,1544,728,645,2917,48461
08-09-2015,10,17211,17532,8081,2500,45326,1595,675,654,2924,48250
08-09-2015,11,17081,17504,8091,2671,45348,1587,657,647,2891,48239
08-09-2015,12,17087,17262,8078,2468,44896,1594,659,638,2891,47787
08-09-2015,13,17067,17033,8037,2375,44513,1590,639,637,2866,47379
08-09-2015,14,16920,17027,7809,2213,43970,1511,534,477,2522,46492
08-09-2015,15,16784,17100,7801,2146,43830,1571,534,467,2572,46402
08-09-2015,16,16791,17086,7692,2131,43700,1509,631,469,2609,46309
08-09-2015,17,16641,17112,7617,2309,43680,1607,531,492,2630,46310
08-09-2015,18,16459,17204,7685,2292,43640,1603,507,488,2598,46238
08-09-2015,19,16678,17185,7802,2114,43779,1625,710,494,2829,46608
08-09-2015,20,17245,17363,7545,1847,44000,1530,487,473,2490,46490
08-09-2015,21,16944,17162,7132,1713,42951,1531,257,368,2156,45107
08-09-2015,22,16374,16275,6865,1455,40968,1412,221,135,1768,42736
08-09-2015,23,15427,15321,6667,1130,38545,1208,210,279,1697,40242
09-09-2015,0,14776,13968,6239,973,35957,1149,207,91,1447,37404
09-09-2015,1,14859,13565,5870,896,35190,1167,203,93,1463,36653
09-09-2015,2,14814,13507,5814,879,35013,1127,197,86,1410,36423
09-09-2015,3,14830,13469,5942,841,35081,1093,201,92,1386,36467
09-09-2015,4,14817,13823,6327,823,35790,1132,262,83,1477,37267
09-09-2015,5,15131,14810,7070,941,37954,1435,399,102,1936,39890
09-09-2015,6,16428,16226,7694,1470,41818,1630,421,303,2354,44172
09-09-2015,7,17352,17481,7987,2101,44921,1651,627,453,2731,47652
09-09-2015,8,17316,17513,8027,2002,44858,1731,764,477,2972,47830
09-09-2015,9,17564,17099,7975,1979,44616,1601,933,297,2831,47447
09-09-2015,10,17203,17037,7941,2137,44318,1565,1003,38,2606,46924
09-09-2015,11,17050,16975,7876,2309,44210,1576,976,40,2592,46802
09-09-2015,12,16940,16854,7828,2050,43673,1422,967,121,2510,46183
09-09-2015,13,16777,16765,7731,2065,43338,1418,983,42,2443,45781
09-09-2015,14,16864,16504,7456,1882,42706,1409,643,40,2092,44798
09-09-2015,15,16711,16603,7571,1807,42693,1416,631,45,2092,44785
09-09-2015,16,16654,16521,7544,1763,42484,1417,738,42,2197,44681
09-09-2015,17,17060,16124,7626,1974,42784,1403,649,42,2094,44878
09-09-2015,18,17169,16151,7778,1895,42993,1396,685,64,2145,45138
09-09-2015,19,17257,16401,7881,1654,43194,1393,805,315,2513,45707
09-09-2015,20,17660,16667,7454,1680,43461,1390,628,305,2323,45784
09-09-2015,21,17242,16222,7133,1577,42175,1301,254,310,1865,44040
09-09-2015,22,16559,15323,6854,1265,40000,1089,222,316,1627,41627
09-09-2015,23,15867,14488,6392,905,37652,1045,206,316,1567,39219
10-09-2015,0,15357,13432,6069,840,35698,983,202,314,1499,37197
10-09-2015,1,14915,13287,5897,777,34876,996,221,305,1522,36398
10-09-2015,2,14706,12929,5916,825,34375,996,220,299,1515,35890
10-09-2015,3,14807,12996,5973,784,34560,999,224,295,1518,36078
10-09-2015,4,14898,13330,6338,841,35408,1041,239,286,1566,36974
10-09-2015,5,15286,14247,7127,982,37643,1332,346,280,1958,39601
10-09-2015,6,16607,15887,7808,1583,41885,1373,564,279,2216,44101
10-09-2015,7,17254,17054,7941,1969,44218,1382,876,276,2534,46752
10-09-2015,8,17307,16968,7957,1930,44163,1376,1029,468,2873,47036
10-09-2015,9,17386,16822,7916,1942,44066,1377,962,431,2770,46836
10-09-2015,10,17430,16898,7929,2011,44268,1387,971,468,2826,47094
10-09-2015,11,17074,16954,7870,2068,43965,1367,936,436,2739,46704
10-09-2015,12,16805,16839,7848,2021,43514,1366,986,436,2788,46302
10-09-2015,13,16794,16732,7679,2025,43229,1385,945,437,2767,45996
10-09-2015,14,16908,16313,7284,1804,42309,1390,739,437,2566,44875
10-09-2015,15,16896,16522,7307,2100,42824,1461,779,406,2646,45470
10-09-2015,16,16609,16556,7234,2287,42686,1470,796,440,2706,45392
10-09-2015,17,16585,16618,7187,2602,42991,1469,781,354,2604,45595
10-09-2015,18,16660,16830,7070,2538,43099,1462,720,364,2546,45645
10-09-2015,19,17183,17286,7030,2497,43995,1441,815,282,2538,46533
10-09-2015,20,17997,17274,6764,2478,44514,1123,640,290,2053,46567
10-09-2015,21,17813,16855,6326,2059,43054,1108,382,293,1783,44837
10-09-2015,22,16937,15738,6020,1707,40403,991,222,297,1510,41913
10-09-2015,23,15745,14278,5822,1690,37534,963,210,302,1475,39009
11-09-2015,0,14865,13075,5846,1516,35303,851,207,317,1375,36678
11-09-2015,1,14431,12621,5732,1671,34456,838,206,321,1365,35821
11-09-2015,2,14408,12489,5582,1759,34238,835,219,308,1362,35600
11-09-2015,3,14390,12652,5633,1726,34401,830,332,303,1465,35866
11-09-2015,4,14693,13087,6016,1775,35571,843,394,301,1538,37109
11-09-2015,5,15085,14371,6651,1968,38077,1037,412,300,1749,39826
11-09-2015,6,16332,16121,7159,2232,41846,1345,501,300,2146,43992
11-09-2015,7,17590,17777,7422,2852,45642,1404,639,453,2496,48138
11-09-2015,8,17900,18303,7458,3100,46761,1406,839,442,2687,49448
11-09-2015,9,17452,18181,7364,3452,46448,1415,838,434,2687,49135
11-09-2015,10,17472,17972,7255,3289,45988,1406,817,439,2662,48650
11-09-2015,11,17018,17820,7111,3469,45417,1409,767,452,2628,48045
11-09-2015,12,16892,17263,7108,3393,44654,1417,797,456,2670,47324
11-09-2015,13,16495,16760,6945,3467,43667,1411,739,467,2617,46284
11-09-2015,14,16060,16378,6556,3635,42630,1269,483,480,2232,44862
11-09-2015,15,15960,16253,6600,3491,42305,1411,509,473,2393,44698
11-09-2015,16,15784,16666,6644,3244,42338,1324,586,480,2390,44728
11-09-2015,17,15953,16787,6688,3166,42596,1381,469,468,2318,44914
11-09-2015,18,15880,16919,6859,2846,42505,1408,476,475,2359,44864
11-09-2015,19,16025,16947,7123,2749,42845,1390,554,488,2432,45277
11-09-2015,20,16228,16721,6901,2474,42324,1125,548,338,2011,44335
11-09-2015,21,15638,16358,6439,2278,40714,888,338,342,1568,42282
11-09-2015,22,14793,15615,6022,2365,38794,819,174,337,1330,40124
11-09-2015,23,14046,14639,5577,2564,36827,755,162,328,1245,38072
12-09-2015,0,13673,13460,5531,2346,35011,701,159,322,1182,36193
12-09-2015,1,13384,12930,5406,2131,33850,682,155,325,1162,35012
12-09-2015,2,13220,12681,5402,1944,33247,685,155,317,1157,34404
12-09-2015,3,13237,12619,5464,1805,33127,674,155,316,1145,34272
12-09-2015,4,13361,12677,5514,1781,33332,670,170,324,1164,34496
12-09-2015,5,13920,12837,5613,1757,34126,673,261,342,1276,35402
12-09-2015,6,13867,13553,5723,1795,34938,649,354,347,1350,36288
12-09-2015,7,14015,14927,5807,2012,36763,676,351,329,1356,38119
12-09-2015,8,14154,15914,5896,2246,38210,711,370,321,1402,39612
12-09-2015,9,14989,16254,5993,2399,39633,783,380,397,1560,41193
12-09-2015,10,15254,16545,5997,2547,40344,818,387,421,1626,41970
12-09-2015,11,15070,16555,6013,2607,40246,828,391,407,1626,41872
12-09-2015,12,14333,16405,5975,2561,39275,799,389,384,1572,40847
12-09-2015,13,14575,15850,5945,2773,39143,743,386,378,1507,40650
12-09-2015,14,14477,15093,5873,2709,38153,736,382,377,1495,39648
12-09-2015,15,14827,15488,5863,2671,38849,782,382,366,1530,40379
12-09-2015,16,14959,15457,5968,2680,39064,795,376,356,1527,40591
12-09-2015,17,15426,15634,6051,2728,39839,842,449,327,1618,41457
12-09-2015,18,15565,15855,6263,2741,40425,854,379,309,1542,41967
12-09-2015,19,15607,15969,6415,2692,40682,871,501,317,1689,42371
12-09-2015,20,15378,15992,6283,2803,40457,889,363,476,1728,42185
12-09-2015,21,14797,15383,6119,2850,39150,845,290,343,1478,40628
12-09-2015,22,13876,14746,5966,2884,37472,794,171,351,1316,38788
12-09-2015,23,13312,13927,5554,2840,35632,691,157,358,1206,36838
13-09-2015,0,12840,12917,5364,2719,33840,696,153,353,1202,35042
13-09-2015,1,12638,12577,5255,2689,33159,697,153,346,1196,34355
13-09-2015,2,12630,12369,5254,2642,32895,679,151,347,1177,34072
13-09-2015,3,12652,12297,5274,2521,32745,669,152,349,1170,33915
13-09-2015,4,12786,12289,5305,2269,32650,679,167,339,1185,33835
13-09-2015,5,12911,12412,5342,2205,32869,692,170,326,1188,34057
13-09-2015,6,13203,12745,5537,2454,33939,688,258,335,1281,35220
13-09-2015,7,13404,13298,5590,2685,34976,686,358,337,1381,36357
13-09-2015,8,14388,14014,5752,2796,36951,622,441,312,1375,38326
13-09-2015,9,15171,14805,5765,2793,38535,662,421,309,1392,39927
13-09-2015,10,15752,15131,5896,2689,39469,684,421,317,1422,40891
13-09-2015,11,16138,15820,5944,2477,40380,669,391,339,1399,41779
13-09-2015,12,16025,15914,5902,2316,40157,654,378,363,1395,41552
13-09-2015,13,15994,15929,5820,2141,39885,622,374,360,1356,41241
13-09-2015,14,15768,15814,5775,2052,39408,609,376,362,1347,40755
13-09-2015,15,15726,15852,5834,1992,39403,617,374,354,1345,40748
13-09-2015,16,16162,16060,5934,1987,40143,692,371,341,1404,41547
13-09-2015,17,16320,16701,6020,2117,41160,716,325,327,1368,42528
13-09-2015,18,16272,16847,6176,2143,41438,801,465,313,1579,43017
13-09-2015,19,16710,17070,6443,2092,42317,862,604,315,1781,44098
13-09-2015,20,16668,17105,6335,2050,42159,899,578,326,1803,43962
13-09-2015,21,16044,16537,6162,2020,40761,901,338,358,1597,42358
13-09-2015,22,15266,15162,5952,2048,38427,825,177,362,1364,39791
13-09-2015,23,14642,13645,5506,2085,35879,722,151,363,1236,37115
14-09-2015,0,13839,12795,5164,2008,33806,638,133,375,1146,34952
14-09-2015,1,13468,12173,5188,2065,32893,624,138,375,1137,34030
14-09-2015,2,13184,12056,5194,2237,32671,656,138,376,1170,33841
14-09-2015,3,13004,12122,5222,2484,32832,692,135,372,1199,34031
14-09-2015,4,13065,12616,5540,2689,33910,734,221,383,1338,35248
14-09-2015,5,13292,13782,6364,2844,36283,1090,322,378,1790,38073
14-09-2015,6,14843,15149,6862,3016,39869,1484,410,380,2274,42143
14-09-2015,7,17039,16354,7180,3103,43676,1546,444,574,2564,46240
14-09-2015,8,17672,16720,7240,3217,44849,1532,509,731,2772,47621
14-09-2015,9,17732,16622,7201,3286,44841,1531,522,742,2795,47636
14-09-2015,10,17612,17131,7034,3383,45160,1518,500,758,2776,47936
14-09-2015,11,17596,17086,6931,3221,44832,1516,442,770,2728,47560
14-09-2015,12,17472,17349,6897,2889,44608,1531,461,775,2767,47375
14-09-2015,13,17843,17391,6994,2754,44982,1532,441,768,2741,47723
14-09-2015,14,17736,17727,6567,2587,44616,1405,405,625,2435,47051
14-09-2015,15,17802,17773,6615,2406,44594,1559,399,574,2532,47126
14-09-2015,16,17131,17745,6671,2144,43691,1550,425,594,2569,46260
14-09-2015,17,17302,17679,6712,2105,43799,1548,420,587,2555,46354
14-09-2015,18,17068,17624,6771,2092,43553,1572,440,563,2575,46128
14-09-2015,19,17460,17830,7001,2002,44294,1589,599,579,2767,47061
14-09-2015,20,17308,17783,6676,1822,43589,1318,387,515,2220,45809
14-09-2015,21,16854,16750,6204,1685,41492,1000,364,406,1770,43262
14-09-2015,22,16136,15509,5652,1764,39061,849,360,430,1639,40700
14-09-2015,23,15116,14303,5557,1791,36768,824,348,429,1601,38369
15-09-2015,0,14213,12960,5474,1557,34202,816,328,430,1574,35776
15-09-2015,1,13719,12436,5522,1749,33426,818,330,426,1574,35000
15-09-2015,2,13866,12397,5604,1678,33544,815,327,409,1551,35095
15-09-2015,3,13674,12145,5709,1939,33466,820,329,398,1547,35013
15-09-2015,4,13476,12264,6216,2102,34057,882,348,405,1635,35692
15-09-2015,5,13934,12780,6999,2299,36013,1142,350,416,1908,37921
15-09-2015,6,15595,14791,7411,2298,40094,1633,384,419,2436,42530
15-09-2015,7,16870,16726,7538,2523,43657,1628,466,742,2836,46493
15-09-2015,8,17435,17172,7584,2854,45046,1617,625,768,3010,48056
15-09-2015,9,17302,17223,7526,3132,45183,1638,632,730,3000,48183
15-09-2015,10,16936,17448,7524,3449,45357,1659,556,715,2930,48287
15-09-2015,11,16808,17170,7514,3197,44689,1675,515,694,2884,47573
15-09-2015,12,16521,17033,7506,3309,44369,1668,529,701,2898,47267
15-09-2015,13,16636,17011,7417,3355,44419,1649,509,669,2827,47246
15-09-2015,14,16545,16749,7111,3334,43738,1473,409,378,2260,45998
15-09-2015,15,16815,16829,7304,2750,43699,1583,419,438,2440,46139
15-09-2015,16,16316,16669,7264,2992,43241,1620,406,544,2570,45811
15-09-2015,17,16881,16646,7361,2977,43866,1618,375,558,2551,46417
15-09-2015,18,17089,16828,7527,2489,43934,1598,411,580,2589,46523
15-09-2015,19,17447,17081,7683,2071,44283,1572,554,629,2755,47038
15-09-2015,20,17331,17093,7435,2311,44171,1499,462,542,2503,46674
15-09-2015,21,16894,16075,7185,2261,42413,1291,333,364,1988,44401
15-09-2015,22,15740,14907,6911,2370,39928,1052,317,315,1684,41612
15-09-2015,23,14290,13502,6420,2505,36717,939,311,318,1568,38285
16-09-2015,0,13414,12173,6420,2457,34463,926,309,292,1527,35990
16-09-2015,1,13104,11530,6031,2330,32995,922,307,283,1512,34507
16-09-2015,2,13140,11181,6015,2363,32700,919,305,280,1504,34204
16-09-2015,3,13148,11153,5947,2350,32597,914,305,293,1512,34109
16-09-2015,4,13583,11487,6105,2343,33518,914,320,298,1532,35050
16-09-2015,5,14558,12223,6652,2182,35615,1236,325,300,1861,37476
16-09-2015,6,16339,14453,7325,2183,40299,1517,368,429,2314,42613
16-09-2015,7,17906,16175,7765,2361,44208,1505,498,623,2626,46834
16-09-2015,8,18491,16770,7799,2606,45666,1536,659,618,2813,48479
16-09-2015,9,18204,16674,7787,2741,45407,1539,693,666,2898,48305
16-09-2015,10,18105,16606,7756,2782,45250,1538,759,625,2922,48172
16-09-2015,11,18376,16767,7757,2720,45620,1546,703,622,2871,48491
16-09-2015,12,18093,16628,7643,2741,45106,1542,693,620,2855,47961
16-09-2015,13,17623,16320,7480,2645,44066,1542,626,621,2789,46855
16-09-2015,14,17880,16249,7208,2711,44048,1540,400,458,2398,46446
16-09-2015,15,18186,16075,7418,2764,44442,1541,398,539,2478,46920
16-09-2015,16,18308,15835,7346,2857,44347,1535,377,580,2492,46839
16-09-2015,17,18490,16068,7429,2778,44766,1519,369,598,2486,47252
16-09-2015,18,18350,15963,7504,2617,44433,1506,412,624,2542,46975
16-09-2015,19,18036,16107,7511,2735,44388,1533,771,706,3010,47398
16-09-2015,20,17482,15963,7163,2706,43315,1503,433,544,2480,45795
16-09-2015,21,16737,15248,6966,2566,41517,1306,348,365,2019,43536
16-09-2015,22,15841,14327,6677,2470,39316,981,323,358,1662,40978
16-09-2015,23,14104,12959,6149,2565,35778,897,309,340,1546,37324
17-09-2015,0,14169,11596,5974,2782,34522,904,307,324,1535,36057
17-09-2015,1,13967,11010,5781,3001,33761,926,305,316,1547,35308
17-09-2015,2,13440,10638,5716,3112,32907,926,305,310,1541,34448
17-09-2015,3,13294,10796,5699,3133,32922,933,306,310,1549,34471
17-09-2015,4,12946,11028,6054,3118,33146,1027,318,316,1661,34807
17-09-2015,5,13695,11830,6660,3049,35235,1303,323,306,1932,37167
17-09-2015,6,15651,13516,7158,3114,39441,1548,365,448,2361,41802
17-09-2015,7,17414,15436,7509,3213,43572,1565,594,507,2666,46238
17-09-2015,8,17883,15739,7698,3254,44575,1563,713,498,2774,47349
17-09-2015,9,17667,15848,7744,3482,44742,1566,708,486,2760,47502
17-09-2015,10,17595,15934,7592,3705,44825,1573,711,488,2772,47597
17-09-2015,11,17272,16112,7385,3916,44684,1579,608,496,2683,47367
17-09-2015,12,16625,16279,7287,3908,44098,1581,655,519,2755,46853
17-09-2015,13,16696,15689,7140,4084,43609,1568,642,522,2732,46341
17-09-2015,14,16505,15646,7050,4018,43217,1446,630,538,2614,45831
17-09-2015,15,16268,15571,7038,4033,42911,1589,626,552,2767,45678
17-09-2015,16,16424,15565,7039,3952,42979,1566,605,535,2706,45685
17-09-2015,17,16477,15478,7026,3907,42889,1580,612,521,2713,45602
17-09-2015,18,16457,15414,7055,3823,42749,1613,614,565,2792,45541
17-09-2015,19,16804,15553,7185,3706,43249,1573,720,533,2826,46075
17-09-2015,20,16525,15341,6910,3553,42330,1146,564,536,2246,44576
17-09-2015,21,16027,14527,6653,3525,40733,1069,386,394,1849,42582
17-09-2015,22,14892,13249,6135,3530,37806,912,351,379,1642,39448
17-09-2015,23,13217,11930,5898,3675,34721,774,322,388,1484,36205
18-09-2015,0,12127,11267,5808,3748,32952,735,315,395,1445,34397
18-09-2015,1,11217,10958,5581,3796,31553,711,307,364,1382,32935
18-09-2015,2,10692,11149,5346,3871,31058,711,314,366,1391,32449
18-09-2015,3,10587,11173,5229,3894,30883,719,322,398,1439,32322
18-09-2015,4,10651,11603,5281,3763,31299,731,322,351,1404,32703
18-09-2015,5,11611,12723,5389,3675,33399,778,325,361,1464,34863
18-09-2015,6,13828,14050,5646,3524,37048,904,353,551,1808,38856
18-09-2015,7,16095,15635,5930,3376,41035,954,658,587,2199,43234
18-09-2015,8,17181,15607,6012,3234,42032,888,902,580,2370,44402
18-09-2015,9,17148,15941,6001,3550,42640,910,899,590,2399,45039
18-09-2015,10,17038,16395,6071,3879,43383,819,856,579,2254,45637
18-09-2015,11,16658,15843,6124,3973,42599,779,790,602,2171,44770
18-09-2015,12,16310,15772,6058,3911,42051,781,790,599,2170,44221
18-09-2015,13,15909,15542,5980,3809,41240,721,760,596,2077,43317
18-09-2015,14,15437,15038,5910,3784,40168,720,529,602,1851,42019
18-09-2015,15,14879,15195,5948,3707,39730,722,574,592,1888,41618
18-09-2015,16,14754,15406,5954,3420,39534,732,621,564,1917,41451
18-09-2015,17,15242,15621,5975,2887,39725,735,624,542,1901,41626
18-09-2015,18,15864,16640,5968,2486,40958,727,726,513,1966,42924
18-09-2015,19,16067,16754,6219,2040,41079,806,737,522,2065,43144
18-09-2015,20,15680,16537,5896,1809,39922,759,518,534,1811,41733
18-09-2015,21,14690,16029,5814,1653,38185,727,370,393,1490,39675
18-09-2015,22,14238,15183,5733,1518,36672,725,350,355,1430,38102
18-09-2015,23,13369,13907,5632,1366,34275,739,339,352,1430,35705
19-09-2015,0,12472,13889,5435,1383,33180,716,342,349,1407,34587
19-09-2015,1,11731,13725,5351,1362,32170,684,338,363,1385,33555
19-09-2015,2,11444,13643,5353,1302,31743,675,332,362,1369,33112
19-09-2015,3,11397,13540,5400,1174,31510,660,331,355,1346,32856
19-09-2015,4,11620,13541,5409,1161,31732,655,345,345,1345,33077
19-09-2015,5,12330,13540,5455,1151,32475,651,346,336,1333,33808
19-09-2015,6,13198,13423,5700,1190,33513,675,349,335,1359,34872
19-09-2015,7,13754,13692,5855,1204,34504,673,360,494,1527,36031
19-09-2015,8,14901,14649,5929,1436,36915,712,450,484,1646,38561
19-09-2015,9,15648,15939,6045,1473,39106,705,391,473,1569,40675
19-09-2015,10,15755,16348,6106,1724,39933,683,381,479,1543,41476
19-09-2015,11,15711,15809,6115,1931,39568,691,380,464,1535,41103
19-09-2015,12,15752,15204,6138,2053,39146,695,379,464,1538,40684
19-09-2015,13,15400,15267,6237,1941,38846,684,375,506,1565,40411
19-09-2015,14,15085,15120,6242,2156,38604,674,364,481,1519,40123
19-09-2015,15,15020,14832,6213,2278,38341,661,364,450,1475,39816
19-09-2015,16,14980,14828,6319,2269,38398,658,356,407,1421,39819
19-09-2015,17,15257,15360,6417,2284,39318,703,354,368,1425,40743
19-09-2015,18,15478,15790,6582,2180,40029,705,348,455,1508,41537
19-09-2015,19,15726,15789,6965,2164,40644,726,434,478,1638,42282
19-09-2015,20,15589,15811,6591,2255,40246,709,339,477,1525,41771
19-09-2015,21,14990,15181,6376,2301,38849,718,337,294,1349,40198
19-09-2015,22,14811,13810,6187,2432,37241,702,332,296,1330,38571
19-09-2015,23,14189,13353,5901,2432,35875,606,320,302,1228,37103
20-09-2015,0,13285,12679,5738,2415,34119,588,317,306,1211,35330
20-09-2015,1,12515,12495,5654,2474,33138,571,313,301,1185,34323
20-09-2015,2,12291,12411,5639,2412,32755,568,312,291,1171,33926
20-09-2015,3,12259,12420,5624,2427,32729,567,315,293,1175,33904
20-09-2015,4,12404,12343,5636,2491,32874,568,324,288,1180,34054
20-09-2015,5,12822,12329,5705,2520,33376,562,325,288,1175,34551
20-09-2015,6,13307,12414,5706,2542,33969,569,326,285,1180,35149
20-09-2015,7,13929,12578,5796,2356,34657,551,355,291,1197,35854
20-09-2015,8,14832,13151,5991,2303,36277,590,357,385,1332,37609
20-09-2015,9,15341,13585,6194,2363,37482,609,348,465,1422,38904
20-09-2015,10,15463,13669,6268,2587,37988,654,347,467,1468,39456
20-09-2015,11,15522,13881,6332,2592,38327,621,358,455,1434,39761
20-09-2015,12,15305,13505,6292,2537,37639,612,326,458,1396,39035
20-09-2015,13,15130,13208,6259,2347,36945,624,327,448,1399,38344
20-09-2015,14,15160,13130,6244,2334,36868,598,328,442,1368,38236
20-09-2015,15,15123,13189,6206,2160,36677,583,326,435,1344,38021
20-09-2015,16,15141,13570,6222,2023,36957,581,326,447,1354,38311
20-09-2015,17,15556,14886,6354,1886,38682,613,330,463,1406,40088
20-09-2015,18,16282,15539,6595,1770,40188,661,411,469,1541,41729
20-09-2015,19,16883,15941,6907,1469,41201,651,566,468,1685,42886
20-09-2015,20,17224,16348,6761,1406,41740,640,426,471,1537,43277
20-09-2015,21,16229,15814,6620,1411,40075,642,330,291,1263,41338
20-09-2015,22,15605,15111,6243,1370,38329,639,323,276,1238,39567
20-09-2015,23,14851,14371,5892,1318,36431,551,312,277,1140,37571
21-09-2015,0,14110,13409,5793,1231,34542,559,310,280,1149,35691
21-09-2015,1,13937,12754,5731,1261,33680,582,311,281,1174,34854
21-09-2015,2,13898,12490,5722,1196,33307,615,310,279,1204,34511
21-09-2015,3,13902,12504,5865,1091,33360,674,309,280,1263,34623
21-09-2015,4,14115,12829,6186,1088,34217,747,318,282,1347,35564
21-09-2015,5,14649,13895,6747,1162,36454,1101,328,289,1718,38172
21-09-2015,6,15941,15908,7180,1554,40583,1433,567,501,2501,43084
21-09-2015,7,17582,16984,7560,1768,43893,1462,630,612,2704,46597
21-09-2015,8,17813,17963,7697,1972,45445,1418,759,616,2793,48238
21-09-2015,9,17821,17874,7679,2023,45399,1363,890,626,2879,48278
21-09-2015,10,17990,17825,7581,1992,45389,1355,866,643,2864,48253
21-09-2015,11,17366,17754,7609,2022,44751,1321,798,640,2759,47510
21-09-2015,12,16831,17660,7569,2006,44066,1283,796,635,2714,46780
21-09-2015,13,17142,17403,7384,1759,43688,1308,704,589,2601,46289
21-09-2015,14,17015,17393,7152,1705,43264,1193,510,510,2213,45477
21-09-2015,15,17104,17339,7184,1714,43341,1280,482,515,2277,45618
21-09-2015,16,17012,17509,7204,1817,43542,1314,576,560,2450,45992
21-09-2015,17,17099,17535,7195,1945,43775,1318,578,553,2449,46224
21-09-2015,18,17018,17703,7436,2059,44215,1311,714,499,2524,46739
21-09-2015,19,17610,17647,7720,2081,45058,1294,710,624,2628,47686
21-09-2015,20,17430,17374,7422,1701,43927,998,334,634,1966,45893
21-09-2015,21,16893,16601,6990,1504,41987,888,328,459,1675,43662
21-09-2015,22,15726,15646,6739,1539,39651,890,321,310,1521,41172
21-09-2015,23,14831,13623,6565,1581,36602,903,309,307,1519,38121
22-09-2015,0,14001,12835,6532,1605,34975,886,307,299,1492,36467
22-09-2015,1,13507,12519,6393,1705,34123,904,306,292,1502,35625
22-09-2015,2,13266,12392,6340,1866,33864,907,304,294,1505,35369
22-09-2015,3,13313,12445,6362,1844,33965,906,305,294,1505,35470
22-09-2015,4,13611,12658,6447,1783,34500,901,314,299,1514,36014
22-09-2015,5,13991,13864,7123,1895,36872,1054,321,296,1671,38543
22-09-2015,6,15164,16190,7501,2005,40861,1293,590,454,2337,43198
22-09-2015,7,17075,17385,7817,2236,44515,1290,786,467,2543,47058
22-09-2015,8,17745,17914,7896,2338,45892,1274,789,514,2577,48469
22-09-2015,9,17660,17894,7865,2431,45850,1321,789,478,2588,48438
22-09-2015,10,17598,17956,7812,2378,45744,1365,770,486,2621,48365
22-09-2015,11,17916,17911,7722,2168,45718,1390,772,482,2644,48362
22-09-2015,12,17531,17825,7618,2231,45206,1413,772,506,2691,47897
22-09-2015,13,17669,17825,7496,2166,45156,1411,765,496,2672,47828
22-09-2015,14,17348,17801,7273,2233,44656,1172,556,464,2192,46848
22-09-2015,15,16879,17743,7367,2354,44342,1378,510,460,2348,46690
22-09-2015,16,17030,17518,7382,2498,44428,1392,598,481,2471,46899
22-09-2015,17,17195,17779,7405,2320,44699,1406,642,474,2522,47221
22-09-2015,18,16956,18093,7558,2069,44677,1422,703,481,2606,47283
22-09-2015,19,17708,18227,7693,1761,45390,1421,840,540,2801,48191
22-09-2015,20,17789,17954,7336,1341,44422,987,542,523,2052,46474
22-09-2015,21,16976,17253,7001,1122,42352,945,406,368,1719,44071
22-09-2015,22,16102,15818,6843,1073,39836,943,328,365,1636,41472
22-09-2015,23,14946,14470,6590,1053,37060,968,319,361,1648,38708
23-09-2015,0,14193,13477,6655,977,35303,967,311,359,1637,36940
23-09-2015,1,13857,13102,6637,927,34521,953,312,357,1622,36143
23-09-2015,2,14056,13108,6628,872,34664,959,308,362,1629,36293
23-09-2015,3,14122,13079,6612,865,34676,940,311,373,1624,36300
23-09-2015,4,14100,13271,6638,882,34891,925,324,377,1626,36517
23-09-2015,5,14474,14601,7075,931,37082,1031,335,368,1734,38816
23-09-2015,6,15649,16352,7551,1457,41010,1235,562,553,2350,43360
23-09-2015,7,17151,17969,7695,1639,44454,1410,765,544,2719,47173
23-09-2015,8,17556,18663,7788,1785,45792,1436,759,520,2715,48507
23-09-2015,9,17516,18669,7717,1919,45821,1456,755,521,2732,48553
23-09-2015,10,17597,18510,7608,1901,45616,1466,767,492,2725,48341
23-09-2015,11,17517,18532,7600,1973,45622,1448,661,490,2599,48221
23-09-2015,12,17265,18519,7537,1999,45320,1422,645,569,2636,47956
23-09-2015,13,17261,18266,7438,2007,44972,1375,684,491,2550,47522
23-09-2015,14,16963,18226,7359,1973,44522,1166,550,474,2190,46712
23-09-2015,15,16827,18240,7381,1881,44329,1308,517,480,2305,46634
23-09-2015,16,16795,18003,7343,1781,43922,1308,564,484,2356,46278
23-09-2015,17,16757,18019,7427,1814,44018,1288,605,481,2374,46392
23-09-2015,18,16727,17988,7591,1901,44207,1364,659,567,2590,46797
23-09-2015,19,17481,17705,7862,1936,44984,1368,706,636,2710,47694
23-09-2015,20,17429,17467,7584,1779,44258,993,564,489,2046,46304
23-09-2015,21,17033,16663,7173,1329,42196,975,331,324,1630,43826
23-09-2015,22,16119,15720,6818,1046,39704,987,323,296,1606,41310
23-09-2015,23,14700,14610,6540,997,36846,983,310,293,1586,38432
24-09-2015,0,14351,13821,6564,1040,35775,954,307,288,1549,37324
24-09-2015,1,13752,13603,6488,1068,34910,920,305,289,1514,36424
24-09-2015,2,13441,13548,6455,1040,34486,911,306,293,1510,35996
24-09-2015,3,13247,13483,6446,1040,34255,911,307,297,1515,35770
24-09-2015,4,13560,13490,6590,1129,34769,905,317,294,1516,36285
24-09-2015,5,14423,14378,6955,1334,37090,1024,322,295,1641,38731
24-09-2015,6,15674,16288,7407,1616,40987,1243,577,454,2274,43261
24-09-2015,7,16916,18322,7433,1942,44613,1474,749,448,2671,47284
24-09-2015,8,17378,18323,7494,2190,45387,1498,754,563,2815,48202
24-09-2015,9,17176,17867,7366,2513,44921,1563,737,519,2819,47740
24-09-2015,10,17208,17482,7289,2584,44563,1531,794,465,2790,47353
24-09-2015,11,16821,17434,7195,2881,44333,1506,784,523,2813,47146
24-09-2015,12,16686,17168,7243,2949,44046,1529,731,641,2901,46947
24-09-2015,13,16491,17244,7196,3160,44091,1493,665,647,2805,46896
24-09-2015,14,16237,17130,7066,3234,43667,1305,570,464,2339,46006
24-09-2015,15,16169,16925,7063,3422,43580,1387,565,461,2413,45993
24-09-2015,16,15750,16741,7138,3271,42900,1343,565,524,2432,45332
24-09-2015,17,16002,16883,7280,3123,43288,1355,636,513,2504,45792
24-09-2015,18,16232,17215,7465,2778,43691,1518,680,630,2828,46519
24-09-2015,19,16638,17267,7515,2748,44168,1576,734,686,2996,47164
24-09-2015,20,16521,16957,7297,2673,43451,1134,577,454,2165,45616
24-09-2015,21,16296,16193,6958,2401,41848,968,397,281,1646,43494
24-09-2015,22,15450,15447,6814,2606,40316,934,322,278,1534,41850
24-09-2015,23,14224,14504,6340,2496,37566,898,315,276,1489,39055
25-09-2015,0,12875,14125,6312,2271,35583,868,307,275,1450,37033
25-09-2015,1,12473,13931,6265,1950,34619,870,306,278,1454,36073
25-09-2015,2,12311,13916,6223,1950,34400,844,305,274,1423,35823
25-09-2015,3,12439,13901,6201,2009,34550,838,304,281,1423,35973
25-09-2015,4,12703,14041,6414,2043,35202,837,313,285,1435,36637
25-09-2015,5,13652,14714,7010,1965,37342,984,338,283,1605,38947
25-09-2015,6,14816,16477,7254,2126,40673,1351,621,324,2296,42969
25-09-2015,7,16016,18357,7387,2393,44153,1483,710,413,2606,46759
25-09-2015,8,16980,18284,7443,2525,45233,1519,805,459,2783,48016
25-09-2015,9,17038,18321,7371,2489,45219,1511,815,454,2780,47999
25-09-2015,10,16871,18327,7340,2649,45189,1492,762,451,2705,47894
25-09-2015,11,16254,18417,7342,2794,44806,1504,671,450,2625,47431
25-09-2015,12,15635,17846,7305,2886,43672,1506,671,591,2768,46440
25-09-2015,13,15747,17268,7181,2785,42982,1453,638,630,2721,45703
25-09-2015,14,15501,17021,7031,2767,42320,1284,586,445,2315,44635
25-09-2015,15,15482,16685,7108,2642,41918,1284,572,444,2300,44218
25-09-2015,16,15707,16707,7159,2676,42250,1296,571,469,2336,44586
25-09-2015,17,15896,17226,7160,2681,42964,1293,570,459,2322,45286
25-09-2015,18,15946,17344,7422,2235,42946,1328,582,582,2492,45438
25-09-2015,19,16789,16890,7460,1889,43028,1355,585,636,2576,45604
25-09-2015,20,16473,16487,6978,1885,41823,1185,562,388,2135,43958
25-09-2015,21,16143,15889,6696,1702,40428,1050,375,294,1719,42147
25-09-2015,22,15554,15478,6541,1607,39179,758,318,300,1376,40555
25-09-2015,23,14647,14900,6277,1507,37331,740,309,301,1350,38681
26-09-2015,0,14301,13900,6179,1476,35857,754,307,298,1359,37216
26-09-2015,1,13464,13489,6342,1451,34745,747,308,300,1355,36100
26-09-2015,2,13212,13321,6397,1456,34385,734,306,300,1340,35725
26-09-2015,3,13116,13256,6424,1367,34165,722,304,302,1328,35493
26-09-2015,4,13330,13273,6430,1391,34425,719,314,303,1336,35761
26-09-2015,5,14010,13301,6510,1391,35213,725,316,305,1346,36559
26-09-2015,6,14572,13703,6891,1486,36651,783,336,308,1427,38078
26-09-2015,7,14995,14025,7024,1590,37632,918,333,305,1556,39188
26-09-2015,8,15861,14770,7059,1654,39344,864,331,401,1596,40940
26-09-2015,9,16408,15688,6991,1679,40767,935,468,285,1688,42455
26-09-2015,10,16724,15651,6937,1808,41120,944,461,290,1695,42815
26-09-2015,11,16224,15444,7066,2042,40777,961,410,297,1668,42445
26-09-2015,12,15584,15006,7054,2213,39858,965,380,305,1650,41508
26-09-2015,13,15207,14947,7029,2314,39498,903,350,310,1563,41061
26-09-2015,14,14583,14882,7001,2467,38935,875,331,318,1524,40459
26-09-2015,15,14274,14944,6966,2499,38684,885,329,321,1535,40219
26-09-2015,16,14391,15012,7136,2533,39073,911,326,320,1557,40630
26-09-2015,17,15129,15331,7275,2459,40194,952,334,334,1620,41814
26-09-2015,18,16119,15419,7614,2091,41245,952,335,438,1725,42970
26-09-2015,19,16610,15798,7617,1829,41853,966,415,513,1894,43747
26-09-2015,20,16279,15584,7392,1730,40986,989,328,476,1793,42779
26-09-2015,21,15373,15252,7183,1750,39557,982,324,328,1634,41191
26-09-2015,22,14832,14548,7082,1699,38163,920,318,303,1541,39704
26-09-2015,23,14611,14172,6863,1594,37240,790,307,299,1396,38636
27-09-2015,0,14034,13594,6527,1445,35601,749,305,294,1348,36949
27-09-2015,1,13437,13451,6437,1363,34687,730,304,286,1320,36007
27-09-2015,2,13369,13412,6410,1289,34481,736,303,283,1322,35803
27-09-2015,3,13328,13518,6407,1329,34582,721,304,283,1308,35890
27-09-2015,4,13420,13588,6440,1371,34819,717,315,284,1316,36135
27-09-2015,5,13786,13830,6455,1320,35392,718,317,283,1318,36710
27-09-2015,6,14041,14086,6525,1291,35943,722,319,287,1328,37271
27-09-2015,7,14484,14322,6653,1291,36751,709,333,289,1331,38082
27-09-2015,8,15221,14805,6807,1288,38120,710,336,283,1329,39449
27-09-2015,9,15901,15423,6932,1337,39594,713,379,276,1368,40962
27-09-2015,10,16060,16102,6966,1330,40458,757,381,286,1424,41882
27-09-2015,11,15832,16121,6994,1400,40348,748,362,300,1410,41758
27-09-2015,12,15457,15565,7090,1537,39650,724,360,308,1392,41042
27-09-2015,13,15285,15454,7023,1494,39257,731,352,326,1409,40666
27-09-2015,14,15248,15379,6986,1463,39076,707,413,338,1458,40534
27-09-2015,15,15194,15497,7040,1428,39160,693,411,346,1450,40610
27-09-2015,16,15266,15616,7180,1333,39396,715,428,336,1479,40875
27-09-2015,17,15599,16166,7361,1432,40559,762,424,322,1508,42067
27-09-2015,18,15893,16636,7570,1457,41557,918,531,328,1777,43334
27-09-2015,19,16143,16899,7683,1440,42164,979,606,331,1916,44080
27-09-2015,20,16092,16950,7391,1301,41735,871,506,333,1710,43445
27-09-2015,21,15448,16566,7194,1180,40387,854,339,310,1503,41890
27-09-2015,22,14944,15488,7068,1117,38617,836,322,305,1463,40080
27-09-2015,23,14104,14602,6809,1023,36538,826,310,300,1436,37974
28-09-2015,0,13716,13939,6911,959,35527,827,310,303,1440,36967
28-09-2015,1,13413,13873,6866,920,35072,816,312,304,1432,36504
28-09-2015,2,13395,13757,6800,918,34870,814,312,305,1431,36301
28-09-2015,3,13904,13703,6889,894,35391,832,312,312,1456,36847
28-09-2015,4,14496,13788,6980,921,36185,922,321,329,1572,37757
28-09-2015,5,15266,14885,7340,1099,38591,1273,331,340,1944,40535
28-09-2015,6,15990,16700,7673,1754,42117,1599,509,504,2612,44729
28-09-2015,7,17558,18251,7884,2169,45863,1592,780,521,2893,48756
28-09-2015,8,18223,18520,7937,2172,46851,1594,746,551,2891,49742
28-09-2015,9,18195,18405,7902,2270,46772,1596,724,484,2804,49576
28-09-2015,10,17930,18272,7971,1884,46056,1582,723,501,2806,48862
28-09-2015,11,17679,17977,7899,1815,45371,1508,724,487,2719,48090
28-09-2015,12,17697,17534,7841,1684,44756,1577,724,497,2798,47554
28-09-2015,13,17567,17257,7822,1771,44416,1544,724,487,2755,47171
28-09-2015,14,17334,17238,7669,1764,44006,1210,571,476,2257,46263
28-09-2015,15,17113,17205,7586,1846,43751,1533,491,492,2516,46267
28-09-2015,16,16936,17216,7544,1742,43438,1509,633,487,2629,46067
28-09-2015,17,17000,17079,7527,1992,43598,1600,631,484,2715,46313
28-09-2015,18,17306,17124,7739,2128,44297,1578,770,586,2934,47231
28-09-2015,19,18272,17770,7856,2063,45959,1574,889,660,3123,49082
28-09-2015,20,18238,17607,7523,1645,45014,1195,586,497,2278,47292
28-09-2015,21,17861,17047,7202,1261,43371,983,329,328,1640,45011
28-09-2015,22,16784,15786,6884,988,40441,990,317,334,1641,42082
28-09-2015,23,15851,14699,6642,892,38083,949,305,339,1593,39676
29-09-2015,0,15613,13872,6614,1072,37170,963,313,340,1616,38786
29-09-2015,1,15262,13340,6554,949,36104,957,307,341,1605,37709
29-09-2015,2,15077,13327,6544,882,35831,945,308,333,1586,37417
29-09-2015,3,14967,13428,6556,914,35864,953,309,316,1578,37442
29-09-2015,4,15232,13647,6850,959,36689,969,317,310,1596,38285
29-09-2015,5,15412,14891,7502,954,38757,1152,327,304,1783,40540
29-09-2015,6,16533,16873,7811,1637,42855,1414,564,484,2462,45317
29-09-2015,7,17736,18505,7966,2005,46213,1444,684,614,2742,48955
29-09-2015,8,18025,18537,8043,2212,46817,1439,732,678,2849,49666
29-09-2015,9,17970,18127,7946,2246,46289,1447,752,605,2804,49093
29-09-2015,10,17953,17936,7773,1964,45626,1462,722,522,2706,48332
29-09-2015,11,17671,17497,7759,1719,44644,1462,737,481,2680,47324
29-09-2015,12,17470,17144,7742,1738,44093,1494,736,498,2728,46821
29-09-2015,13,17174,17153,7656,1583,43567,1484,753,474,2711,46278
29-09-2015,14,16911,17129,7632,1613,43286,1171,599,467,2237,45523
29-09-2015,15,16816,17209,7581,1553,43160,1436,530,470,2436,45596
29-09-2015,16,16424,17160,7571,1559,42716,1431,574,468,2473,45189
29-09-2015,17,16365,17460,7678,1832,43337,1371,590,462,2423,45760
29-09-2015,18,16375,17847,8000,1978,44199,1468,710,546,2724,46923
29-09-2015,19,17028,18052,8132,1907,45119,1387,747,683,2817,47936
29-09-2015,20,17120,17999,7805,1651,44574,848,618,489,1955,46529
29-09-2015,21,16757,17389,7459,1094,42701,911,327,462,1700,44401
29-09-2015,22,15817,16408,7195,837,40257,912,316,284,1512,41769
29-09-2015,23,13900,15876,6980,796,37553,950,307,281,1538,39091
30-09-2015,0,13087,15332,6959,931,36309,954,305,283,1542,37851
30-09-2015,1,12757,14881,6878,942,35459,968,307,281,1556,37015
30-09-2015,2,12618,14708,6815,1039,35181,994,308,278,1580,36761
30-09-2015,3,13020,14692,6830,1043,35585,1006,311,279,1596,37181
30-09-2015,4,13623,14939,7021,1082,36665,1030,325,283,1638,38303
30-09-2015,5,14142,16000,7466,1205,38814,1380,349,287,2016,40830
30-09-2015,6,15261,17614,7746,1957,42577,1631,546,474,2651,45228
30-09-2015,7,16518,18944,7982,2341,45785,1578,654,544,2776,48561
30-09-2015,8,17153,19014,8084,2507,46756,1496,718,652,2866,49622
30-09-2015,9,17385,18820,7954,2514,46674,1472,762,519,2753,49427
30-09-2015,10,17012,18721,7861,2757,46350,1471,732,528,2731,49081
30-09-2015,11,16756,18327,7826,2486,45394,1477,757,481,2715,48109
30-09-2015,12,16736,18116,7733,2167,44751,1461,740,483,2684,47435
30-09-2015,13,16586,18218,7624,2150,44579,1451,693,511,2655,47234
30-09-2015,14,16076,18059,7388,2185,43708,1373,637,481,2491,46199
30-09-2015,15,16517,17822,7435,2030,43803,1455,587,518,2560,46363
30-09-2015,16,16351,17888,7410,2209,43859,1448,656,505,2609,46468
30-09-2015,17,16220,18137,7453,2419,44230,1432,629,500,2561,46791
30-09-2015,18,16023,18304,7787,2329,44444,1497,790,718,3005,47449
30-09-2015,19,16953,18367,7725,2011,45056,1463,917,868,3248,48304
30-09-2015,20,16530,18066,7559,1761,43917,1254,586,499,2339,46256
30-09-2015,21,15934,17328,7435,1617,42315,971,426,415,1812,44127
30-09-2015,22,15093,16593,7299,1487,40472,848,325,361,1534,42006
30-09-2015,23,13818,15649,6858,1534,37857,906,319,376,1601,39458
01-10-2015,0,12654,14029,6799,1633,35116,949,307,389,1645,36761
01-10-2015,1,12022,14793,6660,1692,35167,955,305,389,1649,36816
01-10-2015,2,11775,14820,6634,1765,34993,756,303,386,1445,36438
01-10-2015,3,11799,14756,6698,1837,35090,747,304,364,1415,36505
01-10-2015,4,11804,15071,6984,2022,35880,800,316,367,1483,37363
01-10-2015,5,12585,16101,7541,2104,38330,1034,336,369,1739,40069
01-10-2015,6,14426,17363,7872,2182,41843,1245,644,393,2282,44125
01-10-2015,7,15881,18854,8032,2540,45306,1256,739,565,2560,47866
01-10-2015,8,16501,19103,8142,2734,46480,1253,763,616,2632,49112
01-10-2015,9,16468,19088,8118,2982,46656,1263,768,569,2600,49256
01-10-2015,10,16395,19036,7997,2960,46389,1292,775,537,2604,48993
01-10-2015,11,16535,18810,7925,2972,46242,1308,770,549,2627,48869
01-10-2015,12,16197,18976,7857,2988,46019,1334,778,529,2641,48660
01-10-2015,13,15991,18771,7683,2688,45133,1380,523,573,2476,47609
01-10-2015,14,15906,18472,7663,2641,44683,1443,703,608,2754,47437
01-10-2015,15,15837,18417,7642,2820,44716,1357,657,627,2641,47357
01-10-2015,16,15638,18239,7671,2761,44307,1267,576,613,2456,46763
01-10-2015,17,15681,18336,7690,2809,44516,1245,586,618,2449,46965
01-10-2015,18,15688,18781,7966,2560,44995,1430,734,665,2829,47824
01-10-2015,19,16347,19017,8125,2194,45682,1362,724,622,2708,48390
01-10-2015,20,15339,19098,7594,2204,44235,1014,534,560,2108,46343
01-10-2015,21,14430,18290,7120,2222,42062,1013,339,410,1762,43824
01-10-2015,22,13211,17605,6792,2123,39731,1003,337,420,1760,41491
01-10-2015,23,12603,17080,6891,2069,38643,915,332,397,1644,40287
02-10-2015,0,11628,16489,6633,1994,36745,843,331,413,1587,38332
02-10-2015,1,11457,16233,6383,2002,36074,829,328,417,1574,37648
02-10-2015,2,11307,16083,6283,2012,35684,862,327,415,1604,37288
02-10-2015,3,11048,16306,6411,2101,35867,855,330,427,1612,37479
02-10-2015,4,10861,16655,6934,2197,36649,886,339,430,1655,38304
02-10-2015,5,11267,17735,7480,2263,38746,1079,347,423,1849,40595
02-10-2015,6,12631,19745,7984,2379,42740,1303,480,600,2383,45123
02-10-2015,7,14077,20782,8208,2881,45947,1267,717,601,2585,48532
02-10-2015,8,15008,20959,8269,3026,47263,1277,777,604,2658,49921
02-10-2015,9,15001,20965,8305,3013,47284,1262,780,604,2646,49930
02-10-2015,10,14758,21009,8317,3037,47121,1324,748,627,2699,49820
02-10-2015,11,14624,20987,8218,3046,46875,1328,720,640,2688,49563
02-10-2015,12,14249,20665,8162,2841,45919,1344,719,640,2703,48622
02-10-2015,13,13796,20345,8052,2825,45018,1370,431,645,2446,47464
02-10-2015,14,13464,20384,7904,2875,44628,1269,568,663,2500,47128
02-10-2015,15,13064,20193,7876,2619,43750,1239,543,652,2434,46184
02-10-2015,16,13007,20261,7971,2514,43753,1252,372,603,2227,45980
02-10-2015,17,13675,20561,7787,2627,44651,1172,354,612,2138,46789
02-10-2015,18,13777,21318,7860,2310,45263,1268,444,632,2344,47607
02-10-2015,19,14280,21205,7882,1924,45292,1330,401,626,2357,47649
02-10-2015,20,13825,20695,7698,1867,44084,987,354,429,1770,45854
02-10-2015,21,13596,19732,7470,1703,42502,939,348,386,1673,44175
02-10-2015,22,13176,18999,7123,1712,41008,931,345,376,1652,42660
02-10-2015,23,12562,18100,6833,1627,39121,928,332,376,1636,40757
03-10-2015,0,12368,17346,6715,1291,37718,934,288,366,1588,39306
03-10-2015,1,12429,16731,6593,1132,36885,925,283,353,1561,38446
03-10-2015,2,12526,16269,6552,1003,36350,901,276,345,1522,37872
03-10-2015,3,12408,16278,6478,930,36094,859,272,339,1470,37564
03-10-2015,4,12595,16376,6566,955,36493,861,283,323,1467,37960
03-10-2015,5,12882,17214,6785,985,37867,841,282,299,1422,39289
03-10-2015,6,13137,17821,6885,1049,38892,832,286,287,1405,40297
03-10-2015,7,13486,18433,7029,1032,39981,838,285,279,1402,41383
03-10-2015,8,14519,19079,7142,1181,41922,814,287,321,1422,43344
03-10-2015,9,15222,19405,7119,1165,42911,876,287,272,1435,44346
03-10-2015,10,15337,19425,7156,1104,43021,894,287,271,1452,44473
03-10-2015,11,15306,19368,7116,1065,42855,850,286,272,1408,44263
03-10-2015,12,14794,19281,6973,1099,42148,803,286,273,1362,43510
03-10-2015,13,14486,19015,6883,1138,41524,814,285,276,1375,42899
03-10-2015,14,14189,18756,6902,1113,40959,813,287,274,1374,42333
03-10-2015,15,14245,18840,6994,1085,41165,810,285,273,1368,42533
03-10-2015,16,14493,18928,7168,1110,41699,817,285,274,1376,43075
03-10-2015,17,15043,19183,7469,1360,43057,856,323,274,1453,44510
03-10-2015,18,15678,19490,7779,1648,44595,956,329,312,1597,46192
03-10-2015,19,15784,19709,7827,1494,44813,996,331,368,1695,46508
03-10-2015,20,14957,19478,7585,1361,43382,886,312,286,1484,44866
03-10-2015,21,14389,19062,7379,1193,42022,821,290,297,1408,43430
03-10-2015,22,13896,18500,7048,976,40420,778,286,315,1379,41799
03-10-2015,23,13353,18221,6853,819,39246,794,275,336,1405,40651
04-10-2015,0,13115,17424,6656,683,37878,795,279,329,1403,39281
04-10-2015,1,12867,16872,6642,614,36996,777,280,326,1383,38379
04-10-2015,2,12719,16579,6635,625,36559,771,279,331,1381,37940
04-10-2015,3,12590,16518,6646,602,36355,784,280,326,1390,37745
04-10-2015,4,12574,16491,6684,566,36314,792,287,329,1408,37722
04-10-2015,5,12592,16769,6783,588,36731,788,285,328,1401,38132
04-10-2015,6,12930,17055,6897,584,37466,787,285,330,1402,38868
04-10-2015,7,13111,17414,7043,619,38188,752,287,328,1367,39555
04-10-2015,8,14051,18432,7119,732,40334,773,286,320,1379,41713
04-10-2015,9,14993,19055,7155,917,42121,802,283,296,1381,43502
04-10-2015,10,15398,19422,7162,1311,43292,823,283,281,1387,44679
04-10-2015,11,15367,19284,7070,1330,43051,844,275,279,1398,44449
04-10-2015,12,15125,19114,7093,1419,42752,836,266,278,1380,44132
04-10-2015,13,14769,19178,7064,1379,42391,816,267,278,1361,43752
04-10-2015,14,14546,19278,7065,1227,42116,787,269,277,1333,43449
04-10-2015,15,14701,19254,7140,1270,42365,783,267,275,1325,43690
04-10-2015,16,15004,19240,7209,1279,42732,821,269,277,1367,44099
04-10-2015,17,15580,19429,7509,1495,44012,854,288,276,1418,45430
04-10-2015,18,16587,19689,7873,1561,45710,918,349,426,1693,47403
04-10-2015,19,17532,20130,7734,1721,47119,934,429,409,1772,48891
04-10-2015,20,16924,20000,7541,1698,46164,850,436,293,1579,47743
04-10-2015,21,16385,19424,7326,1684,44819,794,324,287,1405,46224
04-10-2015,22,15434,19127,7168,1392,43122,781,296,280,1357,44479
04-10-2015,23,14264,18412,6951,929,40554,792,264,280,1336,41890
05-10-2015,0,12998,17370,6953,875,38196,808,263,282,1353,39549
05-10-2015,1,12780,16808,6806,879,37274,827,263,278,1368,38642
05-10-2015,2,12691,16542,6745,866,36844,883,263,277,1423,38267
05-10-2015,3,12862,16627,6743,889,37120,926,264,277,1467,38587
05-10-2015,4,13159,16998,6927,875,37959,975,274,276,1525,39484
05-10-2015,5,14335,18140,7419,1036,40932,1052,319,275,1646,42578
05-10-2015,6,16602,19136,7881,1674,45292,1202,440,432,2074,47366
05-10-2015,7,18772,20113,8117,1990,48991,1208,793,432,2433,51424
05-10-2015,8,19730,20466,8177,2291,50664,1202,833,438,2473,53137
05-10-2015,9,19705,20492,8055,2137,50388,1200,843,440,2483,52871
05-10-2015,10,19374,20434,7964,2262,50035,1236,837,435,2508,52543
05-10-2015,11,18718,20058,7953,2278,49009,1253,709,433,2395,51404
05-10-2015,12,18284,19926,7852,2333,48395,1211,753,436,2400,50795
05-10-2015,13,18080,19791,7691,2350,47914,1183,640,468,2291,50205
05-10-2015,14,17745,19735,7702,2359,47542,1188,615,448,2251,49793
05-10-2015,15,17378,19849,7651,2458,47337,1133,569,464,2166,49503
05-10-2015,16,17430,19872,7719,2066,47087,1097,564,451,2112,49199
05-10-2015,17,17484,19987,7775,2122,47369,1197,614,461,2272,49641
05-10-2015,18,17780,20338,8154,2002,48275,1206,714,487,2407,50682
05-10-2015,19,18105,20529,8205,2199,49039,1251,769,581,2601,51640
05-10-2015,20,17332,20252,7920,1985,47489,1050,501,495,2046,49535
05-10-2015,21,16182,19742,7506,2142,45571,997,331,433,1761,47332
05-10-2015,22,14357,19383,7130,1900,42770,987,328,313,1628,44398
05-10-2015,23,12515,18253,7015,2232,40015,971,279,350,1600,41615
06-10-2015,0,11585,16752,6948,2394,37679,890,276,377,1543,39222
06-10-2015,1,11096,16546,6915,2525,37082,876,271,381,1528,38610
06-10-2015,2,10756,16373,6872,2655,36657,894,270,381,1545,38202
06-10-2015,3,10748,16252,6854,2822,36676,915,271,384,1570,38246
06-10-2015,4,10783,16610,7008,2911,37313,923,286,396,1605,38918
06-10-2015,5,11530,17621,7544,3099,39794,1212,345,392,1949,41743
06-10-2015,6,13589,19617,7919,3299,44423,1568,558,373,2499,46922
06-10-2015,7,16128,20865,7972,3413,48378,1599,726,537,2862,51240
06-10-2015,8,16584,20941,8015,3650,49191,1655,865,529,3049,52240
06-10-2015,9,16124,21049,7889,3702,48766,1550,913,535,2998,51764
06-10-2015,10,15566,21117,7832,3994,48510,1553,874,540,2967,51477
06-10-2015,11,15052,20997,7885,4159,48095,1518,784,600,2902,50997
06-10-2015,12,14504,20857,7855,4207,47424,1545,716,553,2814,50238
06-10-2015,13,14202,20574,7595,4217,46589,1551,516,542,2609,49198
06-10-2015,14,13904,20590,7590,4234,46319,1559,622,524,2705,49024
06-10-2015,15,13787,20507,7550,4204,46048,1537,576,541,2654,48702
06-10-2015,16,13893,20487,7619,4384,46383,1402,574,543,2519,48902
06-10-2015,17,14153,20719,7726,4289,46887,1447,631,532,2610,49497
06-10-2015,18,14425,21251,8160,4430,48267,1568,744,534,2846,51113
06-10-2015,19,14613,21222,8286,4440,48561,1571,790,543,2904,51465
06-10-2015,20,13955,20929,7912,4275,47071,1211,493,556,2260,49331
06-10-2015,21,13000,20524,7741,4195,45460,949,353,391,1693,47153
06-10-2015,22,11828,19718,7690,4191,43427,921,332,399,1652,45079
06-10-2015,23,10679,18454,7335,4228,40696,847,276,399,1522,42218
07-10-2015,0,10468,17101,7093,3961,38624,868,289,401,1558,40182
07-10-2015,1,10407,16414,6991,3888,37700,824,367,393,1584,39284
07-10-2015,2,10557,16230,6970,3902,37661,834,262,398,1494,39155
07-10-2015,3,10551,16241,6976,3832,37600,876,263,394,1533,39133
07-10-2015,4,10671,16641,7251,3749,38313,898,364,399,1661,39974
07-10-2015,5,11073,17489,7980,3808,40349,1495,408,401,2304,42653
07-10-2015,6,12995,19435,8609,3720,44761,1638,662,473,2773,47534
07-10-2015,7,14767,21051,8900,3943,48661,1692,797,637,3126,51787
07-10-2015,8,15445,21190,8782,4112,49530,1783,811,674,3268,52798
07-10-2015,9,15261,21027,8727,4228,49243,1657,912,587,3156,52399
07-10-2015,10,15121,20464,8740,4356,48681,1670,889,537,3096,51777
07-10-2015,11,14729,20672,8617,4635,48653,1678,878,548,3104,51757
07-10-2015,12,14660,20538,8452,4647,48297,1663,786,531,2980,51277
07-10-2015,13,14862,20478,8433,4523,48296,1674,556,498,2728,51024
07-10-2015,14,14832,20615,8367,4407,48221,1638,619,492,2749,50970
07-10-2015,15,14705,20816,8520,4328,48369,1410,638,498,2546,50915
07-10-2015,16,14714,20791,8718,4210,48432,1414,652,471,2537,50969
07-10-2015,17,15647,20954,8796,4108,49505,1383,751,491,2625,52130
07-10-2015,18,16091,21165,8974,4075,50305,1487,969,811,3267,53572
07-10-2015,19,16281,21062,8937,3940,50220,1612,1003,628,3243,53463
07-10-2015,20,15532,20859,8392,3823,48605,1549,557,555,2661,51266
07-10-2015,21,14480,20467,8101,3756,46805,1317,416,409,2142,48947
07-10-2015,22,13271,19788,8212,3649,44920,1050,391,410,1851,46771
07-10-2015,23,12246,18656,7922,3511,42335,1004,343,393,1740,44075
08-10-2015,0,11879,17017,7619,3353,39868,1038,336,373,1747,41615
08-10-2015,1,11895,16488,7301,3172,38857,1034,334,372,1740,40597
08-10-2015,2,12076,16357,7252,3119,38806,1030,332,358,1720,40526
08-10-2015,3,12151,16351,7378,2947,38827,1021,331,353,1705,40532
08-10-2015,4,12428,16427,7921,2925,39701,1048,349,341,1738,41439
08-10-2015,5,13435,17042,8550,2907,41934,1479,515,324,2318,44252
08-10-2015,6,15564,19147,8993,2861,46564,1524,901,429,2854,49418
08-10-2015,7,18094,20664,9037,2795,50590,1533,1012,526,3071,53661
08-10-2015,8,18761,20864,8979,3038,51642,1527,1072,571,3170,54812
08-10-2015,9,18684,20593,8964,2955,51197,1536,1118,398,3052,54249
08-10-2015,10,18683,20523,8781,3004,50992,1583,1103,468,3154,54146
08-10-2015,11,18364,20498,8780,2942,50586,1591,974,498,3063,53649
08-10-2015,12,17859,20432,8739,2948,49979,1568,961,477,3006,52985
08-10-2015,13,18051,20345,8610,3030,50036,1504,820,654,2978,53014
08-10-2015,14,17920,20339,8538,3107,49906,1523,880,476,2879,52785
08-10-2015,15,17800,20427,8707,2921,49855,1484,852,466,2802,52657
08-10-2015,16,17764,20308,8871,2692,49636,1439,804,485,2728,52364
08-10-2015,17,18142,20339,8967,2968,50417,1499,874,489,2862,53279
08-10-2015,18,18687,20429,9195,2994,51304,1549,1027,660,3236,54540
08-10-2015,19,19151,20386,9177,2845,51560,1552,1062,669,3283,54843
08-10-2015,20,18196,20093,8657,2699,49645,1483,849,506,2838,52483
08-10-2015,21,17178,19649,8272,2416,47516,1200,735,351,2286,49802
08-10-2015,22,16109,19091,8040,2253,45493,1126,524,333,1983,47476
08-10-2015,23,14903,17970,7895,2105,42873,1091,405,308,1804,44677
09-10-2015,0,15189,16246,7734,1897,41066,1067,392,299,1758,42824
09-10-2015,1,15108,16042,7433,1807,40390,1062,410,292,1764,42154
09-10-2015,2,14905,15926,7320,1712,39864,1053,396,290,1739,41603
09-10-2015,3,14893,15910,7498,1766,40068,1050,402,292,1744,41812
09-10-2015,4,14878,16222,7904,1829,40834,1176,454,285,1915,42749
09-10-2015,5,15586,16979,8453,1851,42868,1532,663,324,2519,45387
09-10-2015,6,17178,19013,9028,2145,47364,1643,934,446,3023,50387
09-10-2015,7,19029,19943,9138,2703,50813,1607,1086,560,3253,54066
09-10-2015,8,19409,20347,9136,2946,51839,1574,1270,475,3319,55158
09-10-2015,9,19393,20127,8985,2796,51300,1571,1178,551,3300,54600
09-10-2015,10,19298,20137,9029,3018,51482,1490,1177,474,3141,54623
09-10-2015,11,19030,20195,9024,3179,51429,1476,1112,359,2947,54376
09-10-2015,12,18550,20038,9027,3031,50647,1439,1166,364,2969,53616
09-10-2015,13,18174,19885,8846,3095,50002,1479,955,524,2958,52960
09-10-2015,14,17948,19658,8691,2967,49264,1546,937,478,2961,52225
09-10-2015,15,17796,19526,8710,2605,48637,1568,921,423,2912,51549
09-10-2015,16,17814,19418,8806,2572,48612,1458,852,427,2737,51349
09-10-2015,17,18054,19336,8920,2800,49110,1518,845,432,2795,51905
09-10-2015,18,18686,19459,9199,2768,50113,1514,924,574,3012,53125
09-10-2015,19,18429,19795,9132,2522,49877,1664,1114,350,3128,53005
09-10-2015,20,17552,19482,8457,2174,47665,1481,924,347,2752,50417
09-10-2015,21,16991,18773,8008,1961,45734,1354,809,357,2520,48254
09-10-2015,22,16312,17923,8131,2010,44376,1047,608,376,2031,46407
09-10-2015,23,15412,17205,7600,1944,42160,938,463,340,1741,43901
10-10-2015,0,14069,17331,7130,1726,40258,867,420,294,1581,41839
10-10-2015,1,13774,16998,7007,1597,39377,856,386,285,1527,40904
10-10-2015,2,13567,16594,7035,1525,38722,862,367,282,1511,40233
10-10-2015,3,13702,16401,6948,1455,38506,862,365,281,1508,40014
10-10-2015,4,13784,16424,7027,1401,38636,870,382,281,1533,40169
10-10-2015,5,13874,16762,7353,1434,39424,867,487,280,1634,41058
10-10-2015,6,14029,17599,7587,1453,40666,866,582,280,1728,42394
10-10-2015,7,14826,18446,7802,1510,42583,855,779,279,1913,44496
10-10-2015,8,15708,19229,7951,1631,44519,887,916,294,2097,46616
10-10-2015,9,16535,19606,7967,1832,45939,945,998,288,2231,48170
10-10-2015,10,16767,19807,7949,1979,46504,946,951,328,2225,48729
10-10-2015,11,16181,19694,7848,2148,45872,963,932,312,2207,48079
10-10-2015,12,15765,19484,7769,1911,44930,923,922,305,2150,47080
10-10-2015,13,15525,19306,7664,1712,44207,936,889,306,2131,46338
10-10-2015,14,15378,19141,7629,1721,43869,963,848,307,2118,45987
10-10-2015,15,15275,19009,7630,1722,43635,1026,848,307,2181,45816
10-10-2015,16,15489,19178,7849,1820,44337,993,849,309,2151,46488
10-10-2015,17,16324,19382,8146,1917,45770,1169,926,307,2402,48172
10-10-2015,18,17197,19559,8447,2050,47253,1181,1127,308,2616,49869
10-10-2015,19,17021,19572,8412,2079,47085,1169,1051,307,2527,49612
10-10-2015,20,15894,19388,8013,2189,45485,1170,830,309,2309,47794
10-10-2015,21,15382,18642,7747,1987,43759,1150,727,307,2184,45943
10-10-2015,22,14658,18074,7763,2106,42602,861,546,288,1695,44297
10-10-2015,23,14018,17155,7405,2144,40721,845,461,292,1598,42319
11-10-2015,0,12423,15801,7147,2092,37462,808,398,299,1505,38967
11-10-2015,1,11695,15090,7019,1996,35800,801,363,303,1467,37267
11-10-2015,2,11795,14890,6961,1835,35482,797,360,307,1464,36946
11-10-2015,3,12000,14912,7008,1731,35652,799,363,315,1477,37129
11-10-2015,4,12238,15088,7101,1717,36145,803,377,316,1496,37641
11-10-2015,5,11756,14940,7144,1744,35584,808,395,315,1518,37102
11-10-2015,6,11762,15345,7210,1739,36056,807,485,326,1618,37674
11-10-2015,7,12651,16325,7264,1668,37907,808,587,327,1722,39629
11-10-2015,8,14032,17981,7500,1683,41195,801,704,364,1869,43064
11-10-2015,9,14536,18666,7667,1676,42546,796,705,394,1895,44441
11-10-2015,10,13742,18840,7758,1748,42087,809,700,340,1849,43936
11-10-2015,11,13194,18510,7708,1965,41379,807,696,312,1815,43194
11-10-2015,12,12956,17297,7474,2119,39847,807,693,315,1815,41662
11-10-2015,13,12910,16862,7389,1982,39143,811,692,311,1814,40957
11-10-2015,14,12803,16764,7397,1930,38893,818,691,316,1825,40718
11-10-2015,15,12752,16793,7405,1914,38863,816,688,317,1821,40684
11-10-2015,16,13189,17144,7579,1918,39829,808,687,315,1810,41639
11-10-2015,17,15268,18488,7656,1903,43314,945,695,306,1946,45260
11-10-2015,18,17147,19395,8119,1913,46575,982,765,318,2065,48640
11-10-2015,19,17762,20271,7403,2060,47497,839,704,364,1907,49404
11-10-2015,20,16731,19958,7109,2157,45955,809,702,336,1847,47802
11-10-2015,21,16094,19428,6947,2065,44534,811,559,326,1696,46230
11-10-2015,22,14907,18971,7040,2022,42941,807,378,338,1523,44464
11-10-2015,23,13422,17865,6969,1923,40178,804,356,331,1491,41669
12-10-2015,0,12848,16408,6906,1832,37994,802,428,322,1552,39546
12-10-2015,1,12072,15778,6966,1797,36613,801,352,313,1466,38079
12-10-2015,2,12386,15728,6984,1775,36874,811,352,306,1469,38343
12-10-2015,3,12072,15781,6998,1695,36546,824,352,307,1483,38029
12-10-2015,4,12214,15954,7275,1727,37171,873,371,303,1547,38718
12-10-2015,5,14505,17565,8041,1766,41878,1112,501,318,1931,43809
12-10-2015,6,17318,19203,8531,1798,46849,1315,768,374,2457,49306
12-10-2015,7,19950,20418,8804,2139,51311,1297,801,448,2546,53857
12-10-2015,8,20171,20637,8818,2796,52423,1314,860,619,2793,55216
12-10-2015,9,20606,20461,8625,2630,52321,1362,829,654,2845,55166
12-10-2015,10,20296,20638,8364,2567,51865,1375,871,647,2893,54758
12-10-2015,11,19944,20541,8147,2493,51125,1413,867,570,2850,53975
12-10-2015,12,19868,20238,8003,2146,50256,1433,875,527,2835,53091
12-10-2015,13,19746,20213,7949,2056,49963,1389,805,578,2772,52735
12-10-2015,14,19535,20075,7777,2210,49598,1391,793,555,2739,52337
12-10-2015,15,19262,20088,7667,2172,49189,1400,791,494,2685,51874
12-10-2015,16,19236,19820,7783,2167,49007,1317,796,432,2545,51552
12-10-2015,17,19556,20193,8083,2308,50140,1386,765,504,2655,52795
12-10-2015,18,19795,20364,8626,2448,51233,1438,766,660,2864,54097
12-10-2015,19,19562,20423,8621,2483,51090,1399,766,562,2727,53817
12-10-2015,20,18754,19889,8044,2300,48988,904,721,519,2144,51132
12-10-2015,21,17829,19380,7690,2142,47040,813,588,365,1766,48806
12-10-2015,22,16736,18750,7319,1957,44762,793,395,377,1565,46327
12-10-2015,23,14990,17754,7116,1850,41711,809,364,363,1536,43247
13-10-2015,0,13810,16412,7168,1682,39072,923,369,367,1659,40731
13-10-2015,1,13344,15952,7158,1702,38154,926,371,367,1664,39818
13-10-2015,2,13243,15901,7072,1606,37822,913,370,367,1650,39472
13-10-2015,3,13394,15916,7062,1568,37941,904,370,372,1646,39587
13-10-2015,4,13815,16368,7223,1865,39272,931,402,369,1702,40974
13-10-2015,5,14623,17979,7794,2102,42498,1106,583,372,2061,44559
13-10-2015,6,17347,19363,8272,2216,47199,1350,712,509,2571,49770
13-10-2015,7,19801,20059,8498,2690,51049,1354,719,701,2774,53823
13-10-2015,8,20429,20129,8534,2915,52008,1364,783,730,2877,54885
13-10-2015,9,20368,20147,8421,3165,52102,1370,779,696,2845,54947
13-10-2015,10,20311,19855,8312,3244,51723,1371,730,713,2814,54537
13-10-2015,11,20062,19689,8045,3175,50973,1365,712,656,2733,53706
13-10-2015,12,19609,19521,7901,3075,50106,1361,792,700,2853,52959
13-10-2015,13,19618,19429,7641,2887,49575,1310,804,669,2783,52358
13-10-2015,14,19627,19780,7536,2811,49754,1300,868,549,2717,52471
13-10-2015,15,19268,19796,7546,2716,49325,1270,808,535,2613,51938
13-10-2015,16,18942,19815,7738,2743,49238,1112,801,505,2418,51656
13-10-2015,17,19382,19780,8077,2684,49924,1206,803,575,2584,52508
13-10-2015,18,19520,20003,8235,3261,51019,1307,803,746,2856,53875
13-10-2015,19,19420,20140,8119,3360,51038,1299,711,679,2689,53727
13-10-2015,20,18799,19832,7721,2892,49246,913,707,566,2186,51432
13-10-2015,21,17640,19287,7294,2644,46865,817,635,376,1828,48693
13-10-2015,22,16194,19128,7087,2562,44971,821,465,376,1662,46633
13-10-2015,23,14508,18229,6988,2381,42106,824,384,356,1564,43670
14-10-2015,0,13516,16842,7024,2305,39688,819,378,367,1564,41252
14-10-2015,1,12804,16405,6956,2443,38609,820,381,363,1564,40173
14-10-2015,2,12872,16247,6981,2183,38284,846,381,343,1570,39854
14-10-2015,3,12989,16201,7001,2279,38471,840,380,335,1555,40026
14-10-2015,4,13371,16331,7293,2398,39394,892,398,339,1629,41023
14-10-2015,5,14502,17984,7856,2244,42588,1091,502,350,1943,44531
14-10-2015,6,17047,19673,8397,2522,47639,1163,792,369,2324,49963
14-10-2015,7,19957,20224,8313,3384,51877,1178,842,551,2571,54448
14-10-2015,8,20409,20223,8300,3577,52510,1208,930,722,2860,55370
14-10-2015,9,20364,20382,8232,3353,52331,1305,906,689,2900,55231
14-10-2015,10,20219,20392,8050,3495,52157,1275,890,645,2810,54967
14-10-2015,11,19647,19975,7960,3646,51229,1217,908,534,2659,53888
14-10-2015,12,19354,19849,7921,3557,50681,1249,887,694,2830,53511
14-10-2015,13,19256,19710,7878,3306,50152,1167,808,561,2536,52688
14-10-2015,14,19081,19625,7794,3352,49850,1105,698,659,2462,52312
14-10-2015,15,18606,19789,7788,3372,49555,999,749,606,2354,51909
14-10-2015,16,18476,19635,7757,3221,49089,1021,871,509,2401,51490
14-10-2015,17,19139,19722,8095,2916,49871,1100,917,577,2594,52465
14-10-2015,18,19874,20213,8421,2937,51444,1199,838,748,2785,54229
14-10-2015,19,19627,20359,8362,3031,51381,1230,863,623,2716,54097
14-10-2015,20,18548,20097,7733,3049,49429,933,805,590,2328,51757
14-10-2015,21,17399,19709,7199,2989,47295,870,611,426,1907,49202
14-10-2015,22,15757,19299,7081,2747,44884,860,493,431,1784,46668
14-10-2015,23,13890,18397,6960,2710,41957,853,418,414,1685,43642
15-10-2015,0,12101,17827,6971,2739,39638,879,413,399,1691,41329
15-10-2015,1,11608,17434,7015,2849,38905,856,381,398,1635,40540
15-10-2015,2,11336,17451,7034,2799,38621,864,382,407,1653,40274
15-10-2015,3,11378,17448,7133,2746,38706,862,401,409,1672,40378
15-10-2015,4,11786,18020,7389,2683,39878,872,491,415,1778,41656
15-10-2015,5,13159,19462,7816,2786,43224,873,565,417,1855,45079
15-10-2015,6,16271,20581,8299,2932,48082,1041,810,501,2352,50434
15-10-2015,7,19045,21538,8546,3416,52547,1026,983,587,2596,55143
15-10-2015,8,19328,21551,8422,3602,52904,1065,1030,679,2774,55678
15-10-2015,9,19280,21462,8379,3588,52710,1055,1029,648,2732,55442
15-10-2015,10,19261,21337,8387,3478,52464,927,990,637,2554,55018
15-10-2015,11,18636,21174,8227,3607,51644,870,1008,502,2380,54024
15-10-2015,12,17889,20857,8219,3730,50695,872,900,656,2428,53123
15-10-2015,13,17581,20650,8101,3671,50004,809,915,605,2329,52333
15-10-2015,14,17091,20427,7897,3627,49040,796,918,591,2305,51345
15-10-2015,15,17007,20288,7792,3637,48724,775,934,554,2263,50987
15-10-2015,16,16992,20424,7793,3563,48773,792,1037,408,2237,51010
15-10-2015,17,17427,20619,8023,3410,49477,903,1143,431,2477,51954
15-10-2015,18,18223,21182,8381,3347,51133,953,1210,539,2702,53835
15-10-2015,19,17948,21408,8247,3422,51024,938,1070,469,2477,53501
15-10-2015,20,16700,21224,7672,3455,49051,867,939,473,2279,51330
15-10-2015,21,15582,20652,7364,3262,46859,877,653,465,1995,48854
15-10-2015,22,13975,20410,7244,2982,44611,908,500,438,1846,46457
15-10-2015,23,12275,19643,7160,2802,41880,930,506,191,1627,43507
16-10-2015,0,12518,17434,7183,2450,39586,900,603,192,1695,41281
16-10-2015,1,12599,16322,7191,2281,38393,902,602,198,1702,40095
16-10-2015,2,12549,16164,7187,2261,38162,920,602,194,1716,39878
16-10-2015,3,12823,16122,7213,2191,38349,922,655,190,1767,40116
16-10-2015,4,13615,16439,7355,2198,39607,931,775,184,1890,41497
16-10-2015,5,14918,17733,7696,2244,42591,957,801,185,1943,44534
16-10-2015,6,17395,19664,7983,2344,47386,1197,947,344,2488,49874
16-10-2015,7,19709,20964,8130,2862,51666,1126,1239,337,2702,54368
16-10-2015,8,20235,21579,8276,3016,53106,1009,1291,490,2790,55896
16-10-2015,9,20026,21567,8189,3071,52853,1034,1154,425,2613,55466
16-10-2015,10,19313,21572,8103,3123,52111,1025,1246,336,2607,54718
16-10-2015,11,18733,21463,7940,3125,51259,1122,1230,366,2718,53977
16-10-2015,12,18176,21246,7675,3217,50313,1145,1237,370,2752,53065
16-10-2015,13,18164,20714,7551,3119,49549,1045,1246,383,2674,52223
16-10-2015,14,17794,20395,7514,2973,48674,1034,1241,375,2650,51324
16-10-2015,15,17661,20044,7528,2855,48088,919,1220,352,2491,50579
16-10-2015,16,17576,20047,7729,2805,48156,880,1247,192,2319,50475
16-10-2015,17,18559,20149,7950,2683,49342,1086,1427,191,2704,52046
16-10-2015,18,19343,20485,8290,2747,50865,1239,1432,210,2881,53746
16-10-2015,19,18970,20493,8142,2704,50309,1244,1253,213,2710,53019
16-10-2015,20,17818,20045,7466,2376,47705,1018,1162,169,2349,50054
16-10-2015,21,17099,19067,7399,2285,45850,923,849,161,1933,47783
16-10-2015,22,16018,18397,7405,2341,44161,918,645,152,1715,45876
16-10-2015,23,15018,17775,7215,2234,42241,920,636,118,1674,43915
17-10-2015,0,14237,16488,7153,2172,40050,926,622,119,1667,41717
17-10-2015,1,13845,16003,7106,2115,39069,863,603,121,1587,40656
17-10-2015,2,13639,15844,7130,2016,38630,904,557,114,1575,40205
17-10-2015,3,13671,15786,7106,1946,38509,880,558,110,1548,40057
17-10-2015,4,13912,15961,7125,1891,38888,869,585,114,1568,40456
17-10-2015,5,14441,16421,7051,1856,39771,870,554,114,1538,41309
17-10-2015,6,15300,17278,7243,1829,41651,873,700,109,1682,43333
17-10-2015,7,16326,18113,7323,1847,43608,869,749,107,1725,45333
17-10-2015,8,17252,18951,7347,1884,45435,853,825,103,1781,47216
17-10-2015,9,18099,19552,7319,1919,46890,842,777,91,1710,48600
17-10-2015,10,18120,20139,7338,2093,47690,846,719,79,1644,49334
17-10-2015,11,17899,20163,7246,2022,47331,851,721,73,1645,48976
17-10-2015,12,17338,19938,7265,1924,46465,846,717,72,1635,48100
17-10-2015,13,16807,19741,7217,1852,45616,846,714,75,1635,47251
17-10-2015,14,16464,19747,7119,1864,45195,845,715,79,1639,46834
17-10-2015,15,16224,19661,7186,1853,44924,845,716,83,1644,46568
17-10-2015,16,17034,19678,7381,1750,45843,843,715,85,1643,47486
17-10-2015,17,18185,19946,7502,2115,47749,840,719,98,1657,49406
17-10-2015,18,18936,20488,7651,2228,49304,838,722,107,1667,50971
17-10-2015,19,18453,20397,7512,2111,48473,835,725,111,1671,50144
17-10-2015,20,17479,19567,7554,1848,46449,859,725,108,1692,48141
17-10-2015,21,17100,18878,7301,1663,44942,883,655,98,1636,46578
17-10-2015,22,16389,18006,7085,1610,43091,896,600,94,1590,44681
17-10-2015,23,15749,17182,7095,1546,41571,888,535,179,1602,43173
18-10-2015,0,14838,16142,6942,1482,39405,897,423,290,1610,41015
18-10-2015,1,14187,15661,6867,1440,38158,832,420,298,1550,39708
18-10-2015,2,14037,15328,6829,1483,37677,838,423,309,1570,39247
18-10-2015,3,13916,15223,6834,1604,37578,858,419,320,1597,39175
18-10-2015,4,14115,15146,6856,1624,37741,852,426,320,1598,39339
18-10-2015,5,14604,15378,6832,1652,38467,857,444,313,1614,40081
18-10-2015,6,15078,15823,6893,1664,39458,867,483,310,1660,41118
18-10-2015,7,15837,16530,6933,1630,40932,860,506,307,1673,42605
18-10-2015,8,16506,17479,7015,1644,42645,782,506,339,1627,44272
18-10-2015,9,17381,18191,7019,1772,44362,735,545,333,1613,45975
18-10-2015,10,17724,18642,7090,1856,45312,710,549,358,1617,46929
18-10-2015,11,17764,18614,7060,1822,45260,676,527,356,1559,46819
18-10-2015,12,17470,18444,7005,1800,44719,662,505,352,1519,46238
18-10-2015,13,17399,18470,6969,1721,44557,651,481,352,1484,46041
18-10-2015,14,17131,18300,6937,1666,44035,637,469,357,1463,45498
18-10-2015,15,16994,18330,6959,1670,43954,634,452,355,1441,45395
18-10-2015,16,17198,18367,7018,1734,44317,635,493,350,1478,45795
18-10-2015,17,18037,18822,7227,2080,46166,643,649,329,1621,47787
18-10-2015,18,19286,19209,7375,2291,48162,712,715,488,1915,50077
18-10-2015,19,19398,19337,7298,2206,48238,658,717,486,1861,50099
18-10-2015,20,18548,19009,7271,1918,46744,611,699,349,1659,48403
18-10-2015,21,18026,18735,7044,1712,45518,605,511,311,1427,46945
18-10-2015,22,17538,17885,6938,1580,43941,624,441,307,1372,45313
18-10-2015,23,16445,16827,6812,1527,41610,651,408,314,1373,42983
19-10-2015,0,15689,16126,6730,1533,40077,635,404,311,1350,41427
19-10-2015,1,15378,15407,6688,1564,39036,626,406,318,1350,40386
19-10-2015,2,15342,15049,6723,1494,38607,649,404,311,1364,39971
19-10-2015,3,15593,14930,6831,1477,38831,670,403,305,1378,40209
19-10-2015,4,16246,15220,7025,1489,39980,715,410,305,1430,41410
19-10-2015,5,17670,16320,7693,1478,43162,1088,496,312,1896,45058
19-10-2015,6,20336,18484,8336,1863,49019,1284,613,468,2365,51384
19-10-2015,7,22006,19959,8711,2470,53146,1312,779,468,2559,55705
19-10-2015,8,21659,20287,8873,2846,53667,1303,803,512,2618,56285
19-10-2015,9,21354,20352,8864,2948,53519,1321,809,512,2642,56161
19-10-2015,10,21056,20209,8863,2920,53048,1320,801,511,2632,55680
19-10-2015,11,20714,20055,8808,2873,52450,1308,773,504,2585,55035
19-10-2015,12,20432,19618,8670,2776,51496,1298,798,463,2559,54055
19-10-2015,13,20359,19038,8582,2752,50732,1284,800,448,2532,53264
19-10-2015,14,20308,19109,8502,2593,50514,1291,794,430,2515,53029
19-10-2015,15,20123,19311,8389,2738,50560,1288,796,386,2470,53030
19-10-2015,16,19978,19372,8353,2567,50269,1267,797,359,2423,52692
19-10-2015,17,20452,19362,8746,2748,51309,1295,803,432,2530,53839
19-10-2015,18,20512,19844,8942,3294,52592,1276,822,530,2628,55220
19-10-2015,19,20745,19816,8931,3128,52619,1253,693,501,2447,55066
19-10-2015,20,20001,18958,8456,2488,49902,987,544,455,1986,51888
19-10-2015,21,19856,18169,7999,2298,48322,809,455,319,1583,49905
19-10-2015,22,19073,17671,7682,1928,46355,753,411,329,1493,47848
19-10-2015,23,17609,16587,7534,1641,43372,708,402,321,1431,44803
20-10-2015,0,16438,15505,7350,1398,40691,678,398,321,1397,42088
20-10-2015,1,16063,14995,7319,1369,39746,675,399,310,1384,41130
20-10-2015,2,15792,14925,7333,1366,39412,679,398,314,1391,40803
20-10-2015,3,15934,14884,7398,1352,39567,667,398,319,1384,40951
20-10-2015,4,16679,15055,7684,1394,40813,717,410,318,1445,42258
20-10-2015,5,17430,16477,8266,1568,43741,829,522,317,1668,45409
20-10-2015,6,19354,18794,8791,1919,48858,1112,598,467,2177,51035
20-10-2015,7,20975,19528,9256,2445,52203,1140,784,475,2399,54602
20-10-2015,8,21122,19562,9417,2510,52612,1145,790,490,2425,55037
20-10-2015,9,21102,19339,9291,2576,52310,1145,805,569,2519,54829
20-10-2015,10,21016,19460,9294,2672,52442,1121,808,569,2498,54940
20-10-2015,11,20791,19522,9165,2787,52265,1118,825,574,2517,54782
20-10-2015,12,20562,19517,9134,2826,52040,1122,824,493,2439,54479
20-10-2015,13,20559,19433,8887,2521,51401,1148,810,502,2460,53861
20-10-2015,14,20395,19734,8759,2448,51336,1109,807,440,2356,53692
20-10-2015,15,20003,19744,8789,2490,51026,1075,807,403,2285,53311
20-10-2015,16,20192,19318,8879,2521,50909,1073,800,418,2291,53200
20-10-2015,17,20722,19649,9208,2666,52245,1147,813,400,2360,54605
20-10-2015,18,20693,20397,9252,2860,53202,1174,807,488,2469,55671
20-10-2015,19,20685,20313,8936,2677,52612,1178,711,484,2373,54985
20-10-2015,20,20414,19574,8314,2432,50735,943,651,480,2074,52809
20-10-2015,21,19607,18826,8126,2149,48708,871,503,313,1687,50395
20-10-2015,22,17892,18183,8085,1981,46141,751,418,300,1469,47610
20-10-2015,23,16480,17185,7943,1658,43267,716,401,286,1403,44670
21-10-2015,0,15410,15901,7713,1630,40654,696,399,87,1182,41836
21-10-2015,1,14997,15574,7574,1639,39785,695,400,85,1180,40965
21-10-2015,2,14962,15364,7578,1565,39467,678,398,81,1157,40624
21-10-2015,3,15065,15338,7562,1610,39575,678,402,80,1160,40735
21-10-2015,4,15656,15863,7656,1694,40868,685,461,79,1225,42093
21-10-2015,5,16978,16831,8071,1753,43634,904,512,93,1509,45143
21-10-2015,6,18713,18953,8511,2131,48310,1179,715,286,2180,50490
21-10-2015,7,20622,19934,8753,2665,51975,1191,802,346,2339,54314
21-10-2015,8,20733,20195,8768,2981,52676,1186,801,424,2411,55087
21-10-2015,9,20623,19641,8535,2785,51584,1180,799,431,2410,53994
21-10-2015,10,20720,19404,8508,2670,51302,1181,743,418,2342,53644
21-10-2015,11,20444,19919,8445,2644,51453,1187,742,358,2287,53740
21-10-2015,12,19842,19993,8489,2949,51273,1193,741,382,2316,53589
21-10-2015,13,19468,20132,8421,3060,51081,1177,729,384,2290,53371
21-10-2015,14,19064,20109,8290,3020,50483,1133,721,326,2180,52663
21-10-2015,15,18730,20034,8338,3089,50192,1071,740,296,2107,52299
21-10-2015,16,18536,20293,8388,3087,50305,1041,725,294,2060,52365
21-10-2015,17,18952,20609,8747,3291,51599,1191,720,325,2236,53835
21-10-2015,18,18837,20787,8912,3338,51875,1231,752,421,2404,54279
21-10-2015,19,18555,20319,8663,3388,50923,1218,750,318,2286,53209
21-10-2015,20,17156,19930,8045,3334,48464,963,718,298,1979,50443
21-10-2015,21,15803,19334,7763,3372,46272,863,488,188,1539,47811
21-10-2015,22,14139,18750,7587,3316,43794,791,467,75,1333,45127
21-10-2015,23,12079,18047,7604,3101,40833,775,407,75,1257,42090
22-10-2015,0,10986,17151,7509,2734,38381,760,405,77,1242,39623
22-10-2015,1,10467,16588,7477,2558,37089,774,404,79,1257,38346
22-10-2015,2,10203,16380,7438,2495,36516,790,403,79,1272,37788
22-10-2015,3,10411,16357,7355,2459,36582,774,407,81,1262,37844
22-10-2015,4,11256,16454,7450,2564,37725,789,451,83,1323,39048
22-10-2015,5,12685,17665,7856,2686,40891,981,483,96,1560,42451
22-10-2015,6,14960,19885,8224,2770,45837,1287,682,258,2227,48064
22-10-2015,7,17578,21208,8506,3081,50373,1272,710,304,2286,52659
22-10-2015,8,17913,20840,8585,3261,50599,1284,783,395,2462,53061
22-10-2015,9,17647,20487,8483,3354,49969,1282,820,386,2488,52457
22-10-2015,10,17984,20501,8437,3378,50301,1295,841,313,2449,52750
22-10-2015,11,17595,20626,8337,3606,50165,1254,834,282,2370,52535
22-10-2015,12,16770,20637,8362,3704,49473,1258,828,289,2375,51848
22-10-2015,13,16690,20232,8215,3864,49000,1335,829,292,2456,51456
22-10-2015,14,16341,20169,8208,3956,48675,1290,844,299,2433,51108
22-10-2015,15,15943,20326,8048,4050,48366,1342,857,317,2516,50882
22-10-2015,16,15707,20358,8332,3909,48304,1313,833,305,2451,50755
22-10-2015,17,16345,20395,8597,3828,49166,1355,826,324,2505,51671
22-10-2015,18,17088,20521,8697,3831,50137,1359,779,343,2481,52618
22-10-2015,19,16420,20572,8473,3969,49436,1365,729,349,2443,51879
22-10-2015,20,15189,19851,8001,4061,47103,1116,688,306,2110,49213
22-10-2015,21,14084,18884,7712,4297,44975,916,516,184,1616,46591
22-10-2015,22,12663,18079,7575,4413,42729,907,443,208,1558,44287
22-10-2015,23,10932,17084,7475,4337,39826,893,439,232,1564,41390
23-10-2015,0,10141,15673,7329,4302,37446,885,448,231,1564,39010
23-10-2015,1,10087,15151,7121,4212,36573,878,448,242,1568,38141
23-10-2015,2,9877,15147,6958,4090,36073,879,443,238,1560,37633
23-10-2015,3,9980,15155,6935,4057,36128,861,438,230,1529,37657
23-10-2015,4,10215,15590,7341,4122,37268,844,440,233,1517,38785
23-10-2015,5,11370,16816,7960,4038,40184,905,511,251,1667,41851
23-10-2015,6,13446,19273,8397,4038,45154,1133,688,301,2122,47276
23-10-2015,7,15696,21449,8602,3968,49715,1138,719,422,2279,51994
23-10-2015,8,16092,22209,8581,3947,50830,1151,888,418,2457,53287
23-10-2015,9,15902,22313,8521,3893,50627,1122,815,413,2350,52977
23-10-2015,10,15724,21993,8426,4076,50219,1112,714,438,2264,52483
23-10-2015,11,15429,21210,8252,4368,49260,1112,704,367,2183,51443
23-10-2015,12,15063,20995,8145,4346,48548,1105,754,421,2280,50828
23-10-2015,13,14469,20522,7971,4169,47130,1095,704,308,2107,49237
23-10-2015,14,14520,20338,8023,3795,46676,1116,713,237,2066,48742
23-10-2015,15,15074,20013,8010,3430,46528,1103,710,228,2041,48569
23-10-2015,16,16044,20274,8099,2775,47192,1047,708,225,1980,49172
23-10-2015,17,17520,20805,8421,2369,49115,1110,805,250,2165,51280
23-10-2015,18,18724,21535,8741,2337,51338,1129,732,377,2238,53576
23-10-2015,19,17937,20921,8552,2300,49711,1123,730,253,2106,51817
23-10-2015,20,17003,20071,8082,2214,47369,939,722,174,1835,49204
23-10-2015,21,16416,19623,7456,2005,45501,847,512,148,1507,47008
23-10-2015,22,15872,18070,7307,1857,43107,828,454,130,1412,44519
23-10-2015,23,14923,17074,7271,1829,41097,833,424,136,1393,42490
24-10-2015,0,13941,15696,7243,1802,38681,801,423,153,1377,40058
24-10-2015,1,13319,15118,7124,1878,37440,785,422,155,1362,38802
24-10-2015,2,12732,14984,6988,2064,36768,810,428,146,1384,38152
24-10-2015,3,12458,15020,6913,2148,36538,835,421,147,1403,37941
24-10-2015,4,12632,15172,6847,2253,36905,827,423,139,1389,38294
24-10-2015,5,13161,15758,6964,2290,38173,731,424,135,1290,39463
24-10-2015,6,13657,16783,7097,2370,39907,720,443,122,1285,41192
24-10-2015,7,13888,17929,7223,2581,41622,719,446,113,1278,42900
24-10-2015,8,14347,18879,7313,2595,43134,786,494,142,1422,44556
24-10-2015,9,15044,19727,7379,2761,44910,819,484,167,1470,46380
24-10-2015,10,15433,19954,7432,2828,45648,783,486,175,1444,47092
24-10-2015,11,15557,19932,7414,2743,45645,819,476,149,1444,47089
24-10-2015,12,15270,19723,7374,2808,45177,807,477,87,1371,46548
24-10-2015,13,14831,19371,7390,2887,44479,798,476,93,1367,45846
24-10-2015,14,14718,19294,7451,2607,44070,794,476,99,1369,45439
24-10-2015,15,14579,19357,7529,2739,44204,798,476,107,1381,45585
24-10-2015,16,14913,19687,7684,2636,44920,784,479,108,1371,46291
24-10-2015,17,15723,20349,7879,2777,46729,828,486,233,1547,48276
24-10-2015,18,15663,20980,7911,3111,47666,855,539,243,1637,49303
24-10-2015,19,14770,20204,7875,3130,45979,834,503,258,1595,47574
24-10-2015,20,13749,19444,7884,2921,43998,790,497,133,1420,45418
24-10-2015,21,13004,18625,7794,2954,42378,726,494,93,1313,43691
24-10-2015,22,11934,17899,7674,2993,40500,700,440,82,1222,41722
24-10-2015,23,10973,17144,7557,2962,38638,682,408,81,1171,39809
25-10-2015,0,10582,16189,7508,2910,37189,720,409,68,1197,38386
25-10-2015,1,10062,15653,7438,2801,35955,746,408,73,1227,37182
25-10-2015,2,9382,15303,7346,2560,34591,703,410,83,1196,35787
25-10-2015,2,9130,15120,7318,2557,34127,718,406,92,1216,35343
25-10-2015,3,9639,15320,7375,2468,34800,702,412,87,1201,36001
25-10-2015,4,10063,15392,7446,2471,35374,698,416,91,1205,36579
25-10-2015,5,10541,15718,7566,2504,36331,704,428,96,1228,37559
25-10-2015,6,10926,16431,7542,2630,37527,715,443,93,1251,38778
25-10-2015,7,11505,16955,7630,2741,38832,737,478,98,1313,40145
25-10-2015,8,12741,17797,7766,2885,41189,781,513,100,1394,42583
25-10-2015,9,13260,18415,7791,3104,42570,838,520,88,1446,44016
25-10-2015,10,13308,18671,7762,3419,43161,823,518,91,1432,44593
25-10-2015,11,13041,18560,7725,3589,42916,807,509,90,1406,44322
25-10-2015,12,12458,18745,7691,3638,42534,838,503,78,1419,43953
25-10-2015,13,12216,18680,7569,3705,42170,884,488,89,1461,43631
25-10-2015,14,12265,18840,7516,3507,42129,813,485,101,1399,43528
25-10-2015,15,13151,19207,7497,3152,43005,834,499,118,1451,44456
25-10-2015,16,14187,20501,7455,2780,44924,862,613,144,1619,46543
25-10-2015,17,15834,21381,7510,2789,47515,858,709,162,1729,49244
25-10-2015,18,16064,21633,7461,2646,47805,848,649,186,1683,49488
25-10-2015,19,15882,21520,7450,2341,47193,812,530,211,1553,48746
25-10-2015,20,15513,21061,7425,2079,46078,768,498,220,1486,47564
25-10-2015,21,14739,20766,7466,1855,44827,763,463,231,1457,46284
25-10-2015,22,14257,20010,7360,1682,43309,726,453,221,1400,44709
25-10-2015,23,14131,18892,7345,1593,41961,745,461,208,1414,43375
26-10-2015,0,13139,17339,7232,1472,39182,748,470,200,1418,40600
26-10-2015,1,12699,17017,7350,1380,38447,759,466,204,1429,39876
26-10-2015,2,12747,16896,7384,1336,38363,770,468,212,1450,39813
26-10-2015,3,13111,16881,7497,1278,38767,808,468,207,1483,40250
26-10-2015,4,14530,17059,7612,1354,40556,849,496,204,1549,42105
26-10-2015,5,16007,17798,7989,1430,43222,934,565,206,1705,44927
26-10-2015,6,17829,19797,8548,1730,47905,1261,643,365,2269,50174
26-10-2015,7,18818,21007,9045,2043,50912,1396,868,322,2586,53498
26-10-2015,8,19164,20841,8968,2234,51209,1413,1023,331,2767,53976
26-10-2015,9,19127,20749,8947,2332,51155,1397,1018,343,2758,53913
26-10-2015,10,19232,20466,8745,2396,50840,1404,940,370,2714,53554
26-10-2015,11,19028,20525,8540,2419,50512,1404,842,343,2589,53101
26-10-2015,12,18765,20347,8360,2579,50052,1411,701,386,2498,52550
26-10-2015,13,18560,20307,8208,2568,49642,1230,811,403,2444,52086
26-10-2015,14,18723,20378,8394,2450,49946,1356,726,406,2488,52434
26-10-2015,15,18707,20531,8528,2304,50070,1377,727,377,2481,52551
26-10-2015,16,18740,20713,8762,2437,50652,1361,896,340,2597,53249
26-10-2015,17,18951,21203,9108,2788,52052,1348,953,339,2640,54692
26-10-2015,18,18705,21723,9084,2878,52391,1303,927,337,2567,54958
26-10-2015,19,18535,21132,8836,2637,51138,1093,695,330,2118,53256
26-10-2015,20,18243,20746,8159,2278,49425,902,515,324,1741,51166
26-10-2015,21,17565,20016,8036,1977,47594,872,485,162,1519,49113
26-10-2015,22,15986,19264,7963,1932,45145,686,430,144,1260,46405
26-10-2015,23,14479,18410,7866,1837,42593,687,395,138,1220,43813
27-10-2015,0,13924,16629,7850,1833,40238,699,373,131,1203,41441
27-10-2015,1,13521,16196,7809,1727,39253,743,372,127,1242,40495
27-10-2015,2,13211,16284,7819,1692,39007,766,373,132,1271,40278
27-10-2015,3,13567,16199,7852,1716,39334,768,376,144,1288,40622
27-10-2015,4,14509,16425,7982,1730,40645,746,436,153,1335,41980
27-10-2015,5,16131,17315,8195,1755,43397,849,664,171,1684,45081
27-10-2015,6,17881,19941,8596,2125,48544,1130,682,289,2101,50645
27-10-2015,7,19221,21211,8914,3046,52393,1323,885,325,2533,54926
27-10-2015,8,19563,20971,9292,3064,52889,1450,1002,337,2789,55678
27-10-2015,9,19451,20782,9480,2778,52491,1441,962,335,2738,55229
27-10-2015,10,19433,20617,9473,2864,52389,1453,1000,292,2745,55134
27-10-2015,11,18974,20155,9531,3068,51726,1458,910,312,2680,54406
27-10-2015,12,18644,19756,9240,3250,50892,1461,943,308,2712,53604
27-10-2015,13,18874,19669,9183,3143,50868,1426,935,299,2660,53528
27-10-2015,14,18809,19759,9101,3183,50853,1494,894,330,2718,53571
27-10-2015,15,18775,20048,9063,3317,51203,1482,883,291,2656,53859
27-10-2015,16,19487,20315,9459,3469,52730,1481,912,306,2699,55429
27-10-2015,17,19936,20729,9649,4189,54503,1494,1069,353,2916,57419
27-10-2015,18,19666,20796,9514,4153,54129,1494,1230,331,3055,57184
27-10-2015,19,19316,20674,9076,3618,52684,1440,796,299,2535,55219
27-10-2015,20,18655,19798,8662,3309,50424,984,731,291,2006,52430
27-10-2015,21,18040,19259,8399,3047,48746,880,477,131,1488,50234
27-10-2015,22,16971,18269,8118,2978,46337,799,373,123,1295,47632
27-10-2015,23,15593,17440,7789,2817,43638,714,368,118,1200,44838
28-10-2015,0,14405,16483,7729,2529,41145,677,372,122,1171,42316
28-10-2015,1,13886,15992,7702,2586,40167,663,372,126,1161,41328
28-10-2015,2,13468,16156,7768,2637,40029,652,372,127,1151,41180
28-10-2015,3,13498,16443,7877,2803,40622,644,378,132,1154,41776
28-10-2015,4,14165,16719,8246,2898,42030,653,433,141,1227,43257
28-10-2015,5,14928,17264,8804,3099,44095,1089,701,159,1949,46044
28-10-2015,6,16844,19401,9214,3546,49007,1327,912,302,2541,51548
28-10-2015,7,18878,20817,9320,3861,52877,1330,1152,331,2813,55690
28-10-2015,8,19421,20649,9381,3853,53304,1321,1276,318,2915,56219
28-10-2015,9,19603,20408,9350,3805,53167,1305,1257,313,2875,56042
28-10-2015,10,19404,20435,9192,3878,52910,1312,1217,313,2842,55752
28-10-2015,11,19014,20232,9047,3953,52247,1319,1130,310,2759,55006
28-10-2015,12,18821,19993,8878,4063,51754,1320,1113,148,2581,54335
28-10-2015,13,18613,19715,8853,4154,51334,1318,1232,218,2768,54102
28-10-2015,14,18434,19759,8844,4045,51082,1304,1174,238,2716,53798
28-10-2015,15,18638,19928,8914,4010,51492,1301,1181,332,2814,54306
28-10-2015,16,18895,20742,9189,4156,52982,1305,1256,376,2937,55919
28-10-2015,17,19753,21459,9290,4347,54849,1326,1356,406,3088,57937
28-10-2015,18,19430,21561,9184,4234,54409,1342,1396,427,3165,57574
28-10-2015,19,18863,21040,8904,4012,52819,1349,920,416,2685,55504
28-10-2015,20,18253,20333,8589,3700,50876,887,828,341,2056,52932
28-10-2015,21,17922,19794,8167,3372,49255,848,688,238,1774,51029
28-10-2015,22,16929,18950,7931,3104,46915,738,419,237,1394,48309
28-10-2015,23,15808,17914,7794,2737,44252,714,387,239,1340,45592
29-10-2015,0,15415,16561,7748,2562,42288,676,384,244,1304,43592
29-10-2015,1,15249,15711,7634,2512,41107,651,385,244,1280,42387
29-10-2015,2,15260,15518,7686,2312,40776,664,384,241,1289,42065
29-10-2015,3,15681,15564,7740,2236,41220,681,394,241,1316,42536
29-10-2015,4,16431,15768,8054,2238,42491,825,580,249,1654,44145
29-10-2015,5,17302,16471,8522,2201,44495,1380,798,257,2435,46930
29-10-2015,6,18471,18985,8893,2372,48721,1361,977,248,2586,51307
29-10-2015,7,19679,20401,9131,2721,51933,1369,1061,400,2830,54763
29-10-2015,8,19909,20592,9134,3008,52643,1356,1174,371,2901,55544
29-10-2015,9,19759,20456,9022,3158,52395,1348,1192,358,2898,55293
29-10-2015,10,19567,20374,8969,3134,52044,1323,1168,326,2817,54861
29-10-2015,11,19437,20103,8906,3090,51537,1309,1099,329,2737,54274
29-10-2015,12,19295,19907,8847,3103,51152,1333,1184,167,2684,53836
29-10-2015,13,19430,19775,8787,3121,51113,1338,1143,335,2816,53929
29-10-2015,14,19434,19779,8864,3179,51258,1327,1127,319,2773,54031
29-10-2015,15,19117,19885,9086,3107,51196,1334,1128,330,2792,53988
29-10-2015,16,19586,20409,9315,2931,52242,1314,1236,337,2887,55129
29-10-2015,17,20534,20916,9458,3037,53944,1308,1337,570,3215,57159
29-10-2015,18,20586,21080,9381,2876,53923,1308,1730,541,3579,57502
29-10-2015,19,20155,20858,9188,2557,52757,1324,1100,357,2781,55538
29-10-2015,20,19718,20723,8724,2211,51375,938,837,183,1958,53333
29-10-2015,21,19418,20294,8212,2004,49927,748,733,164,1645,51572
29-10-2015,22,18481,19174,7883,1672,47209,616,500,146,1262,48471
29-10-2015,23,17429,17427,7707,1644,44207,679,393,128,1200,45407
30-10-2015,0,16896,15744,7720,1539,41899,699,372,120,1191,43090
30-10-2015,1,16505,15208,7654,1441,40807,698,372,116,1186,41993
30-10-2015,2,16211,15104,7676,1384,40376,690,371,111,1172,41548
30-10-2015,3,16535,15212,7655,1420,40822,679,373,109,1161,41983
30-10-2015,4,16743,15841,8032,1570,42187,809,507,111,1427,43614
30-10-2015,5,17213,16831,8411,1799,44254,1249,875,117,2241,46495
30-10-2015,6,18385,19109,9016,2229,48741,1309,930,292,2531,51272
30-10-2015,7,19299,20121,9380,2687,51486,1310,1184,304,2798,54284
30-10-2015,8,19836,19971,9457,2753,52017,1308,1563,334,3205,55222
30-10-2015,9,20137,20029,9513,2840,52519,1299,1337,385,3021,55540
30-10-2015,10,20232,20504,9490,2979,53205,1294,1243,286,2823,56028
30-10-2015,11,19553,20359,9397,3204,52514,1291,1141,287,2719,55233
30-10-2015,12,19498,19774,9223,3016,51511,1298,940,286,2524,54035
30-10-2015,13,20032,19429,9092,2859,51411,1295,1139,289,2723,54134
30-10-2015,14,20197,19354,9094,2785,51430,1233,1092,286,2611,54041
30-10-2015,15,20625,19553,9094,2720,51991,1252,1099,289,2640,54631
30-10-2015,16,20877,20199,9344,2771,53191,1288,1256,303,2847,56038
30-10-2015,17,21699,20294,9617,2748,54358,1294,1156,325,2775,57133
30-10-2015,18,20955,20239,9444,2698,53336,1288,1067,329,2684,56020
30-10-2015,19,20080,19366,8888,2338,50672,1174,739,321,2234,52906
30-10-2015,20,18937,18677,8330,2267,48211,1076,727,190,1993,50204
30-10-2015,21,18172,18243,8095,2138,46648,907,506,195,1608,48256
30-10-2015,22,16980,17796,7806,2123,44704,771,398,176,1345,46049
30-10-2015,23,15555,17159,7545,1991,42251,675,388,164,1227,43478
31-10-2015,0,14314,16032,7537,1656,39539,665,384,165,1214,40753
31-10-2015,1,13768,15789,7461,1576,38595,630,384,159,1173,39768
31-10-2015,2,13388,15734,7447,1554,38122,633,381,151,1165,39287
31-10-2015,3,13197,15694,7412,1624,37927,635,379,144,1158,39085
31-10-2015,4,13285,15594,7523,1614,38017,662,384,144,1190,39207
31-10-2015,5,13499,15907,7553,1673,38632,770,399,153,1322,39954
31-10-2015,6,13121,17099,7644,1818,39682,798,534,152,1484,41166
31-10-2015,7,14088,17604,7695,1959,41347,832,641,164,1637,42984
31-10-2015,8,15215,17982,7731,2202,43131,960,581,151,1692,44823
31-10-2015,9,16024,18491,7735,2385,44635,985,651,140,1776,46411
31-10-2015,10,16766,18421,7721,2366,45275,968,663,129,1760,47035
31-10-2015,11,16643,18641,7655,2447,45386,939,615,126,1680,47066
31-10-2015,12,16351,18719,7460,2385,44915,932,605,129,1666,46581
31-10-2015,13,16121,18557,7556,2246,44479,928,597,127,1652,46131
31-10-2015,14,16364,18492,7657,2026,44539,928,636,130,1694,46233
31-10-2015,15,17045,18607,7562,1914,45129,939,698,145,1782,46911
31-10-2015,16,18283,19132,7572,1929,46916,968,787,176,1931,48847
31-10-2015,17,18826,19712,7664,2148,48350,1002,729,313,2044,50394
31-10-2015,18,17664,19582,7583,2146,46975,995,731,237,1963,48938
31-10-2015,19,16785,19379,7426,2077,45665,969,700,232,1901,47566
31-10-2015,20,15475,19278,7390,1988,44132,880,595,235,1710,45842
31-10-2015,21,14941,18889,7300,1972,43103,784,446,243,1473,44576
31-10-2015,22,14234,18513,7205,1825,41779,651,391,228,1270,43049
31-10-2015,23,13355,17796,7100,1714,39964,710,394,228,1332,41296
01-11-2015,0,12388,16874,7154,1620,38036,710,381,233,1324,39360
01-11-2015,1,12092,16604,7087,1638,37421,704,379,234,1317,38738
01-11-2015,2,11946,16452,7015,1555,36968,691,371,230,1292,38260
01-11-2015,3,11805,16335,6992,1445,36577,718,369,224,1311,37888
01-11-2015,4,11719,16298,7001,1495,36513,729,378,223,1330,37843
01-11-2015,5,12123,16592,6980,1522,37217,730,384,223,1337,38554
01-11-2015,6,12342,17100,7118,1522,38084,742,400,224,1366,39450
01-11-2015,7,12576,18020,7046,1480,39122,727,439,240,1406,40528
01-11-2015,8,13746,18462,7110,1510,40829,752,477,211,1440,42269
01-11-2015,9,14949,18938,7157,1583,42627,783,534,184,1501,44128
01-11-2015,10,16070,19283,7194,1669,44218,804,547,187,1538,45756
01-11-2015,11,16186,19719,7156,1793,44854,818,522,191,1531,46385
01-11-2015,12,16176,19564,7153,1794,44689,773,514,196,1483,46172
01-11-2015,13,15991,19683,7149,1727,44550,774,489,213,1476,46026
01-11-2015,14,15925,19765,7166,1726,44582,732,512,222,1466,46048
01-11-2015,15,15983,19779,7269,1701,44732,793,540,227,1560,46292
01-11-2015,16,17475,20218,7429,2020,47142,874,736,225,1835,48977
01-11-2015,17,18080,20637,7428,2458,48604,886,776,235,1897,50501
01-11-2015,18,17819,20605,7434,2428,48286,899,753,239,1891,50177
01-11-2015,19,17589,20115,7437,2067,47207,850,749,238,1837,49044
01-11-2015,20,16663,19823,7494,1807,45787,803,622,231,1656,47443
01-11-2015,21,16071,19531,7414,1642,44659,745,493,207,1445,46104
01-11-2015,22,14952,18900,7200,1583,42633,668,370,177,1215,43848
01-11-2015,23,13857,18110,6990,1546,40504,688,368,165,1221,41725
02-11-2015,0,13001,16654,7014,1561,38231,647,371,166,1184,39415
02-11-2015,1,12459,16553,6949,1589,37552,644,375,164,1183,38735
02-11-2015,2,12166,16500,6926,1564,37156,657,372,165,1194,38350
02-11-2015,3,11373,16556,6970,1594,36492,630,370,169,1169,37661
02-11-2015,4,13096,16882,7119,1643,38741,779,391,175,1345,40086
02-11-2015,5,14844,17689,7570,1676,41779,1295,642,180,2117,43896
02-11-2015,6,17041,19761,7993,1894,46689,1391,857,314,2562,49251
02-11-2015,7,18895,21094,8049,2436,50474,1397,1152,349,2898,53372
02-11-2015,8,19531,21023,7969,2494,51017,1381,1299,344,3024,54041
02-11-2015,9,19169,20824,7656,2542,50193,1399,1028,339,2766,52959
02-11-2015,10,18721,20573,8086,2692,50071,1413,1013,401,2827,52898
02-11-2015,11,18615,20458,8029,2678,49781,1411,1170,486,3067,52848
02-11-2015,12,18732,20422,7902,2588,49646,1388,1200,420,3008,52654
02-11-2015,13,18623,20476,7922,2601,49621,1400,1185,378,2963,52584
02-11-2015,14,18677,20331,7951,2545,49504,1389,1141,372,2902,52406
02-11-2015,15,19125,20354,8155,2420,50055,1404,1163,374,2941,52996
02-11-2015,16,20144,21034,8288,2475,51942,1393,1312,410,3115,55057
02-11-2015,17,20411,21453,8247,2720,52832,1357,1331,386,3074,55906
02-11-2015,18,20211,21046,8231,2591,52079,1334,1231,377,2942,55021
02-11-2015,19,19329,20552,7741,2166,49789,1343,804,296,2443,52232
02-11-2015,20,18050,19886,7605,1915,47456,1292,728,198,2218,49674
02-11-2015,21,17329,19489,7462,1661,45942,1214,718,183,2115,48057
02-11-2015,22,15953,18706,7245,1554,43459,1146,578,177,1901,45360
02-11-2015,23,14161,17706,7052,1479,40400,1065,412,171,1648,42048
03-11-2015,0,12807,16455,7128,1535,37925,982,384,166,1532,39457
03-11-2015,1,12238,16116,7042,1546,36942,935,382,165,1482,38424
03-11-2015,2,12163,15811,7045,1473,36492,938,385,160,1483,37975
03-11-2015,3,12745,15896,7077,1470,37187,1033,423,161,1617,38804
03-11-2015,4,13860,16190,7235,1507,38792,1042,479,161,1682,40474
03-11-2015,5,15443,17185,7512,1572,41712,1181,942,160,2283,43995
03-11-2015,6,17911,19086,7911,1811,46720,1255,1073,319,2647,49367
03-11-2015,7,20448,19895,7969,2501,50813,1356,1262,352,2970,53783
03-11-2015,8,21034,19949,7974,2692,51649,1365,1383,354,3102,54751
03-11-2015,9,20536,19712,7750,2608,50606,1351,948,512,2811,53417
03-11-2015,10,20821,19514,7848,2628,50813,1342,891,500,2733,53546
03-11-2015,11,20850,19765,7850,2654,51120,1344,1069,492,2905,54025
03-11-2015,12,20421,19979,7734,2593,50728,1352,1111,486,2949,53677
03-11-2015,13,20355,20231,7808,2455,50848,1346,1088,484,2918,53766
03-11-2015,14,20310,20296,7893,2529,51027,1341,1066,495,2902,53929
03-11-2015,15,20341,20182,8231,2458,51212,1331,1079,518,2928,54140
03-11-2015,16,20952,20320,8469,2896,52636,1345,1260,475,3080,55716
03-11-2015,17,21091,20371,8491,3335,53288,1348,1339,527,3214,56502
03-11-2015,18,20569,20371,8403,2840,52182,1333,1171,530,3034,55216
03-11-2015,19,20111,20184,7900,2687,50882,1114,765,315,2194,53076
03-11-2015,20,19381,19901,7441,2213,48936,778,728,182,1688,50624
03-11-2015,21,18398,19462,7117,2010,46987,735,713,149,1597,48584
03-11-2015,22,16685,19037,6822,1752,44296,750,407,143,1300,45596
03-11-2015,23,15033,17913,6710,1626,41283,719,379,140,1238,42521
04-11-2015,0,13918,16112,6857,1580,38466,697,374,138,1209,39675
04-11-2015,1,13212,15684,6782,1636,37314,671,371,134,1176,38490
04-11-2015,2,13084,15552,6685,1599,36920,675,381,132,1188,38108
04-11-2015,3,13487,15612,6683,1549,37331,675,433,131,1239,38570
04-11-2015,4,14190,15767,6796,1472,38224,704,464,131,1299,39523
04-11-2015,5,15773,16683,7027,1553,41035,682,743,135,1560,42595
04-11-2015,6,17897,18814,7648,1737,46095,741,891,242,1874,47969
04-11-2015,7,20479,19605,7935,2259,50279,830,988,321,2139,52418
04-11-2015,8,20933,19993,7869,2385,51180,814,1067,327,2208,53388
04-11-2015,9,21079,19606,7877,2283,50847,845,1068,324,2237,53084
04-11-2015,10,21048,19913,7779,2319,51059,880,1027,321,2228,53287
04-11-2015,11,20952,20169,7702,2216,51038,860,978,313,2151,53189
04-11-2015,12,20602,20068,7645,2308,50623,867,1015,327,2209,52832
04-11-2015,13,20436,19902,7698,2491,50528,857,996,333,2186,52714
04-11-2015,14,20349,19895,7754,2501,50498,869,970,334,2173,52671
04-11-2015,15,20993,19585,7998,2373,50950,878,820,507,2205,53155
04-11-2015,16,21504,19843,8316,2573,52233,870,930,510,2310,54543
04-11-2015,17,21823,19777,8436,3260,53296,912,981,504,2397,55693
04-11-2015,18,21693,19500,8348,3109,52652,902,900,502,2304,54956
04-11-2015,19,21490,19476,8089,2465,51520,760,732,308,1800,53320
04-11-2015,20,20494,19305,7858,2050,49708,732,732,140,1604,51312
04-11-2015,21,18885,18995,7434,2102,47414,678,722,129,1529,48943
04-11-2015,22,17295,18347,7111,2045,44798,660,457,125,1242,46040
04-11-2015,23,15916,16911,6992,1970,41789,650,383,124,1157,42946
05-11-2015,0,15857,15423,7168,1550,39997,571,398,124,1093,41090
05-11-2015,1,15312,15091,7142,1575,39121,559,366,125,1050,40171
05-11-2015,2,15137,14968,7122,1536,38763,563,364,124,1051,39814
05-11-2015,3,15520,14904,7219,1583,39229,566,457,124,1147,40376
05-11-2015,4,16267,15261,7614,1624,40767,579,558,125,1262,42029
05-11-2015,5,17093,16183,8067,1652,42996,715,1268,131,2114,45110
05-11-2015,6,19464,18173,8399,1786,47822,808,1559,291,2658,50480
05-11-2015,7,21619,19531,8620,2376,52144,1149,1299,321,2769,54913
05-11-2015,8,22196,20043,8685,2389,53314,1186,1264,321,2771,56085
05-11-2015,9,21961,20111,8511,2256,52839,1116,1111,300,2527,55366
05-11-2015,10,21765,19949,8729,2299,52742,1189,1130,316,2635,55377
05-11-2015,11,21753,19885,8764,2340,52742,1194,1211,319,2724,55466
05-11-2015,12,21696,19819,8566,2255,52337,1193,1220,324,2737,55074
05-11-2015,13,21723,20077,8434,2259,52492,1178,1214,317,2709,55201
05-11-2015,14,21757,20139,8538,2197,52632,1154,1195,319,2668,55300
05-11-2015,15,21966,20399,8820,2172,53357,1185,1246,324,2755,56112
05-11-2015,16,22111,20506,8957,2489,54064,1181,1404,411,2996,57060
05-11-2015,17,22095,20762,8979,2883,54720,1193,1437,327,2957,57677
05-11-2015,18,21821,20495,8902,2549,53767,1196,1292,325,2813,56580
05-11-2015,19,21611,19763,8768,2252,52393,785,848,251,1884,54277
05-11-2015,20,21132,19106,8204,1934,50375,694,726,135,1555,51930
05-11-2015,21,20459,18369,7895,1833,48555,621,721,133,1475,50030
05-11-2015,22,19078,17800,7447,1672,45997,616,568,126,1310,47307
05-11-2015,23,17309,16771,7219,1613,42913,630,390,128,1148,44061
06-11-2015,0,16036,15412,7153,1583,40182,640,427,130,1197,41379
06-11-2015,1,15378,15138,7053,1499,39068,634,417,135,1186,40254
06-11-2015,2,15175,15080,6925,1507,38688,629,447,134,1210,39898
06-11-2015,3,15365,15156,6951,1580,39053,633,512,136,1281,40334
06-11-2015,4,16134,15237,7430,1632,40433,690,650,136,1476,41909
06-11-2015,5,17139,15797,8014,1814,42764,1081,934,139,2154,44918
06-11-2015,6,19356,17326,8448,1895,47024,1271,1065,302,2638,49662
06-11-2015,7,21821,18878,8600,2152,51453,1306,1189,305,2800,54253
06-11-2015,8,22345,19143,8565,2391,52445,1305,1302,325,2932,55377
06-11-2015,9,22411,18868,8363,2339,51980,1221,1174,141,2536,54516
06-11-2015,10,22342,19146,8316,2321,52124,1275,1236,206,2717,54841
06-11-2015,11,22220,19168,8305,2297,51990,1306,1292,353,2951,54941
06-11-2015,12,21891,18997,8257,2222,51367,1303,1358,363,3024,54391
06-11-2015,13,21530,18985,8217,2130,50862,1296,1344,335,2975,53837
06-11-2015,14,21345,18887,8318,2001,50550,1297,1269,320,2886,53436
06-11-2015,15,21381,19002,8508,1891,50783,1302,1235,303,2840,53623
06-11-2015,16,21750,19319,8521,1917,51506,1304,1383,407,3094,54600
06-11-2015,17,21748,19499,8452,2277,51975,1310,1346,409,3065,55040
06-11-2015,18,21680,19322,8504,2253,51758,1323,1198,245,2766,54524
06-11-2015,19,21144,18764,8132,2105,50146,1144,1002,150,2296,52442
06-11-2015,20,19637,18441,7655,2119,47851,732,726,154,1612,49463
06-11-2015,21,18320,17961,7400,2110,45791,673,720,152,1545,47336
06-11-2015,22,16850,17651,7038,2305,43845,668,571,156,1395,45240
06-11-2015,23,14953,17063,6687,2350,41054,674,420,158,1252,42306
07-11-2015,0,13453,16068,6396,2441,38360,722,482,164,1368,39728
07-11-2015,1,12659,15843,6339,2547,37389,710,473,166,1349,38738
07-11-2015,2,11743,15696,6362,2600,36401,705,444,165,1314,37715
07-11-2015,3,10784,15388,6281,2612,35064,705,474,164,1343,36407
07-11-2015,4,11443,15515,6325,2534,35817,710,509,169,1388,37205
07-11-2015,5,12439,15813,6440,2497,37191,730,670,172,1572,38763
07-11-2015,6,12606,17007,6918,2578,39111,775,485,177,1437,40548
07-11-2015,7,13738,17240,7185,2395,40561,774,573,187,1534,42095
07-11-2015,8,15083,17961,7325,2213,42582,764,673,192,1629,44211
07-11-2015,9,16416,18535,7461,2283,44695,768,712,193,1673,46368
07-11-2015,10,16957,19025,7493,2228,45704,834,712,188,1734,47438
07-11-2015,11,16985,19088,7548,2250,45871,866,716,186,1768,47639
07-11-2015,12,17070,18937,7512,2295,45814,895,715,191,1801,47615
07-11-2015,13,16772,18736,7466,2160,45134,964,715,190,1869,47003
07-11-2015,14,16740,18469,7688,2040,44937,999,719,189,1907,46844
07-11-2015,15,17076,18332,8011,2193,45613,982,722,185,1889,47502
07-11-2015,16,17968,18388,8171,2668,47196,1155,740,184,2079,49275
07-11-2015,17,18192,18292,8178,3259,47921,1160,742,173,2075,49996
07-11-2015,18,17022,17958,7765,3816,46562,1162,741,170,2073,48635
07-11-2015,19,15594,17614,7424,4230,44861,1034,722,174,1930,46791
07-11-2015,20,14121,17198,7089,4261,42670,920,707,176,1803,44473
07-11-2015,21,12768,16429,6916,4320,40432,897,680,184,1761,42193
07-11-2015,22,11812,16215,6521,4237,38785,897,543,200,1640,40425
07-11-2015,23,10724,15620,6338,3983,36665,820,435,206,1461,38126
08-11-2015,0,10668,14475,6329,3087,34559,776,437,205,1418,35977
08-11-2015,1,10422,14436,6093,3030,33982,755,388,221,1364,35346
08-11-2015,2,9937,14311,6031,3180,33459,750,375,262,1387,34846
08-11-2015,3,9619,14356,5978,3432,33387,740,385,302,1427,34814
08-11-2015,4,9616,14436,6024,3561,33636,728,399,340,1467,35103
08-11-2015,5,9986,14737,6200,3635,34558,729,404,351,1484,36042
08-11-2015,6,10439,15327,6362,3527,35656,758,416,355,1529,37185
08-11-2015,7,11096,15772,6403,3271,36542,761,416,356,1533,38075
08-11-2015,8,13190,16916,6650,2885,39643,815,441,363,1619,41262
08-11-2015,9,14392,17897,6794,2684,41766,843,470,364,1677,43443
08-11-2015,10,14831,18472,6797,2741,42842,889,476,363,1728,44570
08-11-2015,11,15082,18592,6670,2712,43058,857,504,359,1720,44778
08-11-2015,12,15075,18816,6651,2427,42970,796,482,361,1639,44609
08-11-2015,13,15767,18736,6660,2151,43313,790,484,359,1633,44946
08-11-2015,14,16537,18874,6799,1915,44124,795,485,363,1643,45767
08-11-2015,15,17322,19012,7106,1778,45218,874,527,365,1766,46984
08-11-2015,16,18921,19239,7457,1982,47599,896,654,362,1912,49511
08-11-2015,17,20701,19031,7412,2098,49242,777,720,363,1860,51102
08-11-2015,18,20390,18798,7254,2361,48803,784,713,362,1859,50662
08-11-2015,19,19567,18435,7008,2432,47443,811,640,353,1804,49247
08-11-2015,20,18018,18329,6628,2801,45777,759,543,334,1636,47413
08-11-2015,21,16590,17456,6628,3183,43857,746,497,291,1534,45391
08-11-2015,22,15425,16850,6477,3195,41947,735,386,256,1377,43324
08-11-2015,23,13858,16285,6115,3427,39687,751,366,235,1352,41039
09-11-2015,0,11401,15514,6117,3797,36830,700,375,208,1283,38113
09-11-2015,1,9983,15005,6076,3704,34767,702,368,181,1251,36018
09-11-2015,2,9596,15265,6000,3712,34572,713,370,158,1241,35813
09-11-2015,3,9560,15717,6046,3644,34966,746,471,147,1364,36330
09-11-2015,4,10138,16032,6702,3474,36345,787,589,140,1516,37861
09-11-2015,5,12155,16836,7577,3419,39987,1129,802,139,2070,42057
09-11-2015,6,15860,19089,8021,3333,46304,1335,1044,316,2695,48999
09-11-2015,7,18860,20506,8373,3257,50997,1363,1142,372,2877,53874
09-11-2015,8,19670,20650,8430,3324,52074,1313,1179,377,2869,54943
09-11-2015,9,19204,20507,8070,3608,51390,1307,976,360,2643,54033
09-11-2015,10,18829,20341,8292,3962,51424,1399,1049,363,2811,54235
09-11-2015,11,18670,20187,8453,3986,51296,1436,1135,370,2941,54237
09-11-2015,12,18475,20099,8386,4193,51153,1458,1158,373,2989,54142
09-11-2015,13,18284,19973,8353,4381,50992,1479,1159,350,2988,53980
09-11-2015,14,18139,19956,8477,4621,51193,1512,1161,358,3031,54224
09-11-2015,15,18244,20037,8701,4569,51551,1524,1168,367,3059,54610
09-11-2015,16,19005,20247,8796,4771,52819,1532,1304,470,3306,56125
09-11-2015,17,19193,20643,8665,4978,53480,1523,1169,477,3169,56649
09-11-2015,18,18292,20696,8525,4884,52397,1529,1126,461,3116,55513
09-11-2015,19,17549,20191,8026,4928,50694,1395,852,448,2695,53389
09-11-2015,20,16773,19674,7696,4784,48929,814,712,328,1854,50783
09-11-2015,21,15798,18892,7313,4654,46658,885,687,343,1915,48573
09-11-2015,22,13322,17895,6935,4550,42701,862,449,348,1659,44360
09-11-2015,23,11633,16900,6598,4073,39204,784,394,360,1538,40742
10-11-2015,0,11207,15923,6667,3552,37349,764,392,364,1520,38869
10-11-2015,1,10927,15772,6585,3056,36339,744,394,365,1503,37842
10-11-2015,2,10706,15698,6618,2859,35882,730,392,365,1487,37369
10-11-2015,3,10770,15610,6699,3000,36078,736,399,366,1501,37579
10-11-2015,4,11310,15580,7251,3295,37435,757,471,362,1590,39025
10-11-2015,5,12496,16309,7807,3560,40171,1029,702,352,2083,42254
10-11-2015,6,16109,18161,8127,3730,46128,1337,904,411,2652,48780
10-11-2015,7,18976,19412,8274,3938,50599,1358,1018,495,2871,53470
10-11-2015,8,19160,19674,8325,3998,51156,1357,1127,493,2977,54133
10-11-2015,9,19169,19241,8090,4167,50667,1246,893,479,2618,53285
10-11-2015,10,19508,19200,8248,4423,51380,1286,883,471,2640,54020
10-11-2015,11,19022,19489,8180,4581,51272,1283,1128,407,2818,54090
10-11-2015,12,18570,19468,8162,4566,50765,1310,1122,450,2882,53647
10-11-2015,13,18337,19179,8219,4500,50236,1313,1096,436,2845,53081
10-11-2015,14,18737,19174,8319,4217,50447,1332,1092,427,2851,53298
10-11-2015,15,19125,19570,8585,4090,51372,1339,1095,453,2887,54259
10-11-2015,16,19788,20158,8726,4088,52761,1320,1273,460,3053,55814
10-11-2015,17,20290,20106,8663,4178,53237,1341,1270,524,3135,56372
10-11-2015,18,19872,20143,8596,3891,52502,1342,1098,463,2903,55405
10-11-2015,19,18983,20076,8215,3905,51180,1152,865,404,2421,53601
10-11-2015,20,18110,19567,7741,3862,49279,806,665,257,1728,51007
10-11-2015,21,17158,18752,7470,3952,47331,770,662,255,1687,49018
10-11-2015,22,15625,18142,7057,3998,44822,765,414,231,1410,46232
10-11-2015,23,13828,17320,6882,3824,41854,764,405,232,1401,43255
11-11-2015,0,13024,16306,6817,3339,39487,762,396,257,1415,40902
11-11-2015,1,12457,15906,6769,3211,38342,706,397,271,1374,39716
11-11-2015,2,12235,15794,6730,3124,37883,704,401,310,1415,39298
11-11-2015,3,12580,15766,6749,3201,38296,710,406,316,1432,39728
11-11-2015,4,13449,16086,7030,3077,39642,718,461,316,1495,41137
11-11-2015,5,14654,16696,7919,2917,42187,1086,761,314,2161,44348
11-11-2015,6,17280,18553,8360,3009,47202,1356,894,367,2617,49819
11-11-2015,7,20190,19360,8536,2991,51079,1369,863,645,2877,53956
11-11-2015,8,20950,19691,8528,2967,52137,1367,1040,632,3039,55176
11-11-2015,9,20267,19728,8305,2758,51058,1259,981,592,2832,53890
11-11-2015,10,20810,19826,8430,2779,51847,1402,963,553,2918,54765
11-11-2015,11,20741,19956,8365,2758,51821,1406,1086,401,2893,54714
11-11-2015,12,20354,20266,8338,2721,51680,1391,1191,338,2920,54600
11-11-2015,13,20351,20051,8256,2721,51379,1402,1194,356,2952,54331
11-11-2015,14,20612,19744,8285,2911,51550,1400,1191,369,2960,54510
11-11-2015,15,21139,19637,8571,3079,52425,1400,1253,352,3005,55430
11-11-2015,16,22025,19836,8793,3466,54120,1381,1125,556,3062,57182
11-11-2015,17,22150,20239,8792,3909,55088,1396,1087,562,3045,58133
11-11-2015,18,21887,20258,8678,3758,54581,1359,1006,553,2918,57499
11-11-2015,19,21164,19589,8290,3629,52672,1216,711,542,2469,55141
11-11-2015,20,20147,18809,7794,3687,50438,806,719,239,1764,52202
11-11-2015,21,19110,18077,7456,3775,48419,773,724,220,1717,50136
11-11-2015,22,17597,17703,7214,3776,46290,752,419,187,1358,47648
11-11-2015,23,15344,17006,7018,3746,43115,746,396,187,1329,44444
12-11-2015,0,14159,15555,7134,3669,40516,740,454,187,1381,41897
12-11-2015,1,13557,15246,7048,3740,39591,738,457,188,1383,40974
12-11-2015,2,13208,14996,7021,3886,39111,738,454,188,1380,40491
12-11-2015,3,13080,15013,7145,3991,39230,719,475,170,1364,40594
12-11-2015,4,13884,15176,7508,4107,40674,726,611,156,1493,42167
12-11-2015,5,15058,16129,8178,4201,43565,1051,836,151,2038,45603
12-11-2015,6,17213,18223,8649,4066,48151,1332,933,355,2620,50771
12-11-2015,7,20008,19413,8795,3368,51586,1350,1053,437,2840,54426
12-11-2015,8,20541,19522,8752,4122,52937,1354,1126,452,2932,55869
12-11-2015,9,19866,19429,8408,4360,52064,1245,944,481,2670,54734
12-11-2015,10,19992,19102,8493,4547,52134,1326,883,494,2703,54837
12-11-2015,11,19353,19070,8492,4583,51498,1346,1212,339,2897,54395
12-11-2015,12,19154,18985,8589,4664,51392,1343,1299,372,3014,54406
12-11-2015,13,19130,19147,8596,4238,51110,1322,1252,384,2958,54068
12-11-2015,14,19856,19330,8758,3598,51543,1277,1224,387,2888,54431
12-11-2015,15,21224,19985,8833,3139,53181,1301,1329,475,3105,56286
12-11-2015,16,22409,20792,8912,2809,54922,1257,1247,743,3247,58169
12-11-2015,17,22871,21355,8911,3028,56165,1328,1130,610,3068,59233
12-11-2015,18,22552,21237,8852,2924,55566,1332,1029,598,2959,58525
12-11-2015,19,22030,20364,8442,2818,53654,1117,759,509,2385,56039
12-11-2015,20,21629,19623,7895,2785,51932,887,730,396,2013,53945
12-11-2015,21,20994,18860,7597,2673,50125,791,622,378,1791,51916
12-11-2015,22,19425,18189,7391,2666,47672,759,399,345,1503,49175
12-11-2015,23,17378,17153,7196,2986,44713,713,371,339,1423,46136
13-11-2015,0,16228,15446,7138,3093,41904,727,370,341,1438,43342
13-11-2015,1,15150,15177,7031,3138,40496,743,366,313,1422,41918
13-11-2015,2,14778,14861,6928,3187,39755,727,363,262,1352,41107
13-11-2015,3,14792,14975,7041,3399,40208,721,364,210,1295,41503
13-11-2015,4,14999,15315,7403,3552,41268,810,492,199,1501,42769
13-11-2015,5,15234,16213,8219,3805,43470,992,842,192,2026,45496
13-11-2015,6,17225,18260,8835,3945,48265,1074,872,503,2449,50714
13-11-2015,7,19762,19766,8988,4018,52535,1165,1014,514,2693,55228
13-11-2015,8,20243,20227,8937,3913,53320,1214,1161,533,2908,56228
13-11-2015,9,19703,20514,8710,3950,52878,1076,887,490,2453,55331
13-11-2015,10,19657,20884,8811,3709,53061,1217,856,487,2560,55621
13-11-2015,11,19046,20993,8955,4088,53082,1240,1025,506,2771,55853
13-11-2015,12,18481,20788,8862,4332,52463,1223,1209,396,2828,55291
13-11-2015,13,18060,20302,8847,4611,51820,1102,1159,388,2649,54469
13-11-2015,14,17810,20072,8823,4718,51422,1151,976,546,2673,54095
13-11-2015,15,18356,20115,9050,4342,51862,1269,937,575,2781,54643
13-11-2015,16,19259,20502,9232,3758,52751,1301,990,617,2908,55659
13-11-2015,17,20301,20530,9103,3539,53474,1311,934,641,2886,56360
13-11-2015,18,19993,20174,8960,3392,52519,1326,820,645,2791,55310
13-11-2015,19,18967,19680,8267,3457,50373,1130,744,405,2279,52652
13-11-2015,20,17229,19144,7870,3626,47870,934,735,315,1984,49854
13-11-2015,21,16153,18384,7774,3808,46122,904,672,313,1889,48011
13-11-2015,22,14466,17890,7516,4059,43932,934,411,294,1639,45571
13-11-2015,23,12045,16952,7397,4003,40397,1008,386,265,1659,42056
14-11-2015,0,11036,15651,7348,3672,37706,912,378,225,1515,39221
14-11-2015,1,10609,15254,7304,3483,36650,866,374,228,1468,38118
14-11-2015,2,10112,15117,7298,3416,35944,848,371,219,1438,37382
14-11-2015,3,9865,14900,7320,3566,35652,829,365,229,1423,37075
14-11-2015,4,10005,14912,7313,3656,35887,810,412,244,1466,37353
14-11-2015,5,10526,15049,7331,3559,36466,796,554,293,1643,38109
14-11-2015,6,11234,15608,7454,3500,37797,766,496,332,1594,39391
14-11-2015,7,12488,16206,7436,3701,39832,787,589,348,1724,41556
14-11-2015,8,13454,16795,7529,3798,41577,729,691,355,1775,43352
14-11-2015,9,14159,17905,7617,4006,43686,703,681,364,1748,45434
14-11-2015,10,14525,17966,7626,4195,44311,729,701,360,1790,46101
14-11-2015,11,14433,18003,7602,4136,44173,688,699,351,1738,45911
14-11-2015,12,13970,18081,7539,4399,43988,657,696,337,1690,45678
14-11-2015,13,13755,18243,7597,4402,43998,672,696,295,1663,45661
14-11-2015,14,13996,18772,7652,4324,44744,693,729,265,1687,46431
14-11-2015,15,15914,19531,7794,4169,47407,706,826,267,1799,49206
14-11-2015,16,17662,20033,7895,3719,49309,803,818,448,2069,51378
14-11-2015,17,18678,20203,7886,3676,50444,804,800,436,2040,52484
14-11-2015,18,18079,20246,7688,3786,49798,786,787,365,1938,51736
14-11-2015,19,16973,20222,7476,3549,48221,742,799,260,1801,50022
14-11-2015,20,15894,19839,7284,3416,46432,744,695,287,1726,48158
14-11-2015,21,15424,19340,7089,3245,45098,759,557,305,1621,46719
14-11-2015,22,14592,18700,7180,3029,43500,699,379,334,1412,44912
14-11-2015,23,14159,17788,6927,2839,41714,665,369,311,1345,43059
15-11-2015,0,13768,16432,6947,2671,39818,688,348,353,1389,41207
15-11-2015,1,12996,15897,6846,2307,38045,677,360,312,1349,39394
15-11-2015,2,12470,15692,6844,2152,37157,666,379,314,1359,38516
15-11-2015,3,11582,15501,6794,1920,35797,660,383,295,1338,37135
15-11-2015,4,11748,15401,6831,1737,35717,666,404,292,1362,37079
15-11-2015,5,12156,15548,6859,1650,36213,671,472,248,1391,37604
15-11-2015,6,12763,15686,6973,1604,37026,657,435,259,1351,38377
15-11-2015,7,13199,16171,7133,1572,38074,658,482,265,1405,39479
15-11-2015,8,14265,16924,7158,1624,39971,642,615,217,1474,41445
15-11-2015,9,15478,17717,7244,1693,42131,724,702,213,1639,43770
15-11-2015,10,16664,17782,7325,1785,43557,779,708,240,1727,45284
15-11-2015,11,17214,18290,7413,1816,44732,778,707,224,1709,46441
15-11-2015,12,16860,18022,7381,1716,43977,766,706,215,1687,45664
15-11-2015,13,16253,17540,7334,1651,42777,736,704,190,1630,44407
15-11-2015,14,16889,17323,7388,1585,43184,775,784,174,1733,44917
15-11-2015,15,18185,17997,7449,1521,45152,776,909,167,1852,47004
15-11-2015,16,20484,18971,7443,1679,48577,700,1121,155,1976,50553
15-11-2015,17,21722,19741,7597,2166,51227,817,1130,151,2098,53325
15-11-2015,18,21579,19893,7559,1946,50978,826,1097,155,2078,53056
15-11-2015,19,21202,19576,7536,1776,50090,825,1012,152,1989,52079
15-11-2015,20,20013,19302,7475,1711,48503,827,712,145,1684,50187
15-11-2015,21,19325,18409,7309,1650,46693,819,667,146,1632,48325
15-11-2015,22,18706,17751,7010,1700,45168,802,436,142,1380,46548
15-11-2015,23,17356,16968,6865,1694,42883,866,406,139,1411,44294
16-11-2015,0,16979,15414,6788,1821,41003,873,402,138,1413,42416
16-11-2015,1,15955,14965,6838,2001,39760,893,401,142,1436,41196
16-11-2015,2,14738,14512,6812,2098,38160,917,401,144,1462,39622
16-11-2015,3,13578,14438,6802,2380,37197,938,402,133,1473,38670
16-11-2015,4,15076,14544,7130,2782,39532,944,469,132,1545,41077
16-11-2015,5,16977,15380,7857,3184,43399,1046,719,249,2014,45413
16-11-2015,6,20253,17581,8422,3583,49839,1487,908,337,2732,52571
16-11-2015,7,22495,19704,8600,4116,54915,1530,1113,373,3016,57931
16-11-2015,8,22678,20198,8631,4563,56070,1514,1192,389,3095,59165
16-11-2015,9,22001,19732,8456,4653,54841,1343,948,340,2631,57472
16-11-2015,10,22031,19919,8586,4281,54817,1522,933,335,2790,57607
16-11-2015,11,21836,20017,8592,4183,54629,1560,1145,340,3045,57674
16-11-2015,12,21334,20155,8503,4383,54375,1554,1126,347,3027,57402
16-11-2015,13,20920,20378,8469,4477,54245,1557,965,353,2875,57120
16-11-2015,14,20709,20612,8640,4376,54336,1557,1106,362,3025,57361
16-11-2015,15,21253,20889,8854,3971,54967,1562,1213,383,3158,58125
16-11-2015,16,21879,21238,8885,3709,55709,1558,1218,437,3213,58922
16-11-2015,17,22170,21549,8772,3571,56061,1554,1165,452,3171,59232
16-11-2015,18,21806,21446,8609,3243,55104,1549,951,417,2917,58021
16-11-2015,19,20847,21303,8270,3114,53535,1291,750,442,2483,56018
16-11-2015,20,19697,21079,7711,2942,51429,973,716,331,2020,53449
16-11-2015,21,18759,20306,7398,2888,49352,975,687,273,1935,51287
16-11-2015,22,17351,19565,7214,2736,46866,997,426,271,1694,48560
16-11-2015,23,15666,18581,7121,2657,44025,1005,413,277,1695,45720
17-11-2015,0,15074,16876,7118,2398,41466,1018,381,261,1660,43126
17-11-2015,1,14683,16328,7125,2358,40494,1017,379,257,1653,42147
17-11-2015,2,14207,16106,7063,2333,39708,1024,377,250,1651,41359
17-11-2015,3,14257,16017,7131,2305,39710,1036,374,262,1672,41382
17-11-2015,4,15614,16145,7156,2313,41228,1021,507,264,1792,43020
17-11-2015,5,17289,17077,7946,2430,44744,1082,804,255,2141,46885
17-11-2015,6,20113,19141,8473,2673,50399,1299,928,437,2664,53063
17-11-2015,7,22964,20649,8736,3078,55428,1407,1120,452,2979,58407
17-11-2015,8,23344,20949,8570,3383,56247,1462,1237,436,3135,59382
17-11-2015,9,23107,20771,8555,3204,55637,1152,1027,376,2555,58192
17-11-2015,10,23006,20512,8726,2995,55238,1377,1002,371,2750,57988
17-11-2015,11,22707,20490,8631,3083,54910,1370,1183,373,2926,57836
17-11-2015,12,22153,20338,8661,3233,54385,1355,1221,399,2975,57360
17-11-2015,13,22209,19995,8612,3313,54129,1319,1204,409,2932,57061
17-11-2015,14,22282,19851,8759,3137,54029,1308,1199,394,2901,56930
17-11-2015,15,22771,20356,9106,3204,55436,1303,1223,415,2941,58377
17-11-2015,16,22906,20804,9222,3437,56371,1307,1247,467,3021,59392
17-11-2015,17,23533,21064,9145,3525,57267,1317,1217,455,2989,60256
17-11-2015,18,22761,20643,9033,3042,55479,1299,1186,416,2901,58380
17-11-2015,19,22140,20361,8502,2530,53533,947,895,352,2194,55727
17-11-2015,20,21054,19659,7768,2416,50899,900,715,307,1922,52821
17-11-2015,21,19366,18807,7516,2409,48099,918,701,237,1856,49955
17-11-2015,22,17186,17646,7225,2554,44610,942,468,194,1604,46214
17-11-2015,23,15211,16155,7139,2881,41387,931,369,174,1474,42861
18-11-2015,0,13681,14992,7186,3075,38935,911,437,176,1524,40459
18-11-2015,1,12987,14557,7105,3157,37806,912,398,188,1498,39304
18-11-2015,2,12789,14386,7047,3256,37477,905,390,189,1484,38961
18-11-2015,3,13228,14394,7083,3398,38101,915,460,213,1588,39689
18-11-2015,4,14202,14499,7274,3341,39316,947,486,241,1674,40990
18-11-2015,5,15588,15353,7873,3468,42282,1153,701,305,2159,44441
18-11-2015,6,18326,16945,8350,3510,47131,1547,714,466,2727,49858
18-11-2015,7,22249,19012,8556,3570,53387,1588,804,488,2880,56267
18-11-2015,8,22981,19396,8443,3866,54685,1649,892,499,3040,57725
18-11-2015,9,22465,19506,8202,3956,54129,1292,779,488,2559,56688
18-11-2015,10,22289,19367,8297,4289,54241,1490,787,507,2784,57025
18-11-2015,11,21932,19573,8331,4491,54328,1525,987,512,3024,57352
18-11-2015,12,20966,19268,8274,4560,53071,1509,1013,514,3036,56107
18-11-2015,13,20807,19151,8306,4450,52715,1520,965,525,3010,55725
18-11-2015,14,20692,19265,8474,4218,52649,1526,974,522,3022,55671
18-11-2015,15,22075,19850,8791,3827,54543,1519,1111,506,3136,57679
18-11-2015,16,22776,20814,8864,3832,56285,1522,1210,476,3208,59493
18-11-2015,17,22858,21250,8803,3698,56611,1525,1132,507,3164,59775
18-11-2015,18,22330,20813,8709,3568,55421,1514,1018,527,3059,58480
18-11-2015,19,21825,20113,8384,3467,53788,1157,716,522,2395,56183
18-11-2015,20,20483,19281,7818,4008,51590,942,706,351,1999,53589
18-11-2015,21,18398,18112,7402,4480,48393,923,671,320,1914,50307
18-11-2015,22,16162,17068,6998,4535,44761,920,418,269,1607,46368
18-11-2015,23,14458,15961,6781,4602,41801,926,380,259,1565,43366
19-11-2015,0,12842,15429,6783,4406,39459,949,373,275,1597,41056
19-11-2015,1,12217,15184,6744,4266,38411,929,373,286,1588,39999
19-11-2015,2,12158,15121,6723,4152,38156,928,369,299,1596,39752
19-11-2015,3,12390,15146,6771,4027,38334,930,375,303,1608,39942
19-11-2015,4,12861,15456,7111,3853,39283,965,417,322,1704,40987
19-11-2015,5,14060,16308,7860,3964,42192,1239,725,364,2328,44520
19-11-2015,6,17587,18139,8346,4080,48153,1414,892,461,2767,50920
19-11-2015,7,21319,20113,8642,3838,53912,1359,1059,543,2961,56873
19-11-2015,8,21648,20497,8589,3892,54625,1275,1166,566,3007,57632
19-11-2015,9,21121,20410,8228,4236,53994,1194,947,591,2732,56726
19-11-2015,10,20154,20144,8373,4589,53261,1315,946,591,2852,56113
19-11-2015,11,19888,19746,8431,4689,52756,1354,1094,580,3028,55784
19-11-2015,12,19849,19618,8515,4831,52813,1315,1151,585,3051,55864
19-11-2015,13,20530,19750,8429,4746,53456,1376,1142,540,3058,56514
19-11-2015,14,21403,20239,8566,4171,54380,1399,1117,570,3086,57466
19-11-2015,15,22233,20647,8816,3668,55364,1415,1400,558,3373,58737
19-11-2015,16,22715,21196,8918,3741,56570,1493,1294,566,3353,59923
19-11-2015,17,23054,21364,8913,3574,56905,1487,1181,552,3220,60125
19-11-2015,18,22702,21192,8794,3438,56128,1462,1111,547,3120,59248
19-11-2015,19,22310,20667,8482,3175,54634,1045,838,526,2409,57043
19-11-2015,20,21661,20063,7899,3019,52643,804,718,383,1905,54548
19-11-2015,21,20676,19748,7611,2883,50917,871,700,317,1888,52805
19-11-2015,22,19258,18726,7378,2793,48156,935,460,298,1693,49849
19-11-2015,23,17211,17502,7214,2667,44594,943,369,262,1574,46168
20-11-2015,0,17015,16736,7014,2964,43730,930,365,263,1558,45288
20-11-2015,1,16825,16106,6911,2901,42744,927,365,307,1599,44343
20-11-2015,2,16108,15695,6932,2644,41379,927,365,351,1643,43022
20-11-2015,3,16603,15697,7026,2626,41953,912,367,373,1652,43605
20-11-2015,4,17637,15997,7524,2660,43818,860,420,329,1609,45427
20-11-2015,5,18990,17337,8111,2639,47076,1123,732,365,2220,49296
20-11-2015,6,21657,19057,8515,2895,52123,1490,868,466,2824,54947
20-11-2015,7,23970,20989,8730,3458,57147,1494,975,624,3093,60240
20-11-2015,8,24255,21484,8780,3703,58221,1504,1095,614,3213,61434
20-11-2015,9,24324,21476,8496,3680,57976,1450,870,569,2889,60865
20-11-2015,10,24409,21467,8749,4000,58627,1548,856,558,2962,61589
20-11-2015,11,24129,21139,8804,3961,58032,1603,1135,459,3197,61229
20-11-2015,12,24146,21150,8735,3162,57193,1630,1224,420,3274,60467
20-11-2015,13,24080,21222,8591,2882,56774,1599,1229,399,3227,60001
20-11-2015,14,24024,21452,8638,2778,56894,1562,1217,377,3156,60050
20-11-2015,15,24450,21669,8932,2696,57748,1607,1335,428,3370,61118
20-11-2015,16,25045,21852,9041,3131,59070,1606,1193,574,3373,62443
20-11-2015,17,25292,21606,9073,3717,59687,1624,1092,504,3220,62907
20-11-2015,18,24816,21556,8956,3604,58933,1566,989,497,3052,61985
20-11-2015,19,24037,21306,8597,3079,57020,1054,775,498,2327,59347
20-11-2015,20,22496,20966,7890,2911,54262,984,711,316,2011,56273
20-11-2015,21,21230,20512,7697,2852,52291,981,702,141,1824,54115
20-11-2015,22,20259,19589,7605,2793,50247,995,527,131,1653,51900
20-11-2015,23,19421,18164,7342,2771,47698,1032,382,128,1542,49240
21-11-2015,0,18751,17075,7229,2566,45621,1025,443,130,1598,47219
21-11-2015,1,18133,16606,7165,2631,44536,1024,395,130,1549,46085
21-11-2015,2,16634,16272,7051,2701,42658,1013,384,131,1528,44186
21-11-2015,3,15075,16201,6965,2627,40867,1013,440,138,1591,42458
21-11-2015,4,14692,16198,6967,2584,40443,995,479,146,1620,42063
21-11-2015,5,15545,16380,7001,2674,41599,989,531,140,1660,43259
21-11-2015,6,16639,17123,7112,2719,43592,1015,603,142,1760,45352
21-11-2015,7,19496,18409,7292,3024,48222,1017,701,140,1858,50080
21-11-2015,8,21015,19106,7363,3240,50723,1002,707,284,1993,52716
21-11-2015,9,22270,19631,7398,3278,52579,998,711,322,2031,54610
21-11-2015,10,22666,20305,7407,3319,53698,1009,730,334,2073,55771
21-11-2015,11,22706,20342,7494,3268,53811,1014,896,159,2069,55880
21-11-2015,12,22355,20211,7550,3167,53284,1049,902,133,2084,55368
21-11-2015,13,22134,19936,7642,3031,52743,1035,884,133,2052,54795
21-11-2015,14,22274,20041,7825,2872,53012,1014,879,134,2027,55039
21-11-2015,15,22957,19747,8163,2952,53819,1081,1030,142,2253,56072
21-11-2015,16,23765,19536,8325,3348,54973,1151,926,348,2425,57398
21-11-2015,17,24120,19366,8382,3552,55420,1103,808,426,2337,57757
21-11-2015,18,24074,19745,8155,3384,55358,1091,805,348,2244,57602
21-11-2015,19,23188,19327,7855,3286,53656,1069,835,233,2137,55793
21-11-2015,20,22475,18805,7635,3118,52032,1094,733,148,1975,54007
21-11-2015,21,22081,18061,7444,2960,50544,1111,745,154,2010,52554
21-11-2015,22,20846,17453,7358,2982,48638,1117,443,153,1713,50351
21-11-2015,23,19544,16801,7318,3001,46664,1110,390,165,1665,48329
22-11-2015,0,18841,15706,7395,3031,44973,1147,399,184,1730,46703
22-11-2015,1,17395,15350,7206,3018,42970,1116,382,191,1689,44659
22-11-2015,2,17201,15279,7202,3214,42897,1117,381,190,1688,44585
22-11-2015,3,15640,15180,7105,3301,41226,1105,384,205,1694,42920
22-11-2015,4,15106,15191,7089,3271,40657,1082,410,222,1714,42371
22-11-2015,5,15501,15155,7148,3505,41308,1052,433,236,1721,43029
22-11-2015,6,15681,15710,7290,3699,42379,1000,502,244,1746,44125
22-11-2015,7,16262,16547,7442,3936,44188,997,556,244,1797,45985
22-11-2015,8,17411,17329,7439,4242,46422,977,689,222,1888,48310
22-11-2015,9,19192,18371,7605,4181,49349,943,712,222,1877,51226
22-11-2015,10,20544,18724,7740,4538,51546,933,723,211,1867,53413
22-11-2015,11,20658,18506,7729,5002,51895,931,728,204,1863,53758
22-11-2015,12,20459,18422,7739,5115,51735,912,728,196,1836,53571
22-11-2015,13,19285,18478,7778,5043,50586,897,743,200,1840,52426
22-11-2015,14,19064,18348,7699,4956,50066,904,828,185,1917,51983
22-11-2015,15,20465,18401,7949,4897,51714,903,986,180,2069,53783
22-11-2015,16,22688,19316,8125,5050,55179,915,1089,190,2194,57373
22-11-2015,17,23531,20040,8011,4859,56439,912,1113,198,2223,58662
22-11-2015,18,23849,19820,7835,4696,56200,924,1082,178,2184,58384
22-11-2015,19,23620,19486,7777,4706,55590,935,985,172,2092,57682
22-11-2015,20,22861,18979,7651,4508,53999,938,786,169,1893,55892
22-11-2015,21,22326,18726,7542,4227,52820,949,757,165,1871,54691
22-11-2015,22,21505,18172,7444,4046,51167,927,463,138,1528,52695
22-11-2015,23,20704,17474,7248,3698,49124,907,405,138,1450,50574
23-11-2015,0,19037,15661,7244,3419,45362,894,399,135,1428,46790
23-11-2015,1,19818,15081,7442,3407,45748,942,382,134,1458,47206
23-11-2015,2,20157,15131,7448,3274,46008,925,384,130,1439,47447
23-11-2015,3,20836,15369,7636,3155,46997,952,449,139,1540,48537
23-11-2015,4,22044,15914,7965,2997,48920,995,668,140,1803,50723
23-11-2015,5,22898,17252,8490,3020,51659,1164,1079,326,2569,54228
23-11-2015,6,24595,19404,9251,3279,56529,1501,1164,319,2984,59513
23-11-2015,7,24809,20248,9702,4261,59019,1561,1487,515,3563,62582
23-11-2015,8,24648,20082,9615,4673,59018,1523,1587,880,3990,63008
23-11-2015,9,24535,19771,9592,4282,58180,1379,1388,869,3636,61816
23-11-2015,10,24348,19960,9681,4264,58252,1539,1397,858,3794,62046
23-11-2015,11,24372,20030,9661,4145,58209,1404,1392,818,3614,61823
23-11-2015,12,24260,20073,9671,4160,58164,1388,1373,611,3372,61536
23-11-2015,13,23946,20236,9629,4353,58165,1380,1371,503,3254,61419
23-11-2015,14,23635,20388,9663,4431,58118,1399,1379,510,3288,61406
23-11-2015,15,23669,20683,9891,4571,58814,1374,1387,851,3612,62426
23-11-2015,16,23546,20757,9969,4770,59043,1521,1546,922,3989,63032
23-11-2015,17,23704,20684,9989,4745,59122,1610,1547,907,4064,63186
23-11-2015,18,23751,20253,9857,4602,58463,1416,1366,889,3671,62134
23-11-2015,19,23604,19836,9528,4328,57295,1416,1037,484,2937,60232
23-11-2015,20,23548,19921,9018,4414,56900,1180,750,393,2323,59223
23-11-2015,21,23168,19392,8534,4123,55217,998,729,383,2110,57327
23-11-2015,22,21188,19083,7949,4098,52318,987,560,198,1745,54063
23-11-2015,23,19222,17781,7754,4126,48884,1009,557,169,1735,50619
24-11-2015,0,18006,16051,7834,4149,46041,995,563,159,1717,47758
24-11-2015,1,17123,15908,7810,4308,45149,970,565,157,1692,46841
24-11-2015,2,16797,16038,7735,4420,44990,970,563,168,1701,46691
24-11-2015,3,16726,16146,7846,4480,45198,947,576,176,1699,46897
24-11-2015,4,17288,16545,8165,4628,46626,996,631,193,1820,48446
24-11-2015,5,18231,17185,8928,4780,49123,1256,946,216,2418,51541
24-11-2015,6,19887,19481,9378,4817,53563,1536,1138,228,2902,56465
24-11-2015,7,22375,20686,9460,5153,57674,1552,1331,398,3281,60955
24-11-2015,8,22350,21219,9446,5452,58467,1512,1362,585,3459,61926
24-11-2015,9,22514,21110,9317,5373,58314,1328,1153,394,2875,61189
24-11-2015,10,22587,21319,9362,5344,58612,1437,1143,413,2993,61605
24-11-2015,11,21685,21609,9350,5803,58448,1465,1189,418,3072,61520
24-11-2015,12,21519,21378,9355,5696,57948,1435,1212,433,3080,61028
24-11-2015,13,21397,21297,9368,5791,57853,1428,1212,409,3049,60902
24-11-2015,14,21503,21410,9429,5463,57804,1480,1233,437,3150,60954
24-11-2015,15,21951,21519,9593,5611,58673,1491,1398,629,3518,62191
24-11-2015,16,22412,21784,9639,5568,59404,1571,1385,483,3439,62843
24-11-2015,17,23228,21248,9458,5433,59367,1543,1281,474,3298,62665
24-11-2015,18,22871,21028,9247,4924,58072,1620,1162,485,3267,61339
24-11-2015,19,22135,20738,8857,4578,56308,1250,926,437,2613,58921
24-11-2015,20,21185,20416,8205,4339,54146,1184,926,296,2406,56552
24-11-2015,21,20112,19716,7940,4187,51955,1236,872,297,2405,54360
24-11-2015,22,19038,18936,7856,3744,49574,1245,619,294,2158,51732
24-11-2015,23,17365,17779,7752,3582,46481,1247,591,281,2119,48600
25-11-2015,0,16980,15761,7652,3704,44097,1211,589,283,2083,46180
25-11-2015,1,16497,15276,7586,3662,43022,1198,591,273,2062,45084
25-11-2015,2,16539,15102,7577,3526,42744,1186,590,274,2050,44794
25-11-2015,3,16931,15055,7598,3481,43064,1239,591,273,2103,45167
25-11-2015,4,18368,15302,7802,3437,44909,1292,621,275,2188,47097
25-11-2015,5,19730,16603,8235,3355,47923,1223,916,276,2415,50338
25-11-2015,6,21779,19294,9014,3394,53483,1320,968,484,2772,56255
25-11-2015,7,24217,20776,9195,3607,57796,1595,1155,485,3235,61031
25-11-2015,8,24284,21077,9131,3872,58365,1575,1281,477,3333,61698
25-11-2015,9,24270,20926,9019,3846,58061,1319,1079,457,2855,60916
25-11-2015,10,24041,21085,9365,3808,58299,1493,996,454,2943,61242
25-11-2015,11,23893,21051,9422,3897,58266,1449,1157,444,3050,61316
25-11-2015,12,23927,20759,9388,3678,57752,1433,1185,439,3057,60809
25-11-2015,13,24018,20736,9506,3561,57821,1440,1186,442,3068,60889
25-11-2015,14,24420,20542,9729,3776,58466,1503,1203,453,3159,61625
25-11-2015,15,24904,20651,9586,4122,59262,1546,1322,483,3351,62613
25-11-2015,16,25057,20581,9686,4199,59522,1528,1347,512,3387,62909
25-11-2015,17,24685,20450,9686,4166,58987,1550,1453,671,3674,62661
25-11-2015,18,24968,19888,9637,4162,58657,1583,1154,486,3223,61880
25-11-2015,19,24803,19623,9159,3733,57317,1238,936,485,2659,59976
25-11-2015,20,23724,18919,8645,3452,54740,1186,859,348,2393,57133
25-11-2015,21,22678,18734,8278,3483,53173,1161,760,323,2244,55417
25-11-2015,22,21102,18523,7884,3279,50788,1153,593,289,2035,52823
25-11-2015,23,19272,17099,7807,3258,47436,1125,582,265,1972,49408
26-11-2015,0,19092,14870,7811,3057,44830,1118,576,259,1953,46783
26-11-2015,1,18458,14586,7840,3049,43934,1108,574,244,1926,45860
26-11-2015,2,17927,14643,7783,3098,43451,1114,569,233,1916,45367
26-11-2015,3,18374,14670,7761,3122,43927,1129,568,234,1931,45858
26-11-2015,4,19541,14957,7995,3171,45664,1167,606,234,2007,47671
26-11-2015,5,21226,15829,8376,3209,48642,1220,919,234,2373,51015
26-11-2015,6,23025,18478,8960,3504,53968,1378,1093,410,2881,56849
26-11-2015,7,25065,19910,9564,3978,58518,1631,1228,409,3268,61786
26-11-2015,8,25212,20216,9693,4133,59253,1652,1299,439,3390,62643
26-11-2015,9,24742,20302,9522,3727,58293,1573,1108,391,3072,61365
26-11-2015,10,24427,20657,9586,3728,58399,1618,1095,380,3093,61492
26-11-2015,11,24303,20594,9461,3987,58344,1567,1244,402,3213,61557
26-11-2015,12,24465,20525,9405,3736,58131,1497,1266,425,3188,61319
26-11-2015,13,24000,20472,9493,3579,57544,1527,1269,411,3207,60751
26-11-2015,14,24511,20004,9607,3628,57750,1547,1273,403,3223,60973
26-11-2015,15,24441,20128,9903,3735,58209,1563,1359,455,3377,61586
26-11-2015,16,24554,19988,9802,3900,58244,1490,1541,838,3869,62113
26-11-2015,17,24766,19803,9612,3894,58075,1577,1611,741,3929,62004
26-11-2015,18,24697,19793,9487,3601,57577,1551,1244,419,3214,60791
26-11-2015,19,23672,20404,8866,3620,56562,1208,1018,387,2613,59175
26-11-2015,20,22024,19894,8305,3480,53702,1206,925,213,2344,56046
26-11-2015,21,20976,18927,8099,3473,51475,1213,858,201,2272,53747
26-11-2015,22,19086,18463,7877,3620,49046,1218,461,197,1876,50922
26-11-2015,23,16538,17764,7745,3697,45744,1216,406,202,1824,47568
27-11-2015,0,14873,16773,7716,3789,43152,1160,394,211,1765,44917
27-11-2015,1,14081,16613,7616,3833,42142,1175,394,199,1768,43910
27-11-2015,2,13369,16460,7576,4040,41444,1174,393,199,1766,43210
27-11-2015,3,13339,16544,7589,4058,41530,1167,403,215,1785,43315
27-11-2015,4,14134,16722,7762,4205,42823,1186,502,248,1936,44759
27-11-2015,5,15458,17533,8117,4342,45451,1147,888,286,2321,47772
27-11-2015,6,17437,19833,8749,4597,50616,1208,951,573,2732,53348
27-11-2015,7,20536,20699,9034,4724,54995,1221,1059,573,2853,57848
27-11-2015,8,20949,21150,8963,4888,55950,1211,1175,560,2946,58896
27-11-2015,9,20336,20736,8712,5055,54839,1149,1003,477,2629,57468
27-11-2015,10,20452,20801,8786,4938,54977,1191,991,487,2669,57646
27-11-2015,11,19946,20555,8813,5115,54430,1204,1127,469,2800,57230
27-11-2015,12,19615,20229,8815,5169,53827,1184,1170,479,2833,56660
27-11-2015,13,19312,20070,8839,5107,53327,1176,1132,499,2807,56134
27-11-2015,14,19023,19993,9031,5112,53160,1222,1112,509,2843,56003
27-11-2015,15,19243,20018,9130,5133,53523,1257,1139,609,3005,56528
27-11-2015,16,19505,20267,9167,5123,54062,1338,1105,690,3133,57195
27-11-2015,17,18978,20580,8994,5139,53692,1357,1038,693,3088,56780
27-11-2015,18,18165,20357,8782,5117,52421,1351,1079,523,2953,55374
27-11-2015,19,17057,20253,8292,5096,50697,1126,885,485,2496,53193
27-11-2015,20,15545,19626,7880,4943,47995,1119,697,339,2155,50150
27-11-2015,21,14587,18984,7711,4803,46087,1118,692,326,2136,48223
27-11-2015,22,13653,18275,7726,4697,44352,1149,480,310,1939,46291
27-11-2015,23,12544,17384,7432,4815,42176,1105,421,315,1841,44017
28-11-2015,0,11662,16510,7596,4779,40548,1091,417,318,1826,42374
28-11-2015,1,11184,16098,7506,4758,39546,1089,417,315,1821,41367
28-11-2015,2,10964,15966,7422,4729,39080,1083,417,284,1784,40864
28-11-2015,3,10890,15820,7424,4750,38884,1081,416,287,1784,40668
28-11-2015,4,11133,15753,7511,4530,38927,1077,416,285,1778,40705
28-11-2015,5,11876,16058,7581,4147,39661,1086,443,271,1800,41461
28-11-2015,6,12737,16594,7711,3997,41040,1079,581,285,1945,42985
28-11-2015,7,14411,17143,7886,3791,43230,1015,452,285,1752,44982
28-11-2015,8,16121,17915,7982,3532,45551,827,560,265,1652,47203
28-11-2015,9,17095,18744,8078,3622,47538,834,624,271,1729,49267
28-11-2015,10,17799,19164,8142,3755,48860,886,627,257,1770,50630
28-11-2015,11,17975,19096,8089,3958,49119,926,610,276,1812,50931
28-11-2015,12,17938,18969,8136,3926,48970,926,593,338,1857,50827
28-11-2015,13,17995,18920,8147,3884,48946,971,583,315,1869,50815
28-11-2015,14,18145,19146,8219,3718,49228,989,588,297,1874,51102
28-11-2015,15,19127,19157,8273,3810,50368,1035,681,344,2060,52428
28-11-2015,16,20325,19208,8411,3834,51778,1027,667,431,2125,53903
28-11-2015,17,20715,19274,8452,4099,52540,781,668,390,1839,54379
28-11-2015,18,19740,19051,8457,4321,51568,777,669,334,1780,53348
28-11-2015,19,18176,18699,8338,4646,49859,782,665,269,1716,51575
28-11-2015,20,16524,17720,8266,4887,47399,789,647,258,1694,49093
28-11-2015,21,14957,17322,7877,5173,45329,795,528,247,1570,46899
28-11-2015,22,13900,16899,7699,5343,43842,809,419,226,1454,45296
28-11-2015,23,12265,16437,7504,5369,41575,843,400,251,1494,43069
29-11-2015,0,11835,15943,7265,4641,39684,838,394,234,1466,41150
29-11-2015,1,11044,15774,7251,4470,38540,828,387,198,1413,39953
29-11-2015,2,10739,15758,7248,4400,38145,798,382,180,1360,39505
29-11-2015,3,10627,15837,7330,4251,38047,772,380,187,1339,39386
29-11-2015,4,10622,15967,7430,4167,38187,761,387,185,1333,39520
29-11-2015,5,10546,16232,7510,4409,38698,732,477,182,1391,40089
29-11-2015,6,10876,16554,7782,4548,39761,715,511,183,1409,41170
29-11-2015,7,10989,17279,7836,4689,40793,696,605,213,1514,42307
29-11-2015,8,11493,18060,7782,4801,42136,667,734,246,1647,43783
29-11-2015,9,12816,18643,7815,4906,44181,667,702,278,1647,45828
29-11-2015,10,13862,19442,7842,4910,46057,666,705,308,1679,47736
29-11-2015,11,14721,19621,7954,4888,47186,674,671,319,1664,48850
29-11-2015,12,14873,20192,8074,4726,47865,685,673,369,1727,49592
29-11-2015,13,14061,19894,8110,4645,46709,691,662,357,1710,48419
29-11-2015,14,14385,19537,8165,4637,46724,822,687,346,1855,48579
29-11-2015,15,15471,19763,8242,4469,47946,967,796,423,2186,50132
29-11-2015,16,15714,20098,8410,4911,49135,1013,886,449,2348,51483
29-11-2015,17,15984,19574,8483,5344,49385,1036,870,471,2377,51762
29-11-2015,18,15881,19085,8499,5415,48880,1050,761,553,2364,51244
29-11-2015,19,15955,18924,8489,4675,48044,1043,734,418,2195,50239
29-11-2015,20,15888,19315,8240,4155,47598,1042,633,388,2063,49661
29-11-2015,21,15304,18581,8075,4259,46219,1029,419,397,1845,48064
29-11-2015,22,14285,18094,7938,4430,44747,1031,399,392,1822,46569
29-11-2015,23,13516,17354,7898,4461,43228,1014,394,419,1827,45055
30-11-2015,0,12345,16541,7983,4528,41398,1019,406,429,1854,43252
30-11-2015,1,12009,15988,7894,3891,39782,1047,404,429,1880,41662
30-11-2015,2,11949,15938,7807,3857,39550,1086,405,426,1917,41467
30-11-2015,3,12180,16576,7880,3947,40584,1131,404,429,1964,42548
30-11-2015,4,13146,16769,7858,4026,41799,1170,425,427,2022,43821
30-11-2015,5,14478,17462,8135,4443,44519,1157,658,414,2229,46748
30-11-2015,6,17226,20173,8786,4815,50999,1244,862,593,2699,53698
30-11-2015,7,21078,21646,8915,5036,56674,1481,976,600,3057,59731
30-11-2015,8,21493,22003,8827,5547,57871,1462,1118,649,3229,61100
30-11-2015,9,21235,21398,8591,5749,56971,1397,948,611,2956,59927
30-11-2015,10,21410,21195,8803,5704,57112,1483,821,634,2938,60050
30-11-2015,11,21239,21082,8749,5774,56844,1452,987,607,3046,59890
30-11-2015,12,21070,20820,8790,5513,56193,1450,1023,613,3086,59279
30-11-2015,13,21226,20791,8728,5313,56058,1449,1007,601,3057,59115
30-11-2015,14,21378,21022,8819,5074,56293,1560,1093,667,3320,59613
30-11-2015,15,22169,21405,8930,4679,57182,1571,1275,923,3769,60951
30-11-2015,16,23003,21805,8999,4754,58561,1527,1199,833,3559,62120
30-11-2015,17,23358,22006,9077,4455,58896,1522,1053,650,3225,62121
30-11-2015,18,23040,21993,8957,4253,58243,1488,964,643,3095,61338
30-11-2015,19,22439,21896,8610,3874,56820,1155,669,623,2447,59267
30-11-2015,20,21473,21457,8254,3518,54703,1079,660,463,2202,56905
30-11-2015,21,20664,20785,8224,3515,53189,1046,557,425,2028,55217
30-11-2015,22,18327,20364,7999,3736,50426,1033,417,421,1871,52297
30-11-2015,23,14748,18545,7834,3987,45115,1035,393,401,1829,46944
01-12-2015,0,13730,16803,8029,4028,42590,979,394,400,1773,44363
01-12-2015,1,12619,16509,8010,4085,41223,1010,390,386,1786,43009
01-12-2015,2,12101,16614,7940,4362,41017,1036,387,364,1787,42804
01-12-2015,3,12155,16698,7918,4426,41198,997,415,339,1751,42949
01-12-2015,4,13426,17015,7943,4493,42880,991,445,340,1776,44656
01-12-2015,5,16020,18037,8253,4705,47014,1160,722,332,2214,49228
01-12-2015,6,19182,20101,8658,4416,52357,1354,909,575,2838,55195
01-12-2015,7,21749,21574,8854,4530,56708,1447,1096,582,3125,59833
01-12-2015,8,22224,22135,8852,4605,57817,1464,1094,614,3172,60989
01-12-2015,9,22377,22018,8740,4356,57492,1442,1010,620,3072,60564
01-12-2015,10,22084,21825,8544,4343,56797,1401,683,554,2638,59435
01-12-2015,11,22086,21797,8585,4287,56756,1472,664,474,2610,59366
01-12-2015,12,21976,21444,8649,4132,56201,1479,784,665,2928,59129
01-12-2015,13,22018,21270,8601,4041,55932,1461,889,643,2993,58925
01-12-2015,14,22461,21252,8809,3861,56383,1373,957,665,2995,59378
01-12-2015,15,23424,21570,8973,3744,57710,1355,1028,878,3261,60971
01-12-2015,16,24389,22283,9036,3805,59512,1425,951,838,3214,62726
01-12-2015,17,24530,22356,9012,3889,59788,1485,871,783,3139,62927
01-12-2015,18,24396,22310,8926,3699,59330,1486,909,654,3049,62379
01-12-2015,19,24096,22157,8670,3384,58306,1023,670,607,2300,60606
01-12-2015,20,22496,21807,8514,3128,55945,910,637,474,2021,57966
01-12-2015,21,21264,21136,8494,2727,53622,899,556,459,1914,55536
01-12-2015,22,19742,20048,8377,2363,50531,932,425,438,1795,52326
01-12-2015,23,18115,18582,8283,1985,46966,913,403,419,1735,48701
02-12-2015,0,18035,16765,8100,1995,44894,918,399,393,1710,46604
02-12-2015,1,17370,16239,8042,2083,43736,935,398,369,1702,45438
02-12-2015,2,15883,15912,8030,2474,42300,946,408,377,1731,44031
02-12-2015,3,16156,15722,8039,2486,42403,949,439,376,1764,44167
02-12-2015,4,18456,15850,8066,2394,44767,955,498,370,1823,46590
02-12-2015,5,20112,16867,8318,2917,48214,1106,788,375,2269,50483
02-12-2015,6,21901,19145,8718,3365,53129,1455,990,576,3021,56150
02-12-2015,7,23810,20873,8987,3801,57471,1480,1149,706,3335,60806
02-12-2015,8,24351,21181,8932,4048,58513,1464,1101,715,3280,61793
02-12-2015,9,23677,21105,8855,4485,58121,1472,1092,585,3149,61270
02-12-2015,10,23439,21090,8793,4700,58022,1351,999,455,2805,60827
02-12-2015,11,23306,20915,8865,4704,57789,1443,947,501,2891,60680
02-12-2015,12,23063,20774,8865,4535,57237,1438,1224,484,3146,60383
02-12-2015,13,22767,20458,8813,4520,56557,1412,1192,520,3124,59681
02-12-2015,14,22749,20652,8825,4540,56766,1383,1262,700,3345,60111
02-12-2015,15,22820,21095,8886,4521,57323,1357,1697,798,3852,61175
02-12-2015,16,22896,21126,8986,4640,57649,1355,1452,914,3721,61370
02-12-2015,17,22965,21116,9082,4638,57801,1349,1418,756,3523,61324
02-12-2015,18,22571,20808,9142,4357,56877,1343,1220,609,3172,60049
02-12-2015,19,21932,20567,9069,4063,55631,998,908,409,2315,57946
02-12-2015,20,20578,20260,8686,4013,53538,834,727,378,1939,55477
02-12-2015,21,18919,20267,8531,3945,51663,816,743,263,1822,53485
02-12-2015,22,17338,18914,8505,3747,48505,805,429,240,1474,49979
02-12-2015,23,15633,18289,8310,3589,45820,831,440,251,1522,47342
03-12-2015,0,14602,16699,8203,3382,42886,887,391,265,1543,44429
03-12-2015,1,14046,16402,8178,3131,41759,896,394,247,1537,43296
03-12-2015,2,14050,16248,8171,2930,41399,901,395,243,1539,42938
03-12-2015,3,14742,16151,8163,2668,41725,912,405,254,1571,43296
03-12-2015,4,16051,16341,8183,2497,43073,983,566,262,1811,44884
03-12-2015,5,17651,17369,8411,2309,45741,1098,867,285,2250,47991
03-12-2015,6,20343,19436,8675,2623,51077,1447,961,513,2921,53998
03-12-2015,7,23223,20807,8883,2993,55907,1488,1263,520,3271,59178
03-12-2015,8,23537,21027,8920,3211,56694,1497,1229,789,3515,60209
03-12-2015,9,23219,20563,8914,2986,55680,1463,1461,782,3706,59386
03-12-2015,10,23363,20832,8612,2865,55672,1216,1282,640,3138,58810
03-12-2015,11,22814,21092,8827,3013,55747,1418,921,504,2843,58590
03-12-2015,12,22573,20783,8794,3005,55155,1435,1155,484,3074,58229
03-12-2015,13,22624,21167,8893,3181,55863,1421,1162,478,3061,58924
03-12-2015,14,22885,21184,9061,3252,56382,1403,1047,612,3062,59444
03-12-2015,15,23542,21586,9034,3431,57592,1398,1373,644,3415,61007
03-12-2015,16,23444,21778,9116,4002,58338,1436,1203,662,3301,61639
03-12-2015,17,23649,21331,9011,3969,57961,1468,1046,622,3136,61097
03-12-2015,18,23503,21000,8904,3741,57149,1530,933,618,3081,60230
03-12-2015,19,22532,21029,8533,3930,56024,1142,784,475,2401,58425
03-12-2015,20,21239,20369,8348,3909,53865,1010,762,390,2162,56027
03-12-2015,21,19966,19656,8256,3916,51795,1013,602,294,1909,53704
03-12-2015,22,18307,18970,8087,3953,49317,1014,438,273,1725,51042
03-12-2015,23,15969,17983,8004,3829,45786,982,416,279,1677,47463
04-12-2015,0,14500,16569,8039,3890,42998,990,413,251,1654,44652
04-12-2015,1,13364,16546,7965,4330,42205,972,415,233,1620,43825
04-12-2015,2,12825,16425,7923,4407,41582,971,418,231,1620,43202
04-12-2015,3,12403,16552,7850,4559,41364,972,437,244,1653,43017
04-12-2015,4,12795,16630,7948,4577,41949,1018,503,272,1793,43742
04-12-2015,5,14016,17650,8466,4766,44899,1168,631,308,2107,47006
04-12-2015,6,16680,19902,9000,5033,50615,1403,1040,331,2774,53389
04-12-2015,7,19382,21316,9169,5257,55123,1530,1123,520,3173,58296
04-12-2015,8,20086,21320,9122,5562,56091,1536,1117,611,3264,59355
04-12-2015,9,20070,21102,9006,5436,55614,1575,974,787,3336,58950
04-12-2015,10,19887,21359,8780,5277,55304,1467,760,791,3018,58322
04-12-2015,11,19525,21468,9005,5352,55350,1567,824,639,3030,58380
04-12-2015,12,19400,21838,8972,5474,55685,1549,947,743,3239,58924
04-12-2015,13,18927,21878,8921,5461,55187,1525,910,660,3095,58282
04-12-2015,14,18650,21908,8988,5208,54755,1678,925,645,3248,58003
04-12-2015,15,18759,21442,9032,5159,54394,1687,840,961,3488,57882
04-12-2015,16,19577,21533,8871,5079,55061,1747,837,932,3516,58577
04-12-2015,17,20169,21747,8731,4838,55484,1816,920,679,3415,58899
04-12-2015,18,19090,22103,8619,4597,54409,1766,814,672,3252,57661
04-12-2015,19,18098,21641,8340,4708,52787,1260,742,489,2491,55278
04-12-2015,20,16851,20814,7867,4476,50008,1147,747,485,2379,52387
04-12-2015,21,15739,19986,7816,4708,48249,1150,520,475,2145,50394
04-12-2015,22,14677,19019,7697,4861,46254,1151,426,498,2075,48329
04-12-2015,23,13789,17885,7596,4750,44019,1164,411,461,2036,46055
05-12-2015,0,13258,16230,7749,4585,41822,1133,411,460,2004,43826
05-12-2015,1,12794,15635,7567,4692,40688,1088,421,458,1967,42655
05-12-2015,2,12158,15617,7336,4766,39877,1095,419,459,1973,41850
05-12-2015,3,11928,15688,7209,4798,39623,1082,420,461,1963,41586
05-12-2015,4,11770,15836,7202,4785,39595,1084,426,465,1975,41570
05-12-2015,5,11960,16152,7276,4850,40239,1081,420,462,1963,42202
05-12-2015,6,12207,16756,7551,4897,41411,1086,442,454,1982,43393
05-12-2015,7,12832,17701,7796,4990,43320,1057,475,423,1955,45275
05-12-2015,8,13608,18159,7990,5045,44802,1036,493,431,1960,46762
05-12-2015,9,14631,19213,8080,5112,47036,1019,537,440,1996,49032
05-12-2015,10,14783,19462,8255,4978,47479,1022,567,448,2037,49516
05-12-2015,11,15059,19517,8250,4780,47608,958,561,460,1979,49587
05-12-2015,12,15248,19474,8334,4691,47745,907,538,455,1900,49645
05-12-2015,13,15215,19371,8357,4669,47611,912,538,441,1891,49502
05-12-2015,14,15035,19475,8404,4744,47659,983,553,430,1966,49625
05-12-2015,15,15446,20055,8493,4861,48856,1035,728,429,2192,51048
05-12-2015,16,15749,20994,8542,5006,50291,1090,766,455,2311,52602
05-12-2015,17,15572,21196,8497,5283,50548,1096,717,469,2282,52830
05-12-2015,18,15075,20675,8425,5253,49428,1107,649,470,2226,51654
05-12-2015,19,14005,19995,8214,5096,47311,1104,646,466,2216,49527
05-12-2015,20,13630,19261,8047,4553,45492,1118,548,466,2132,47624
05-12-2015,21,13127,18648,7959,4690,44424,1142,463,471,2076,46500
05-12-2015,22,12700,17813,7842,4603,42958,1122,445,460,2027,44985
05-12-2015,23,12079,17120,7500,4557,41255,1124,440,458,2022,43277
06-12-2015,0,12102,16519,7214,4373,40208,1152,421,463,2036,42244
06-12-2015,1,11113,16191,7106,4256,38667,1135,420,462,2017,40684
06-12-2015,2,10613,16043,7061,4319,38035,1123,419,462,2004,40039
06-12-2015,3,10595,16026,7022,4304,37948,1133,421,464,2018,39966
06-12-2015,4,11036,16146,7081,4427,38690,1135,432,469,2036,40726
06-12-2015,5,11174,16146,7236,4460,39017,1134,435,468,2037,41054
06-12-2015,6,11001,16131,7375,4854,39361,1127,436,463,2026,41387
06-12-2015,7,12058,16265,7476,4697,40496,1116,471,457,2044,42540
06-12-2015,8,13231,16965,7552,4763,42511,1103,494,459,2056,44567
06-12-2015,9,13543,17616,7768,4998,43923,1107,542,502,2151,46074
06-12-2015,10,14027,18350,7902,5044,45323,1066,591,464,2121,47444
06-12-2015,11,14283,18913,7988,5088,46272,1037,607,468,2112,48384
06-12-2015,12,13567,19503,8087,5062,46222,1029,594,468,2091,48313
06-12-2015,13,13275,19636,8155,5018,46083,991,588,464,2043,48126
06-12-2015,14,13474,19959,8199,5068,46702,957,573,516,2046,48748
06-12-2015,15,14045,21335,8260,5123,48762,965,725,548,2238,51000
06-12-2015,16,14432,22026,8352,5228,50037,1034,719,638,2391,52428
06-12-2015,17,14682,22490,8367,5133,50672,1019,674,642,2335,53007
06-12-2015,18,14734,22490,8291,4933,50448,1038,584,691,2313,52761
06-12-2015,19,14644,22213,8287,4868,50012,1029,658,529,2216,52228
06-12-2015,20,14355,21799,8230,4792,49176,1025,549,528,2102,51278
06-12-2015,21,14294,20977,8144,4660,48074,1043,453,467,1963,50037
06-12-2015,22,13888,19997,7971,4667,46524,1062,414,463,1939,48463
06-12-2015,23,13411,18599,7721,4376,44108,1088,410,458,1956,46064
07-12-2015,0,12951,17717,7585,4185,42439,1086,415,458,1959,44398
07-12-2015,1,12364,17412,7546,4001,41322,1080,413,457,1950,43272
07-12-2015,2,12425,17479,7543,3872,41320,1089,418,456,1963,43283
07-12-2015,3,12457,17598,7604,3711,41371,1083,417,458,1958,43329
07-12-2015,4,12627,18610,7768,3503,42507,1085,443,462,1990,44497
07-12-2015,5,13370,20919,8422,3219,45929,1084,555,462,2101,48030
07-12-2015,6,17407,22188,8865,3044,51504,1174,937,673,2784,54288
07-12-2015,7,20832,23377,9060,3147,56416,1439,1340,675,3454,59870
07-12-2015,8,21433,23851,8986,3355,57625,1416,1341,816,3573,61198
07-12-2015,9,21402,23295,9021,3208,56924,1346,1324,813,3483,60407
07-12-2015,10,21698,23147,9038,3065,56949,1306,1230,664,3200,60149
07-12-2015,11,21690,23229,9056,3169,57145,1281,1180,666,3127,60272
07-12-2015,12,21607,22776,8960,3042,56385,1243,1345,738,3326,59711
07-12-2015,13,22071,22718,8938,2568,56295,1209,1442,625,3276,59571
07-12-2015,14,22410,22730,9065,2460,56665,1325,1444,645,3414,60079
07-12-2015,15,22970,22946,9154,2570,57641,1457,1450,785,3692,61333
07-12-2015,16,23276,22886,9167,3072,58402,1466,1464,744,3674,62076
07-12-2015,17,23324,22768,9174,3179,58445,1452,1536,596,3584,62029
07-12-2015,18,23144,22791,9051,3150,58137,1451,1351,665,3467,61604
07-12-2015,19,22883,22391,8842,2980,57098,1290,1294,502,3086,60184
07-12-2015,20,22049,21966,8735,2901,55652,1187,1091,488,2766,58418
07-12-2015,21,20945,21623,8613,2653,53834,1197,741,465,2403,56237
07-12-2015,22,19413,20987,8437,2521,51358,1188,427,278,1893,53251
07-12-2015,23,17802,19681,8176,2471,48131,1191,408,248,1847,49978
08-12-2015,0,16841,17958,8166,2571,45536,1175,412,235,1822,47358
08-12-2015,1,16184,17358,7997,2563,44102,1171,415,223,1809,45911
08-12-2015,2,16046,17060,7959,2655,43720,1184,416,201,1801,45521
08-12-2015,3,16012,17055,7972,2763,43802,1202,417,197,1816,45618
08-12-2015,4,16636,17318,8169,2807,44931,1237,524,195,1956,46887
08-12-2015,5,17507,18850,8392,2973,47722,1228,763,331,2322,50044
08-12-2015,6,20056,20641,8752,3103,52552,1354,1017,382,2753,55305
08-12-2015,7,22655,22163,8933,3537,57289,1604,1038,549,3191,60480
08-12-2015,8,23003,22409,8911,3902,58226,1602,1124,553,3279,61505
08-12-2015,9,22338,22129,8869,4108,57444,1543,1143,546,3232,60676
08-12-2015,10,22428,21969,8700,4046,57144,1329,1039,392,2760,59904
08-12-2015,11,22223,21947,8624,4004,56799,1523,916,386,2825,59624
08-12-2015,12,22269,21878,8611,3968,56727,1519,1155,434,3108,59835
08-12-2015,13,22297,21974,8720,3685,56675,1394,1153,439,2986,59661
08-12-2015,14,22200,22268,8766,3657,56891,1463,1281,532,3276,60167
08-12-2015,15,21967,22458,8826,3705,56955,1482,1438,671,3591,60546
08-12-2015,16,21967,22831,8785,3784,57368,1500,1412,681,3593,60961
08-12-2015,17,22046,22470,8781,4023,57319,1523,1190,695,3408,60727
08-12-2015,18,21237,21934,8725,4126,56022,1534,1101,647,3282,59304
08-12-2015,19,20303,21497,8685,4254,54738,1292,797,440,2529,57267
08-12-2015,20,19367,20909,8345,4159,52781,1215,792,431,2438,55219
08-12-2015,21,18252,20420,7980,3998,50650,1210,752,327,2289,52939
08-12-2015,22,16951,19977,7716,3754,48396,1244,443,278,1965,50361
08-12-2015,23,15008,18957,7487,3554,45007,1246,416,300,1962,46969
09-12-2015,0,14065,17408,7451,3459,42384,1251,412,296,1959,44343
09-12-2015,1,13608,16839,7451,3324,41221,1199,412,300,1911,43132
09-12-2015,2,13301,16791,7421,3271,40784,1207,416,282,1905,42689
09-12-2015,3,13322,16824,7494,3304,40944,1208,422,280,1910,42854
09-12-2015,4,13789,17108,7561,3265,41723,1215,473,276,1964,43687
09-12-2015,5,14662,18112,8120,3349,44244,1219,593,277,2089,46333
09-12-2015,6,16734,19764,8684,3683,48867,1333,937,386,2656,51523
09-12-2015,7,19765,21474,8843,3867,53949,1486,958,638,3082,57031
09-12-2015,8,20355,21982,8906,4199,55441,1490,921,638,3049,58490
09-12-2015,9,20315,21787,8784,4225,55112,1454,934,654,3042,58154
09-12-2015,10,20204,21855,8499,4384,54940,1302,950,541,2793,57733
09-12-2015,11,19588,21900,8679,4404,54572,1339,863,517,2719,57291
09-12-2015,12,19461,21926,8707,3992,54086,1427,952,507,2886,56972
09-12-2015,13,19676,21954,8805,3731,54165,1466,959,536,2961,57126
09-12-2015,14,19881,22021,8927,3539,54369,1490,1048,524,3062,57431
09-12-2015,15,20507,22479,8929,3765,55680,1543,1220,711,3474,59154
09-12-2015,16,20627,23078,8946,4199,56851,1470,1082,774,3326,60177
09-12-2015,17,20613,23088,8838,4378,56917,1474,1051,657,3182,60099
09-12-2015,18,20040,22744,8708,4637,56130,1482,947,659,3088,59218
09-12-2015,19,18930,22129,8477,4878,54415,1299,888,515,2702,57117
09-12-2015,20,17867,21662,8090,4751,52370,1202,771,496,2469,54839
09-12-2015,21,16752,21211,7827,4797,50586,1218,613,358,2189,52775
09-12-2015,22,15334,20015,7604,4902,47854,1233,434,352,2019,49873
09-12-2015,23,13600,18706,7541,4813,44660,1229,428,341,1998,46658
10-12-2015,0,12478,17793,7501,4713,42486,1214,421,316,1951,44437
10-12-2015,1,11958,17121,7399,4737,41214,1205,430,309,1944,43158
10-12-2015,2,11941,16804,7297,4816,40858,1185,422,305,1912,42770
10-12-2015,3,11807,16843,7370,4841,40863,1159,413,322,1894,42757
10-12-2015,4,12209,17342,7578,5042,42172,1155,436,333,1924,44096
10-12-2015,5,13102,18244,8092,5070,44510,1176,619,349,2144,46654
10-12-2015,6,15621,19970,8621,5009,49222,1338,1049,398,2785,52007
10-12-2015,7,17798,21806,8877,5380,53861,1461,996,633,3090,56951
10-12-2015,8,18082,22178,8902,5560,54721,1425,1071,523,3019,57740
10-12-2015,9,17914,22271,8705,5475,54366,1428,983,585,2996,57362
10-12-2015,10,18379,22251,8582,5477,54688,1165,815,478,2458,57146
10-12-2015,11,18367,22487,8644,5373,54871,1251,812,394,2457,57328
10-12-2015,12,18342,22494,8743,5443,55022,1198,980,548,2726,57748
10-12-2015,13,18222,22556,8849,5523,55148,1341,950,556,2847,57995
10-12-2015,14,18255,22551,8908,5548,55262,1432,968,574,2974,58236
10-12-2015,15,18906,22675,8922,5411,55916,1452,1260,633,3345,59261
10-12-2015,16,19461,22952,8820,5292,56526,1466,1194,625,3285,59811
10-12-2015,17,19743,22729,8712,4968,56152,1472,1046,693,3211,59363
10-12-2015,18,19194,22905,8519,4555,55173,1469,968,654,3091,58264
10-12-2015,19,18793,22840,8247,4355,54236,1277,801,600,2678,56914
10-12-2015,20,18168,22387,7890,4223,52668,1222,794,465,2481,55149
10-12-2015,21,17458,22003,7645,4145,51252,1204,488,469,2161,53413
10-12-2015,22,16028,20885,7476,4060,48450,1211,452,448,2111,50561
10-12-2015,23,14801,19483,7328,3875,45486,1215,446,425,2086,47572
11-12-2015,0,14438,17765,7312,3722,43237,1204,442,406,2052,45289
11-12-2015,1,14086,17048,7290,3649,42073,1196,441,426,2063,44136
11-12-2015,2,14201,16945,7263,3551,41960,1186,442,424,2052,44012
11-12-2015,3,14390,17260,7264,3448,42362,1137,442,424,2003,44365
11-12-2015,4,14843,17592,7481,3424,43340,1141,451,431,2023,45363
11-12-2015,5,16264,18601,8025,3440,46331,1239,521,457,2217,48548
11-12-2015,6,18627,20309,8626,3756,51318,1331,791,567,2689,54007
11-12-2015,7,20733,22201,8908,4098,55939,1269,1118,763,3150,59089
11-12-2015,8,21425,22485,8876,4691,57478,1209,1129,770,3108,60586
11-12-2015,9,21604,22258,8866,4603,57332,1161,1053,771,2985,60317
11-12-2015,10,21399,22449,8711,4669,57229,1126,806,478,2410,59639
11-12-2015,11,20939,22382,8698,4840,56860,1112,890,555,2557,59417
11-12-2015,12,20485,22085,8713,4699,55982,1142,1164,536,2842,58824
11-12-2015,13,20318,21676,8693,4623,55310,1169,1097,607,2873,58183
11-12-2015,14,20743,21728,8731,4529,55729,1197,1329,649,3175,58904
11-12-2015,15,20873,22095,8881,4687,56536,1172,1275,764,3211,59747
11-12-2015,16,21680,22670,8909,4744,58002,1151,1269,737,3157,61159
11-12-2015,17,21818,22843,8813,4607,58081,1163,1126,688,2977,61058
11-12-2015,18,21168,22609,8689,4404,56871,1243,848,709,2800,59671
11-12-2015,19,20329,22362,8393,3891,54974,1207,719,370,2296,57270
11-12-2015,20,19495,21688,8061,3571,52814,1045,662,413,2120,54934
11-12-2015,21,18468,20978,7943,3399,50788,1008,496,436,1940,52728
11-12-2015,22,16998,19887,7710,3166,47761,980,452,417,1849,49610
11-12-2015,23,15117,18948,7587,3077,44727,898,440,401,1739,46466
12-12-2015,0,14548,17305,7502,3203,42558,881,413,378,1672,44230
12-12-2015,1,14015,16454,7375,3308,41153,895,419,387,1701,42854
12-12-2015,2,13687,16317,7354,3310,40669,896,408,414,1718,42387
12-12-2015,3,13675,16227,7484,3323,40708,877,415,439,1731,42439
12-12-2015,4,13842,16178,7520,3312,40852,858,432,426,1716,42568
12-12-2015,5,14392,16415,7593,3253,41653,850,461,419,1730,43383
12-12-2015,6,15356,17047,7705,3206,43314,852,475,426,1753,45067
12-12-2015,7,17335,18616,7803,3296,47049,846,486,414,1746,48795
12-12-2015,8,19220,19543,7853,3275,49891,832,530,388,1750,51641
12-12-2015,9,19902,20462,7951,3241,51556,832,576,368,1776,53332
12-12-2015,10,20392,20839,8020,3349,52601,838,595,408,1841,54442
12-12-2015,11,20239,21021,8022,3410,52691,831,595,409,1835,54526
12-12-2015,12,20028,20914,8109,3387,52438,773,603,395,1771,54209
12-12-2015,13,19751,20897,8219,3330,52198,739,648,379,1766,53964
12-12-2015,14,19982,21031,8412,3149,52574,817,669,356,1842,54416
12-12-2015,15,21354,21623,8573,2787,54338,850,989,373,2212,56550
12-12-2015,16,22227,22111,8627,2765,55729,828,1147,368,2343,58072
12-12-2015,17,22820,22410,8646,2754,56631,820,831,676,2327,58958
12-12-2015,18,22655,22333,8611,2926,56525,841,895,362,2098,58623
12-12-2015,19,21752,21724,8439,2815,54731,790,692,355,1837,56568
12-12-2015,20,21297,20638,8128,2621,52684,836,627,342,1805,54489
12-12-2015,21,20858,19864,8050,2561,51333,836,474,339,1649,52982
12-12-2015,22,20626,18904,7863,2278,49670,873,443,324,1640,51310
12-12-2015,23,19662,17949,7627,2166,47404,846,427,318,1591,48995
13-12-2015,0,17811,16734,7469,1982,43997,848,416,307,1571,45568
13-12-2015,1,16479,16024,7470,2142,42116,847,413,289,1549,43665
13-12-2015,2,16041,15653,7497,2164,41356,857,413,262,1532,42888
13-12-2015,3,15970,15486,7476,2257,41190,856,414,264,1534,42724
13-12-2015,4,15992,15409,7513,2451,41364,841,423,272,1536,42900
13-12-2015,5,16314,15523,7593,2834,42264,834,427,294,1555,43819
13-12-2015,6,16703,15797,7641,3262,43404,837,431,263,1531,44935
13-12-2015,7,17672,16338,7670,3335,45016,831,474,238,1543,46559
13-12-2015,8,19563,17810,7808,3358,48538,824,575,250,1649,50187
13-12-2015,9,21945,18969,7941,3452,52308,784,758,232,1774,54082
13-12-2015,10,23073,19436,7949,3401,53860,735,778,223,1736,55596
13-12-2015,11,23376,19805,7893,3498,54572,720,787,202,1709,56281
13-12-2015,12,23236,19950,7887,3502,54576,717,787,196,1700,56276
13-12-2015,13,23159,19989,8036,3348,54533,699,804,194,1697,56230
13-12-2015,14,23439,20196,8342,3296,55274,681,878,180,1739,57013
13-12-2015,15,23864,20844,8519,3251,56478,808,984,381,2173,58651
13-12-2015,16,24321,21840,8519,3292,57971,839,914,585,2338,60309
13-12-2015,17,24456,22271,8581,3427,58734,866,1001,420,2287,61021
13-12-2015,18,24523,22200,8507,3289,58520,967,805,599,2371,60891
13-12-2015,19,24500,22137,8476,3046,58159,826,759,418,2003,60162
13-12-2015,20,24425,21837,8250,2750,57265,873,759,246,1878,59143
13-12-2015,21,24238,21298,8135,2567,56239,889,728,269,1886,58125
13-12-2015,22,23623,20177,7873,2235,53909,870,516,263,1649,55558
13-12-2015,23,22626,19124,7683,2100,51533,875,414,257,1546,53079
14-12-2015,0,22196,18140,7493,2057,49886,894,409,248,1551,51437
14-12-2015,1,21400,17751,7455,1947,48553,947,410,254,1611,50164
14-12-2015,2,21008,17740,7482,2034,48264,989,445,239,1673,49937
14-12-2015,3,20620,17896,7542,2053,48111,1011,459,267,1737,49848
14-12-2015,4,21464,18084,7813,2178,49541,1091,489,267,1847,51388
14-12-2015,5,22122,19076,8572,2371,52142,1413,679,274,2366,54508
14-12-2015,6,23724,21537,9004,2903,57167,1586,1105,472,3163,60330
14-12-2015,7,24644,22414,9270,4056,60385,1571,1556,483,3610,63995
14-12-2015,8,25050,22471,9477,4374,61375,1609,1760,615,3984,65359
14-12-2015,9,25162,22100,9410,4444,61116,1593,1358,458,3409,64525
14-12-2015,10,25213,22108,9441,4257,61018,1605,1108,451,3164,64182
14-12-2015,11,25060,22563,9527,4255,61404,1636,995,440,3071,64475
14-12-2015,12,24738,22438,9617,4248,61040,1606,1239,433,3278,64318
14-12-2015,13,25100,22290,9619,4177,61186,1509,1309,426,3244,64430
14-12-2015,14,25188,22098,9711,4342,61340,1487,1486,380,3353,64693
14-12-2015,15,25645,22318,9675,4612,62249,1486,1715,595,3796,66045
14-12-2015,16,25959,22535,9531,4805,62830,1477,1874,919,4270,67100
14-12-2015,17,25259,22256,9505,5239,62260,1452,1613,901,3966,66226
14-12-2015,18,25232,21886,9475,4924,61516,1440,1444,706,3590,65106
14-12-2015,19,25197,21918,9193,4964,61272,1439,831,397,2667,63939
14-12-2015,20,24874,21901,8721,4356,59851,887,779,308,1974,61825
14-12-2015,21,24406,21737,8352,3691,58186,958,746,207,1911,60097
14-12-2015,22,23049,20849,8151,3325,55374,892,426,189,1507,56881
14-12-2015,23,21709,19403,8068,2859,52040,898,410,183,1491,53531
15-12-2015,0,21057,18101,8108,2737,50003,922,406,188,1516,51519
15-12-2015,1,20499,17842,8124,2578,49044,914,406,182,1502,50546
15-12-2015,2,20251,17947,8206,2328,48733,916,406,183,1505,50238
15-12-2015,3,20464,18282,8306,2391,49443,904,408,189,1501,50944
15-12-2015,4,21824,19180,8541,2573,52119,911,540,186,1637,53756
15-12-2015,5,22605,20239,9200,3128,55172,1007,803,205,2015,57187
15-12-2015,6,23542,20597,9819,3388,57346,1209,971,422,2602,59948
15-12-2015,7,24004,21853,10186,5045,61089,1588,1153,565,3306,64395
15-12-2015,8,24223,21799,10099,4991,61113,1638,1397,882,3917,65030
15-12-2015,9,24403,21633,10066,4823,60926,1550,1619,865,4034,64960
15-12-2015,10,24671,21726,10145,4579,61123,1523,1225,412,3160,64283
15-12-2015,11,24805,21473,10165,4653,61098,1553,1519,520,3592,64690
15-12-2015,12,24663,21427,10122,4592,60806,1576,1443,394,3413,64219
15-12-2015,13,24592,21490,10034,4607,60723,1554,1293,387,3234,63957
15-12-2015,14,24582,21631,9970,4641,60826,1579,1187,499,3265,64091
15-12-2015,15,24835,21659,10060,4638,61192,1582,1507,540,3629,64821
15-12-2015,16,24751,21901,10206,4917,61773,1529,1811,625,3965,65738
15-12-2015,17,24580,21710,10169,4900,61360,1527,1955,847,4329,65689
15-12-2015,18,24559,21478,10120,4804,60961,1577,1754,544,3875,64836
15-12-2015,19,24407,21492,9929,4559,60386,1658,883,414,2955,63341
15-12-2015,20,24160,21374,9814,4135,59482,1136,791,335,2262,61744
15-12-2015,21,23990,21037,9263,3540,57830,979,772,214,1965,59795
15-12-2015,22,22767,19895,8701,3215,54577,991,471,201,1663,56240
15-12-2015,23,21494,18479,8487,3085,51543,979,423,196,1598,53141
16-12-2015,0,21295,17278,8088,2805,49466,979,424,202,1605,51071
16-12-2015,1,20659,16887,7965,2644,48156,981,428,213,1622,49778
16-12-2015,2,20089,16778,7963,2622,47453,975,426,215,1616,49069
16-12-2015,3,20331,16798,7999,2650,47778,971,444,209,1624,49402
16-12-2015,4,21114,17182,8302,2833,49430,1014,588,221,1823,51253
16-12-2015,5,21732,18411,8852,3075,52071,1248,863,249,2360,54431
16-12-2015,6,22843,20692,9257,4026,56818,1607,1035,446,3088,59906
16-12-2015,7,24025,21783,9666,4421,59894,1620,1257,449,3326,63220
16-12-2015,8,24397,21780,9671,4767,60615,1605,1185,578,3368,63983
16-12-2015,9,24455,21609,9616,4883,60563,1608,1162,559,3329,63892
16-12-2015,10,24491,21378,9481,4904,60254,1604,891,589,3084,63338
16-12-2015,11,24481,21317,9560,4923,60283,1630,942,416,2988,63271
16-12-2015,12,24656,21333,9613,4872,60474,1653,1177,438,3268,63742
16-12-2015,13,24487,21637,9580,4933,60638,1653,1179,446,3278,63916
16-12-2015,14,24622,21697,9622,4883,60824,1658,1498,410,3566,64390
16-12-2015,15,24902,21728,9682,4633,60946,1649,1303,541,3493,64439
16-12-2015,16,24359,21710,9754,5015,60838,1654,1184,594,3432,64270
16-12-2015,17,24305,21282,9590,5218,60395,1634,1152,583,3369,63764
16-12-2015,18,24366,20989,9387,5135,59877,1591,1067,606,3264,63141
16-12-2015,19,24306,20856,9112,4613,58887,1551,787,434,2772,61659
16-12-2015,20,24158,20931,8837,4384,58310,1016,763,333,2112,60422
16-12-2015,21,23512,20308,8483,4189,56492,973,722,222,1917,58409
16-12-2015,22,22487,19013,8210,3923,53635,910,427,210,1547,55182
16-12-2015,23,21709,17131,7908,3526,50273,833,413,208,1454,51727
17-12-2015,0,21029,16051,7736,3050,47866,800,408,203,1411,49277
17-12-2015,1,20182,15774,7664,2873,46492,810,408,202,1420,47912
17-12-2015,2,19736,15720,7711,2910,46076,824,406,188,1418,47494
17-12-2015,3,19587,15777,7808,2790,45964,841,411,193,1445,47409
17-12-2015,4,20389,15747,8268,2763,47167,938,444,195,1577,48744
17-12-2015,5,21544,16445,8921,2865,49774,1157,791,264,2212,51986
17-12-2015,6,22860,19029,9314,3387,54591,1480,1080,482,3042,57633
17-12-2015,7,24190,21015,9656,3956,58817,1467,1285,569,3321,62138
17-12-2015,8,24398,21411,9784,4796,60389,1513,1264,519,3296,63685
17-12-2015,9,24136,21496,9748,5006,60385,1540,1225,546,3311,63696
17-12-2015,10,23993,21186,9466,4781,59427,1541,975,531,3047,62474
17-12-2015,11,23902,21203,9505,4526,59136,1544,923,487,2954,62090
17-12-2015,12,23838,21101,9579,4340,58858,1538,1189,478,3205,62063
17-12-2015,13,23741,21032,9450,4270,58494,1545,1203,459,3207,61701
17-12-2015,14,23818,21125,9561,4404,58909,1559,1347,437,3343,62252
17-12-2015,15,23909,21269,9684,4394,59256,1559,1362,605,3526,62782
17-12-2015,16,23756,21522,9699,4899,59879,1563,1312,480,3355,63234
17-12-2015,17,23526,20986,9590,5026,59128,1571,1226,496,3293,62421
17-12-2015,18,23431,20604,9387,4868,58289,1558,1138,472,3168,61457
17-12-2015,19,23466,20483,8909,4280,57139,1306,795,445,2546,59685
17-12-2015,20,22952,19664,8363,4143,55123,861,771,355,1987,57110
17-12-2015,21,22472,18517,8029,3994,53012,881,692,279,1852,54864
17-12-2015,22,21396,17573,7722,3807,50498,845,436,280,1561,52059
17-12-2015,23,19288,16366,7516,3703,46874,832,415,285,1532,48406
18-12-2015,0,17919,15120,7510,3534,44083,798,415,313,1526,45609
18-12-2015,1,17404,14700,7490,3487,43083,780,418,290,1488,44571
18-12-2015,2,16765,14897,7522,3509,42693,777,415,261,1453,44146
18-12-2015,3,17016,15092,7533,3534,43175,772,417,247,1436,44611
18-12-2015,4,17743,15578,7876,3471,44667,778,480,249,1507,46174
18-12-2015,5,18655,16532,8454,3542,47182,1057,680,263,2000,49182
18-12-2015,6,20209,18536,9035,3474,51255,1336,879,454,2669,53924
18-12-2015,7,22557,20649,9212,3545,55963,1352,1303,587,3242,59205
18-12-2015,8,23440,21254,9361,3937,57991,1371,1373,505,3249,61240
18-12-2015,9,22961,21347,9170,4008,57485,1295,1229,529,3053,60538
18-12-2015,10,22722,20977,8767,4095,56561,1290,918,506,2714,59275
18-12-2015,11,22534,20724,8769,4237,56264,1513,861,475,2849,59113
18-12-2015,12,21990,20353,8757,4190,55290,1575,1113,484,3172,58462
18-12-2015,13,21570,20395,8688,4070,54723,1607,1086,525,3218,57941
18-12-2015,14,21071,20486,8987,4170,54715,1592,1104,559,3255,57970
18-12-2015,15,21526,20351,9084,4124,55084,1643,1135,618,3396,58480
18-12-2015,16,21690,20780,8918,4112,55501,1647,1132,589,3368,58869
18-12-2015,17,21776,20753,8744,4148,55420,1638,1083,531,3252,58672
18-12-2015,18,21392,20518,8586,3969,54464,1582,979,558,3119,57583
18-12-2015,19,20105,20045,8311,3989,52450,1129,794,412,2335,54785
18-12-2015,20,18716,19317,7815,4139,49988,883,730,413,2026,52014
18-12-2015,21,18012,18248,7548,4197,48004,869,560,430,1859,49863
18-12-2015,22,16787,17647,7275,4051,45760,881,420,431,1732,47492
18-12-2015,23,15404,16796,7039,3892,43130,874,424,434,1732,44862
19-12-2015,0,14336,16295,7089,3905,41626,864,413,447,1724,43350
19-12-2015,1,13818,15750,6982,4014,40564,871,413,463,1747,42311
19-12-2015,2,13341,15547,6968,3925,39784,846,407,464,1717,41501
19-12-2015,3,13198,15415,7013,3966,39591,747,414,471,1632,41223
19-12-2015,4,13271,15353,7077,3968,39669,739,420,476,1635,41304
19-12-2015,5,13851,15605,7164,4007,40628,759,423,477,1659,42287
19-12-2015,6,14316,16184,7337,3858,41695,756,437,470,1663,43358
19-12-2015,7,15302,17313,7583,3758,43956,738,576,471,1785,45741
19-12-2015,8,16347,18019,7614,3492,45472,739,652,473,1864,47336
19-12-2015,9,17051,18777,7650,3382,46860,725,690,467,1882,48742
19-12-2015,10,17718,18895,7702,3542,47855,716,742,484,1942,49797
19-12-2015,11,17901,18953,7793,3663,48309,718,711,487,1916,50225
19-12-2015,12,17467,18998,7789,3783,48036,714,733,495,1942,49978
19-12-2015,13,17554,18542,7775,3868,47740,669,724,493,1886,49626
19-12-2015,14,18246,18687,7863,3820,48616,651,779,457,1887,50503
19-12-2015,15,19074,19411,8128,3827,50442,653,813,536,2002,52444
19-12-2015,16,19687,19576,8243,4104,51610,688,809,574,2071,53681
19-12-2015,17,19849,19228,8308,4368,51753,687,807,517,2011,53764
19-12-2015,18,19346,19145,8211,4301,51004,690,816,469,1975,52979
19-12-2015,19,18260,18587,8057,4250,49154,650,738,401,1789,50943
19-12-2015,20,17002,18277,7688,4288,47255,609,689,371,1669,48924
19-12-2015,21,15671,18062,7624,4324,45681,597,622,355,1574,47255
19-12-2015,22,14970,17842,7696,4323,44830,628,415,324,1367,46197
19-12-2015,23,14476,16920,7300,4267,42964,644,397,320,1361,44325
20-12-2015,0,13963,15810,7245,3990,41007,653,392,334,1379,42386
20-12-2015,1,12996,15544,7180,3876,39597,666,390,347,1403,41000
20-12-2015,2,12399,15325,7185,3954,38863,752,398,366,1516,40379
20-12-2015,3,12089,15255,7228,3821,38393,793,404,346,1543,39936
20-12-2015,4,12021,15262,7355,3786,38424,794,417,345,1556,39980
20-12-2015,5,11663,15305,7359,3762,38089,822,430,351,1603,39692
20-12-2015,6,11956,15547,7499,3730,38731,842,472,365,1679,40410
20-12-2015,7,13215,15910,7649,3846,40619,860,511,340,1711,42330
20-12-2015,8,15047,16549,7617,4094,43307,867,595,307,1769,45076
20-12-2015,9,16098,17160,7642,4217,45119,873,673,316,1862,46981
20-12-2015,10,16685,17929,7810,4311,46735,890,720,302,1912,48647
20-12-2015,11,16433,18442,7870,4543,47288,900,748,304,1952,49240
20-12-2015,12,16291,18565,7840,4404,47101,883,754,286,1923,49024
20-12-2015,13,16338,18733,7815,4471,47357,880,741,305,1926,49283
20-12-2015,14,16654,18911,7957,4414,47937,879,736,315,1930,49867
20-12-2015,15,17049,19361,8175,4311,48896,879,841,382,2102,50998
20-12-2015,16,17555,19816,8230,4138,49739,892,981,373,2246,51985
20-12-2015,17,17709,19682,8311,4109,49809,910,738,448,2096,51905
20-12-2015,18,17497,19522,8216,3955,49190,897,738,403,2038,51228
20-12-2015,19,17205,19183,8162,4046,48597,909,606,407,1922,50519
20-12-2015,20,16413,18744,7899,4144,47201,927,601,427,1955,49156
20-12-2015,21,16092,17980,7942,4157,46172,937,504,411,1852,48024
20-12-2015,22,15175,17267,7738,4134,44314,918,421,377,1716,46030
20-12-2015,23,13709,16413,7577,4150,41847,886,413,366,1665,43512
21-12-2015,0,12584,15585,7307,3921,39398,881,411,378,1670,41068
21-12-2015,1,11968,15694,7228,3940,38832,885,412,362,1659,40491
21-12-2015,2,11676,15540,7200,3910,38324,901,408,344,1653,39977
21-12-2015,3,11742,15373,7212,3874,38202,852,408,327,1587,39789
21-12-2015,4,12549,15555,7338,3806,39247,840,422,342,1604,40851
21-12-2015,5,13821,16401,7626,3879,41729,853,570,367,1790,43519
21-12-2015,6,15255,19076,8206,3873,46410,885,725,539,2149,48559
21-12-2015,7,17477,20947,8665,4068,51157,817,961,541,2319,53476
21-12-2015,8,18173,21817,8757,4236,52984,827,986,619,2432,55416
21-12-2015,9,18377,21661,8653,4324,53016,844,1040,535,2419,55435
21-12-2015,10,18531,21502,8474,4241,52749,823,819,551,2193,54942
21-12-2015,11,18233,21559,8627,4249,52668,820,751,528,2099,54767
21-12-2015,12,17917,21569,8639,4206,52331,818,1025,531,2374,54705
21-12-2015,13,18017,21344,8638,4266,52266,815,950,586,2351,54617
21-12-2015,14,18270,21872,8881,4220,53243,811,950,580,2341,55584
21-12-2015,15,18574,22477,9001,3998,54050,810,1092,615,2517,56567
21-12-2015,16,18738,22361,8917,4133,54149,834,1113,542,2489,56638
21-12-2015,17,18732,22198,8879,4169,53980,788,964,665,2417,56397
21-12-2015,18,18139,22283,8817,4363,53601,757,932,612,2301,55902
21-12-2015,19,17478,21995,8502,4357,52332,748,712,476,1936,54268
21-12-2015,20,16774,20776,8033,4482,50066,747,621,418,1786,51852
21-12-2015,21,16350,19535,7803,4566,48252,748,469,433,1650,49902
21-12-2015,22,15084,17739,7601,4618,45040,758,404,416,1578,46618
21-12-2015,23,13909,16383,7449,4199,41939,747,390,422,1559,43498
22-12-2015,0,12514,15461,7372,3962,39308,752,406,415,1573,40881
22-12-2015,1,12191,15348,7247,3967,38753,759,424,402,1585,40338
22-12-2015,2,12053,15332,7198,4100,38685,753,416,431,1600,40285
22-12-2015,3,11880,15286,7219,4509,38895,728,403,451,1582,40477
22-12-2015,4,12282,15526,7285,4254,39345,721,410,470,1601,40946
22-12-2015,5,14480,16203,7551,4059,42293,707,466,471,1644,43937
22-12-2015,6,17349,18240,8048,3833,47471,663,699,492,1854,49325
22-12-2015,7,19540,20456,8372,3736,52104,691,809,670,2170,54274
22-12-2015,8,19892,21829,8408,3589,53719,697,771,668,2136,55855
22-12-2015,9,19897,21723,8308,3707,53636,686,676,663,2025,55661
22-12-2015,10,19935,21650,8176,4119,53879,682,540,499,1721,55600
22-12-2015,11,19633,21370,8172,4570,53746,717,551,488,1756,55502
22-12-2015,12,18965,20900,8240,4554,52660,727,791,479,1997,54657
22-12-2015,13,19408,20109,8259,4705,52481,747,745,484,1976,54457
22-12-2015,14,19754,20381,8381,4746,53262,792,729,526,2047,55309
22-12-2015,15,20201,20608,8559,5189,54556,774,854,638,2266,56822
22-12-2015,16,19793,20974,8510,5580,54856,828,925,606,2359,57215
22-12-2015,17,19938,20994,8487,5150,54570,827,723,554,2104,56674
22-12-2015,18,19405,20276,8495,5024,53200,871,682,551,2104,55304
22-12-2015,19,18993,19590,8360,4882,51825,799,555,360,1714,53539
22-12-2015,20,18383,19018,8026,4692,50121,718,542,370,1630,51751
22-12-2015,21,17395,18329,7903,4773,48400,693,473,343,1509,49909
22-12-2015,22,16791,17379,7649,4471,46290,696,449,392,1537,47827
22-12-2015,23,14846,16601,7216,4181,42843,708,438,448,1594,44437
23-12-2015,0,13885,15805,7071,3813,40574,726,434,473,1633,42207
23-12-2015,1,12598,15133,6951,3475,38158,751,437,477,1665,39823
23-12-2015,2,12299,14900,6782,3184,37165,773,426,469,1668,38833
23-12-2015,3,12825,15197,6947,3065,38034,767,427,468,1662,39696
23-12-2015,4,13070,15242,7043,3196,38552,866,450,463,1779,40331
23-12-2015,5,14308,15610,7185,3387,40492,916,456,467,1839,42331
23-12-2015,6,17003,16557,7617,3749,44926,888,574,521,1983,46909
23-12-2015,7,19438,18474,8013,3674,49599,892,652,666,2210,51809
23-12-2015,8,20238,18989,8194,4064,51486,878,658,744,2280,53766
23-12-2015,9,20489,19167,8130,4428,52215,872,565,742,2179,54394
23-12-2015,10,19850,19401,7943,4669,51863,878,544,475,1897,53760
23-12-2015,11,19622,19308,8050,4813,51795,816,576,481,1873,53668
23-12-2015,12,19166,18953,7978,4929,51026,806,559,660,2025,53051
23-12-2015,13,18860,18724,7983,5003,50570,804,545,653,2002,52572
23-12-2015,14,19204,18883,8301,4882,51272,794,541,653,1988,53260
23-12-2015,15,19642,19232,8530,4907,52312,818,606,677,2101,54413
23-12-2015,16,20199,19734,8526,4814,53274,862,664,676,2202,55476
23-12-2015,17,20183,19689,8460,4807,53139,898,557,717,2172,55311
23-12-2015,18,19610,19678,8341,4734,52364,889,557,659,2105,54469
23-12-2015,19,19113,19209,8117,4659,51097,871,525,481,1877,52974
23-12-2015,20,18414,18667,7748,4350,49178,857,488,482,1827,51005
23-12-2015,21,17861,18234,7688,3991,47774,853,455,486,1794,49568
23-12-2015,22,17367,17616,7303,3871,46156,842,476,482,1800,47956
23-12-2015,23,16335,16830,7003,3607,43776,849,466,485,1800,45576
24-12-2015,0,15293,16054,6846,3299,41492,781,290,479,1550,43042
24-12-2015,1,14256,15719,6840,3078,39893,698,290,491,1479,41372
24-12-2015,2,13529,15515,6845,3023,38914,722,286,472,1480,40394
24-12-2015,3,13383,15375,6856,3130,38745,705,287,472,1464,40209
24-12-2015,4,13488,15195,6880,3429,38993,720,304,468,1492,40485
24-12-2015,5,14364,15162,6873,3452,39852,731,302,441,1474,41326
24-12-2015,6,15509,15510,7146,3527,41693,727,310,407,1444,43137
24-12-2015,7,16705,16044,7303,3574,43626,718,316,492,1526,45152
24-12-2015,8,18012,16503,7527,3803,45846,703,370,547,1620,47466
24-12-2015,9,19192,16786,7659,3893,47531,700,373,586,1659,49190
24-12-2015,10,19704,17231,7780,3924,48640,672,293,498,1463,50103
24-12-2015,11,19500,17468,7838,4109,48915,664,331,477,1472,50387
24-12-2015,12,19149,17461,7884,3985,48480,641,371,613,1625,50105
24-12-2015,13,18713,17546,7873,4090,48220,614,406,634,1654,49874
24-12-2015,14,18798,17431,8027,4037,48293,623,466,573,1662,49955
24-12-2015,15,19331,17558,8153,4117,49160,621,565,680,1866,51026
24-12-2015,16,19236,17612,8133,4390,49372,617,504,733,1854,51226
24-12-2015,17,17936,17328,8157,4474,47897,650,373,718,1741,49638
24-12-2015,18,15852,16896,8110,4582,45441,682,316,613,1611,47052
24-12-2015,19,14128,16605,7843,4764,43340,670,277,375,1322,44662
24-12-2015,20,12896,16531,7562,5220,42209,666,281,407,1354,43563
24-12-2015,21,12500,16521,7523,4953,41498,630,280,376,1286,42784
24-12-2015,22,12253,16478,7372,5056,41159,664,275,402,1341,42500
24-12-2015,23,11703,16326,7288,4824,40142,683,270,390,1343,41485
25-12-2015,0,10923,15675,7278,4531,38407,606,253,370,1229,39636
25-12-2015,1,10288,15328,7241,4035,36892,611,255,367,1233,38125
25-12-2015,2,9607,15321,7155,3922,36005,615,263,357,1235,37240
25-12-2015,3,9551,15280,7171,4138,36139,638,267,367,1272,37411
25-12-2015,4,10637,15328,7234,4057,37256,649,268,371,1288,38544
25-12-2015,5,11391,15449,7276,4147,38263,659,268,379,1306,39569
25-12-2015,6,11540,16017,7526,4289,39372,652,255,392,1299,40671
25-12-2015,7,12215,16170,7556,4786,40727,670,248,402,1320,42047
25-12-2015,8,14079,16326,7753,4564,42722,662,327,405,1394,44116
25-12-2015,9,14911,16673,7829,4603,44017,642,241,443,1326,45343
25-12-2015,10,15940,16665,7930,4681,45216,645,261,475,1381,46597
25-12-2015,11,16701,16660,8034,4791,46188,642,255,504,1401,47589
25-12-2015,12,16639,16718,8054,4852,46264,650,260,504,1414,47678
25-12-2015,13,16592,16563,8122,4831,46107,632,216,496,1344,47451
25-12-2015,14,16944,16629,8158,4679,46409,621,207,489,1317,47726
25-12-2015,15,18145,16974,8254,4371,47745,637,357,518,1512,49257
25-12-2015,16,18888,17254,8390,4066,48597,631,391,601,1623,50220
25-12-2015,17,19002,17218,8389,3822,48431,628,476,491,1595,50026
25-12-2015,18,18904,17084,8463,3454,47906,637,406,530,1573,49479
25-12-2015,19,18580,16846,8248,3353,47027,633,300,483,1416,48443
25-12-2015,20,18067,16543,8004,3161,45776,636,275,482,1393,47169
25-12-2015,21,17951,16443,7885,2758,45038,639,260,484,1383,46421
25-12-2015,22,17512,16200,7642,2367,43721,648,255,483,1386,45107
25-12-2015,23,16700,15745,7340,1917,41701,688,248,477,1413,43114
26-12-2015,0,14106,15237,7475,1746,38564,679,197,471,1347,39911
26-12-2015,1,13093,15018,7421,1623,37155,660,195,471,1326,38481
26-12-2015,2,12502,14861,7419,1744,36528,663,196,470,1329,37857
26-12-2015,3,12251,14460,7417,1904,36032,649,195,462,1306,37338
26-12-2015,4,12453,14134,7511,2051,36150,647,200,431,1278,37428
26-12-2015,5,12980,13952,7657,2112,36702,640,201,404,1245,37947
26-12-2015,6,13986,14025,7875,2160,38046,630,197,388,1215,39261
26-12-2015,7,15381,14367,8120,2115,39983,668,197,381,1246,41229
26-12-2015,8,17213,14828,8161,2108,42309,659,284,390,1333,43642
26-12-2015,9,18672,15023,8255,2122,44072,646,296,346,1288,45360
26-12-2015,10,19576,15647,8270,2300,45793,642,304,429,1375,47168
26-12-2015,11,19968,15875,8306,2299,46449,637,298,446,1381,47830
26-12-2015,12,19791,16157,8356,2241,46546,646,295,438,1379,47925
26-12-2015,13,19646,16275,8353,2093,46368,642,249,418,1309,47677
26-12-2015,14,20074,16612,8505,2122,47313,654,313,388,1355,48668
26-12-2015,15,20649,17406,8571,2331,48956,659,463,496,1618,50574
26-12-2015,16,21937,18005,8596,2595,51132,678,444,601,1723,52855
26-12-2015,17,22139,18355,8435,2644,51574,685,503,497,1685,53259
26-12-2015,18,21727,18074,8571,2740,51111,680,458,491,1629,52740
26-12-2015,19,21161,17734,8447,2728,50070,666,514,358,1538,51608
26-12-2015,20,20914,17500,8391,2819,49624,682,433,387,1502,51126
26-12-2015,21,19807,16676,8149,3222,47854,683,439,252,1374,49228
26-12-2015,22,19152,15915,8145,3549,46762,685,186,237,1108,47870
26-12-2015,23,18190,15039,8309,3859,45398,740,199,217,1156,46554
27-12-2015,0,17093,14323,8128,3963,43507,756,207,215,1178,44685
27-12-2015,1,16044,14359,8062,3891,42355,766,203,201,1170,43525
27-12-2015,2,15634,14384,7958,3898,41875,761,205,188,1154,43029
27-12-2015,3,15411,14406,7874,4034,41724,748,205,186,1139,42863
27-12-2015,4,15589,14505,7837,4299,42230,728,206,195,1129,43359
27-12-2015,5,15776,14882,7802,4192,42652,698,214,193,1105,43757
27-12-2015,6,16121,15398,7880,4269,43668,655,258,189,1102,44770
27-12-2015,7,16628,16099,8023,4267,45018,620,349,185,1154,46172
27-12-2015,8,17083,16939,8005,4421,46448,612,508,207,1327,47775
27-12-2015,9,17848,17668,8039,4441,47996,586,662,196,1444,49440
27-12-2015,10,18609,18373,8091,4512,49586,598,456,245,1299,50885
27-12-2015,11,19550,18682,8118,4543,50892,582,454,242,1278,52170
27-12-2015,12,19746,18672,8268,4710,51397,567,418,240,1225,52622
27-12-2015,13,19608,18804,8249,4684,51344,545,388,242,1175,52519
27-12-2015,14,20254,18737,8583,4536,52110,578,411,265,1254,53364
27-12-2015,15,21306,19102,8857,4291,53555,661,510,349,1520,55075
27-12-2015,16,22159,19782,8976,4316,55235,688,616,361,1665,56900
27-12-2015,17,22500,19933,8981,4347,55762,694,600,392,1686,57448
27-12-2015,18,22428,20070,8877,4242,55616,677,579,391,1647,57263
27-12-2015,19,22227,19925,8793,4106,55052,638,577,302,1517,56569
27-12-2015,20,21659,19363,8501,4117,53639,675,504,256,1435,55074
27-12-2015,21,21124,19124,8595,4032,52876,679,301,261,1241,54117
27-12-2015,22,20575,18397,8422,3881,51274,667,233,237,1137,52411
27-12-2015,23,20467,17457,7998,3605,49526,701,240,253,1194,50720
28-12-2015,0,19976,16528,7795,3159,47456,730,200,199,1129,48585
28-12-2015,1,19957,15986,7831,2915,46689,744,188,203,1135,47824
28-12-2015,2,20096,15704,7888,2817,46506,765,301,229,1295,47801
28-12-2015,3,20226,15560,7952,2687,46425,777,281,229,1287,47712
28-12-2015,4,20957,15957,8201,2472,47588,886,315,205,1406,48994
28-12-2015,5,21729,16896,8623,2293,49543,1047,489,263,1799,51342
28-12-2015,6,22415,18503,8962,2339,52219,1141,997,450,2588,54807
28-12-2015,7,24209,19895,9228,2309,55641,1210,1222,615,3047,58688
28-12-2015,8,24867,20814,9274,2387,57342,1258,1298,652,3208,60550
28-12-2015,9,25592,21270,9119,2799,58779,1313,1133,600,3046,61825
28-12-2015,10,26044,22006,8924,2888,59861,1399,942,355,2696,62557
28-12-2015,11,25979,21978,9113,2819,59888,1410,971,418,2799,62687
28-12-2015,12,25692,21863,9214,2856,59627,1439,1035,506,2980,62607
28-12-2015,13,25363,21851,9151,2971,59334,1448,1002,529,2979,62313
28-12-2015,14,25341,21801,9100,3191,59431,1474,1406,523,3403,62834
28-12-2015,15,25267,22169,9185,3647,60269,1485,1431,844,3760,64029
28-12-2015,16,25021,22064,9259,4035,60380,1492,1510,698,3700,64080
28-12-2015,17,24345,22044,9351,4168,59908,1480,1433,657,3570,63478
28-12-2015,18,24096,21293,9326,4234,58950,1471,1298,654,3423,62373
28-12-2015,19,23602,20515,9056,4448,57622,1464,1010,360,2834,60456
28-12-2015,20,22903,19930,8921,4542,56297,1090,975,335,2400,58697
28-12-2015,21,22135,19304,9029,4508,54976,1033,746,296,2075,57051
28-12-2015,22,21001,18747,8827,4614,53188,895,458,328,1681,54869
28-12-2015,23,19925,17978,8317,4613,50833,886,428,289,1603,52436
29-12-2015,0,18773,16818,8213,4566,48371,884,425,268,1577,49948
29-12-2015,1,18101,16534,8064,4490,47189,860,422,255,1537,48726
29-12-2015,2,17373,16602,8044,4487,46507,831,422,251,1504,48011
29-12-2015,3,16386,16834,8240,4807,46267,828,421,247,1496,47763
29-12-2015,4,16715,16950,8802,4736,47203,837,428,234,1499,48702
29-12-2015,5,17587,17780,9391,4813,49571,1031,524,223,1778,51349
29-12-2015,6,18502,18974,9603,4907,51987,1362,838,388,2588,54575
29-12-2015,7,19986,20174,9677,5147,54984,1386,989,649,3024,58008
29-12-2015,8,20785,20997,9717,5354,56852,1400,913,696,3009,59861
29-12-2015,9,20898,21582,9709,5502,57692,1391,920,487,2798,60490
29-12-2015,10,21046,21819,9512,5572,57950,1167,931,202,2300,60250
29-12-2015,11,20913,22071,9656,5572,58211,1335,878,200,2413,60624
29-12-2015,12,21123,21751,9632,5550,58058,1334,888,442,2664,60722
29-12-2015,13,20841,21766,9620,5554,57780,1335,873,441,2649,60429
29-12-2015,14,21124,21839,9759,5337,58060,1349,885,444,2678,60738
29-12-2015,15,21714,22127,10011,5344,59196,1352,1145,494,2991,62187
29-12-2015,16,22267,22464,10013,5211,59957,1358,1067,525,2950,62907
29-12-2015,17,22428,22660,9942,5268,60299,1354,1030,491,2875,63174
29-12-2015,18,21575,22737,9996,5290,59598,1348,920,518,2786,62384
29-12-2015,19,21100,22218,9663,5097,58079,1124,861,276,2261,60340
29-12-2015,20,20356,21589,9324,4671,55940,1094,796,272,2162,58102
29-12-2015,21,19702,20749,9412,4644,54508,782,554,297,1633,56141
29-12-2015,22,18855,20034,9149,4484,52522,841,441,272,1554,54076
29-12-2015,23,17878,19404,8721,4425,50430,845,431,263,1539,51969
30-12-2015,0,16268,18573,8657,4431,47928,817,432,264,1513,49441
30-12-2015,1,15572,18121,8653,4446,46791,778,425,267,1470,48261
30-12-2015,2,15309,18048,8645,4409,46411,792,407,268,1467,47878
30-12-2015,3,15092,18031,8634,4316,46072,808,408,253,1469,47541
30-12-2015,4,15459,18282,8756,4402,46898,798,422,238,1458,48356
30-12-2015,5,15633,19184,9293,4440,48550,904,495,263,1662,50212
30-12-2015,6,16270,20523,9633,4403,50830,1180,876,299,2355,53185
30-12-2015,7,17733,21773,9805,4452,53764,1193,1252,254,2699,56463
30-12-2015,8,18809,22382,9781,4692,55664,1193,1220,296,2709,58373
30-12-2015,9,19447,22653,9748,4817,56667,1178,1073,271,2522,59189
30-12-2015,10,19801,22859,9431,4852,56944,1010,769,265,2044,58988
30-12-2015,11,19761,22959,9530,4927,57177,1156,793,269,2218,59395
30-12-2015,12,19458,22953,9608,4950,56969,1150,907,317,2374,59343
30-12-2015,13,19481,22995,9611,5002,57088,1101,935,239,2275,59363
30-12-2015,14,19515,22977,9801,5034,57328,1130,919,291,2340,59668
30-12-2015,15,19667,23334,9994,4976,57969,1144,1047,284,2475,60444
30-12-2015,16,19951,23299,9907,5125,58281,1190,1093,338,2621,60902
30-12-2015,17,20023,23215,9720,5301,58259,1211,1089,316,2616,60875
30-12-2015,18,19554,22882,9647,5386,57469,1177,1041,301,2519,59988
30-12-2015,19,18812,22426,9389,5289,55917,938,703,351,1992,57909
30-12-2015,20,17850,22103,8989,5146,54089,831,701,353,1885,55974
30-12-2015,21,17216,21357,8763,5204,52540,832,476,323,1631,54171
30-12-2015,22,16208,20662,8310,5118,50299,863,443,308,1614,51913
30-12-2015,23,15280,19481,7844,5097,47703,855,435,297,1587,49290
31-12-2015,0,13767,17952,7879,5058,44656,833,440,301,1574,46230
31-12-2015,1,12525,17429,7882,4970,42805,809,438,312,1559,44364
31-12-2015,2,11985,17302,7879,4954,42121,808,431,306,1545,43666
31-12-2015,3,12007,17200,7873,4878,41957,802,433,284,1519,43476
31-12-2015,4,12237,17040,8030,4980,42288,825,444,275,1544,43832
31-12-2015,5,12732,17301,8525,5111,43670,881,459,285,1625,45295
31-12-2015,6,13273,17948,8890,5298,45409,857,660,322,1839,47248
31-12-2015,7,14429,19057,9246,5384,48116,886,820,340,2046,50162
31-12-2015,8,15983,20428,9260,5396,51067,924,927,337,2188,53255
31-12-2015,9,16735,21270,9310,5350,52665,954,920,274,2148,54813
31-12-2015,10,17153,21754,9009,5354,53269,878,781,238,1897,55166
31-12-2015,11,17554,21968,9257,5261,54043,903,737,228,1868,55911
31-12-2015,12,17828,22286,9277,5172,54565,880,922,229,2031,56596
31-12-2015,13,18075,22333,9271,4872,54551,911,924,221,2056,56607
31-12-2015,14,18464,22965,9372,4616,55418,1066,930,242,2238,57656
31-12-2015,15,19434,23034,9536,4528,56531,1147,1168,251,2566,59097
31-12-2015,16,20531,23231,9597,4422,57780,1270,1211,288,2769,60549
31-12-2015,17,20749,23010,9531,4222,57513,1238,1104,328,2670,60183
31-12-2015,18,20155,22312,9398,3982,55848,1121,965,348,2434,58282
31-12-2015,19,18671,21836,8802,3846,53154,997,679,331,2007,55161
31-12-2015,20,17619,21257,8592,3640,51109,995,624,328,1947,53056
31-12-2015,21,17613,20519,8544,3403,50079,988,452,311,1751,51830
31-12-2015,22,17565,20114,8356,2985,49021,1001,464,283,1748,50769
31-12-2015,23,17270,19454,8043,2810,47578,1017,469,259,1745,49323
01-01-2016,0,16764,18054,7964,2914,45697,1041,436,252,1729,47426
01-01-2016,1,16326,17523,7862,2888,44601,1042,432,255,1729,46330
01-01-2016,2,15811,17186,7983,2781,43761,1058,428,241,1727,45488
01-01-2016,3,15302,17078,7917,2723,43022,1064,427,228,1719,44741
01-01-2016,4,15178,17016,7926,2690,42811,1039,435,227,1701,44512
01-01-2016,5,15620,17145,7918,2624,43307,929,443,233,1605,44912
01-01-2016,6,14939,18008,8089,2592,43628,764,439,249,1452,45080
01-01-2016,7,15184,18979,8212,2437,44813,777,437,251,1465,46278
01-01-2016,8,15453,19937,8200,2282,45872,694,446,252,1392,47264
01-01-2016,9,16187,20232,8154,2088,46661,672,446,253,1371,48032
01-01-2016,10,17128,20896,8222,1785,48032,739,440,285,1464,49496
01-01-2016,11,17940,21290,8400,1668,49298,700,458,221,1379,50677
01-01-2016,12,18484,21768,8459,1657,50369,737,457,231,1425,51794
01-01-2016,13,18949,21933,8432,1680,50993,741,458,238,1437,52430
01-01-2016,14,19737,22208,8517,1737,52199,903,457,283,1643,53842
01-01-2016,15,20960,22604,8680,1831,54075,914,533,387,1834,55909
01-01-2016,16,21760,23138,8612,1952,55462,921,648,393,1962,57424
01-01-2016,17,21831,23240,8678,2284,56033,977,544,421,1942,57975
01-01-2016,18,21314,23170,8767,2304,55555,984,514,393,1891,57446
01-01-2016,19,20292,22835,8656,2164,53947,1001,503,343,1847,55794
01-01-2016,20,19779,22396,8381,2146,52702,952,436,326,1714,54416
01-01-2016,21,19208,22067,8371,2137,51783,922,434,189,1545,53328
01-01-2016,22,17914,21362,8582,2316,50173,933,436,205,1574,51747
01-01-2016,23,17240,20309,8215,2439,48204,993,431,207,1631,49835
02-01-2016,0,16874,18771,7974,2527,46146,978,424,213,1615,47761
02-01-2016,1,15892,17968,7929,2857,44646,942,424,209,1575,46221
02-01-2016,2,13822,17221,7894,3347,42284,942,428,208,1578,43862
02-01-2016,3,12025,16808,7876,3677,40386,937,429,192,1558,41944
02-01-2016,4,11386,16764,7890,4108,40149,937,436,182,1555,41704
02-01-2016,5,11702,16957,8046,4154,40858,940,436,208,1584,42442
02-01-2016,6,12234,17259,8204,4470,42168,941,459,222,1622,43790
02-01-2016,7,13478,18652,8374,4718,45222,942,498,230,1670,46892
02-01-2016,8,15366,20173,8515,5251,49304,919,505,369,1793,51097
02-01-2016,9,16283,21251,8594,5372,51501,923,504,308,1735,53236
02-01-2016,10,17281,21834,8729,5752,53597,904,504,368,1776,55373
02-01-2016,11,17770,22024,8813,5879,54487,878,502,367,1747,56234
02-01-2016,12,17478,22693,8790,6023,54985,880,502,345,1727,56712
02-01-2016,13,17666,22716,8856,5896,55135,879,522,339,1740,56875
02-01-2016,14,17757,22888,9163,6006,55814,893,528,385,1806,57620
02-01-2016,15,18249,23175,9495,6029,56947,1023,786,430,2239,59186
02-01-2016,16,19158,23322,9501,6064,58046,1024,976,639,2639,60685
02-01-2016,17,19809,23460,9425,6011,58707,1028,1155,455,2638,61345
02-01-2016,18,19678,23445,9270,6054,58446,1028,963,588,2579,61025
02-01-2016,19,18895,23161,9240,6061,57357,1027,727,441,2195,59552
02-01-2016,20,18291,22718,9009,5805,55822,969,549,444,1962,57784
02-01-2016,21,17339,22264,9149,5644,54397,912,493,244,1649,56046
02-01-2016,22,16843,21840,8896,5458,53038,966,438,203,1607,54645
02-01-2016,23,15758,20831,8477,5664,50730,976,425,160,1561,52291
03-01-2016,0,15836,18739,8080,5496,48150,945,418,142,1505,49655
03-01-2016,1,15782,17852,7738,4919,46291,963,418,129,1510,47801
03-01-2016,2,15595,17562,7685,5297,46139,992,418,119,1529,47668
03-01-2016,3,15186,17499,7719,5441,45845,1026,419,110,1555,47400
03-01-2016,4,14722,17550,7676,5419,45368,1038,424,106,1568,46936
03-01-2016,5,15032,17703,7840,5466,46040,1035,446,113,1594,47634
03-01-2016,6,14954,18484,8030,5305,46773,1040,507,112,1659,48432
03-01-2016,7,15414,19431,8129,5305,48279,1035,685,114,1834,50113
03-01-2016,8,16346,19933,8382,5305,49965,1047,711,137,1895,51860
03-01-2016,9,17645,20445,8413,5538,52041,1043,745,278,2066,54107
03-01-2016,10,19385,21618,8433,5738,55175,1057,748,117,1922,57097
03-01-2016,11,19848,21853,8631,5847,56180,1062,747,129,1938,58118
03-01-2016,12,19701,21623,8590,6078,55994,1068,754,131,1953,57947
03-01-2016,13,19689,21797,8580,6021,56086,1011,764,130,1905,57991
03-01-2016,14,19932,22140,8851,5929,56853,981,769,126,1876,58729
03-01-2016,15,20754,22496,9251,5707,58207,988,726,296,2010,60217
03-01-2016,16,21958,22902,9400,5712,59973,1021,721,444,2186,62159
03-01-2016,17,22641,23143,9230,5671,60685,1206,718,435,2359,63044
03-01-2016,18,21916,23339,9200,5730,60185,1206,714,383,2303,62488
03-01-2016,19,20987,23380,9081,5723,59170,1193,652,347,2192,61362
03-01-2016,20,20271,22971,8977,5506,57727,1202,677,196,2075,59802
03-01-2016,21,19577,22319,8979,5665,56540,1203,482,206,1891,58431
03-01-2016,22,18505,21827,8770,5562,54665,1203,428,190,1821,56486
03-01-2016,23,17027,21150,8321,5441,51940,1224,421,138,1783,53723
04-01-2016,0,16487,19274,8262,5589,49612,1190,413,145,1748,51360
04-01-2016,1,16444,18499,8254,5565,48762,1198,415,146,1759,50521
04-01-2016,2,16243,18316,8307,5531,48398,1223,416,133,1772,50170
04-01-2016,3,16284,18337,8323,5463,48406,1280,441,126,1847,50253
04-01-2016,4,16488,18590,8646,5485,49208,1326,475,127,1928,51136
04-01-2016,5,17404,20114,9235,5554,52307,1198,762,131,2091,54398
04-01-2016,6,19947,22047,9813,5773,57580,1239,856,330,2425,60005
04-01-2016,7,23577,23503,9898,5549,62527,1538,968,511,3017,65544
04-01-2016,8,24790,24052,9948,5697,64488,1643,1046,341,3030,67518
04-01-2016,9,25025,24172,9896,5654,64747,1379,1037,361,2777,67524
04-01-2016,10,25012,24208,9786,5772,64779,1444,998,365,2807,67586
04-01-2016,11,24744,24177,9756,6031,64709,1441,936,343,2720,67429
04-01-2016,12,24347,24226,9654,6172,64399,1479,935,363,2777,67176
04-01-2016,13,24267,24409,9602,6181,64458,1557,935,335,2827,67285
04-01-2016,14,24243,24438,9748,6065,64494,1650,934,338,2922,67416
04-01-2016,15,24668,24572,9955,5986,65181,1674,1013,483,3170,68351
04-01-2016,16,25478,24790,10063,5646,65978,1676,1050,513,3239,69217
04-01-2016,17,25297,25194,10027,5733,66251,1652,1052,423,3127,69378
04-01-2016,18,24329,25130,10053,5485,64996,1695,960,455,3110,68106
04-01-2016,19,23635,24917,9893,5359,63804,1672,940,404,3016,66820
04-01-2016,20,22600,24640,9707,5364,62313,1322,869,313,2504,64817
04-01-2016,21,21909,23918,9682,5248,60756,1258,830,217,2305,63061
04-01-2016,22,20733,23145,9285,5155,58318,1210,571,112,1893,60211
04-01-2016,23,19411,22143,8747,5080,55383,1212,561,106,1879,57262
05-01-2016,0,19507,20041,8600,5076,53224,1186,556,102,1844,55068
05-01-2016,1,19333,19147,8570,4920,51971,1164,555,104,1823,53794
05-01-2016,2,19173,19120,8537,4908,51739,1169,555,105,1829,53568
05-01-2016,3,19185,19130,8526,4888,51729,1178,554,107,1839,53568
05-01-2016,4,19563,19278,8952,4806,52600,1187,580,107,1874,54474
05-01-2016,5,20389,20241,9744,4776,55150,1210,841,111,2162,57312
05-01-2016,6,22096,22095,10102,4911,59204,1268,1038,232,2538,61742
05-01-2016,7,24712,23529,10277,5195,63713,1622,1066,379,3067,66780
05-01-2016,8,25580,24191,10395,5449,65617,1599,1096,454,3149,68766
05-01-2016,9,25495,24362,10367,5408,65632,1601,1152,457,3210,68842
05-01-2016,10,25553,24370,10220,5416,65559,1641,1107,497,3245,68804
05-01-2016,11,25531,24280,10262,5386,65460,1634,1169,320,3123,68583
05-01-2016,12,25382,24115,10219,5374,65090,1568,1200,320,3088,68178
05-01-2016,13,25168,24058,10208,5361,64796,1630,1131,344,3105,67901
05-01-2016,14,25309,24038,10242,5137,64725,1738,1150,344,3232,67957
05-01-2016,15,25428,24301,10542,4764,65035,1756,1118,492,3366,68401
05-01-2016,16,26205,24874,10577,4772,66429,1750,1187,500,3437,69866
05-01-2016,17,26148,24900,10641,5189,66878,1748,1139,505,3392,70270
05-01-2016,18,26010,24674,10486,5039,66207,1761,1100,477,3338,69545
05-01-2016,19,25773,24130,10358,4689,64949,1746,1102,377,3225,68174
05-01-2016,20,24999,23400,10056,4446,62900,1536,1084,169,2789,65689
05-01-2016,21,24601,22898,9867,4633,61999,1531,948,145,2624,64623
05-01-2016,22,23771,22420,9755,4666,60611,1294,634,132,2060,62671
05-01-2016,23,22345,21999,9319,4255,57917,1205,603,134,1942,59859
06-01-2016,0,22346,20147,9015,4069,55575,1134,582,137,1853,57428
06-01-2016,1,22173,19469,8740,4030,54411,1094,574,131,1799,56210
06-01-2016,2,22020,19445,8573,3944,53983,1128,572,124,1824,55807
06-01-2016,3,22101,19374,8629,4027,54130,1146,571,127,1844,55974
06-01-2016,4,22418,19572,8875,4080,54946,1147,633,135,1915,56861
06-01-2016,5,22592,20338,9158,4119,56208,1194,966,132,2292,58500
06-01-2016,6,23623,21842,9492,4322,59278,1279,1075,267,2621,61899
06-01-2016,7,25559,23309,9587,4611,63067,1533,1107,279,2919,65986
06-01-2016,8,25999,24035,9694,4954,64681,1657,1111,326,3094,67775
06-01-2016,9,25703,24346,9823,5186,65056,1758,1111,265,3134,68190
06-01-2016,10,25764,24324,9961,5261,65308,1883,1112,281,3276,68584
06-01-2016,11,25662,24336,10080,6104,66182,1841,1109,216,3166,69348
06-01-2016,12,25610,24248,10238,5382,65479,1792,1111,199,3102,68581
06-01-2016,13,25558,24192,10140,5350,65240,1767,1116,117,3000,68240
06-01-2016,14,26077,24184,10281,5247,65788,1731,1129,150,3010,68798
06-01-2016,15,26478,24222,10503,5229,66431,1726,1183,337,3246,69677
06-01-2016,16,26549,24550,10675,5327,67102,1711,1349,332,3392,70494
06-01-2016,17,26546,24509,10651,5929,67635,1759,1225,532,3516,71151
06-01-2016,18,26286,24420,10552,5505,66763,1783,1143,398,3324,70087
06-01-2016,19,26766,24298,10539,5181,66783,1769,1116,157,3042,69825
06-01-2016,20,26563,23843,10512,5045,65964,1710,1095,160,2965,68929
06-01-2016,21,26109,23296,10252,4915,64572,1718,863,147,2728,67300
06-01-2016,22,24967,22496,9938,4804,62204,1670,601,133,2404,64608
06-01-2016,23,23970,21610,9613,4430,59624,1554,573,136,2263,61887
07-01-2016,0,24500,20070,9370,3924,57863,1380,636,132,2148,60011
07-01-2016,1,24214,19525,9279,3830,56848,1369,586,129,2084,58932
07-01-2016,2,23682,19226,9213,3862,55983,1251,585,127,1963,57946
07-01-2016,3,23629,19269,9316,3839,56053,1265,589,136,1990,58043
07-01-2016,4,24026,19452,9716,3789,56984,1325,613,135,2073,59057
07-01-2016,5,24002,20426,10250,4191,58869,1645,986,160,2791,61660
07-01-2016,6,25006,22523,10612,4689,62829,1679,1262,382,3323,66152
07-01-2016,7,26610,24250,10672,4878,66409,1741,1400,561,3702,70111
07-01-2016,8,26738,24680,10827,5421,67667,1792,1584,629,4005,71672
07-01-2016,9,26381,24691,10844,5593,67509,1840,1528,600,3968,71477
07-01-2016,10,26572,24517,10723,5583,67395,1870,1556,545,3971,71366
07-01-2016,11,26396,24492,10649,5765,67303,1914,1534,491,3939,71242
07-01-2016,12,26319,24458,10690,5882,67349,1920,1451,431,3802,71151
07-01-2016,13,26373,24595,10794,5859,67621,1917,1320,298,3535,71156
07-01-2016,14,25944,24604,10743,6061,67352,1914,1280,409,3603,70955
07-01-2016,15,25979,24903,10790,5893,67565,1920,1443,561,3924,71489
07-01-2016,16,25993,25052,10874,6064,67983,1988,1687,639,4314,72297
07-01-2016,17,26169,25052,10872,6187,68281,2093,1325,597,4015,72296
07-01-2016,18,25391,25089,10763,6163,67406,2098,1255,581,3934,71340
07-01-2016,19,24977,24700,10605,6003,66285,2095,1202,365,3662,69947
07-01-2016,20,24604,23918,10495,5769,64784,2002,1042,222,3266,68050
07-01-2016,21,24129,22724,10351,5613,62817,1982,985,203,3170,65987
07-01-2016,22,23070,21895,10257,5429,60652,1624,596,215,2435,63087
07-01-2016,23,21722,21267,9886,5380,58256,1449,592,216,2257,60513
08-01-2016,0,20102,19748,9814,5603,55268,1316,578,202,2096,57364
08-01-2016,1,18956,19151,9518,5398,53022,1289,528,197,2014,55036
08-01-2016,2,18625,19177,9493,5332,52626,1282,607,170,2059,54685
08-01-2016,3,18451,19133,9587,5247,52417,1288,616,157,2061,54478
08-01-2016,4,18220,19238,10078,5162,52698,1343,715,164,2222,54920
08-01-2016,5,19610,20041,10633,5082,55368,1746,923,181,2850,58218
08-01-2016,6,22505,22322,11062,5174,61063,1908,951,177,3036,64099
08-01-2016,7,24590,23785,11104,5680,65158,1908,1060,374,3342,68500
08-01-2016,8,25438,24245,10993,5696,66373,1939,924,436,3299,69672
08-01-2016,9,26026,24140,11017,5522,66704,1951,969,228,3148,69852
08-01-2016,10,26079,24373,11036,5434,66923,1990,990,249,3229,70152
08-01-2016,11,26185,24327,10914,5241,66667,2096,752,469,3317,69984
08-01-2016,12,25752,24453,10841,5121,66166,2095,596,545,3236,69402
08-01-2016,13,25659,23885,10754,4800,65098,2100,573,525,3198,68296
08-01-2016,14,26069,23715,10714,4461,64961,2120,561,526,3207,68168
08-01-2016,15,26531,23796,10895,4331,65555,2125,785,532,3442,68997
08-01-2016,16,26554,24159,10976,4585,66274,2110,1071,383,3564,69838
08-01-2016,17,26585,24388,10997,4651,66620,2075,951,442,3468,70088
08-01-2016,18,26716,24220,10961,4489,66387,2047,920,345,3312,69699
08-01-2016,19,26450,23761,10700,4294,65206,2035,900,320,3255,68461
08-01-2016,20,26090,22908,10247,3927,63173,1996,896,147,3039,66212
08-01-2016,21,25653,22412,9983,3257,61305,2021,780,152,2953,64258
08-01-2016,22,25185,21678,9684,2988,59535,1691,611,134,2436,61971
08-01-2016,23,24301,20869,9318,2864,57354,1619,551,125,2295,59649
09-01-2016,0,24573,19688,8917,2741,55919,1400,417,119,1936,57855
09-01-2016,1,23776,19397,8734,3003,54909,1307,415,115,1837,56746
09-01-2016,2,23205,19051,8628,3132,54018,1303,415,115,1833,55851
09-01-2016,3,22768,18926,8584,3097,53375,1287,418,113,1818,55193
09-01-2016,4,22355,18768,8653,2930,52705,1314,438,113,1865,54570
09-01-2016,5,22518,19141,8948,3159,53768,1278,586,116,1980,55748
09-01-2016,6,22986,19842,9185,3363,55375,1290,681,112,2083,57458
09-01-2016,7,24461,20866,9442,3427,58197,1437,711,113,2261,60458
09-01-2016,8,25241,22000,9513,3616,60370,1428,688,113,2229,62599
09-01-2016,9,25894,22507,9612,4041,62053,1401,728,111,2240,64293
09-01-2016,10,26179,22889,9739,4219,63024,1397,760,111,2268,65292
09-01-2016,11,26122,23011,9709,4427,63270,1374,815,115,2304,65574
09-01-2016,12,26100,23023,9680,4168,62969,1381,776,115,2272,65241
09-01-2016,13,26171,22976,9663,4105,62914,1391,793,115,2299,65213
09-01-2016,14,25953,23155,9830,4165,63104,1466,812,114,2392,65496
09-01-2016,15,26017,23334,10102,4107,63560,1642,1124,115,2881,66441
09-01-2016,16,26152,23688,10308,4332,64479,1609,1183,117,2909,67388
09-01-2016,17,26498,23801,10294,4582,65177,1649,911,475,3035,68212
09-01-2016,18,26335,23863,10104,4476,64777,1649,858,478,2985,67762
09-01-2016,19,25626,23536,9742,4472,63376,1641,776,476,2893,66269
09-01-2016,20,24794,22972,9566,4157,61487,1455,917,116,2488,63975
09-01-2016,21,24150,22165,9572,4175,60063,1416,710,109,2235,62298
09-01-2016,22,23144,21546,9526,4160,58376,1226,572,96,1894,60270
09-01-2016,23,22139,20700,9141,4016,55997,1147,566,96,1809,57806
10-01-2016,0,20426,19075,8917,3752,52171,1024,563,97,1684,53855
10-01-2016,1,18641,18291,8716,3886,49535,1003,564,100,1667,51202
10-01-2016,2,18036,17849,8581,3844,48309,988,568,103,1659,49968
10-01-2016,3,17727,17778,8556,3886,47949,1003,571,106,1680,49629
10-01-2016,4,17543,17717,8574,3985,47819,1007,577,110,1694,49513
10-01-2016,5,17581,17783,8725,4136,48225,1034,601,116,1751,49976
10-01-2016,6,17558,18250,8858,4350,49015,1058,857,126,2041,51056
10-01-2016,7,18031,18671,9006,4660,50368,1095,784,131,2010,52378
10-01-2016,8,18866,19294,9115,4897,52173,1079,932,126,2137,54310
10-01-2016,9,20189,19631,9283,5057,54159,1110,926,127,2163,56322
10-01-2016,10,21553,20619,9414,5402,56988,1121,773,131,2025,59013
10-01-2016,11,22568,21470,9469,5542,59049,1209,786,133,2128,61177
10-01-2016,12,22731,22159,9403,5337,59629,1272,766,141,2179,61808
10-01-2016,13,22275,22259,9385,4816,58735,1314,751,152,2217,60952
10-01-2016,14,22083,22381,9584,4477,58526,1307,760,152,2219,60745
10-01-2016,15,22732,22687,9905,4463,59788,1499,831,174,2504,62292
10-01-2016,16,24077,23406,9988,4307,61778,1565,1014,211,2790,64568
10-01-2016,17,25194,23924,9932,4358,63407,1574,1019,354,2947,66354
10-01-2016,18,25343,23710,9863,3960,62876,1589,1013,330,2932,65808
10-01-2016,19,25053,23341,9643,3814,61851,1560,1004,300,2864,64715
10-01-2016,20,24510,22691,9402,3684,60287,1335,1008,295,2638,62925
10-01-2016,21,23996,21906,9500,3406,58807,1365,623,305,2293,61100
10-01-2016,22,23068,21190,9279,3315,56852,1317,597,303,2217,59069
10-01-2016,23,21686,20337,8848,3232,54104,1273,581,292,2146,56250
11-01-2016,0,20670,19368,8722,2877,51637,1325,584,283,2192,53829
11-01-2016,1,19037,18648,8717,2582,48984,1355,589,298,2242,51226
11-01-2016,2,18488,18315,8652,2516,47971,1357,587,283,2227,50198
11-01-2016,3,17963,18192,8848,2417,47420,1355,580,312,2247,49667
11-01-2016,4,18517,18461,9251,2462,48692,1502,605,301,2408,51100
11-01-2016,5,21161,19620,9937,2529,53247,1850,710,326,2886,56133
11-01-2016,6,24252,22063,10600,3097,60012,2050,1051,452,3553,63565
11-01-2016,7,25597,23698,10956,3977,64227,2129,1066,614,3809,68036
11-01-2016,8,25755,23930,10997,3972,64655,2106,1055,709,3870,68525
11-01-2016,9,25930,23552,10933,3708,64124,2033,1065,686,3784,67908
11-01-2016,10,26048,23615,10619,3733,64016,1961,1065,645,3671,67687
11-01-2016,11,26017,23622,10472,3750,63861,1965,1059,586,3610,67471
11-01-2016,12,25756,23650,10628,3744,63778,2086,1057,642,3785,67563
11-01-2016,13,25789,23948,10780,3804,64322,2054,1061,620,3735,68057
11-01-2016,14,25464,24152,10942,3887,64446,2073,1061,599,3733,68179
11-01-2016,15,25541,24085,11009,3857,64492,2095,1031,764,3890,68382
11-01-2016,16,25086,24032,10968,3955,64040,2099,1034,770,3903,67943
11-01-2016,17,24848,23742,10866,4052,63509,2111,1033,663,3807,67316
11-01-2016,18,24799,23357,10717,4169,63041,2092,1034,556,3682,66723
11-01-2016,19,24961,23390,10053,3849,62254,2038,1039,515,3592,65846
11-01-2016,20,24546,23230,9498,3717,60992,1603,1005,326,2934,63926
11-01-2016,21,24150,22809,9380,3299,59637,1494,792,324,2610,62247
11-01-2016,22,22499,22011,9184,3213,56906,1414,597,309,2320,59226
11-01-2016,23,20519,20919,8991,2931,53359,1395,565,306,2266,55625
12-01-2016,0,19578,18726,9109,2719,50133,1234,562,303,2099,52232
12-01-2016,1,18105,18195,8947,2802,48049,1185,562,303,2050,50099
12-01-2016,2,16964,17824,8886,2844,46518,1195,565,303,2063,48581
12-01-2016,3,15880,17718,8967,2835,45402,1175,564,307,2046,47448
12-01-2016,4,16843,17823,9437,2952,47055,1314,584,316,2214,49269
12-01-2016,5,19673,18689,10062,2977,51402,1652,702,339,2693,54095
12-01-2016,6,23180,21740,10452,3335,58707,1886,1066,538,3490,62197
12-01-2016,7,25727,23748,10622,3905,64003,1995,1298,553,3846,67849
12-01-2016,8,25832,24253,10521,3816,64422,2014,1267,545,3826,68248
12-01-2016,9,25859,23223,10522,3798,63403,1991,1272,565,3828,67231
12-01-2016,10,26071,23181,10409,3879,63538,1978,1038,557,3573,67111
12-01-2016,11,26143,23067,10300,3959,63469,1971,1036,500,3507,66976
12-01-2016,12,26053,23054,10410,4062,63579,1962,1038,501,3501,67080
12-01-2016,13,26045,23171,10539,4026,63780,1958,1042,611,3611,67391
12-01-2016,14,25729,23226,10810,4013,63778,1964,1156,563,3683,67461
12-01-2016,15,25936,22930,10901,3881,63649,1964,1246,612,3822,67471
12-01-2016,16,25953,22908,10960,3797,63620,1971,1275,626,3872,67492
12-01-2016,17,25830,22999,10936,3887,63653,1946,1288,596,3830,67483
12-01-2016,18,25873,23009,10769,3991,63643,1918,1197,634,3749,67392
12-01-2016,19,25831,23071,10287,3813,63002,1692,944,577,3213,66215
12-01-2016,20,25477,22939,9781,3501,61698,1520,959,445,2924,64622
12-01-2016,21,24977,22591,9548,3336,60451,1311,819,434,2564,63015
12-01-2016,22,23560,22055,9311,3381,58306,1199,623,400,2222,60528
12-01-2016,23,21516,20822,9191,3373,54900,1201,595,387,2183,57083
13-01-2016,0,20154,18911,9225,3324,51614,1230,584,163,1977,53591
13-01-2016,1,18270,18207,9034,3171,48681,1206,585,183,1974,50655
13-01-2016,2,17098,17817,8997,3164,47076,1210,588,197,1995,49071
13-01-2016,3,17127,17615,9179,3162,47082,1226,589,192,2007,49089
13-01-2016,4,18314,18052,9532,3095,48993,1335,628,225,2188,51181
13-01-2016,5,20860,19057,10207,3208,53332,1777,1062,267,3106,56438
13-01-2016,6,24132,22114,10495,3507,60249,2037,1228,370,3635,63884
13-01-2016,7,25893,23932,10814,3937,64576,2055,1345,506,3906,68482
13-01-2016,8,25913,24319,10800,4236,65268,2042,1247,549,3838,69106
13-01-2016,9,25973,23936,10716,4038,64662,2036,1199,567,3802,68464
13-01-2016,10,26189,24307,10783,3967,65247,1788,969,502,3259,68506
13-01-2016,11,26037,24160,10678,3553,64427,1796,956,477,3229,67656
13-01-2016,12,25846,23675,10687,3222,63431,1836,962,533,3331,66762
13-01-2016,13,25911,23532,10776,3187,63406,1908,1039,568,3515,66921
13-01-2016,14,25764,23746,10956,3289,63756,1922,1058,619,3599,67355
13-01-2016,15,26115,24139,11211,3375,64841,1988,1393,510,3891,68732
13-01-2016,16,26050,24524,11456,3805,65835,2018,1456,604,4078,69913
13-01-2016,17,26229,24320,11449,4026,66024,2020,1274,586,3880,69904
13-01-2016,18,26298,23954,11259,4109,65619,2025,1137,510,3672,69291
13-01-2016,19,26360,23389,10663,3971,64383,2043,1024,289,3356,67739
13-01-2016,20,26225,22986,10175,3851,63238,1356,976,299,2631,65869
13-01-2016,21,26159,23060,9803,3739,62762,1148,803,386,2337,65099
13-01-2016,22,25577,22524,9447,3303,60851,1106,661,398,2165,63016
13-01-2016,23,24362,21319,9227,2928,57835,1085,593,402,2080,59915
14-01-2016,0,23981,19433,9151,3054,55619,1084,622,403,2109,57728
14-01-2016,1,23078,18733,9105,2908,53823,1126,620,402,2148,55971
14-01-2016,2,22355,18472,9098,2857,52782,1128,609,390,2127,54909
14-01-2016,3,21968,18406,9219,2899,52494,1105,613,390,2108,54602
14-01-2016,4,22685,18903,9545,3034,54167,1211,619,390,2220,56387
14-01-2016,5,24030,20445,10319,3146,57941,1674,801,389,2864,60805
14-01-2016,6,25784,22791,10728,3624,62927,2013,1136,351,3500,66427
14-01-2016,7,25810,24111,11221,4929,66071,2048,1458,535,4041,70112
14-01-2016,8,25979,23782,11403,4946,66110,2058,1487,928,4473,70583
14-01-2016,9,26085,23203,11317,4723,65329,2132,1474,1076,4682,70011
14-01-2016,10,26205,23041,11182,4418,64846,2136,1422,693,4251,69097
14-01-2016,11,25897,23610,11057,4343,64906,2147,1237,660,4044,68950
14-01-2016,12,25701,23417,11041,4295,64455,2143,1219,651,4013,68468
14-01-2016,13,26009,23432,10984,4217,64641,2134,1275,685,4094,68735
14-01-2016,14,26016,23718,10988,4262,64985,2054,1297,643,3994,68979
14-01-2016,15,26069,23930,11045,4650,65694,2152,1431,724,4307,70001
14-01-2016,16,25860,24412,11348,4800,66419,2135,1647,1049,4831,71250
14-01-2016,17,26002,24209,11347,4880,66438,2128,1757,1039,4924,71362
14-01-2016,18,26123,24148,11115,4953,66338,2138,1481,1024,4643,70981
14-01-2016,19,26221,24145,10790,5033,66189,2111,1323,432,3866,70055
14-01-2016,20,25990,23631,10273,5086,64982,1877,1036,377,3290,68272
14-01-2016,21,25739,23468,9851,4881,63939,1446,877,367,2690,66629
14-01-2016,22,25262,23030,9478,4597,62368,1358,615,353,2326,64694
14-01-2016,23,24877,21690,9082,3962,59612,1326,604,341,2271,61883
15-01-2016,0,24222,20160,8847,3965,57192,1260,696,130,2086,59278
15-01-2016,1,24187,19740,8793,3992,56714,1225,659,123,2007,58721
15-01-2016,2,24233,19891,8765,3967,56856,1235,650,122,2007,58863
15-01-2016,3,23731,19907,8930,4088,56657,1269,673,124,2066,58723
15-01-2016,4,23793,20109,9553,3942,57397,1646,774,117,2537,59934
15-01-2016,5,24171,21518,10003,3987,59680,2058,1177,125,3360,63040
15-01-2016,6,25361,24429,10544,4206,64541,2219,1384,316,3919,68460
15-01-2016,7,26105,25289,11039,4892,67326,2237,1487,650,4374,71700
15-01-2016,8,26503,25161,11038,5192,67894,2267,1797,959,5023,72917
15-01-2016,9,26464,25025,11056,4908,67451,2254,1590,930,4774,72225
15-01-2016,10,26362,24886,11056,4742,67046,2240,1459,471,4170,71216
15-01-2016,11,26434,24752,11011,4668,66866,2220,1222,433,3875,70741
15-01-2016,12,26472,24492,10921,4492,66377,2208,1235,371,3814,70191
15-01-2016,13,26177,24510,10838,4301,65825,2206,1315,381,3902,69727
15-01-2016,14,26102,24426,10766,4303,65599,2169,1316,382,3867,69466
15-01-2016,15,26441,24058,10968,4223,65689,2159,1443,412,4014,69703
15-01-2016,16,26008,24654,11164,4241,66067,2154,1507,818,4479,70546
15-01-2016,17,26176,24405,11229,4279,66089,2182,1614,827,4623,70712
15-01-2016,18,26305,24318,11301,4295,66218,2115,1503,569,4187,70405
15-01-2016,19,26414,24165,11031,4284,65895,2053,1266,176,3495,69390
15-01-2016,20,25964,24074,10531,4028,64596,1598,1115,165,2878,67474
15-01-2016,21,25792,23709,10017,3720,63238,1276,940,164,2380,65618
15-01-2016,22,25621,23178,9689,3299,61787,1209,617,168,1994,63781
15-01-2016,23,25477,22405,9173,3038,60094,1206,584,174,1964,62058
16-01-2016,0,24465,20836,9172,2992,57465,1213,490,169,1872,59337
16-01-2016,1,24271,20046,9130,3017,56463,1144,487,156,1787,58250
16-01-2016,2,24289,19826,9046,3021,56182,1138,483,157,1778,57960
16-01-2016,3,23980,19578,8937,2995,55489,1085,482,154,1721,57210
16-01-2016,4,23852,19641,8938,2994,55424,1062,486,156,1704,57128
16-01-2016,5,24095,20345,8940,3082,56464,1096,529,160,1785,58249
16-01-2016,6,24075,21632,9093,3111,57909,1053,602,151,1806,59715
16-01-2016,7,24924,22895,9416,3232,60467,1072,556,151,1779,62246
16-01-2016,8,25800,23810,9666,3647,62924,1098,693,158,1949,64873
16-01-2016,9,25878,24258,10090,4000,64227,1166,778,172,2116,66343
16-01-2016,10,26170,24338,9852,4099,64460,1386,777,177,2340,66800
16-01-2016,11,25966,24164,9823,4009,63963,1313,800,171,2284,66247
16-01-2016,12,25962,23806,9706,3818,63292,1198,1038,163,2399,65691
16-01-2016,13,25772,23740,9692,3609,62813,1177,1053,155,2385,65198
16-01-2016,14,25467,23745,9771,3580,62563,1200,913,160,2273,64836
16-01-2016,15,25483,23630,10049,3846,63009,1393,959,179,2531,65540
16-01-2016,16,25669,23842,10322,4243,64076,1420,1163,490,3073,67149
16-01-2016,17,26040,23968,10420,4426,64855,1407,1230,492,3129,67984
16-01-2016,18,25913,23931,10570,4556,64971,1414,1142,370,2926,67897
16-01-2016,19,25864,23882,10186,4471,64403,1338,1022,143,2503,66906
16-01-2016,20,25409,23573,9823,4142,62948,1227,922,131,2280,65228
16-01-2016,21,25329,23278,9588,3782,61978,1135,691,133,1959,63937
16-01-2016,22,24410,22823,9338,3632,60203,1116,649,135,1900,62103
16-01-2016,23,23382,22068,9161,3425,58037,1092,644,146,1882,59919
17-01-2016,0,21570,20404,8925,3346,54246,1122,608,165,1895,56141
17-01-2016,1,20710,19681,8913,3316,52620,1109,602,189,1900,54520
17-01-2016,2,20882,19548,8896,3323,52650,1131,606,196,1933,54583
17-01-2016,3,21008,19457,8925,3207,52596,1152,607,192,1951,54547
17-01-2016,4,20996,19498,8988,3208,52690,1151,620,193,1964,54654
17-01-2016,5,20858,19657,9025,3099,52639,1152,633,200,1985,54624
17-01-2016,6,20541,20272,9097,3143,53054,1145,741,189,2075,55129
17-01-2016,7,21999,21315,9143,3250,55706,1156,901,168,2225,57931
17-01-2016,8,23187,22785,9242,3435,58647,1175,853,167,2195,60842
17-01-2016,9,25283,23290,9411,3619,61604,1233,869,169,2271,63875
17-01-2016,10,25880,23884,9715,3822,63302,1239,908,168,2315,65617
17-01-2016,11,25873,24034,9656,3908,63470,1243,959,160,2362,65832
17-01-2016,12,25786,23746,9657,3865,63055,1222,1007,157,2386,65441
17-01-2016,13,25820,23606,9684,3674,62786,1205,1005,156,2366,65152
17-01-2016,14,25592,23477,9604,3444,62117,1240,914,157,2311,64428
17-01-2016,15,25720,23622,9847,3448,62636,1434,898,158,2490,65126
17-01-2016,16,26039,23915,10073,3503,63530,1416,1004,357,2777,66307
17-01-2016,17,26282,24107,10178,3685,64252,1406,1028,359,2793,67045
17-01-2016,18,26479,24290,10140,3765,64674,1403,1024,355,2782,67456
17-01-2016,19,26403,24225,10221,3712,64561,1391,1024,315,2730,67291
17-01-2016,20,26126,24111,10231,3594,64062,1274,1033,196,2503,66565
17-01-2016,21,25854,24042,9951,3561,63409,1283,727,199,2209,65618
17-01-2016,22,24794,23457,9584,3428,61265,1203,613,196,2012,63277
17-01-2016,23,23981,22355,9332,3180,58851,1180,610,195,1985,60836
18-01-2016,0,22863,20755,9146,3080,55845,1139,611,195,1945,57790
18-01-2016,1,22260,20201,9112,3233,54806,1135,612,185,1932,56738
18-01-2016,2,22559,20119,9128,3250,55056,1182,609,187,1978,57034
18-01-2016,3,22522,20063,9263,3259,55107,1290,621,195,2106,57213
18-01-2016,4,22588,19996,9745,3405,55733,1596,704,197,2497,58230
18-01-2016,5,23048,20852,10550,3441,57891,1967,1057,258,3282,61173
18-01-2016,6,25136,23897,10789,3681,63504,2202,1289,587,4078,67582
18-01-2016,7,26464,25244,10895,4233,66836,2158,1588,853,4599,71435
18-01-2016,8,26220,25393,10892,4406,66911,2169,1557,973,4699,71610
18-01-2016,9,26360,25170,10872,4347,66750,2151,1461,756,4368,71118
18-01-2016,10,26668,25340,10823,4484,67314,2149,1327,503,3979,71293
18-01-2016,11,26737,25417,10826,4569,67549,2174,1210,532,3916,71465
18-01-2016,12,26262,25373,10739,4714,67087,2163,1381,514,4058,71145
18-01-2016,13,26342,25321,10716,4631,67011,2145,1406,518,4069,71080
18-01-2016,14,26331,25249,10542,4554,66676,2129,1368,596,4093,70769
18-01-2016,15,26127,25214,10741,4567,66649,2047,1518,840,4405,71054
18-01-2016,16,26379,25178,10845,4477,66881,2105,1541,1053,4699,71580
18-01-2016,17,26372,25183,10858,4814,67229,2105,1451,1120,4676,71905
18-01-2016,18,26096,25159,10787,5173,67216,2087,1381,716,4184,71400
18-01-2016,19,25875,25097,10329,5093,66395,2084,1226,480,3790,70185
18-01-2016,20,25695,24715,9830,5005,65246,1819,1010,334,3163,68409
18-01-2016,21,25103,23946,9726,5054,63830,1739,903,288,2930,66760
18-01-2016,22,24378,22972,9474,5018,61842,1539,633,275,2447,64289
18-01-2016,23,23501,21444,9081,4900,58926,1469,611,283,2363,61289
19-01-2016,0,23256,19605,8707,4493,56062,1584,612,266,2462,58524
19-01-2016,1,22516,18876,8596,4963,54953,1522,621,260,2403,57356
19-01-2016,2,22110,18718,8694,5133,54654,1522,621,273,2416,57070
19-01-2016,3,22452,18728,8889,5027,55096,1525,630,272,2427,57523
19-01-2016,4,22705,19018,9344,4979,56047,1741,650,281,2672,58719
19-01-2016,5,23551,19976,9870,4774,58172,2126,972,292,3390,61562
19-01-2016,6,24494,22517,10405,4738,62155,2136,1179,679,3994,66149
19-01-2016,7,25634,24281,10706,4785,65407,2148,1422,710,4280,69687
19-01-2016,8,25962,24544,10773,4750,66028,2165,1488,924,4577,70605
19-01-2016,9,26379,24574,10810,4665,66429,2157,1489,666,4312,70741
19-01-2016,10,26530,24723,10528,4639,66419,2142,1453,623,4218,70637
19-01-2016,11,26359,24631,10546,4531,66067,2123,1408,626,4157,70224
19-01-2016,12,25943,24524,10596,4489,65553,2121,1427,606,4154,69707
19-01-2016,13,26248,24082,10527,4493,65349,2094,1421,584,4099,69448
19-01-2016,14,26190,23885,10604,4371,65050,2076,1362,606,4044,69094
19-01-2016,15,25998,23864,10844,4318,65023,2063,1437,752,4252,69275
19-01-2016,16,26489,24144,10948,4391,65971,2107,1764,806,4677,70648
19-01-2016,17,26267,24708,11033,4614,66623,2104,1638,826,4568,71191
19-01-2016,18,26153,24297,10969,4598,66018,2083,1421,672,4176,70194
19-01-2016,19,26332,23950,10591,4441,65313,2088,1297,458,3843,69156
19-01-2016,20,26248,23560,10218,4062,64088,2003,1132,280,3415,67503
19-01-2016,21,25906,22971,9850,3866,62594,1989,927,317,3233,65827
19-01-2016,22,25270,22357,9574,3819,61021,1699,621,302,2622,63643
19-01-2016,23,24964,21206,9254,3654,59079,1690,651,316,2657,61736
20-01-2016,0,23935,19738,9151,3558,56384,1531,635,326,2492,58876
20-01-2016,1,23640,19421,8935,3488,55484,1512,641,305,2458,57942
20-01-2016,2,23574,19513,8997,3584,55668,1506,636,330,2472,58140
20-01-2016,3,23531,19430,9071,3551,55585,1475,628,347,2450,58035
20-01-2016,4,23529,19635,9490,3649,56303,1595,636,329,2560,58863
20-01-2016,5,24082,20470,10029,3740,58321,2019,720,317,3056,61377
20-01-2016,6,25378,23035,10638,4036,63088,2101,1125,487,3713,66801
20-01-2016,7,26630,24743,11093,4624,67091,2014,1379,535,3928,71019
20-01-2016,8,26158,25137,11109,4706,67111,1986,1456,667,4109,71220
20-01-2016,9,26261,25019,11037,4704,67021,1973,1455,668,4096,71117
20-01-2016,10,26195,24887,10912,4602,66596,1973,1438,648,4059,70655
20-01-2016,11,26107,24561,10795,4535,65998,1995,1190,635,3820,69818
20-01-2016,12,25999,24161,10724,4586,65471,1986,1404,448,3838,69309
20-01-2016,13,26319,23925,10608,4495,65348,1983,1348,453,3784,69132
20-01-2016,14,26089,24332,10552,4343,65317,1980,1272,388,3640,68957
20-01-2016,15,26180,24614,10710,4390,65893,1988,1395,370,3753,69646
20-01-2016,16,26504,24993,10894,4594,66985,1989,1523,627,4139,71124
20-01-2016,17,26616,25089,10937,4791,67433,2032,1739,654,4425,71858
20-01-2016,18,26584,25198,10888,4857,67527,1992,1377,626,3995,71522
20-01-2016,19,26470,25085,10760,4622,66936,1987,1301,240,3528,70464
20-01-2016,20,26253,24753,10425,4262,65694,1944,1126,164,3234,68928
20-01-2016,21,25814,24028,10152,4058,64052,1897,915,152,2964,67016
20-01-2016,22,25423,23269,9631,3868,62193,1874,649,140,2663,64856
20-01-2016,23,25368,21369,9364,3712,59815,1790,604,147,2541,62356
21-01-2016,0,24353,20204,9165,3586,57309,1478,605,134,2217,59526
21-01-2016,1,24003,19680,9122,3570,56375,1427,604,126,2157,58532
21-01-2016,2,23967,19353,9163,3603,56086,1432,605,123,2160,58246
21-01-2016,3,23859,19054,9252,3633,55798,1438,625,125,2188,57986
21-01-2016,4,23902,19129,9544,3756,56331,1704,830,117,2651,58982
21-01-2016,5,24463,20145,10086,3791,58484,1939,1119,196,3254,61738
21-01-2016,6,25447,22678,10599,4184,62906,1945,1267,526,3738,66644
21-01-2016,7,26655,24267,10986,4832,66743,1969,1393,992,4354,71097
21-01-2016,8,26351,24644,11034,4936,66966,1981,1534,1038,4553,71519
21-01-2016,9,26302,24623,11094,4735,66754,1966,1455,932,4353,71107
21-01-2016,10,26316,24492,10972,4633,66414,1961,1427,783,4171,70585
21-01-2016,11,26286,24327,10939,4936,66488,1967,1358,554,3879,70367
21-01-2016,12,26319,24263,10831,4747,66161,1976,1380,519,3875,70036
21-01-2016,13,26290,24059,10857,4758,65965,1987,1382,489,3858,69823
21-01-2016,14,26439,23716,10879,4714,65749,1956,1373,512,3841,69590
21-01-2016,15,26304,24335,10931,4663,66235,1945,1390,322,3657,69892
21-01-2016,16,26252,25021,11041,4875,67189,1965,1442,608,4015,71204
21-01-2016,17,26541,25005,11067,4984,67598,1943,1779,611,4333,71931
21-01-2016,18,26464,24946,10998,5016,67422,1958,1375,615,3948,71370
21-01-2016,19,26465,24741,10789,4749,66743,1869,1312,400,3581,70324
21-01-2016,20,26331,24294,10690,4494,65809,1778,1098,144,3020,68829
21-01-2016,21,26069,23461,10385,4380,64296,1626,862,135,2623,66919
21-01-2016,22,25511,22696,9980,4159,62346,1597,607,127,2331,64677
21-01-2016,23,24604,21363,9554,3969,59492,1575,603,118,2296,61788
22-01-2016,0,24128,19936,9543,3823,57431,1415,606,117,2138,59569
22-01-2016,1,23954,19984,9374,3756,57067,1390,605,113,2108,59175
22-01-2016,2,23825,19894,9392,3709,56821,1368,602,103,2073,58894
22-01-2016,3,23722,19825,9429,3743,56719,1322,605,101,2028,58747
22-01-2016,4,23871,20075,9884,3754,57585,1615,664,101,2380,59965
22-01-2016,5,24088,20958,10633,3803,59483,1657,1071,111,2839,62322
22-01-2016,6,25244,23373,11261,4513,64392,1745,1283,302,3330,67722
22-01-2016,7,26640,25470,11285,5113,68508,1748,1428,693,3869,72377
22-01-2016,8,26323,25077,11181,5855,68436,1741,1620,803,4164,72600
22-01-2016,9,26269,24835,11108,5495,67707,1746,1561,951,4258,71965
22-01-2016,10,26601,24290,11130,5288,67309,1682,1092,703,3477,70786
22-01-2016,11,26731,24809,10982,5385,67907,1642,1089,532,3263,71170
22-01-2016,12,26355,24826,10939,5535,67657,1638,1092,628,3358,71015
22-01-2016,13,25919,24489,10882,5416,66707,1633,1090,675,3398,70105
22-01-2016,14,25460,24381,10908,5292,66040,1679,1088,612,3379,69419
22-01-2016,15,25565,24733,11020,5045,66364,1647,1274,655,3576,69940
22-01-2016,16,25681,24751,11063,5093,66587,1646,1417,710,3773,70360
22-01-2016,17,25965,24605,11056,5330,66956,1650,1423,632,3705,70661
22-01-2016,18,25725,24438,10923,5658,66744,1668,1353,520,3541,70285
22-01-2016,19,25130,24259,10365,5433,65189,1658,1021,323,3002,68191
22-01-2016,20,24685,23556,10119,5332,63693,1425,1038,109,2572,66265
22-01-2016,21,24135,22375,9740,5304,61556,1458,616,109,2183,63739
22-01-2016,22,23501,21628,9518,4905,59550,1146,606,98,1850,61400
22-01-2016,23,23032,20590,9055,4239,56916,1159,607,92,1858,58774
23-01-2016,0,22569,19433,8836,4364,55202,1048,607,104,1759,56961
23-01-2016,1,22370,18944,8583,4005,53904,1032,609,125,1766,55670
23-01-2016,2,22246,18722,8489,3603,53060,1021,606,133,1760,54820
23-01-2016,3,22446,18641,8462,3311,52859,1020,608,130,1758,54617
23-01-2016,4,22743,18476,8439,3137,52796,1026,618,126,1770,54566
23-01-2016,5,22402,18451,8680,2915,52449,1028,641,121,1790,54239
23-01-2016,6,22320,19271,8764,2889,53243,1046,840,128,2014,55257
23-01-2016,7,23785,20771,9085,2829,56469,1098,991,131,2220,58689
23-01-2016,8,24814,21653,9116,2828,58411,1110,1006,133,2249,60660
23-01-2016,9,25332,22491,9142,2699,59665,1221,1039,135,2395,62060
23-01-2016,10,25731,22754,9208,2935,60628,1080,1049,140,2269,62897
23-01-2016,11,25885,22766,9210,2961,60822,1049,1143,140,2332,63154
23-01-2016,12,25775,22622,9117,2837,60349,1026,1140,144,2310,62659
23-01-2016,13,25553,22372,9026,2827,59778,1013,1129,148,2290,62068
23-01-2016,14,25505,22203,9170,2849,59729,1044,938,159,2141,61870
23-01-2016,15,25501,22138,9312,3115,60067,1181,979,176,2336,62403
23-01-2016,16,25996,22516,9556,3502,61572,1230,1147,227,2604,64176
23-01-2016,17,26150,23467,9662,3767,63047,1237,1150,390,2777,65824
23-01-2016,18,25871,23391,9545,3683,62489,1144,1148,415,2707,65196
23-01-2016,19,25540,22766,9125,3119,60550,1101,1102,266,2469,63019
23-01-2016,20,25302,21736,8808,2790,58637,1033,902,253,2188,60825
23-01-2016,21,24571,21215,8736,2998,57519,1020,622,244,1886,59405
23-01-2016,22,23596,20317,8436,3001,55350,989,613,234,1836,57186
23-01-2016,23,23327,18884,8016,2894,53122,965,605,200,1770,54892
24-01-2016,0,22297,17579,7852,3110,50838,892,584,175,1651,52489
24-01-2016,1,21425,17287,7800,3054,49566,902,584,163,1649,51215
24-01-2016,2,20770,17189,7710,3234,48902,898,581,163,1642,50544
24-01-2016,3,20565,17112,7654,3299,48630,897,582,152,1631,50261
24-01-2016,4,20869,17099,7687,3042,48697,897,600,149,1646,50343
24-01-2016,5,21440,17204,7690,2939,49273,916,743,155,1814,51087
24-01-2016,6,21215,17426,7773,2792,49205,918,765,154,1837,51042
24-01-2016,7,21782,18007,8090,2983,50862,935,796,156,1887,52749
24-01-2016,8,22268,19346,7994,3120,52729,869,887,173,1929,54658
24-01-2016,9,23275,20624,8040,3268,55206,887,934,174,1995,57201
24-01-2016,10,23908,21403,8077,3433,56822,921,967,176,2064,58886
24-01-2016,11,23931,21575,8111,3591,57206,858,928,162,1948,59154
24-01-2016,12,23758,21429,8100,3696,56983,869,811,156,1836,58819
24-01-2016,13,23579,21468,8081,3691,56818,868,800,154,1822,58640
24-01-2016,14,23458,21305,8192,3728,56685,892,834,143,1869,58554
24-01-2016,15,23732,21437,8528,3594,57292,925,926,149,2000,59292
24-01-2016,16,24656,22075,8708,3655,59095,967,1035,169,2171,61266
24-01-2016,17,24846,22762,8718,4135,60460,965,1041,182,2188,62648
24-01-2016,18,24372,22678,8732,3954,59737,929,978,199,2106,61843
24-01-2016,19,23584,22231,8669,3836,58321,909,915,179,2003,60324
24-01-2016,20,22975,21853,8379,3818,57026,898,831,169,1898,58924
24-01-2016,21,22624,20979,8279,3735,55618,882,627,193,1702,57320
24-01-2016,22,22197,19761,8097,3366,53421,865,606,220,1691,55112
24-01-2016,23,21408,18517,7870,2969,50765,838,592,174,1604,52369
25-01-2016,0,19366,17507,7723,2994,47591,882,628,158,1668,49259
25-01-2016,1,18715,17147,7642,2956,46461,899,665,151,1715,48176
25-01-2016,2,18592,17002,7688,2900,46182,901,631,158,1690,47872
25-01-2016,3,18743,16967,7903,2954,46567,914,615,180,1709,48276
25-01-2016,4,19172,17125,8265,2892,47454,1101,592,181,1874,49328
25-01-2016,5,20619,17901,8778,3111,50409,1557,680,185,2422,52831
25-01-2016,6,23403,20650,9422,3404,56880,1656,1107,360,3123,60003
25-01-2016,7,25371,23139,9750,4030,62291,1663,1312,480,3455,65746
25-01-2016,8,25621,23288,9747,4381,63038,1667,1360,476,3503,66541
25-01-2016,9,25077,23077,9649,4209,62011,1658,1359,487,3504,65515
25-01-2016,10,25380,23058,9258,4358,62054,1680,1148,319,3147,65201
25-01-2016,11,25266,22981,9251,4246,61744,1613,1075,310,2998,64742
25-01-2016,12,24658,23067,9475,3942,61143,1683,1105,296,3084,64227
25-01-2016,13,24343,23181,9507,4051,61082,1686,1286,303,3275,64357
25-01-2016,14,24566,23304,9444,3737,61053,1685,1298,304,3287,64340
25-01-2016,15,24478,23457,9543,3722,61200,1700,1335,452,3487,64687
25-01-2016,16,24711,23637,9632,4022,62001,1718,1359,513,3590,65591
25-01-2016,17,24901,24007,9668,4324,62901,1697,1363,558,3618,66519
25-01-2016,18,24096,24007,9495,3896,61495,1691,1327,431,3449,64944
25-01-2016,19,22871,23726,9016,4012,59626,1524,1112,285,2921,62547
25-01-2016,20,21611,23451,8726,4428,58216,1044,956,286,2286,60502
25-01-2016,21,20649,22388,8620,4697,56354,1006,864,91,1961,58315
25-01-2016,22,19217,20954,8326,5039,53537,1029,592,89,1710,55247
25-01-2016,23,17354,19812,7924,4693,49784,971,589,101,1661,51445
26-01-2016,0,16360,19411,7868,4562,48201,870,585,119,1574,49775
26-01-2016,1,15461,19171,7829,4569,47031,837,594,135,1566,48597
26-01-2016,2,14259,18960,7810,4721,45749,854,594,154,1602,47351
26-01-2016,3,14078,18924,7951,4708,45663,878,600,177,1655,47318
26-01-2016,4,15204,19172,8602,4718,47697,1018,604,207,1829,49526
26-01-2016,5,16049,19581,10057,4766,50452,1322,650,255,2227,52679
26-01-2016,6,17992,21321,10489,4692,54494,1612,910,455,2977,57471
26-01-2016,7,20626,23453,10370,4797,59246,1641,1146,447,3234,62480
26-01-2016,8,21759,24579,9985,4571,60895,1653,1226,455,3334,64229
26-01-2016,9,21816,24625,9626,4543,60611,1658,1092,475,3225,63836
26-01-2016,10,21679,24600,9319,4421,60019,1468,939,317,2724,62743
26-01-2016,11,21506,24417,9191,4409,59525,1466,931,328,2725,62250
26-01-2016,12,21248,24259,9471,4297,59275,1632,957,346,2935,62210
26-01-2016,13,21162,24429,9575,4209,59376,1557,974,535,3066,62442
26-01-2016,14,21272,24346,9331,4352,59301,1600,991,562,3153,62454
26-01-2016,15,21131,24048,9540,4859,59578,1660,1007,571,3238,62816
26-01-2016,16,21576,23883,9791,5123,60373,1671,1112,495,3278,63651
26-01-2016,17,22035,23989,9632,5333,60990,1649,1095,503,3247,64237
26-01-2016,18,20929,23728,9499,5633,59789,1614,986,498,3098,62887
26-01-2016,19,20048,22959,9089,5580,57677,1320,940,366,2626,60303
26-01-2016,20,19075,22437,8499,5523,55534,957,908,327,2192,57726
26-01-2016,21,18248,21707,8280,5547,53782,938,602,307,1847,55629
26-01-2016,22,16223,21300,8033,5434,50992,921,583,302,1806,52798
26-01-2016,23,13687,19984,7659,5310,46641,926,588,248,1762,48403
27-01-2016,0,12580,19200,7499,5423,44703,909,588,185,1682,46385
27-01-2016,1,12111,19150,7444,5138,43844,940,593,208,1741,45585
27-01-2016,2,11993,19089,7581,4846,43508,956,591,221,1768,45276
27-01-2016,3,11891,19139,7708,4926,43664,960,595,263,1818,45482
27-01-2016,4,11953,19215,8150,5174,44492,1059,627,310,1996,46488
27-01-2016,5,14020,19604,8664,4917,47205,1394,845,344,2583,49788
27-01-2016,6,17011,22138,9077,4854,53081,1851,958,440,3249,56330
27-01-2016,7,19287,24482,9232,4767,57767,1928,1044,573,3545,61312
27-01-2016,8,19904,24742,9058,4608,58313,1898,1156,552,3606,61919
27-01-2016,9,19670,24288,9032,4472,57462,1894,1133,424,3451,60913
27-01-2016,10,19678,24417,8710,4477,57282,1784,1032,398,3214,60496
27-01-2016,11,19226,24219,8768,4744,56957,1757,991,397,3145,60102
27-01-2016,12,18526,24160,8917,5201,56805,1906,978,398,3282,60087
27-01-2016,13,18671,23872,8802,5353,56699,1845,987,497,3329,60028
27-01-2016,14,18815,23634,8876,5368,56692,1751,979,476,3206,59898
27-01-2016,15,18941,23645,8911,5280,56778,1912,945,499,3356,60134
27-01-2016,16,19537,24163,9099,5350,58148,1934,1076,557,3567,61715
27-01-2016,17,20131,24724,9195,5393,59444,1929,1115,513,3557,63001
27-01-2016,18,19539,24304,9032,5332,58207,1875,952,495,3322,61529
27-01-2016,19,18892,23896,8795,5356,56939,1356,836,382,2574,59513
27-01-2016,20,17932,23335,8302,5486,55054,1040,758,381,2179,57233
27-01-2016,21,17310,22316,8077,5413,53118,1062,596,383,2041,55159
27-01-2016,22,15468,21249,7777,5431,49923,999,597,388,1984,51907
27-01-2016,23,13632,19656,7475,4853,45617,987,578,389,1954,47571
28-01-2016,0,13505,18439,7366,4991,44303,948,612,388,1948,46251
28-01-2016,1,12915,18131,7283,4724,43052,960,594,377,1931,44983
28-01-2016,2,12483,18036,7258,4521,42298,982,591,388,1961,44259
28-01-2016,3,12381,18171,7319,4556,42427,1000,592,378,1970,44397
28-01-2016,4,12590,18285,7659,4738,43273,1109,591,391,2091,45364
28-01-2016,5,15177,18681,8513,4731,47104,1504,591,394,2489,49593
28-01-2016,6,17460,21008,8802,4984,52254,1967,713,681,3361,55615
28-01-2016,7,19360,23707,9046,5134,57247,1997,790,822,3609,60856
28-01-2016,8,20048,24405,8971,5060,58484,2009,870,810,3689,62173
28-01-2016,9,19688,24158,8885,5097,57828,2000,730,819,3549,61377
28-01-2016,10,19808,24304,8562,5268,57944,1739,679,559,2977,60921
28-01-2016,11,19597,24328,8517,5183,57626,1647,673,470,2790,60416
28-01-2016,12,19171,24331,8713,5100,57314,1810,670,462,2942,60256
28-01-2016,13,19061,24213,8830,5111,57215,1795,693,717,3205,60420
28-01-2016,14,19093,23977,8962,4988,57021,1862,681,632,3175,60196
28-01-2016,15,19572,24074,9152,4892,57691,1908,702,684,3294,60985
28-01-2016,16,20425,24626,9279,4771,59101,1988,843,802,3633,62734
28-01-2016,17,21556,25327,9356,4645,60885,1971,839,814,3624,64509
28-01-2016,18,20906,25406,9253,4628,60194,1955,840,684,3479,63673
28-01-2016,19,19623,25175,8858,4692,58350,1617,848,411,2876,61226
28-01-2016,20,18368,24743,8247,4791,56148,1453,841,408,2702,58850
28-01-2016,21,17841,23692,8236,4785,54554,1207,599,404,2210,56764
28-01-2016,22,16729,22557,8110,4881,52277,1123,579,391,2093,54370
28-01-2016,23,15638,21013,7701,4686,49039,1075,595,394,2064,51103
29-01-2016,0,14775,19761,7454,4784,46776,1093,426,393,1912,48688
29-01-2016,1,14140,19518,7321,4736,45713,1095,415,386,1896,47609
29-01-2016,2,13655,19325,7356,4949,45285,1084,412,386,1882,47167
29-01-2016,3,13653,19261,7485,5010,45408,1086,415,371,1872,47280
29-01-2016,4,13644,19246,8033,4996,45920,1155,456,351,1962,47882
29-01-2016,5,14716,20036,8806,5040,48598,1445,643,560,2648,51246
29-01-2016,6,16853,22044,9015,5037,52949,1905,844,690,3439,56388
29-01-2016,7,18548,24772,9254,5145,57718,1996,1054,733,3783,61501
29-01-2016,8,19270,25217,9223,5262,58971,1989,1030,727,3746,62717
29-01-2016,9,18922,24973,9158,5481,58535,2004,937,657,3598,62133
29-01-2016,10,18747,25189,8890,5795,58620,1804,902,337,3043,61663
29-01-2016,11,17782,25323,8824,5979,57908,1767,788,311,2866,60774
29-01-2016,12,16730,24660,8981,5963,56335,1981,788,271,3040,59375
29-01-2016,13,16736,23653,9023,5941,55355,1941,823,488,3252,58607
29-01-2016,14,16235,23826,9051,6096,55206,1869,772,500,3141,58347
29-01-2016,15,16272,24057,9159,5892,55379,1919,787,491,3197,58576
29-01-2016,16,16690,24807,9338,5728,56564,2000,911,486,3397,59961
29-01-2016,17,16969,25213,9173,5737,57091,2067,952,430,3449,60540
29-01-2016,18,17160,25151,9132,5508,56952,2052,977,382,3411,60363
29-01-2016,19,16426,25075,8809,5327,55637,1393,844,400,2637,58274
29-01-2016,20,15103,24236,8321,5423,53085,1016,543,404,1963,55048
29-01-2016,21,14909,23221,8056,5181,51367,991,444,409,1844,53211
29-01-2016,22,14317,21955,7691,4951,48915,969,442,405,1816,50731
29-01-2016,23,13357,20121,7525,4915,45916,888,427,456,1771,47687
30-01-2016,0,12723,19072,7461,4807,44063,884,412,455,1751,45814
30-01-2016,1,12768,18288,7431,4693,43178,851,410,385,1646,44824
30-01-2016,2,12510,18067,7294,4623,42495,869,410,396,1675,44170
30-01-2016,3,12115,18065,7257,4285,41722,842,411,396,1649,43371
30-01-2016,4,11581,18328,7251,4332,41493,859,413,395,1667,43160
30-01-2016,5,11548,18706,7425,4422,42100,854,410,387,1651,43751
30-01-2016,6,12448,19389,7531,4655,44021,835,312,392,1539,45560
30-01-2016,7,13044,20331,7634,5144,46152,843,328,386,1557,47709
30-01-2016,8,13884,20681,7756,4999,47319,829,429,377,1635,48954
30-01-2016,9,14749,21459,7915,4267,48391,830,461,388,1679,50070
30-01-2016,10,15109,22101,8053,4239,49502,824,472,395,1691,51193
30-01-2016,11,15036,22218,8009,4289,49552,821,546,396,1763,51315
30-01-2016,12,14809,22116,8018,4671,49613,828,573,407,1808,51421
30-01-2016,13,14706,21899,8184,4858,49646,823,567,402,1792,51438
30-01-2016,14,14590,21874,8452,4880,49798,800,447,396,1643,51441
30-01-2016,15,15124,22177,8554,4741,50598,832,438,400,1670,52268
30-01-2016,16,16813,23192,8590,4700,53295,831,796,401,2028,55323
30-01-2016,17,18993,24088,8581,4879,56539,853,908,407,2168,58707
30-01-2016,18,18686,23955,8490,4802,55935,853,709,415,1977,57912
30-01-2016,19,17674,23624,8286,4851,54435,831,652,379,1862,56297
30-01-2016,20,16457,23036,7997,4931,52421,802,419,374,1595,54016
30-01-2016,21,15802,22084,7737,4826,50450,778,345,358,1481,51931
30-01-2016,22,14500,21151,7612,4903,48166,787,329,306,1422,49588
30-01-2016,23,13189,20383,7560,5007,46138,785,363,282,1430,47568
31-01-2016,0,13254,19384,7533,4957,45129,787,242,255,1284,46413
31-01-2016,1,12701,18883,7512,5161,44255,784,232,243,1259,45514
31-01-2016,2,12304,18514,7529,5294,43641,778,226,225,1229,44870
31-01-2016,3,12204,18365,7494,5200,43263,775,236,239,1250,44513
31-01-2016,4,12657,18381,7491,4717,43247,787,240,276,1303,44550
31-01-2016,5,12742,18378,7500,4909,43530,775,236,284,1295,44825
31-01-2016,6,13357,18772,7610,4798,44537,743,251,306,1300,45837
31-01-2016,7,13705,19440,7797,4982,45923,756,341,344,1441,47364
31-01-2016,8,14098,20144,7864,4981,47088,754,494,314,1562,48650
31-01-2016,9,15100,20822,7955,4869,48746,745,586,310,1641,50387
31-01-2016,10,15523,21621,7994,4824,49963,847,434,322,1603,51566
31-01-2016,11,15864,21706,7916,4973,50459,899,434,345,1678,52137
31-01-2016,12,15726,21798,7926,5144,50595,868,431,355,1654,52249
31-01-2016,13,15427,21660,7892,5036,50014,827,406,381,1614,51628
31-01-2016,14,15448,21681,7933,4772,49834,819,404,410,1633,51467
31-01-2016,15,16007,21790,8153,4446,50396,977,467,422,1866,52262
31-01-2016,16,17913,22518,8559,3990,52980,969,659,427,2055,55035
31-01-2016,17,20393,23470,8600,3902,56365,998,853,465,2316,58681
31-01-2016,18,20947,23655,8642,3843,57087,1027,835,470,2332,59419
31-01-2016,19,20662,23622,8488,3714,56486,979,780,416,2175,58661
31-01-2016,20,19978,23440,8037,3528,54982,841,585,421,1847,56829
31-01-2016,21,18901,23086,7896,3381,53264,854,253,412,1519,54783
31-01-2016,22,18041,22646,7659,3267,51612,804,250,357,1411,53023
31-01-2016,23,15970,21360,7432,3322,48084,792,254,302,1348,49432
01-02-2016,0,14702,19261,7355,3215,44532,830,253,279,1362,45894
01-02-2016,1,13215,18643,7320,3097,42274,845,249,264,1358,43632
01-02-2016,2,13435,18509,7398,2853,42196,866,252,258,1376,43572
01-02-2016,3,13721,18643,7582,2680,42625,889,291,250,1430,44055
01-02-2016,4,14524,19001,7900,2617,44043,1132,343,228,1703,45746
01-02-2016,5,17423,20201,8621,2555,48800,1459,575,219,2253,51053
01-02-2016,6,21470,23101,9268,2782,56620,1581,1003,245,2829,59449
01-02-2016,7,24705,24772,9556,3068,62102,1586,1226,446,3258,65360
01-02-2016,8,24943,25541,9524,3427,63434,1576,1175,445,3196,66630
01-02-2016,9,24462,25124,9449,3588,62624,1566,1182,423,3171,65795
01-02-2016,10,23613,24880,9198,4219,61912,1427,979,431,2837,64749
01-02-2016,11,22991,24426,8971,4506,60894,1313,899,437,2649,63543
01-02-2016,12,22090,24244,8966,4977,60276,1469,948,445,2862,63138
01-02-2016,13,21777,24251,9112,5370,60511,1594,952,442,2988,63499
01-02-2016,14,21421,24561,9364,5492,60838,1504,1109,438,3051,63889
01-02-2016,15,20713,24985,9593,5613,60903,1470,1150,415,3035,63938
01-02-2016,16,20524,24871,9781,5790,60967,1628,1203,462,3293,64260
01-02-2016,17,21048,24961,9687,5927,61623,1643,1050,435,3128,64751
01-02-2016,18,20226,25052,9522,5816,60618,1626,1053,468,3147,63765
01-02-2016,19,19217,24463,9268,5861,58810,1492,857,346,2695,61505
01-02-2016,20,17966,23521,8938,5753,56177,1159,489,353,2001,58178
01-02-2016,21,16108,23069,8618,5887,53684,1181,480,348,2009,55693
01-02-2016,22,15316,22092,8307,5515,51232,1097,450,395,1942,53174
01-02-2016,23,14195,20942,8123,5110,48369,1010,451,406,1867,50236
02-02-2016,0,13402,19427,8019,5156,46003,1009,448,412,1869,47872
02-02-2016,1,13029,19300,7876,5035,45239,1066,441,411,1918,47157
02-02-2016,2,12127,19171,7752,4707,43758,1054,441,407,1902,45660
02-02-2016,3,11895,19129,7823,4676,43525,1054,450,408,1912,45437
02-02-2016,4,12391,19234,8088,4840,44553,1119,449,407,1975,46528
02-02-2016,5,13954,19550,8848,5000,47353,1443,475,446,2364,49717
02-02-2016,6,16503,22392,9248,5661,53803,1785,595,486,2866,56669
02-02-2016,7,19720,24502,9451,5430,59102,1771,892,484,3147,62249
02-02-2016,8,19973,24338,9229,5645,59183,1747,1000,634,3381,62564
02-02-2016,9,19857,24203,9055,5711,58826,1755,980,650,3385,62211
02-02-2016,10,19722,24214,8827,5821,58585,1795,531,492,2818,61403
02-02-2016,11,19349,24140,8725,5898,58111,1766,627,622,3015,61126
02-02-2016,12,19218,23883,8878,5853,57831,1754,595,492,2841,60672
02-02-2016,13,19170,23799,8921,5805,57696,1739,859,738,3336,61032
02-02-2016,14,19362,23766,8997,5711,57837,1739,875,721,3335,61172
02-02-2016,15,19502,23726,8970,5683,57881,1732,846,716,3294,61175
02-02-2016,16,20332,23955,8995,5567,58848,1713,1062,771,3546,62394
02-02-2016,17,21120,24021,8986,5595,59722,1715,1170,825,3710,63432
02-02-2016,18,20614,24010,9002,5611,59237,1698,1078,754,3530,62767
02-02-2016,19,19642,23731,8787,5753,57913,1352,1018,682,3052,60965
02-02-2016,20,18578,23295,8676,5684,56233,1163,507,463,2133,58366
02-02-2016,21,17434,23024,8445,5743,54646,1205,429,413,2047,56693
02-02-2016,22,15865,22259,8037,5826,51988,1205,413,405,2023,54011
02-02-2016,23,14681,20941,7611,5522,48754,1119,420,413,1952,50706
03-02-2016,0,14630,18956,7241,5408,46235,1106,282,424,1812,48047
03-02-2016,1,14175,18492,7181,5483,45333,1079,282,429,1790,47123
03-02-2016,2,14165,18420,7180,5087,44853,1098,281,431,1810,46663
03-02-2016,3,14285,18485,7341,5274,45386,1120,281,434,1835,47221
03-02-2016,4,14021,18529,7750,5344,45644,1205,292,437,1934,47578
03-02-2016,5,15450,19576,8243,5387,48656,1572,720,584,2876,51532
03-02-2016,6,18063,22625,8565,4876,54129,1909,793,691,3393,57522
03-02-2016,7,20930,24271,8740,4816,58757,1938,999,716,3653,62410
03-02-2016,8,21915,24711,8677,4736,60040,1931,1007,716,3654,63694
03-02-2016,9,21910,24693,8750,4548,59901,1918,846,697,3461,63362
03-02-2016,10,21583,24527,8557,4583,59251,1903,492,620,3015,62266
03-02-2016,11,21219,24275,8477,4698,58670,1897,488,595,2980,61650
03-02-2016,12,20575,23916,8626,4843,57960,1892,484,495,2871,60831
03-02-2016,13,20855,23599,8779,4673,57906,1956,482,677,3115,61021
03-02-2016,14,20621,23525,8778,4625,57549,1968,477,622,3067,60616
03-02-2016,15,20772,23220,8904,4568,57464,1989,616,672,3277,60741
03-02-2016,16,21365,23450,9075,4583,58475,1983,997,693,3673,62148
03-02-2016,17,22529,23888,9133,4747,60298,1923,1244,633,3800,64098
03-02-2016,18,21826,24203,9118,4800,59947,1936,973,643,3552,63499
03-02-2016,19,21038,23557,9100,4852,58548,1576,712,424,2712,61260
03-02-2016,20,19979,23617,8882,4966,57444,1146,492,387,2025,59469
03-02-2016,21,18863,23186,8658,4944,55651,1146,379,258,1783,57434
03-02-2016,22,17777,22518,8271,4844,53409,1144,412,239,1795,55204
03-02-2016,23,16617,21456,7901,4782,50757,1089,382,194,1665,52422
04-02-2016,0,15994,19763,7854,5042,48655,1072,254,185,1511,50166
04-02-2016,1,15664,19303,7828,5015,47812,1068,258,180,1506,49318
04-02-2016,2,14863,19291,7880,4982,47017,1068,257,188,1513,48530
04-02-2016,3,13817,19387,7937,4884,46025,1058,257,205,1520,47545
04-02-2016,4,14360,19606,8342,4722,47031,1083,298,216,1597,48628
04-02-2016,5,16133,20858,8904,4699,50592,1451,614,295,2360,52952
04-02-2016,6,19188,23666,9340,4469,56663,1827,782,478,3087,59750
04-02-2016,7,22599,25200,9376,4445,61621,1878,1062,492,3432,65053
04-02-2016,8,23235,25706,9262,4380,62584,1874,1028,499,3401,65985
04-02-2016,9,23188,25606,9108,4064,61967,1853,965,453,3271,65238
04-02-2016,10,23186,25538,8857,3980,61562,1793,598,318,2709,64271
04-02-2016,11,22429,25543,8891,4284,61148,1697,665,314,2676,63824
04-02-2016,12,21586,25501,8850,4443,60380,1680,664,322,2666,63046
04-02-2016,13,21149,25192,8918,4437,59696,1885,665,349,2899,62595
04-02-2016,14,20958,24735,9032,4365,59092,1927,674,512,3113,62205
04-02-2016,15,21270,24175,9136,4131,58712,1937,740,496,3173,61885
04-02-2016,16,22454,24343,9220,3863,59881,1938,1044,486,3468,63349
04-02-2016,17,24055,24846,9386,3890,62178,1942,1155,681,3778,65956
04-02-2016,18,23854,25073,9322,3897,62146,1922,1074,697,3693,65839
04-02-2016,19,23317,24975,9197,3667,61156,1692,1070,321,3083,64239
04-02-2016,20,22483,24811,8841,3536,59668,1176,718,325,2219,61887
04-02-2016,21,21420,24506,8724,3389,58038,1134,626,313,2073,60111
04-02-2016,22,20090,24105,8427,3079,55702,1076,292,289,1657,57359
04-02-2016,23,18615,22960,8046,2879,52500,1064,265,293,1622,54122
05-02-2016,0,18802,20508,7852,3127,50288,1014,262,278,1554,51842
05-02-2016,1,18586,19640,7849,3056,49130,1018,261,263,1542,50672
05-02-2016,2,18468,19861,7843,3026,49198,1015,257,288,1560,50758
05-02-2016,3,18993,19787,8057,2869,49705,934,258,369,1561,51266
05-02-2016,4,19404,20190,8454,2702,50750,1069,271,359,1699,52449
05-02-2016,5,20529,20768,8803,2651,52752,1504,690,356,2550,55302
05-02-2016,6,22882,22771,9245,2734,57632,1725,941,548,3214,60846
05-02-2016,7,25631,24435,9491,3074,62631,1742,1016,575,3333,65964
05-02-2016,8,25904,24779,9513,3346,63542,1746,1042,594,3382,66924
05-02-2016,9,25866,24599,9490,3539,63494,1751,1038,559,3348,66842
05-02-2016,10,26086,24519,9324,3590,63519,1711,685,571,2967,66486
05-02-2016,11,25690,24146,9273,3544,62654,1670,978,437,3085,65739
05-02-2016,12,24950,24141,9254,3669,62015,1714,1005,429,3148,65163
05-02-2016,13,24365,23833,9485,3704,61389,1696,1000,458,3154,64543
05-02-2016,14,24398,23581,9571,3418,60968,1709,988,452,3149,64117
05-02-2016,15,24065,23604,9493,3381,60543,1703,982,449,3134,63677
05-02-2016,16,24768,23781,9684,3437,61669,1671,1230,492,3393,65062
05-02-2016,17,25537,23943,9627,3713,62819,1670,1317,683,3670,66489
05-02-2016,18,24799,23836,9635,3840,62110,1649,1245,606,3500,65610
05-02-2016,19,23575,23320,9516,3706,60118,1451,1013,315,2779,62897
05-02-2016,20,22150,22816,8965,3656,57586,1256,929,296,2481,60067
05-02-2016,21,20939,21658,8674,3575,54847,1165,552,256,1973,56820
05-02-2016,22,19742,20879,8493,3636,52750,1064,261,167,1492,54242
05-02-2016,23,18404,20088,8261,3914,50668,892,257,162,1311,51979
06-02-2016,0,17473,18878,7990,4076,48417,722,184,140,1046,49463
06-02-2016,1,15693,18523,7950,4332,46498,707,185,123,1015,47513
06-02-2016,2,14812,18260,7956,4490,45518,709,186,138,1033,46551
06-02-2016,3,13608,18147,7923,4612,44289,699,188,136,1023,45312
06-02-2016,4,13207,18108,8029,4580,43923,712,192,154,1058,44981
06-02-2016,5,13212,18375,8334,4543,44464,764,203,141,1108,45572
06-02-2016,6,13879,18995,8596,4749,46218,878,284,163,1325,47543
06-02-2016,7,15419,20248,8798,4716,49182,906,408,245,1559,50741
06-02-2016,8,16603,21325,8939,4787,51655,927,375,260,1562,53217
06-02-2016,9,17524,22294,9105,4838,53761,915,465,260,1640,55401
06-02-2016,10,17737,22889,9105,5171,54901,928,530,262,1720,56621
06-02-2016,11,17313,23066,8993,4991,54364,944,602,208,1754,56118
06-02-2016,12,16611,23307,8893,4644,53456,956,630,175,1761,55217
06-02-2016,13,15536,23020,8753,4341,51651,926,510,237,1673,53324
06-02-2016,14,15140,22631,8749,4329,50849,932,491,242,1665,52514
06-02-2016,15,15552,22253,9033,4309,51147,971,507,253,1731,52878
06-02-2016,16,17421,22120,9297,4625,53463,1033,589,265,1887,55350
06-02-2016,17,20047,23090,9309,4675,57123,1039,493,300,1832,58955
06-02-2016,18,19892,23432,9232,4866,57423,990,501,300,1791,59214
06-02-2016,19,18381,22498,8954,5017,54851,913,493,323,1729,56580
06-02-2016,20,16159,21729,8522,4864,51272,861,409,269,1539,52811
06-02-2016,21,14721,20577,8421,4841,48560,839,304,293,1436,49996
06-02-2016,22,14127,19896,8181,4655,46859,782,264,290,1336,48195
06-02-2016,23,13524,19173,7839,4518,45055,787,261,301,1349,46404
07-02-2016,0,13011,17827,7634,4431,42904,773,223,286,1282,44186
07-02-2016,1,12438,17273,7557,4348,41616,785,215,280,1280,42896
07-02-2016,2,12105,17088,7460,4279,40933,772,205,259,1236,42169
07-02-2016,3,11746,16995,7402,4228,40372,776,200,267,1243,41615
07-02-2016,4,11332,16650,7393,4157,39531,761,203,280,1244,40775
07-02-2016,5,11359,16730,7454,4191,39733,766,216,259,1241,40974
07-02-2016,6,12056,17285,7399,4277,41018,773,311,261,1345,42363
07-02-2016,7,12961,18096,7447,4440,42944,751,475,269,1495,44439
07-02-2016,8,13296,18608,7591,4613,44108,748,598,252,1598,45706
07-02-2016,9,14301,19259,7701,4944,46204,745,688,212,1645,47849
07-02-2016,10,15038,19788,7739,4858,47423,823,685,225,1733,49156
07-02-2016,11,15139,20255,7798,4774,47966,822,531,220,1573,49539
07-02-2016,12,14954,20857,7787,4713,48310,832,514,203,1549,49859
07-02-2016,13,14628,20862,7816,4542,47848,846,506,205,1557,49405
07-02-2016,14,14273,20811,7823,4742,47647,813,507,225,1545,49192
07-02-2016,15,14277,20743,7990,4880,47889,810,511,268,1589,49478
07-02-2016,16,14514,20871,8265,4910,48560,883,625,299,1807,50367
07-02-2016,17,16823,21782,8333,4799,51737,929,698,361,1988,53725
07-02-2016,18,17829,22487,8262,4547,53124,953,656,362,1971,55095
07-02-2016,19,17053,22229,8136,4627,52047,970,528,357,1855,53902
07-02-2016,20,15787,21690,8023,4691,50192,932,398,347,1677,51869
07-02-2016,21,14487,20848,7967,4873,48175,884,418,314,1616,49791
07-02-2016,22,13915,20157,7809,4819,46700,857,267,325,1449,48149
07-02-2016,23,12768,19076,7686,4900,44431,847,275,324,1446,45877
08-02-2016,0,11408,18561,7558,4948,42476,842,213,316,1371,43847
08-02-2016,1,10282,17848,7547,5087,40766,847,211,297,1355,42121
08-02-2016,2,10441,17811,7598,4932,40782,867,207,288,1362,42144
08-02-2016,3,10439,17775,7625,4954,40793,856,263,275,1394,42187
08-02-2016,4,11140,18266,7925,5072,42403,893,309,248,1450,43853
08-02-2016,5,12019,19191,8608,5292,45110,1162,388,277,1827,46937
08-02-2016,6,14009,20918,9167,5478,49572,1289,924,493,2706,52278
08-02-2016,7,16667,23345,9336,5847,55195,1328,1002,504,2834,58029
08-02-2016,8,17432,23944,9380,5674,56429,1318,1042,472,2832,59261
08-02-2016,9,17256,24002,9148,5729,56136,1305,1029,403,2737,58873
08-02-2016,10,18025,24664,8967,5789,57444,1180,693,232,2105,59549
08-02-2016,11,18024,25515,8929,5736,58205,1166,660,247,2073,60278
08-02-2016,12,17277,24920,8974,5436,56607,1199,663,284,2146,58753
08-02-2016,13,16690,24160,9222,5346,55416,1290,830,336,2456,57872
08-02-2016,14,16696,23853,9177,5109,54835,1305,1001,449,2755,57590
08-02-2016,15,17181,23451,9339,5225,55196,1286,1039,525,2850,58046
08-02-2016,16,17628,23424,9434,4969,55456,1298,1373,782,3453,58909
08-02-2016,17,19196,24159,9420,4947,57723,1316,1070,839,3225,60948
08-02-2016,18,19098,24752,9310,4789,57950,1290,1050,641,2981,60931
08-02-2016,19,18393,24002,8973,4783,56151,1179,772,469,2420,58571
08-02-2016,20,16455,22719,8596,4749,52519,879,612,453,1944,54463
08-02-2016,21,15409,21754,8453,4660,50276,870,518,378,1766,52042
08-02-2016,22,14531,20979,8143,4509,48163,830,436,357,1623,49786
08-02-2016,23,13140,20064,7853,4230,45287,810,435,343,1588,46875
09-02-2016,0,12786,18719,7771,3690,42967,807,369,334,1510,44477
09-02-2016,1,12406,18402,7715,3692,42215,836,362,352,1550,43765
09-02-2016,2,11672,18157,7731,3699,41260,840,370,356,1566,42826
09-02-2016,3,11475,18060,7787,3786,41108,834,375,350,1559,42667
09-02-2016,4,11853,17905,8205,4046,42009,832,370,339,1541,43550
09-02-2016,5,13393,18463,8736,4169,44762,1059,464,388,1911,46673
09-02-2016,6,16365,21276,9104,4499,51245,1337,903,432,2672,53917
09-02-2016,7,19825,23035,9116,4601,56577,1347,1087,626,3060,59637
09-02-2016,8,20352,23434,8990,4602,57378,1326,1152,591,3069,60447
09-02-2016,9,19903,23810,9136,4704,57554,1307,982,369,2658,60212
09-02-2016,10,19634,23410,8970,4838,56852,1168,952,453,2573,59425
09-02-2016,11,19571,23496,8911,4898,56877,1155,844,408,2407,59284
09-02-2016,12,19172,22938,8897,4942,55948,1181,948,392,2521,58469
09-02-2016,13,19263,23131,9032,4761,56187,1331,879,453,2663,58850
09-02-2016,14,19654,23050,9020,4626,56350,1332,976,501,2809,59159
09-02-2016,15,20457,23391,9182,4232,57263,1338,983,437,2758,60021
09-02-2016,16,21495,23329,9213,3856,57892,1344,1073,584,3001,60893
09-02-2016,17,23292,23836,9192,3416,59738,1344,1155,529,3028,62766
09-02-2016,18,23209,24094,9125,3296,59726,1318,1170,456,2944,62670
09-02-2016,19,22737,23724,8961,3106,58526,1090,1130,343,2563,61089
09-02-2016,20,22076,23220,8388,2637,56322,905,935,368,2208,58530
09-02-2016,21,20232,22464,8228,2612,53536,807,684,276,1767,55303
09-02-2016,22,19162,21017,7832,2411,50421,792,468,282,1542,51963
09-02-2016,23,16405,19546,7382,2274,45608,806,399,311,1516,47124
10-02-2016,0,16015,17663,7502,2156,43337,796,377,318,1491,44828
10-02-2016,1,15098,17142,7396,2108,41744,771,373,343,1487,43231
10-02-2016,2,15102,17055,7377,2281,41815,753,374,369,1496,43311
10-02-2016,3,15158,16987,7474,2504,42124,735,380,384,1499,43623
10-02-2016,4,15425,17302,7850,2523,43100,753,369,356,1478,44578
10-02-2016,5,17314,18165,8545,2548,46573,1004,372,387,1763,48336
10-02-2016,6,21284,21099,8809,2675,53868,1242,828,629,2699,56567
10-02-2016,7,24009,22761,9015,2733,58519,1244,1020,593,2857,61376
10-02-2016,8,24643,23245,9030,2850,59768,1262,1102,565,2929,62697
10-02-2016,9,24754,23738,9026,2836,60354,1298,965,579,2842,63196
10-02-2016,10,25107,24338,8769,2901,61116,1205,702,340,2247,63363
10-02-2016,11,24894,24501,8655,2991,61040,1159,706,313,2178,63218
10-02-2016,12,24795,24222,8618,2931,60566,1172,700,261,2133,62699
10-02-2016,13,24780,24305,8826,2930,60840,1314,763,312,2389,63229
10-02-2016,14,24913,24128,8950,2778,60769,1335,864,440,2639,63408
10-02-2016,15,24864,24233,8993,2653,60743,1342,878,416,2636,63379
10-02-2016,16,25122,24728,9207,2493,61551,1347,1057,428,2832,64383
10-02-2016,17,25387,25114,9211,2807,62519,1360,1102,400,2862,65381
10-02-2016,18,25321,25195,9081,2757,62354,1357,1181,390,2928,65282
10-02-2016,19,24959,24570,8893,2368,60791,1331,807,179,2317,63108
10-02-2016,20,24553,24257,8347,2172,59330,1017,694,175,1886,61216
10-02-2016,21,23146,23496,8247,2077,56966,931,570,173,1674,58640
10-02-2016,22,21596,22288,7934,1761,53581,879,421,109,1409,54990
10-02-2016,23,19936,21058,7601,1736,50331,800,375,103,1278,51609
11-02-2016,0,18848,18751,7608,1558,46764,757,216,90,1063,47827
11-02-2016,1,18498,18123,7559,1484,45666,725,195,174,1094,46760
11-02-2016,2,16893,17885,7433,1505,43715,729,201,193,1123,44838
11-02-2016,3,17139,17871,7519,1594,44123,714,206,195,1115,45238
11-02-2016,4,18401,18408,8038,1592,46441,785,221,193,1199,47640
11-02-2016,5,19936,19438,8655,1768,49795,980,618,202,1800,51595
11-02-2016,6,22796,21637,9061,1990,55485,1214,830,380,2424,57909
11-02-2016,7,25475,23313,9205,2260,60253,1239,1092,397,2728,62981
11-02-2016,8,25737,23882,9113,2667,61399,1236,1073,373,2682,64081
11-02-2016,9,25640,24039,9199,2365,61244,1226,1049,353,2628,63872
11-02-2016,10,25371,23918,8781,2430,60500,1207,1054,379,2640,63140
11-02-2016,11,24761,24100,8646,2549,60058,1209,1049,383,2641,62699
11-02-2016,12,24202,24056,8713,2593,59563,1202,1080,385,2667,62230
11-02-2016,13,24053,23964,9057,2447,59522,1206,1107,363,2676,62198
11-02-2016,14,24065,23891,9040,2323,59318,1209,1097,380,2686,62004
11-02-2016,15,23643,24141,8891,2392,59068,1218,1093,425,2736,61804
11-02-2016,16,23976,24086,8962,2485,59508,1223,1113,606,2942,62450
11-02-2016,17,24750,24222,8891,2660,60523,1236,1181,607,3024,63547
11-02-2016,18,25391,24281,8814,2746,61231,1231,1167,575,2973,64204
11-02-2016,19,24757,24363,8734,2367,60222,1225,1127,458,2810,63032
11-02-2016,20,23697,24241,8301,2315,58554,1035,1139,272,2446,61000
11-02-2016,21,22924,23851,8122,2177,57075,924,629,227,1780,58855
11-02-2016,22,21530,23109,7935,2022,54596,891,409,155,1455,56051
11-02-2016,23,19887,22174,7603,1991,51657,798,445,202,1445,53102
12-02-2016,0,19552,20553,7408,1958,49472,781,236,202,1219,50691
12-02-2016,1,19249,19955,7350,2000,48555,759,232,198,1189,49744
12-02-2016,2,19025,19974,7378,2029,48407,747,232,200,1179,49586
12-02-2016,3,19289,20144,7536,1984,48952,743,233,198,1174,50126
12-02-2016,4,19882,20364,8162,1948,50356,838,337,198,1373,51729
12-02-2016,5,20724,21596,8617,1959,52895,1136,629,206,1971,54866
12-02-2016,6,23265,23195,8933,2268,57662,1342,1309,209,2860,60522
12-02-2016,7,25498,24664,9216,2854,62232,1365,1121,488,2974,65206
12-02-2016,8,25686,24893,9191,2953,62722,1379,1099,456,2934,65656
12-02-2016,9,25434,24857,9232,3074,62597,1377,1091,381,2849,65446
12-02-2016,10,25397,24697,8958,3267,62319,1385,1078,215,2678,64997
12-02-2016,11,25233,24451,9023,2997,61704,1333,1082,218,2633,64337
12-02-2016,12,25131,24203,9034,2718,61088,1321,1096,218,2635,63723
12-02-2016,13,24985,24077,9136,2794,60992,1394,1084,236,2714,63706
12-02-2016,14,24657,24161,9205,2596,60620,1402,1077,231,2710,63330
12-02-2016,15,24187,24484,9277,2508,60456,1414,1076,389,2879,63335
12-02-2016,16,24619,24439,9364,2468,60889,1391,1070,585,3046,63935
12-02-2016,17,25480,24524,9449,2687,62141,1373,1262,591,3226,65367
12-02-2016,18,25426,25067,9421,2914,62827,1341,1101,599,3041,65868
12-02-2016,19,24659,25015,9064,2569,61306,1204,1039,440,2683,63989
12-02-2016,20,23440,24533,8573,2186,58732,995,1031,272,2298,61030
12-02-2016,21,22664,23831,8385,1986,56866,920,816,237,1973,58839
12-02-2016,22,21718,22930,8189,1817,54656,848,250,220,1318,55974
12-02-2016,23,20776,22056,7853,1854,52540,819,227,215,1261,53801
13-02-2016,0,20973,20430,7633,1826,50863,760,204,210,1174,52037
13-02-2016,1,20712,19619,7588,1872,49792,762,208,198,1168,50960
13-02-2016,2,20024,19244,7623,1901,48793,769,207,191,1167,49960
13-02-2016,3,20170,19069,7642,1868,48749,762,209,171,1142,49891
13-02-2016,4,20511,18992,7706,1878,49086,765,206,169,1140,50226
13-02-2016,5,20914,19310,7819,1898,49942,797,265,177,1239,51181
13-02-2016,6,20690,20664,7884,1838,51076,804,443,182,1429,52505
13-02-2016,7,21438,21725,7890,1859,52912,839,496,199,1534,54446
13-02-2016,8,22098,22727,8373,1934,55132,880,575,185,1640,56772
13-02-2016,9,23030,23060,8597,2174,56862,875,934,164,1973,58835
13-02-2016,10,23429,23099,8667,2276,57474,863,919,163,1945,59419
13-02-2016,11,23143,23175,8605,2365,57288,853,897,165,1915,59203
13-02-2016,12,22399,23134,8519,2388,56439,842,889,178,1909,58348
13-02-2016,13,21963,23000,8519,2223,55705,825,876,194,1895,57600
13-02-2016,14,21690,22848,8638,2138,55314,826,735,196,1757,57071
13-02-2016,15,21742,22708,8895,2086,55431,836,583,188,1607,57038
13-02-2016,16,23088,22799,8794,2327,57007,831,800,186,1817,58824
13-02-2016,17,24820,23239,8974,2631,59663,846,1093,194,2133,61796
13-02-2016,18,24975,23403,8987,2894,60260,853,983,210,2046,62306
13-02-2016,19,23593,23050,8672,2964,58278,867,914,210,1991,60269
13-02-2016,20,22350,22246,8316,2945,55857,877,610,211,1698,57555
13-02-2016,21,21208,21475,8389,2780,53851,770,382,201,1353,55204
13-02-2016,22,20236,20881,8005,2755,51877,755,203,199,1157,53034
13-02-2016,23,18547,19798,7791,2825,48961,769,202,196,1167,50128
14-02-2016,0,16888,18321,7691,2767,45667,725,200,191,1116,46783
14-02-2016,1,15981,17599,7627,2781,43989,702,199,189,1090,45079
14-02-2016,2,15484,17402,7560,2893,43339,698,197,183,1078,44417
14-02-2016,3,15368,17310,7569,3054,43301,699,197,180,1076,44377
14-02-2016,4,15580,17341,7605,3295,43821,694,197,186,1077,44898
14-02-2016,5,16178,17474,7637,3524,44812,711,196,196,1103,45915
14-02-2016,6,16483,17862,7764,3705,45813,754,196,201,1151,46964
14-02-2016,7,16693,18387,7864,3808,46752,753,294,195,1242,47994
14-02-2016,8,17812,19087,7995,3787,48680,827,466,192,1485,50165
14-02-2016,9,19395,20571,8030,3738,51734,750,510,182,1442,53176
14-02-2016,10,20064,22274,8084,3864,54286,761,459,496,1716,56002
14-02-2016,11,20731,21784,8116,3800,54432,742,589,166,1497,55929
14-02-2016,12,19889,21833,8119,3942,53782,805,1070,150,2025,55807
14-02-2016,13,18961,21682,8120,3972,52735,792,621,148,1561,54296
14-02-2016,14,18371,21840,8125,4090,52427,700,574,152,1426,53853
14-02-2016,15,18468,22107,7967,4045,52588,698,603,156,1457,54045
14-02-2016,16,19545,22094,8238,3701,53577,748,641,157,1546,55123
14-02-2016,17,21936,22830,8483,3835,57082,782,766,154,1702,58784
14-02-2016,18,23178,23133,8405,3860,58577,781,824,153,1758,60335
14-02-2016,19,22681,23042,8225,3851,57800,770,772,152,1694,59494
14-02-2016,20,21910,22969,7979,3601,56460,761,506,148,1415,57875
14-02-2016,21,21323,22757,8010,3389,55479,742,507,144,1393,56872
14-02-2016,22,20197,22420,7964,3314,53894,725,364,142,1231,55125
14-02-2016,23,18823,21283,7610,3269,50984,681,365,142,1188,52172
15-02-2016,0,17449,19500,7565,3277,47793,676,197,147,1020,48813
15-02-2016,1,16324,18958,7542,3319,46143,676,195,146,1017,47160
15-02-2016,2,15517,18949,7549,3255,45270,646,196,144,986,46256
15-02-2016,3,15856,18983,7803,3218,45861,684,213,143,1040,46901
15-02-2016,4,16678,19309,8427,3146,47561,785,248,146,1179,48740
15-02-2016,5,18183,20331,8997,3146,50656,938,661,162,1761,52417
15-02-2016,6,22241,23076,9516,3303,58135,1019,1063,181,2263,60398
15-02-2016,7,25578,24909,9617,3784,63888,1228,1098,362,2688,66576
15-02-2016,8,25822,25157,9661,4095,64736,1315,920,362,2597,67333
15-02-2016,9,25829,25236,9567,4022,64655,1316,993,299,2608,67263
15-02-2016,10,25772,25344,9195,4398,64708,1373,1033,177,2583,67291
15-02-2016,11,25254,24989,9015,4502,63762,1430,1046,164,2640,66402
15-02-2016,12,24794,24640,8834,4404,62671,1442,1075,171,2688,65359
15-02-2016,13,24366,24436,9103,4293,62199,1496,1031,177,2704,64903
15-02-2016,14,24106,24583,9150,4107,61946,1509,1037,188,2734,64680
15-02-2016,15,23719,24586,9167,4066,61538,1484,1060,188,2732,64270
15-02-2016,16,24103,24341,9394,4082,61920,1496,1073,214,2783,64703
15-02-2016,17,25436,24563,9764,3870,63634,1515,1044,229,2788,66422
15-02-2016,18,25711,25044,9721,4087,64563,1484,1025,219,2728,67291
15-02-2016,19,25367,25094,9480,3499,63440,1243,1033,220,2496,65936
15-02-2016,20,24489,25189,8971,2949,61598,1034,659,225,1918,63516
15-02-2016,21,23585,24701,8875,2657,59819,948,486,224,1658,61477
15-02-2016,22,22321,24489,8821,2354,57985,901,463,233,1597,59582
15-02-2016,23,21083,23974,8642,2226,55924,883,431,246,1560,57484
16-02-2016,0,21393,20321,8648,2472,52834,906,410,247,1563,54397
16-02-2016,1,21272,19723,8690,2378,52062,905,402,246,1553,53615
16-02-2016,2,21243,19520,8679,2349,51791,902,406,255,1563,53354
16-02-2016,3,21478,19580,8785,2294,52138,900,403,236,1539,53677
16-02-2016,4,22380,20067,9039,2383,53869,896,403,242,1541,55410
16-02-2016,5,24217,21212,9781,2520,57730,1046,438,238,1722,59452
16-02-2016,6,25898,23663,10138,3040,62738,1418,609,249,2276,65014
16-02-2016,7,26221,24130,10396,3814,64563,1548,1117,252,2917,67480
16-02-2016,8,26062,23798,10477,3806,64144,1531,1117,408,3056,67200
16-02-2016,9,25928,23078,10304,4084,63394,1533,1118,433,3084,66478
16-02-2016,10,26239,23142,10094,3958,63433,1534,1160,326,3020,66453
16-02-2016,11,26210,22970,9942,3944,63065,1525,1096,226,2847,65912
16-02-2016,12,25922,23022,9814,3900,62659,1483,1105,225,2813,65472
16-02-2016,13,25841,22967,9747,3842,62399,1440,1104,223,2767,65166
16-02-2016,14,25755,22934,9668,3864,62222,1307,1104,219,2630,64852
16-02-2016,15,25455,22663,9541,3650,61309,1288,1135,206,2629,63938
16-02-2016,16,25658,22707,9741,3732,61838,1523,1060,216,2799,64637
16-02-2016,17,25857,23087,9984,3784,62713,1558,1123,412,3093,65806
16-02-2016,18,26159,23700,10059,3864,63782,1534,1127,409,3070,66852
16-02-2016,19,25660,23649,9946,3772,63028,1161,1131,204,2496,65524
16-02-2016,20,24542,23236,9182,3573,60534,1073,1118,187,2378,62912
16-02-2016,21,23033,22993,8813,3627,58465,985,717,174,1876,60341
16-02-2016,22,21170,22597,8560,3477,55805,947,400,176,1523,57328
16-02-2016,23,19321,21129,8430,3519,52399,944,420,175,1539,53938
17-02-2016,0,18380,19879,8454,3495,50207,955,386,170,1511,51718
17-02-2016,1,17795,19490,8343,3579,49207,963,388,146,1497,50704
17-02-2016,2,17409,19476,8333,3627,48846,940,390,179,1509,50355
17-02-2016,3,17805,19514,8372,3640,49331,937,388,179,1504,50835
17-02-2016,4,18835,20047,8685,3751,51319,945,395,177,1517,52836
17-02-2016,5,19630,20885,9263,3932,53709,1160,695,176,2031,55740
17-02-2016,6,21288,23087,9703,4029,58108,1361,940,372,2673,60781
17-02-2016,7,24007,24327,9646,4227,62208,1405,1044,379,2828,65036
17-02-2016,8,24564,24613,9787,4464,63427,1406,1029,329,2764,66191
17-02-2016,9,23976,24626,9835,4618,63055,1390,1024,198,2612,65667
17-02-2016,10,23707,24260,9429,4859,62255,1242,1008,163,2413,64668
17-02-2016,11,23127,23909,9205,4969,61211,1193,974,190,2357,63568
17-02-2016,12,22783,23465,9135,4919,60302,1199,938,190,2327,62629
17-02-2016,13,22854,23291,9432,4857,60433,1194,942,198,2334,62767
17-02-2016,14,22810,23433,9359,4663,60265,1179,973,206,2358,62623
17-02-2016,15,22736,23583,9327,4369,60017,1188,964,236,2388,62405
17-02-2016,16,22990,23886,9497,4319,60692,1274,922,287,2483,63175
17-02-2016,17,24411,24142,9650,4298,62499,1289,976,369,2634,65133
17-02-2016,18,24622,24497,9701,4457,63277,1317,1012,423,2752,66029
17-02-2016,19,23601,24595,9423,4175,61792,1064,999,436,2499,64291
17-02-2016,20,22013,24270,8916,3969,59169,992,635,460,2087,61256
17-02-2016,21,21526,23772,8726,3668,57693,940,455,448,1843,59536
17-02-2016,22,20473,23159,8586,3258,55474,930,435,450,1815,57289
17-02-2016,23,19441,22185,8386,2861,52872,928,408,457,1793,54665
18-02-2016,0,19477,20325,8444,2555,50802,875,417,426,1718,52520
18-02-2016,1,19778,20006,8358,2467,50608,865,423,458,1746,52354
18-02-2016,2,19677,19743,8338,2306,50065,870,423,466,1759,51824
18-02-2016,3,20222,19625,8397,2235,50479,884,419,444,1747,52226
18-02-2016,4,21106,19963,8627,2349,52044,914,408,416,1738,53782
18-02-2016,5,22365,20938,9175,2384,54863,1033,412,403,1848,56711
18-02-2016,6,24331,22824,9622,2594,59371,1261,446,410,2117,61488
18-02-2016,7,25212,24041,9761,3592,62606,1335,933,498,2766,65372
18-02-2016,8,25698,23940,9727,3625,62988,1347,1019,809,3175,66163
18-02-2016,9,25614,24186,9761,3881,63443,1353,963,513,2829,66272
18-02-2016,10,25707,24210,9516,3679,63113,1257,519,425,2201,65314
18-02-2016,11,25722,23920,9404,3628,62673,1221,481,411,2113,64786
18-02-2016,12,25365,23543,9401,3453,61762,1217,473,406,2096,63858
18-02-2016,13,25455,23510,9605,3304,61874,1310,485,361,2156,64030
18-02-2016,14,25757,23687,9605,3174,62224,1362,734,356,2452,64676
18-02-2016,15,25529,23741,9641,3477,62390,1363,734,511,2608,64998
18-02-2016,16,25568,23928,9721,3355,62571,1356,990,674,3020,65591
18-02-2016,17,26022,24181,9867,3836,63906,1318,988,703,3009,66915
18-02-2016,18,25905,24145,9837,4037,63923,1311,980,673,2964,66887
18-02-2016,19,25595,23897,9537,3588,62619,1102,901,249,2252,64871
18-02-2016,20,24831,23378,8926,3490,60626,1094,610,209,1913,62539
18-02-2016,21,23791,23034,8728,3199,58752,962,454,200,1616,60368
18-02-2016,22,22179,22420,8488,3095,56181,893,382,188,1463,57644
18-02-2016,23,20642,21363,8268,2836,53109,888,382,179,1449,54558
19-02-2016,0,20872,19394,8210,2652,51128,811,201,158,1170,52298
19-02-2016,1,20415,19113,8165,2629,50323,789,197,155,1141,51464
19-02-2016,2,20335,18993,8190,2490,50008,775,195,155,1125,51133
19-02-2016,3,21128,18954,8259,2506,50848,742,195,150,1087,51935
19-02-2016,4,21669,19372,8585,2601,52228,794,196,153,1143,53371
19-02-2016,5,22010,20757,9227,2829,54824,891,236,157,1284,56108
19-02-2016,6,24330,22701,9663,2867,59562,903,556,346,1805,61367
19-02-2016,7,25764,24020,9779,3611,63175,920,914,336,2170,65345
19-02-2016,8,26157,24186,9726,3931,64001,936,1001,532,2469,66470
19-02-2016,9,26195,24267,9697,3766,63925,969,914,552,2435,66360
19-02-2016,10,25949,24321,9420,3675,63365,962,647,550,2159,65524
19-02-2016,11,25534,24255,9367,3315,62471,955,587,560,2102,64573
19-02-2016,12,25189,23992,9286,2921,61389,956,597,550,2103,63492
19-02-2016,13,24456,23686,9342,3103,60587,950,590,464,2004,62591
19-02-2016,14,24139,23506,9462,3129,60236,961,591,376,1928,62164
19-02-2016,15,23554,23433,9399,3205,59591,958,677,413,2048,61639
19-02-2016,16,24033,23389,9416,3240,60077,943,763,480,2186,62263
19-02-2016,17,24589,23717,9445,3419,61170,945,1025,557,2527,63697
19-02-2016,18,24231,23790,9438,3603,61062,917,1005,548,2470,63532
19-02-2016,19,23362,23372,9217,3915,59866,764,626,196,1586,61452
19-02-2016,20,21834,22857,8778,3878,57346,632,565,152,1349,58695
19-02-2016,21,20680,22205,8468,3964,55316,679,274,152,1105,56421
19-02-2016,22,18965,21533,8137,4334,52970,643,198,149,990,53960
19-02-2016,23,17266,21038,7746,4343,50393,649,197,148,994,51387
20-02-2016,0,16507,19527,7698,4428,48159,668,196,144,1008,49167
20-02-2016,1,15277,18763,7555,4770,46367,642,195,142,979,47346
20-02-2016,2,14053,18494,7446,5002,44996,615,196,140,951,45947
20-02-2016,3,14012,18663,7473,5082,45230,631,196,137,964,46194
20-02-2016,4,14158,18875,7636,5180,45849,629,195,138,962,46811
20-02-2016,5,14579,19253,7860,4999,46691,629,282,135,1046,47737
20-02-2016,6,14791,20004,8240,5051,48086,644,373,129,1146,49232
20-02-2016,7,14279,21235,8257,5264,49035,645,649,132,1426,50461
20-02-2016,8,14748,22091,8767,5138,50743,684,734,109,1527,52270
20-02-2016,9,15801,23171,8898,5218,53089,769,733,105,1607,54696
20-02-2016,10,16648,24025,8875,5336,54884,747,732,107,1586,56470
20-02-2016,11,17001,24948,8807,5244,56001,741,736,120,1597,57598
20-02-2016,12,16457,24548,8368,5160,54533,729,752,139,1620,56153
20-02-2016,13,15575,23962,8268,5014,52819,715,755,170,1640,54459
20-02-2016,14,15346,23702,8442,5046,52536,707,759,190,1656,54192
20-02-2016,15,15506,23404,8655,5065,52629,700,759,229,1688,54317
20-02-2016,16,16545,23908,9008,4695,54156,765,770,280,1815,55971
20-02-2016,17,18634,24902,9265,4579,57380,779,884,527,2190,59570
20-02-2016,18,19391,25017,9076,4665,58150,785,775,559,2119,60269
20-02-2016,19,18504,24828,8583,4445,56359,727,750,391,1868,58227
20-02-2016,20,16695,23890,8279,4592,53456,692,637,383,1712,55168
20-02-2016,21,15186,22759,8147,4289,50381,749,270,393,1412,51793
20-02-2016,22,14704,21787,8067,4034,48594,712,231,390,1333,49927
20-02-2016,23,14096,20600,7963,3844,46503,716,233,384,1333,47836
21-02-2016,0,13716,19706,7893,3965,45279,690,230,360,1280,46559
21-02-2016,1,13033,19043,7839,4180,44095,674,222,320,1216,45311
21-02-2016,2,12840,18576,7864,4196,43476,673,218,289,1180,44656
21-02-2016,3,12972,18098,7955,4179,43205,669,220,265,1154,44359
21-02-2016,4,13018,18194,7960,4218,43392,673,220,268,1161,44553
21-02-2016,5,13141,18154,7971,4193,43459,662,215,256,1133,44592
21-02-2016,6,13825,18318,8144,3824,44112,613,211,238,1062,45174
21-02-2016,7,13885,18888,8227,4218,45218,672,209,231,1112,46330
21-02-2016,8,14720,18920,8349,4399,46388,630,497,220,1347,47735
21-02-2016,9,15683,19697,8391,4707,48479,612,510,212,1334,49813
21-02-2016,10,15658,20525,8404,4919,49507,597,506,222,1325,50832
21-02-2016,11,15522,20394,8442,5168,49526,587,503,234,1324,50850
21-02-2016,12,15418,20245,8424,5053,49141,578,502,246,1326,50467
21-02-2016,13,14754,19960,8445,4911,48070,573,501,300,1374,49444
21-02-2016,14,14907,20294,8316,4514,48032,575,509,344,1428,49460
21-02-2016,15,15034,20778,8388,4210,48410,569,511,335,1415,49825
21-02-2016,16,15615,21455,8503,4022,49594,560,624,335,1519,51113
21-02-2016,17,17114,22161,8726,3791,51793,661,676,304,1641,53434
21-02-2016,18,18425,22767,8596,3770,53557,696,756,283,1735,55292
21-02-2016,19,18113,22536,8437,3707,52794,697,657,287,1641,54435
21-02-2016,20,16993,22182,8567,3499,51241,694,517,278,1489,52730
21-02-2016,21,16376,21514,8320,3626,49836,678,220,241,1139,50975
21-02-2016,22,15714,21148,8017,3530,48410,582,214,204,1000,49410
21-02-2016,23,15081,19990,7744,3518,46335,537,213,200,950,47285
22-02-2016,0,15253,18064,7669,3218,44204,601,205,225,1031,45235
22-02-2016,1,14353,17494,7601,3157,42606,619,211,188,1018,43624
22-02-2016,2,14265,16995,7544,3191,41994,635,209,179,1023,43017
22-02-2016,3,14493,16766,7635,3442,42335,644,208,174,1026,43361
22-02-2016,4,14960,16820,7800,4003,43584,652,213,167,1032,44616
22-02-2016,5,15865,18106,7946,4353,46270,681,356,140,1177,47447
22-02-2016,6,18444,21419,8505,4378,52746,783,501,127,1411,54157
22-02-2016,7,22262,23048,8642,4762,58713,769,706,215,1690,60403
22-02-2016,8,23224,23155,8513,4661,59553,721,708,440,1869,61422
22-02-2016,9,22704,22996,8534,4843,59078,724,715,498,1937,61015
22-02-2016,10,22148,22912,8437,5162,58660,712,729,494,1935,60595
22-02-2016,11,21125,22434,8418,5424,57401,709,738,562,2009,59410
22-02-2016,12,20815,22311,8339,5593,57058,763,752,569,2084,59142
22-02-2016,13,20805,22421,8274,5651,57152,710,717,587,2014,59166
22-02-2016,14,20749,22448,8222,5540,56961,700,712,593,2005,58966
22-02-2016,15,20800,22626,8253,5301,56980,777,690,577,2044,59024
22-02-2016,16,21257,22598,8450,5214,57518,773,693,543,2009,59527
22-02-2016,17,23108,23051,8575,5167,59901,844,908,554,2306,62207
22-02-2016,18,23235,23362,8657,5001,60256,860,847,556,2263,62519
22-02-2016,19,22212,23217,8567,4962,58960,816,777,595,2188,61148
22-02-2016,20,21003,22778,8265,5050,57095,731,727,527,1985,59080
22-02-2016,21,20119,22407,8055,4882,55464,642,529,387,1558,57022
22-02-2016,22,18997,21435,7958,4802,53191,598,363,380,1341,54532
22-02-2016,23,17537,19947,7748,4549,49782,610,340,326,1276,51058
23-02-2016,0,16369,18180,7651,4809,47009,654,222,301,1177,48186
23-02-2016,1,15565,17493,7660,4830,45548,664,221,289,1174,46722
23-02-2016,2,15387,17411,7680,4908,45386,683,219,289,1191,46577
23-02-2016,3,15546,17265,7697,4675,45184,658,225,302,1185,46369
23-02-2016,4,16270,17642,7716,4767,46396,672,221,327,1220,47616
23-02-2016,5,19032,18810,7953,4582,50378,674,219,330,1223,51601
23-02-2016,6,20942,21632,8492,4686,55752,751,483,385,1619,57371
23-02-2016,7,23118,22919,8581,4921,59539,1000,637,456,2093,61632
23-02-2016,8,23827,23082,8519,4931,60359,1039,670,603,2312,62671
23-02-2016,9,23633,22934,8429,5103,60100,1052,678,495,2225,62325
23-02-2016,10,23236,22709,8371,5280,59597,1032,673,487,2192,61789
23-02-2016,11,22960,22403,8224,5382,58971,1028,703,404,2135,61106
23-02-2016,12,22499,22223,8202,5261,58185,1021,692,416,2129,60314
23-02-2016,13,22324,22254,8194,5077,57851,1031,681,410,2122,59973
23-02-2016,14,22210,22300,8193,4886,57588,1036,675,412,2123,59711
23-02-2016,15,22029,22471,8225,4771,57497,1029,679,395,2103,59600
23-02-2016,16,22144,22623,8441,4871,58078,1030,673,377,2080,60158
23-02-2016,17,23287,22832,8818,4817,59754,968,674,662,2304,62058
23-02-2016,18,23671,23127,8941,5036,60774,924,679,569,2172,62946
23-02-2016,19,22996,23146,8849,4820,59810,903,684,486,2073,61883
23-02-2016,20,21609,22966,8624,4570,57769,837,688,347,1872,59641
23-02-2016,21,20226,22634,8485,4425,55772,774,495,253,1522,57294
23-02-2016,22,19043,21832,8183,4252,53310,757,202,233,1192,54502
23-02-2016,23,16511,20315,7982,4450,49258,751,200,171,1122,50380
24-02-2016,0,16408,18737,8070,4498,47712,778,196,218,1192,48904
24-02-2016,1,15302,18509,8016,4679,46506,797,196,197,1190,47696
24-02-2016,2,15037,18451,7995,4812,46296,823,195,206,1224,47520
24-02-2016,3,15114,18426,8079,4814,46433,842,193,184,1219,47652
24-02-2016,4,16296,18501,8434,4697,47929,875,194,185,1254,49183
24-02-2016,5,18582,19603,9016,4680,51881,1010,198,181,1389,53270
24-02-2016,6,20680,22472,9149,4609,56910,1141,588,363,2092,59002
24-02-2016,7,23555,23683,9241,4596,61075,1183,760,362,2305,63380
24-02-2016,8,24153,23906,9193,4772,62025,1222,1101,529,2852,64877
24-02-2016,9,24067,23768,9101,4811,61748,1243,1033,536,2812,64560
24-02-2016,10,23488,23674,8874,5280,61316,1148,695,398,2241,63557
24-02-2016,11,22454,23146,8719,5612,59931,1155,733,555,2443,62374
24-02-2016,12,22028,22110,8787,5443,58370,1130,842,722,2694,61064
24-02-2016,13,21464,21491,8950,5022,56925,1230,987,821,3038,59963
24-02-2016,14,21433,21213,8897,5038,56578,1381,990,811,3182,59760
24-02-2016,15,21599,21085,8823,4895,56403,1352,1032,725,3109,59512
24-02-2016,16,22247,21746,8987,4581,57561,1259,1078,383,2720,60281
24-02-2016,17,23994,22553,9081,4251,59878,1216,1107,540,2863,62741
24-02-2016,18,24484,23419,9111,4651,61665,1216,1317,518,3051,64716
24-02-2016,19,23834,23309,8974,4494,60611,1147,842,363,2352,62963
24-02-2016,20,22936,22883,8628,4286,58733,978,720,184,1882,60615
24-02-2016,21,21971,22556,8327,4020,56875,905,541,176,1622,58497
24-02-2016,22,20850,21941,8095,3783,54670,833,226,176,1235,55905
24-02-2016,23,19455,20788,7961,3519,51723,859,207,159,1225,52948
25-02-2016,0,19645,19010,7878,3542,50073,869,206,183,1258,51331
25-02-2016,1,19288,18802,7852,3557,49500,875,204,210,1289,50789
25-02-2016,2,18856,19001,7814,3629,49301,885,205,193,1283,50584
25-02-2016,3,19206,19013,7825,3671,49718,915,209,221,1345,51063
25-02-2016,4,20033,18999,8178,3637,50846,921,212,228,1361,52207
25-02-2016,5,21954,19613,8693,3673,53933,1041,291,388,1720,55653
25-02-2016,6,23738,22061,8952,3675,58426,1243,642,388,2273,60699
25-02-2016,7,25113,23036,9111,3928,61189,1205,1096,389,2690,63879
25-02-2016,8,25287,22931,8942,3912,61071,1249,1182,190,2621,63692
25-02-2016,9,25218,22979,8916,3852,60965,1322,1259,371,2952,63917
25-02-2016,10,25408,22954,8990,3900,61253,1303,663,275,2241,63494
25-02-2016,11,25050,22787,8874,3977,60688,1250,663,315,2228,62916
25-02-2016,12,24637,22414,8751,3946,59747,1273,665,423,2361,62108
25-02-2016,13,24485,22135,8855,3792,59267,1329,920,423,2672,61939
25-02-2016,14,24155,21931,8860,3708,58654,1313,985,418,2716,61370
25-02-2016,15,24185,21980,8906,3477,58547,1336,924,423,2683,61230
25-02-2016,16,24022,22353,8918,3486,58780,1315,1062,448,2825,61605
25-02-2016,17,24447,22564,9139,3645,59797,1302,1082,472,2856,62653
25-02-2016,18,24897,23078,9082,4066,61123,1323,1260,421,3004,64127
25-02-2016,19,24835,22827,8815,3886,60364,1314,988,300,2602,62966
25-02-2016,20,24340,22756,8583,3580,59258,1042,651,300,1993,61251
25-02-2016,21,22842,22565,8481,3384,57273,964,497,289,1750,59023
25-02-2016,22,21582,21707,8336,3125,54750,927,272,252,1451,56201
25-02-2016,23,20134,20657,8158,2893,51842,913,274,233,1420,53262
26-02-2016,0,20358,18435,8124,3154,50070,846,271,242,1359,51429
26-02-2016,1,20068,18114,8051,3214,49446,864,268,216,1348,50794
26-02-2016,2,19866,17901,8075,3153,48995,868,269,219,1356,50351
26-02-2016,3,20319,17916,8189,3331,49756,872,273,203,1348,51104
26-02-2016,4,21396,18070,8513,3399,51378,869,271,200,1340,52718
26-02-2016,5,22458,19111,8963,3424,53956,1111,286,215,1612,55568
26-02-2016,6,23799,21581,9376,3532,58287,1347,409,204,1960,60247
26-02-2016,7,25336,23254,9447,4089,62126,1343,944,201,2488,64614
26-02-2016,8,25576,23626,9376,4326,62905,1355,1074,406,2835,65740
26-02-2016,9,25579,23389,9193,4348,62508,1359,1167,392,2918,65426
26-02-2016,10,25362,23413,9174,4490,62439,1338,697,300,2335,64774
26-02-2016,11,24963,22863,9215,4503,61543,1318,682,249,2249,63792
26-02-2016,12,24296,22117,9194,4396,60005,1269,714,264,2247,62252
26-02-2016,13,23992,21755,9243,4238,59229,1315,831,337,2483,61712
26-02-2016,14,23530,21479,9221,4118,58349,1365,1009,444,2818,61167
26-02-2016,15,23378,21529,9367,3868,58141,1361,803,309,2473,60614
26-02-2016,16,23908,21669,9408,3553,58537,1384,892,356,2632,61169
26-02-2016,17,24709,22566,9487,3647,60409,1384,1099,453,2936,63345
26-02-2016,18,24851,23524,9566,3799,61738,1330,1176,484,2990,64728
26-02-2016,19,24457,23167,9466,3494,60583,1230,675,323,2228,62811
26-02-2016,20,23713,22785,8969,3283,58750,864,649,319,1832,60582
26-02-2016,21,22774,22289,8805,3077,56944,667,494,303,1464,58408
26-02-2016,22,21755,21604,8752,2766,54879,644,269,279,1192,56071
26-02-2016,23,21156,20390,8343,2495,52384,650,266,268,1184,53568
27-02-2016,0,21486,18942,8068,2516,51013,635,266,262,1163,52176
27-02-2016,1,20701,18807,8031,2687,50226,630,263,268,1161,51387
27-02-2016,2,20511,18797,7973,2525,49805,622,258,271,1151,50956
27-02-2016,3,20136,18879,8015,2513,49542,644,258,263,1165,50707
27-02-2016,4,20093,18977,7937,2557,49565,667,260,256,1183,50748
27-02-2016,5,20482,18935,8019,2566,50003,667,261,253,1181,51184
27-02-2016,6,21504,19484,8171,2432,51590,662,265,258,1185,52775
27-02-2016,7,22323,20433,8183,2420,53360,704,289,235,1228,54588
27-02-2016,8,23515,21705,8322,2507,56049,734,307,253,1294,57343
27-02-2016,9,23697,22591,8442,2708,57437,733,403,418,1554,58991
27-02-2016,10,23501,22846,8359,2798,57505,730,560,413,1703,59208
27-02-2016,11,22546,22753,8301,2779,56379,747,547,415,1709,58088
27-02-2016,12,21774,22277,8177,2657,54884,751,527,417,1695,56579
27-02-2016,13,21246,21886,8075,2614,53821,761,477,414,1652,55473
27-02-2016,14,20842,21617,8185,2517,53161,770,463,386,1619,54780
27-02-2016,15,20945,21748,8470,2506,53669,783,458,363,1604,55273
27-02-2016,16,21712,21823,8781,2449,54766,809,530,344,1683,56449
27-02-2016,17,23176,22349,9001,2436,56962,812,877,442,2131,59093
27-02-2016,18,23666,23507,9090,2664,58927,791,760,445,1996,60923
27-02-2016,19,23077,23321,8942,2521,57860,788,574,376,1738,59598
27-02-2016,20,22191,22911,8560,2434,56096,784,335,373,1492,57588
27-02-2016,21,21433,22333,8600,2398,54765,719,282,193,1194,55959
27-02-2016,22,20603,21655,8413,2323,52993,722,284,174,1180,54173
27-02-2016,23,20077,20549,8109,2172,50907,719,285,183,1187,52094
28-02-2016,0,20112,18740,7995,2174,49021,703,259,184,1146,50167
28-02-2016,1,18314,17940,7915,2185,46353,709,253,166,1128,47481
28-02-2016,2,17045,17590,7881,2191,44706,721,252,140,1113,45819
28-02-2016,3,16932,17441,7868,2197,44438,731,251,130,1112,45550
28-02-2016,4,16699,17277,7834,2204,44013,725,247,131,1103,45116
28-02-2016,5,17135,17421,7830,2260,44647,721,250,130,1101,45748
28-02-2016,6,17312,17765,7893,2243,45212,713,254,142,1109,46321
28-02-2016,7,17787,18366,7963,2180,46296,706,436,135,1277,47573
28-02-2016,8,18876,19541,8114,2268,48799,757,437,133,1327,50126
28-02-2016,9,20316,20528,8141,2440,51425,776,521,128,1425,52850
28-02-2016,10,20529,20611,8167,2678,51987,786,516,125,1427,53414
28-02-2016,11,20101,20600,8203,2622,51525,795,562,121,1478,53003
28-02-2016,12,18493,20084,8161,2777,49514,799,478,120,1397,50911
28-02-2016,13,18102,19778,8074,2620,48575,773,475,120,1368,49943
28-02-2016,14,17705,19708,8097,2455,47964,743,448,122,1313,49277
28-02-2016,15,17297,19873,8068,2379,47617,743,508,126,1377,48994
28-02-2016,16,18103,20113,8236,2398,48851,733,560,128,1421,50272
28-02-2016,17,21358,21556,8624,2504,54042,726,635,127,1488,55530
28-02-2016,18,23735,22927,8758,2848,58270,732,704,286,1722,59992
28-02-2016,19,24030,22892,8701,2769,58392,809,695,126,1630,60022
28-02-2016,20,23416,22629,8580,2542,57167,803,485,129,1417,58584
28-02-2016,21,22278,22082,8605,2501,55467,797,283,119,1199,56666
28-02-2016,22,22431,21400,8468,2279,54579,778,244,116,1138,55717
28-02-2016,23,21427,20448,8273,2291,52439,765,242,120,1127,53566
29-02-2016,0,19334,19001,8228,2208,48772,668,242,125,1035,49807
29-02-2016,1,17502,18082,8177,2125,45887,672,243,128,1043,46930
29-02-2016,2,17050,17861,8208,2150,45269,710,334,135,1179,46448
29-02-2016,3,17157,17992,8308,2128,45584,748,333,129,1210,46794
29-02-2016,4,18266,18484,8560,2129,47437,824,335,127,1286,48723
29-02-2016,5,21346,19637,9168,2365,52516,940,460,126,1526,54042
29-02-2016,6,24904,22460,9225,2977,59566,1098,1047,315,2460,62026
29-02-2016,7,26076,23926,9302,3681,62986,1129,1238,336,2703,65689
29-02-2016,8,25870,24044,9342,3754,63011,1130,1276,335,2741,65752
29-02-2016,9,25658,23860,9332,3545,62394,1133,1148,520,2801,65195
29-02-2016,10,25479,23792,9174,3596,62041,1154,972,305,2431,64472
29-02-2016,11,25275,23775,9029,3603,61681,1151,807,329,2287,63968
29-02-2016,12,24883,23381,8919,3397,60580,1147,745,317,2209,62789
29-02-2016,13,24636,22749,9002,3252,59640,1161,959,325,2445,62085
29-02-2016,14,24760,22583,9041,3154,59539,1154,1091,335,2580,62119
29-02-2016,15,24570,22713,9039,3082,59406,1181,767,347,2295,61701
29-02-2016,16,24730,21799,9052,3020,58603,1168,759,330,2257,60860
29-02-2016,17,25609,22541,9235,3099,60483,1143,1115,356,2614,63097
29-02-2016,18,25364,23195,9324,3752,61634,1140,1140,410,2690,64324
29-02-2016,19,25002,23149,9149,3493,60793,966,929,416,2311,63104
29-02-2016,20,24838,22519,8866,2877,59100,915,747,242,1904,61004
29-02-2016,21,23862,22426,8704,2623,57614,919,627,234,1780,59394
29-02-2016,22,22588,21867,8467,2545,55465,987,455,234,1676,57141
29-02-2016,23,21013,20793,8342,2624,52772,998,431,235,1664,54436
01-03-2016,0,20708,18802,8254,2589,50354,958,416,273,1647,52001
01-03-2016,1,20201,18345,8176,2505,49227,980,419,286,1685,50912
01-03-2016,2,19985,18365,8174,2506,49030,976,423,275,1674,50704
01-03-2016,3,20150,18480,8279,2613,49520,973,420,281,1674,51194
01-03-2016,4,20599,18740,8626,2785,50749,983,420,303,1706,52455
01-03-2016,5,21893,19494,8889,3130,53407,1120,446,298,1864,55271
01-03-2016,6,23301,21618,8907,3365,57190,1326,719,471,2516,59706
01-03-2016,7,25267,23647,9214,3917,62045,1335,1147,515,2997,65042
01-03-2016,8,25518,24084,9325,4484,63410,1336,1149,512,2997,66407
01-03-2016,9,25139,24126,9247,4421,62933,1330,1149,518,2997,65930
01-03-2016,10,24607,23923,9070,4603,62203,1330,1150,540,3020,65223
01-03-2016,11,24009,23413,9031,4669,61122,1296,1069,534,2899,64021
01-03-2016,12,23674,23235,9029,4842,60779,1305,963,517,2785,63564
01-03-2016,13,23262,23098,8940,4966,60266,1268,1099,322,2689,62955
01-03-2016,14,22850,23054,9001,5072,59976,1200,801,307,2308,62284
01-03-2016,15,22597,23232,9155,4877,59861,1211,894,289,2394,62255
01-03-2016,16,22362,23453,9259,4927,60003,1198,884,431,2513,62516
01-03-2016,17,23288,23627,9281,5120,61317,1356,1175,560,3091,64408
01-03-2016,18,23143,23987,9277,5366,61772,1356,1189,618,3163,64935
01-03-2016,19,22628,23766,9181,5377,60952,1135,866,251,2252,63204
01-03-2016,20,21486,23499,8894,5351,59231,1057,815,204,2076,61307
01-03-2016,21,20281,22808,8663,5314,57066,1074,427,161,1662,58728
01-03-2016,22,18320,21785,8451,5221,53778,1055,416,148,1619,55397
01-03-2016,23,15696,20550,8279,5022,49547,1058,417,138,1613,51160
02-03-2016,0,14018,19427,8297,4722,46463,1043,418,127,1588,48051
02-03-2016,1,14106,18912,8294,4441,45753,1046,414,115,1575,47328
02-03-2016,2,14086,18696,8329,4185,45296,1028,414,111,1553,46849
02-03-2016,3,14100,18754,8301,4160,45315,1012,412,109,1533,46848
02-03-2016,4,14971,19026,8444,3749,46191,1033,423,111,1567,47758
02-03-2016,5,16980,20019,8747,3780,49527,1185,582,109,1876,51403
02-03-2016,6,20358,22535,9010,4054,55955,1371,824,127,2322,58277
02-03-2016,7,23519,24264,9129,4143,61055,1351,1156,293,2800,63855
02-03-2016,8,24225,25001,9207,4373,62807,1371,1150,400,2921,65728
02-03-2016,9,24637,24666,9173,4211,62687,1345,1148,467,2960,65647
02-03-2016,10,24502,24763,9128,3827,62220,1364,1146,559,3069,65289
02-03-2016,11,24250,24755,9145,3580,61731,1355,1145,504,3004,64735
02-03-2016,12,24352,24123,9188,3766,61429,1368,1142,356,2866,64295
02-03-2016,13,24431,23852,8947,3659,60889,1369,1001,399,2769,63658
02-03-2016,14,24581,23720,8938,3416,60656,1376,843,335,2554,63210
02-03-2016,15,24800,24134,9048,2940,60922,1391,809,306,2506,63428
02-03-2016,16,24533,24212,9148,3121,61013,1394,857,322,2573,63586
02-03-2016,17,24515,23941,9355,3870,61679,1383,1149,399,2931,64610
02-03-2016,18,24917,23694,9417,4036,62064,1358,1303,576,3237,65301
02-03-2016,19,24617,23330,9362,3897,61207,1167,1217,359,2743,63950
02-03-2016,20,24231,22808,9018,3476,59533,1040,868,234,2142,61675
02-03-2016,21,23602,22256,8865,3385,58108,985,601,214,1800,59908
02-03-2016,22,21961,21702,8660,3127,55451,976,421,208,1605,57056
02-03-2016,23,20273,20499,8506,2866,52144,975,413,199,1587,53731
03-03-2016,0,19209,18916,8329,2765,49219,973,498,194,1665,50884
03-03-2016,1,18743,18268,8263,2771,48045,978,499,183,1660,49705
03-03-2016,2,18124,17926,8247,2671,46969,984,500,178,1662,48631
03-03-2016,3,17079,17808,8265,2620,45774,1003,499,175,1677,47451
03-03-2016,4,18241,17802,8467,2623,47133,1052,545,174,1771,48904
03-03-2016,5,20504,18609,9029,2760,50901,1338,649,174,2161,53062
03-03-2016,6,23206,21520,9289,3109,57125,1492,961,173,2626,59751
03-03-2016,7,24715,23214,9352,3541,60822,1494,1250,326,3070,63892
03-03-2016,8,25421,23531,9264,3654,61871,1486,1273,343,3102,64973
03-03-2016,9,25367,23683,9233,3756,62039,1493,1263,348,3104,65143
03-03-2016,10,25246,23573,9231,4016,62064,1492,1220,337,3049,65113
03-03-2016,11,24782,23503,9148,3863,61296,1492,1184,513,3189,64485
03-03-2016,12,24863,23393,9059,3782,61098,1487,1189,355,3031,64129
03-03-2016,13,24796,23159,9107,3822,60883,1485,1190,349,3024,63907
03-03-2016,14,24681,22987,9098,3519,60285,1474,949,333,2756,63041
03-03-2016,15,25073,22804,9131,3435,60444,1489,954,342,2785,63229
03-03-2016,16,24939,22963,9203,3307,60412,1502,1011,351,2864,63276
03-03-2016,17,25429,22900,9327,3627,61283,1510,1360,422,3292,64575
03-03-2016,18,25597,23444,9418,3784,62242,1441,1696,566,3703,65945
03-03-2016,19,25031,23410,9359,3419,61219,1248,1187,354,2789,64008
03-03-2016,20,24377,23045,8995,3388,59805,910,935,199,2044,61849
03-03-2016,21,23716,22329,8776,3107,57929,804,741,203,1748,59677
03-03-2016,22,22803,21362,8494,2820,55479,786,539,214,1539,57018
03-03-2016,23,21516,20425,8275,2638,52853,813,530,217,1560,54413
04-03-2016,0,20373,18500,8160,2356,49389,857,516,196,1569,50958
04-03-2016,1,19789,17814,8082,2357,48041,864,521,179,1564,49605
04-03-2016,2,19122,17559,8055,2300,47037,851,517,175,1543,48580
04-03-2016,3,18603,17516,8077,2282,46480,848,516,175,1539,48019
04-03-2016,4,18466,17513,8175,2321,46475,886,530,152,1568,48043
04-03-2016,5,20762,18136,8766,2462,50126,1133,625,150,1908,52034
04-03-2016,6,23433,21144,9097,2759,56433,1242,924,235,2401,58834
04-03-2016,7,24970,22956,9130,3447,60503,1237,1265,353,2855,63358
04-03-2016,8,25354,23449,9268,3597,61668,1232,1428,359,3019,64687
04-03-2016,9,25347,23425,9301,3448,61519,1223,1379,506,3108,64627
04-03-2016,10,25100,23370,9367,3407,61242,1233,1242,470,2945,64187
04-03-2016,11,24659,23105,9392,3113,60269,1231,1229,354,2814,63083
04-03-2016,12,24413,22733,9368,3263,59777,1244,1224,347,2815,62592
04-03-2016,13,23998,22489,9220,2842,58550,1230,1237,338,2805,61355
04-03-2016,14,23578,22281,9231,2848,57940,1235,886,325,2446,60386
04-03-2016,15,23705,22166,9146,2885,57902,1235,1051,314,2600,60502
04-03-2016,16,24002,22478,9196,3000,58676,1223,1124,317,2664,61340
04-03-2016,17,24460,22928,9393,3126,59907,1220,1253,465,2938,62845
04-03-2016,18,24870,22968,9372,3364,60573,1223,1474,467,3164,63737
04-03-2016,19,23758,22790,9093,3596,59238,1122,869,252,2243,61481
04-03-2016,20,22627,22415,8716,3470,57227,785,866,121,1772,58999
04-03-2016,21,21742,21770,8685,3330,55528,748,717,121,1586,57114
04-03-2016,22,21073,20849,8351,3317,53589,744,524,122,1390,54979
04-03-2016,23,20207,19685,8119,3407,51418,643,510,72,1225,52643
05-03-2016,0,19218,17301,8019,3797,48336,650,258,68,976,49312
05-03-2016,1,18058,16908,7866,4064,46897,649,256,64,969,47866
05-03-2016,2,17775,16711,7830,4079,46396,648,256,68,972,47368
05-03-2016,3,17507,16627,7813,4018,45966,645,256,70,971,46937
05-03-2016,4,17158,16654,7774,4155,45742,647,254,95,996,46738
05-03-2016,5,17555,16906,7879,4173,46512,647,253,72,972,47484
05-03-2016,6,17959,17898,7945,4024,47827,632,264,77,973,48800
05-03-2016,7,19552,18911,8168,4065,50696,619,408,119,1146,51842
05-03-2016,8,20868,19904,8450,4034,53255,664,424,114,1202,54457
05-03-2016,9,22239,20916,8450,4161,55766,665,712,115,1492,57258
05-03-2016,10,22415,21796,8345,4346,56902,666,718,125,1509,58411
05-03-2016,11,22160,21760,8293,4186,56399,668,692,119,1479,57878
05-03-2016,12,21685,21490,8224,4047,55446,670,678,112,1460,56906
05-03-2016,13,21093,21184,8255,3995,54528,669,602,113,1384,55912
05-03-2016,14,20744,21229,8206,4143,54323,676,401,123,1200,55523
05-03-2016,15,20739,21127,8239,4023,54127,687,410,135,1232,55359
05-03-2016,16,21353,21181,8406,3938,54877,697,414,146,1257,56134
05-03-2016,17,22654,21523,8808,3737,56721,678,420,160,1258,57979
05-03-2016,18,23372,21976,8778,3661,57785,688,536,166,1390,59175
05-03-2016,19,22621,21954,8487,3610,56672,692,407,167,1266,57938
05-03-2016,20,21285,21729,8183,3769,54966,681,405,177,1263,56229
05-03-2016,21,20897,20884,8037,3518,53335,685,288,138,1111,54446
05-03-2016,22,20436,20518,7978,3417,52350,682,265,154,1101,53451
05-03-2016,23,19681,19708,7733,3307,50429,663,265,171,1099,51528
06-03-2016,0,19187,18238,7634,2945,48004,647,253,196,1096,49100
06-03-2016,1,18293,17675,7654,2735,46357,635,256,178,1069,47426
06-03-2016,2,17316,17308,7583,2596,44804,632,256,157,1045,45849
06-03-2016,3,16298,17317,7539,2542,43696,628,255,169,1052,44748
06-03-2016,4,15907,17278,7522,2463,43170,631,256,159,1046,44216
06-03-2016,5,16574,17470,7543,2400,43988,644,258,155,1057,45045
06-03-2016,6,16430,18337,7651,2452,44869,639,257,181,1077,45946
06-03-2016,7,16986,19218,7799,2414,46417,626,254,172,1052,47469
06-03-2016,8,18855,19945,7960,2530,49292,634,256,188,1078,50370
06-03-2016,9,20398,20864,8025,2656,51944,677,254,192,1123,53067
06-03-2016,10,20682,21399,8082,2728,52891,687,247,194,1128,54019
06-03-2016,11,20860,21547,8140,2683,53230,690,242,198,1130,54360
06-03-2016,12,20200,21276,8113,2613,52201,693,243,204,1140,53341
06-03-2016,13,18627,20930,8048,2534,50139,699,244,229,1172,51311
06-03-2016,14,17911,20802,8115,2541,49370,706,255,244,1205,50575
06-03-2016,15,17951,20997,8156,2622,49725,719,258,241,1218,50943
06-03-2016,16,18921,21488,8251,2616,51277,728,259,235,1222,52499
06-03-2016,17,21250,22307,8505,2904,54965,741,278,273,1292,56257
06-03-2016,18,23794,23160,8592,2997,58544,748,385,302,1435,59979
06-03-2016,19,23757,23224,8493,2915,58390,755,265,403,1423,59813
06-03-2016,20,22543,22965,8406,2938,56853,728,266,291,1285,58138
06-03-2016,21,21878,22490,8183,2787,55339,735,280,257,1272,56611
06-03-2016,22,20514,21655,8118,2747,53034,730,278,207,1215,54249
06-03-2016,23,19699,20546,8034,2716,50995,712,256,165,1133,52128
07-03-2016,0,18894,19383,7931,2615,48823,700,254,179,1133,49956
07-03-2016,1,18358,18925,7926,2457,47665,703,252,178,1133,48798
07-03-2016,2,18177,18716,7917,2476,47286,708,250,161,1119,48405
07-03-2016,3,17984,18589,7938,2421,46933,721,247,172,1140,48073
07-03-2016,4,18688,18534,7973,2450,47645,697,250,163,1110,48755
07-03-2016,5,20911,19797,8050,2654,51413,704,275,120,1099,52512
07-03-2016,6,22697,22115,8251,2997,56060,757,454,129,1340,57400
07-03-2016,7,24289,23815,8537,3284,59925,783,891,338,2012,61937
07-03-2016,8,24669,24285,8762,3600,61315,774,829,342,1945,63260
07-03-2016,9,24303,24454,8691,3775,61222,773,860,335,1968,63190
07-03-2016,10,24070,24614,8625,3677,60987,766,836,335,1937,62924
07-03-2016,11,23561,24609,8510,3627,60307,753,872,251,1876,62183
07-03-2016,12,23165,24282,8458,3593,59500,741,865,290,1896,61396
07-03-2016,13,23176,23610,8458,3693,58938,746,848,259,1853,60791
07-03-2016,14,23330,23141,8431,3554,58458,720,849,264,1833,60291
07-03-2016,15,23358,23042,8443,3543,58386,704,849,192,1745,60131
07-03-2016,16,23297,23445,8363,3500,58604,699,853,139,1691,60295
07-03-2016,17,23981,23761,8470,3681,59894,709,855,297,1861,61755
07-03-2016,18,24305,23748,8725,3694,60473,715,1004,350,2069,62542
07-03-2016,19,24299,23577,8709,3459,60045,687,838,235,1760,61805
07-03-2016,20,23849,23219,8460,2988,58516,660,716,329,1705,60221
07-03-2016,21,23179,22526,8192,2858,56755,658,644,117,1419,58174
07-03-2016,22,21989,21621,8052,2767,54430,643,407,106,1156,55586
07-03-2016,23,20914,20643,7997,2566,52121,614,409,114,1137,53258
08-03-2016,0,20527,18328,7832,2541,49227,579,255,104,938,50165
08-03-2016,1,19776,17778,7865,2510,47930,560,249,95,904,48834
08-03-2016,2,19581,17675,7827,2450,47533,570,247,100,917,48450
08-03-2016,3,19808,17636,7890,2494,47828,563,247,102,912,48740
08-03-2016,4,20635,17864,7894,2596,48988,566,246,107,919,49907
08-03-2016,5,22421,18852,8077,2673,52022,592,266,122,980,53002
08-03-2016,6,23646,21736,8304,2754,56440,692,438,176,1306,57746
08-03-2016,7,24352,23424,8571,3445,59791,723,987,393,2103,61894
08-03-2016,8,24292,23485,8676,3806,60260,790,1193,575,2558,62818
08-03-2016,9,24086,23263,8670,3840,59859,700,962,420,2082,61941
08-03-2016,10,24073,22958,8474,3720,59226,701,860,339,1900,61126
08-03-2016,11,24081,23041,8243,3545,58910,701,732,355,1788,60698
08-03-2016,12,23804,22957,8134,3417,58313,700,777,350,1827,60140
08-03-2016,13,23237,22838,8129,3514,57719,705,722,349,1776,59495
08-03-2016,14,23485,22736,8040,3292,57553,707,675,353,1735,59288
08-03-2016,15,23296,22655,8063,3272,57287,708,590,361,1659,58946
08-03-2016,16,23372,22585,8169,3294,57420,693,576,343,1612,59032
08-03-2016,17,23829,22720,8563,3642,58753,703,644,412,1759,60512
08-03-2016,18,24303,23232,8671,3772,59976,705,1042,495,2242,62218
08-03-2016,19,24389,23139,8677,3635,59840,699,792,343,1834,61674
08-03-2016,20,23977,22556,8266,3420,58220,697,633,336,1666,59886
08-03-2016,21,23552,21882,7980,3069,56482,696,536,136,1368,57850
08-03-2016,22,22252,20874,7831,3188,54145,685,292,133,1110,55255
08-03-2016,23,20704,19951,7565,3160,51381,644,287,123,1054,52435
09-03-2016,0,19585,17922,7545,3033,48085,645,395,127,1167,49252
09-03-2016,1,18957,17151,7488,3106,46702,667,415,121,1203,47905
09-03-2016,2,18516,16929,7408,3052,45905,684,406,117,1207,47112
09-03-2016,3,17942,16893,7424,3100,45359,720,422,75,1217,46576
09-03-2016,4,18171,16919,7759,3171,46021,755,419,113,1287,47308
09-03-2016,5,20403,17624,8125,3341,49493,907,699,113,1719,51212
09-03-2016,6,22597,20753,8429,3494,55274,1037,1019,122,2178,57452
09-03-2016,7,24351,22531,8641,3901,59423,1029,1198,130,2357,61780
09-03-2016,8,24642,22917,8705,4030,60297,1028,1192,293,2513,62810
09-03-2016,9,23928,22649,8641,4023,59241,1037,1437,310,2784,62025
09-03-2016,10,23707,22288,8508,3986,58491,1044,1476,116,2636,61127
09-03-2016,11,23557,22020,8553,4039,58169,1040,1362,123,2525,60694
09-03-2016,12,21900,22414,8506,4399,57218,1000,1369,209,2578,59796
09-03-2016,13,21471,22267,8454,4019,56211,1002,1448,133,2583,58794
09-03-2016,14,21642,22286,8537,3729,56195,1016,1104,134,2254,58449
09-03-2016,15,21864,21641,8626,3386,55518,1014,1114,140,2268,57786
09-03-2016,16,22912,21282,8841,3337,56372,1012,1125,146,2283,58655
09-03-2016,17,23769,21900,8953,3498,58121,1010,1147,336,2493,60614
09-03-2016,18,24019,22931,8901,4124,59975,1007,1417,425,2849,62824
09-03-2016,19,24169,22607,8771,4195,59741,681,1229,281,2191,61932
09-03-2016,20,23890,22365,8386,3738,58380,665,773,172,1610,59990
09-03-2016,21,23040,21648,8207,3626,56523,659,591,158,1408,57931
09-03-2016,22,21849,20858,7980,3565,54251,598,582,156,1336,55587
09-03-2016,23,20344,19938,7886,3389,51556,604,577,150,1331,52887
10-03-2016,0,18174,17567,7833,3187,46760,588,555,151,1294,48054
10-03-2016,1,16999,17000,7785,3200,44984,587,575,141,1303,46287
10-03-2016,2,16772,16722,7793,3176,44461,591,575,149,1315,45776
10-03-2016,3,17204,16872,7758,3174,45007,599,571,143,1313,46320
10-03-2016,4,18655,17317,7851,3253,47076,615,577,143,1335,48411
10-03-2016,5,20045,18123,8279,3431,49879,840,759,151,1750,51629
10-03-2016,6,23148,20847,8556,3531,56083,1015,777,163,1955,58038
10-03-2016,7,24357,22945,8725,3998,60025,1009,1075,165,2249,62274
10-03-2016,8,24763,23316,8819,4141,61040,1002,1092,337,2431,63471
10-03-2016,9,24288,23156,8761,4059,60264,1014,1072,335,2421,62685
10-03-2016,10,24049,22459,8732,3861,59102,1013,1068,332,2413,61515
10-03-2016,11,23903,21799,8727,3776,58204,996,1023,351,2370,60574
10-03-2016,12,23868,21708,8693,3781,58051,1000,1205,216,2421,60472
10-03-2016,13,23646,21635,8653,3682,57616,990,1019,341,2350,59966
10-03-2016,14,23568,21772,8624,3610,57574,1002,980,203,2185,59759
10-03-2016,15,23555,21446,8729,3643,57373,1013,966,161,2140,59513
10-03-2016,16,23565,21142,8787,3570,57064,1011,996,214,2221,59285
10-03-2016,17,23810,21531,8922,3720,57984,1020,960,359,2339,60323
10-03-2016,18,24161,22854,9035,3778,59828,1006,1007,365,2378,62206
10-03-2016,19,24064,22771,8828,3717,59381,978,772,181,1931,61312
10-03-2016,20,24217,21891,8379,3620,58107,694,659,173,1526,59633
10-03-2016,21,23723,20940,8284,3380,56327,651,574,171,1396,57723
10-03-2016,22,22230,20743,7959,2885,53816,612,563,166,1341,55157
10-03-2016,23,20304,20011,7716,2809,50840,608,567,160,1335,52175
11-03-2016,0,19560,17967,7612,2717,47855,610,565,156,1331,49186
11-03-2016,1,18621,17334,7624,2632,46213,612,565,155,1332,47545
11-03-2016,2,18859,17048,7675,2592,46175,604,563,155,1322,47497
11-03-2016,3,18833,16891,7754,2592,46069,600,568,160,1328,47397
11-03-2016,4,19729,17119,8022,2817,47687,607,568,169,1344,49031
11-03-2016,5,21681,17928,8463,2934,51006,726,581,175,1482,52488
11-03-2016,6,23530,21144,8686,3447,56809,893,817,185,1895,58704
11-03-2016,7,24645,22661,8909,3819,60033,983,1160,178,2321,62354
11-03-2016,8,24027,22804,8947,4167,59945,1046,1178,300,2524,62469
11-03-2016,9,24030,22491,8901,4190,59612,1054,1260,335,2649,62261
11-03-2016,10,24036,22429,8811,3979,59256,1055,1117,334,2506,61762
11-03-2016,11,23595,22221,8802,3911,58530,1052,1087,325,2464,60994
11-03-2016,12,23094,21592,8754,3870,57310,1055,1148,333,2536,59846
11-03-2016,13,23255,21010,8718,3737,56720,1065,1135,335,2535,59255
11-03-2016,14,22945,20757,8494,3531,55727,1063,1094,171,2328,58055
11-03-2016,15,22798,20793,8602,3260,55453,1067,1092,163,2322,57775
11-03-2016,16,22874,20938,8613,3164,55589,1054,1113,159,2326,57915
11-03-2016,17,23003,21520,8789,3529,56842,1064,1143,344,2551,59393
11-03-2016,18,23539,22114,8920,3744,58318,1045,1203,537,2785,61103
11-03-2016,19,23057,22189,8729,3899,57874,1020,1136,152,2308,60182
11-03-2016,20,23197,21142,8444,3006,55791,610,781,147,1538,57329
11-03-2016,21,23198,20401,8189,2891,54680,611,441,137,1189,55869
11-03-2016,22,22461,19731,7896,2853,52942,596,421,140,1157,54099
11-03-2016,23,20585,18859,7786,2752,49982,560,411,112,1083,51065
12-03-2016,0,20289,16807,7743,2828,47668,590,254,138,982,48650
12-03-2016,1,19851,16315,7705,2621,46491,580,246,136,962,47453
12-03-2016,2,19637,16060,7685,2609,45991,582,246,146,974,46965
12-03-2016,3,19553,16148,7653,2679,46033,583,246,148,977,47010
12-03-2016,4,19949,16229,7659,2665,46503,577,248,148,973,47476
12-03-2016,5,20422,16555,7703,2874,47554,555,248,147,950,48504
12-03-2016,6,20384,17097,7868,3000,48350,545,249,147,941,49291
12-03-2016,7,21008,17798,7987,3092,49886,556,590,149,1295,51181
12-03-2016,8,21836,19148,8080,3183,52247,576,596,156,1328,53575
12-03-2016,9,22450,20104,8364,3315,54234,575,612,151,1338,55572
12-03-2016,10,22406,20190,8374,3463,54434,550,609,149,1308,55742
12-03-2016,11,22363,20107,8357,3311,54139,553,602,150,1305,55444
12-03-2016,12,21977,19686,8226,3155,53042,552,602,141,1295,54337
12-03-2016,13,21586,19249,8050,3040,51925,552,666,143,1361,53286
12-03-2016,14,20964,19142,7999,2989,51097,549,600,157,1306,52403
12-03-2016,15,20757,19226,8096,2959,51039,544,586,156,1286,52325
12-03-2016,16,21015,19606,8123,2975,51720,559,591,159,1309,53029
12-03-2016,17,21947,20426,8402,3048,53824,565,694,156,1415,55239
12-03-2016,18,22937,21021,8652,3320,55930,605,852,165,1622,57552
12-03-2016,19,22549,20977,8603,3249,55377,621,797,192,1610,56987
12-03-2016,20,21794,19872,8392,2991,53049,598,602,211,1411,54460
12-03-2016,21,21784,19085,8216,2936,52020,610,574,204,1388,53408
12-03-2016,22,21124,18477,8068,2928,50598,604,365,190,1159,51757
12-03-2016,23,20416,17725,7934,2670,48746,584,255,211,1050,49796
13-03-2016,0,19273,16715,7867,2523,46377,574,205,197,976,47353
13-03-2016,1,18262,16300,7886,2424,44872,583,204,161,948,45820
13-03-2016,2,17346,15908,7876,2283,43413,586,203,168,957,44370
13-03-2016,3,16576,15849,7840,2065,42330,585,200,152,937,43267
13-03-2016,4,16520,15946,7801,2139,42406,591,201,101,893,43299
13-03-2016,5,16498,16217,7909,2312,42935,594,202,110,906,43841
13-03-2016,6,16296,16271,8118,2188,42874,584,390,112,1086,43960
13-03-2016,7,16850,16206,8125,2405,43586,584,703,109,1396,44982
13-03-2016,8,18134,16850,8071,2648,45704,588,686,132,1406,47110
13-03-2016,9,19104,17909,8071,2841,47925,592,688,128,1408,49333
13-03-2016,10,19742,18493,8115,2974,49322,597,696,133,1426,50748
13-03-2016,11,19435,18709,8287,3030,49461,589,701,137,1427,50888
13-03-2016,12,18560,18518,8284,3124,48486,588,699,136,1423,49909
13-03-2016,13,17526,18210,8154,3050,46940,592,699,139,1430,48370
13-03-2016,14,17429,18084,8233,3075,46821,607,696,145,1448,48269
13-03-2016,15,17312,18122,8280,2963,46678,626,709,151,1486,48164
13-03-2016,16,17729,18661,8315,2960,47666,625,691,164,1480,49146
13-03-2016,17,19034,19545,8418,2882,49879,654,760,175,1589,51468
13-03-2016,18,21586,20924,8573,3186,54270,672,917,200,1789,56059
13-03-2016,19,21793,21232,8565,3069,54660,631,890,192,1713,56373
13-03-2016,20,20982,20689,8449,3033,53152,610,709,178,1497,54649
13-03-2016,21,20512,19979,8309,2867,51667,670,634,147,1451,53118
13-03-2016,22,19595,19326,8107,2777,49806,680,349,150,1179,50985
13-03-2016,23,18477,18162,8108,2749,47497,673,368,114,1155,48652
14-03-2016,0,17006,17290,8070,2438,44805,666,332,177,1175,45980
14-03-2016,1,15861,16861,8047,2483,43251,684,328,138,1150,44401
14-03-2016,2,15096,16722,8011,2406,42237,705,370,184,1259,43496
14-03-2016,3,15311,16627,8090,2303,42331,717,373,177,1267,43598
14-03-2016,4,16226,16775,8318,2393,43712,729,571,181,1481,45193
14-03-2016,5,18062,17604,8599,2717,46981,773,732,188,1693,48674
14-03-2016,6,21519,20918,8714,2877,54030,899,1101,198,2198,56228
14-03-2016,7,23175,22791,9038,3256,58259,905,1231,375,2511,60770
14-03-2016,8,23409,23039,9048,3479,58974,924,1221,359,2504,61478
14-03-2016,9,23038,22905,9018,3454,58417,933,1436,381,2750,61167
14-03-2016,10,22914,22871,9074,3022,57882,933,1244,396,2573,60455
14-03-2016,11,22628,22773,8922,2860,57184,941,1210,410,2561,59745
14-03-2016,12,21927,22500,8728,2757,55912,944,1245,448,2637,58549
14-03-2016,13,21211,21931,8562,2702,54405,940,1209,436,2585,56990
14-03-2016,14,21035,21662,8403,2652,53753,898,1129,327,2354,56107
14-03-2016,15,21393,21841,8521,2680,54435,876,1200,318,2394,56829
14-03-2016,16,21342,22135,8447,2786,54712,886,1181,282,2349,57061
14-03-2016,17,21556,22407,8722,2923,55608,882,1400,275,2557,58165
14-03-2016,18,21859,23009,8730,3067,56665,873,1534,415,2822,59487
14-03-2016,19,21635,23025,8393,3196,56251,868,1140,275,2283,58534
14-03-2016,20,21732,22295,7652,2791,54469,649,1130,271,2050,56519
14-03-2016,21,20905,21580,7645,2735,52866,648,740,250,1638,54504
14-03-2016,22,19759,20597,7631,2831,50818,666,576,255,1497,52315
14-03-2016,23,17983,19769,7495,2735,47982,610,556,244,1410,49392
15-03-2016,0,16372,18509,7518,2589,44987,591,506,236,1333,46320
15-03-2016,1,15427,18032,7654,2703,43816,593,509,233,1335,45151
15-03-2016,2,15524,17908,7694,2751,43878,580,508,220,1308,45186
15-03-2016,3,15550,17981,7617,2747,43895,544,508,202,1254,45149
15-03-2016,4,16496,18110,7745,2810,45161,559,550,205,1314,46475
15-03-2016,5,18347,18529,8071,3022,47969,642,708,209,1559,49528
15-03-2016,6,20348,20571,8233,3270,52423,809,1111,212,2132,54555
15-03-2016,7,22210,22229,8367,3555,56362,820,1119,268,2207,58569
15-03-2016,8,22500,22149,8707,3804,57161,839,1141,406,2386,59547
15-03-2016,9,22397,21847,8708,3643,56594,860,1141,411,2412,59006
15-03-2016,10,22128,22137,8495,3554,56314,873,1123,410,2406,58720
15-03-2016,11,21322,21873,8511,3604,55310,861,1117,391,2369,57679
15-03-2016,12,20981,21295,8480,3675,54431,858,1103,371,2332,56763
15-03-2016,13,20926,21169,8391,3641,54128,865,1152,354,2371,56499
15-03-2016,14,20458,20715,8202,3619,52992,857,1112,159,2128,55120
15-03-2016,15,20510,20493,8315,3490,52808,864,1112,133,2109,54917
15-03-2016,16,20553,20435,8369,3172,52529,868,1128,155,2151,54680
15-03-2016,17,20709,21067,8703,2796,53274,876,1131,307,2314,55588
15-03-2016,18,20848,22235,9041,3066,55190,863,1171,318,2352,57542
15-03-2016,19,21338,21934,8685,3004,54962,694,1125,155,1974,56936
15-03-2016,20,21400,21417,8230,2751,53797,665,1137,117,1919,55716
15-03-2016,21,20485,20731,8171,2530,51918,637,712,111,1460,53378
15-03-2016,22,19346,19889,7989,2395,49618,677,570,112,1359,50977
15-03-2016,23,17697,19003,7932,2205,46838,664,563,112,1339,48177
16-03-2016,0,16429,17597,7824,2212,44062,666,299,113,1078,45140
16-03-2016,1,15939,16981,7781,2154,42855,673,337,116,1126,43981
16-03-2016,2,15721,16912,7777,2054,42465,695,344,121,1160,43625
16-03-2016,3,15284,16964,7742,2022,42011,720,348,125,1193,43204
16-03-2016,4,16000,17080,7816,2145,43042,756,554,129,1439,44481
16-03-2016,5,18122,17936,7983,2384,46427,764,652,139,1555,47982
16-03-2016,6,20760,20991,8321,2577,52648,784,1060,147,1991,54639
16-03-2016,7,22351,22806,8666,2924,56749,982,1047,151,2180,58929
16-03-2016,8,22614,22855,8653,2960,57082,985,1047,334,2366,59448
16-03-2016,9,22336,22347,8524,2964,56172,986,1047,335,2368,58540
16-03-2016,10,21114,21344,8423,2988,53870,976,1052,351,2379,56249
16-03-2016,11,21169,20696,8251,3090,53206,957,1038,287,2282,55488
16-03-2016,12,20522,20505,8202,3019,52249,972,1046,342,2360,54609
16-03-2016,13,19859,20267,8068,2933,51128,957,1046,285,2288,53416
16-03-2016,14,19837,20361,7697,2961,50854,915,1043,303,2261,53115
16-03-2016,15,19712,20452,7937,2747,50849,928,1041,305,2274,53123
16-03-2016,16,20056,20833,8011,2658,51558,953,1056,284,2293,53851
16-03-2016,17,20666,21062,8490,2620,52837,979,1013,259,2251,55088
16-03-2016,18,20979,21622,9108,2716,54424,1008,1021,442,2471,56895
16-03-2016,19,21247,21663,8893,2573,54376,923,1044,252,2219,56595
16-03-2016,20,20507,21515,8344,2527,52893,827,1039,239,2105,54998
16-03-2016,21,19668,21067,8148,2595,51478,733,750,234,1717,53195
16-03-2016,22,18556,20467,7965,2420,49408,716,537,151,1404,50812
16-03-2016,23,17069,19786,7924,2383,47163,721,546,124,1391,48554
17-03-2016,0,15760,18522,7903,2286,44471,715,342,164,1221,45692
17-03-2016,1,15221,18195,7852,2341,43610,731,340,161,1232,44842
17-03-2016,2,15227,18146,7840,2417,43630,747,340,165,1252,44882
17-03-2016,3,15819,18115,7834,2466,44234,758,341,167,1266,45500
17-03-2016,4,17034,18596,7850,2427,45907,753,546,166,1465,47372
17-03-2016,5,18785,19462,7937,2510,48694,750,661,159,1570,50264
17-03-2016,6,20741,21431,8270,2812,53254,756,1050,157,1963,55217
17-03-2016,7,22677,22774,8687,3377,57515,887,1036,163,2086,59601
17-03-2016,8,22598,22798,8915,3554,57866,901,1065,366,2332,60198
17-03-2016,9,22024,22531,8813,3676,57045,903,1055,370,2328,59373
17-03-2016,10,21848,22301,8665,3450,56265,888,1045,387,2320,58585
17-03-2016,11,21584,22030,8650,3511,55777,910,1029,408,2347,58124
17-03-2016,12,20418,21846,8599,3529,54393,888,1029,436,2353,56746
17-03-2016,13,19715,21578,8486,3597,53376,871,1029,348,2248,55624
17-03-2016,14,19560,21354,8415,3572,52902,809,1022,285,2116,55018
17-03-2016,15,19695,21425,8575,3439,53135,846,995,290,2131,55266
17-03-2016,16,20370,21801,8641,3430,54243,847,991,287,2125,56368
17-03-2016,17,21005,22095,8741,3456,55298,927,956,413,2296,57594
17-03-2016,18,21258,22514,9106,3494,56373,990,1044,446,2480,58853
17-03-2016,19,21631,22084,8873,3368,55955,862,1044,238,2144,58099
17-03-2016,20,20966,21833,8396,3120,54315,758,1041,202,2001,56316
17-03-2016,21,19767,21898,8086,3175,52926,754,748,184,1686,54612
17-03-2016,22,18463,21309,8032,3013,50819,753,538,181,1472,52291
17-03-2016,23,17021,20199,8000,2740,47962,703,548,187,1438,49400
18-03-2016,0,15412,18170,8059,2705,44347,693,353,158,1204,45551
18-03-2016,1,14273,17639,8082,2685,42680,744,358,156,1258,43938
18-03-2016,2,14229,17505,8171,2604,42509,738,363,152,1253,43762
18-03-2016,3,14719,17625,8245,2659,43248,719,375,166,1260,44508
18-03-2016,4,15552,17945,8328,2630,44456,678,569,204,1451,45907
18-03-2016,5,18025,19207,8601,2764,48597,744,666,238,1648,50245
18-03-2016,6,19956,21631,8992,3041,53620,816,908,264,1988,55608
18-03-2016,7,22278,23328,9372,3103,58081,955,933,460,2348,60429
18-03-2016,8,23024,23397,9503,3254,59179,983,977,494,2454,61633
18-03-2016,9,22519,23528,9497,3041,58585,994,974,551,2519,61104
18-03-2016,10,21554,23327,9412,2980,57275,1001,979,600,2580,59855
18-03-2016,11,21247,23199,9289,2846,56581,1001,985,564,2550,59131
18-03-2016,12,20518,22871,9213,2857,55459,1008,975,613,2596,58055
18-03-2016,13,19749,22637,9098,2809,54294,1025,966,551,2542,56836
18-03-2016,14,19701,22123,8953,2810,53588,987,966,443,2396,55984
18-03-2016,15,19791,21842,9055,2679,53367,958,962,408,2328,55695
18-03-2016,16,20227,21720,8932,2546,53425,931,967,376,2274,55699
18-03-2016,17,21318,21911,9057,2408,54693,979,962,582,2523,57216
18-03-2016,18,21931,21955,9223,2402,55511,975,1077,799,2851,58362
18-03-2016,19,22254,21607,9166,2389,55417,896,1048,725,2669,58086
18-03-2016,20,21107,21453,8572,2405,53538,809,1048,611,2468,56006
18-03-2016,21,20280,20564,8485,2265,51595,788,747,592,2127,53722
18-03-2016,22,19634,19664,8431,2164,49893,803,582,568,1953,51846
18-03-2016,23,18738,19053,8211,2114,48116,800,563,362,1725,49841
19-03-2016,0,18146,16971,8370,2063,45551,670,226,236,1132,46683
19-03-2016,1,17933,16590,8336,2003,44862,665,218,255,1138,46000
19-03-2016,2,17942,16467,8298,2063,44770,671,300,276,1247,46017
19-03-2016,3,18163,16429,8368,2041,45000,671,310,253,1234,46234
19-03-2016,4,18609,16534,8356,2047,45545,670,231,236,1137,46682
19-03-2016,5,18838,16867,8356,2112,46173,671,222,202,1095,47268
19-03-2016,6,18878,17533,8331,2113,46855,646,280,169,1095,47950
19-03-2016,7,19521,18485,8240,2218,48465,667,397,489,1553,50018
19-03-2016,8,20024,19863,8135,2502,50525,661,871,150,1682,52207
19-03-2016,9,20709,20221,8070,2650,51651,664,989,239,1892,53543
19-03-2016,10,20162,20157,7967,2809,51096,666,980,249,1895,52991
19-03-2016,11,19348,19899,7949,3108,50304,662,896,405,1963,52267
19-03-2016,12,18528,19564,7962,3318,49373,670,888,472,2030,51403
19-03-2016,13,17973,18899,7977,3493,48344,680,878,502,2060,50404
19-03-2016,14,16765,18752,7990,3738,47244,665,882,515,2062,49306
19-03-2016,15,16349,18478,8046,3901,46774,662,885,447,1994,48768
19-03-2016,16,16967,18502,8074,3891,47434,658,879,333,1870,49304
19-03-2016,17,18445,18981,8201,3920,49548,655,871,418,1944,51492
19-03-2016,18,19441,19511,8486,4114,51553,620,904,591,2115,53668
19-03-2016,19,19308,19792,8427,4123,51650,616,862,656,2134,53784
19-03-2016,20,18382,19046,8243,4067,49740,612,855,451,1918,51658
19-03-2016,21,17743,18413,8260,3974,48390,631,262,590,1483,49873
19-03-2016,22,17342,17765,8205,3756,47069,629,225,417,1271,48340
19-03-2016,23,16506,17321,8081,3731,45639,623,220,385,1228,46867
20-03-2016,0,14760,16057,8249,3848,42915,698,349,143,1190,44105
20-03-2016,1,13579,15491,8186,4097,41351,694,349,116,1159,42510
20-03-2016,2,12999,15162,8182,4080,40423,676,347,115,1138,41561
20-03-2016,3,12985,14993,8193,3965,40138,673,350,117,1140,41278
20-03-2016,4,13304,14938,8274,3800,40317,662,354,122,1138,41455
20-03-2016,5,13666,15041,8262,3729,40699,679,367,121,1167,41866
20-03-2016,6,13978,15184,8179,3715,41058,708,367,125,1200,42258
20-03-2016,7,14194,15518,7994,3487,41193,722,637,125,1484,42677
20-03-2016,8,15158,16516,7887,3514,43075,768,858,126,1752,44827
20-03-2016,9,16436,17077,7946,3710,45168,808,906,126,1840,47008
20-03-2016,10,16850,17370,7879,3791,45890,819,893,127,1839,47729
20-03-2016,11,16971,17599,7882,3774,46227,827,884,126,1837,48064
20-03-2016,12,16226,17404,7737,3758,45125,818,900,125,1843,46968
20-03-2016,13,15703,17130,7693,3598,44126,807,902,125,1834,45960
20-03-2016,14,15214,16856,7710,3513,43292,801,896,125,1822,45114
20-03-2016,15,15211,16883,7747,3452,43292,793,902,127,1822,45114
20-03-2016,16,15221,17525,7753,3204,43704,792,909,128,1829,45533
20-03-2016,17,16530,18496,7953,3232,46211,777,902,127,1806,48017
20-03-2016,18,19460,19858,8062,3064,50444,772,1132,134,2038,52482
20-03-2016,19,19791,19988,8008,3435,51221,771,1077,126,1974,53195
20-03-2016,20,18732,19681,7980,3530,49924,781,964,118,1863,51787
20-03-2016,21,18070,19170,8000,3510,48752,756,1098,117,1971,50723
20-03-2016,22,17449,18429,7891,3642,47411,768,786,94,1648,49059
20-03-2016,23,16195,17620,7830,3895,45540,715,462,113,1290,46830
21-03-2016,0,15510,16483,7760,3867,43622,691,496,121,1308,44930
21-03-2016,1,14823,16060,7770,3895,42547,703,498,122,1323,43870
21-03-2016,2,14547,16094,7734,4052,42427,727,500,119,1346,43773
21-03-2016,3,15300,16195,7856,3946,43298,763,515,119,1397,44695
21-03-2016,4,16358,16243,8324,4049,44974,822,537,138,1497,46471
21-03-2016,5,17613,16831,8648,4060,47152,921,1104,187,2212,49364
21-03-2016,6,18795,19329,9077,4112,51315,995,1255,193,2443,53758
21-03-2016,7,20551,20619,9238,4281,54689,1156,1447,212,2815,57504
21-03-2016,8,21426,20729,9072,4524,55750,1204,1469,376,3049,58799
21-03-2016,9,21113,20662,9011,4725,55511,1216,1369,394,2979,58490
21-03-2016,10,20730,20635,8928,4922,55215,1213,1376,276,2865,58080
21-03-2016,11,19674,20318,8965,4912,53868,1207,1245,283,2735,56603
21-03-2016,12,19668,19957,8949,4904,53478,1178,1231,307,2716,56194
21-03-2016,13,19549,20071,8777,4664,53062,1164,1248,292,2704,55766
21-03-2016,14,18969,20258,8741,4541,52511,1151,1190,288,2629,55140
21-03-2016,15,18958,19975,8652,4597,52184,1154,1214,302,2670,54854
21-03-2016,16,19078,19788,8561,4695,52122,1203,1263,228,2694,54816
21-03-2016,17,20024,20178,8716,4340,53259,1221,1382,348,2951,56210
21-03-2016,18,21062,20657,8875,4282,54874,1200,1598,324,3122,57996
21-03-2016,19,21648,20784,8844,3987,55263,1205,1156,325,2686,57949
21-03-2016,20,20653,20723,8473,3880,53730,933,1085,139,2157,55887
21-03-2016,21,19843,20154,8508,3814,52320,904,927,120,1951,54271
21-03-2016,22,19200,19128,8260,3641,50229,856,669,120,1645,51874
21-03-2016,23,17768,18171,7881,3651,47471,851,495,114,1460,48931
22-03-2016,0,16438,16805,7778,3789,44812,825,510,90,1425,46237
22-03-2016,1,15702,16356,7716,3678,43452,817,510,92,1419,44871
22-03-2016,2,15737,16280,7702,3534,43253,826,507,94,1427,44680
22-03-2016,3,16663,16345,7801,3428,44239,839,509,109,1457,45696
22-03-2016,4,17741,16600,8472,3441,46255,922,534,125,1581,47836
22-03-2016,5,18928,17336,8799,3381,48445,1136,1148,166,2450,50895
22-03-2016,6,19907,20082,9002,3337,52328,1313,1348,190,2851,55179
22-03-2016,7,21399,21680,9117,3569,55766,1388,1590,291,3269,59035
22-03-2016,8,21825,22199,8918,3739,56681,1400,1609,324,3333,60014
22-03-2016,9,21832,22229,8828,4021,56909,1376,1607,271,3254,60163
22-03-2016,10,21454,22215,8667,3868,56204,1368,1491,281,3140,59344
22-03-2016,11,20880,22080,8523,3488,54972,1388,1396,187,2971,57943
22-03-2016,12,21054,21904,8655,3436,55050,1384,1154,167,2705,57755
22-03-2016,13,20679,21722,8591,3540,54532,1383,1100,157,2640,57172
22-03-2016,14,20181,21389,8506,3388,53462,1376,1028,159,2563,56025
22-03-2016,15,20319,21253,8488,3248,53308,1377,1105,238,2720,56028
22-03-2016,16,20742,21543,8513,2867,53665,1379,1090,233,2702,56367
22-03-2016,17,21340,21939,8752,2675,54707,1374,1229,232,2835,57542
22-03-2016,18,21994,22017,8871,2438,55320,1355,1550,235,3140,58460
22-03-2016,19,22239,22381,8775,2593,55989,1334,1013,145,2492,58481
22-03-2016,20,21637,22043,8615,2453,54748,874,881,141,1896,56644
22-03-2016,21,20417,21658,8511,2476,53062,859,733,152,1744,54806
22-03-2016,22,18890,20700,8422,2630,50641,860,612,146,1618,52259
22-03-2016,23,17581,19597,8361,2747,48288,833,608,107,1548,49836
23-03-2016,0,17346,17115,8139,2834,45433,755,515,104,1374,46807
23-03-2016,1,17024,16449,8086,2753,44312,730,509,92,1331,45643
23-03-2016,2,16354,16593,8049,2673,43669,743,518,146,1407,45076
23-03-2016,3,17031,16627,8079,2942,44681,752,595,159,1506,46187
23-03-2016,4,17479,16750,8484,3072,45785,864,673,131,1668,47453
23-03-2016,5,18280,17509,8743,3073,47605,1185,1022,175,2382,49987
23-03-2016,6,19652,19767,8846,3075,51341,1425,1280,291,2996,54337
23-03-2016,7,21603,21381,8958,3193,55135,1418,1440,352,3210,58345
23-03-2016,8,22518,21887,8929,3372,56705,1394,1520,350,3264,59969
23-03-2016,9,22213,21979,8851,3189,56232,1426,1473,340,3239,59471
23-03-2016,10,22125,22038,8798,3171,56130,1457,1413,340,3210,59340
23-03-2016,11,21346,21864,8577,3314,55101,1449,1525,346,3320,58421
23-03-2016,12,20601,21464,8510,3477,54052,1442,1380,352,3174,57226
23-03-2016,13,20188,21210,8564,3455,53418,1433,1275,338,3046,56464
23-03-2016,14,19788,21017,8574,3386,52764,1415,1219,148,2782,55546
23-03-2016,15,19659,21031,8579,2941,52211,1368,1318,148,2834,55045
23-03-2016,16,19782,20964,8734,2731,52212,1373,1264,157,2794,55006
23-03-2016,17,20776,21016,9002,2711,53506,1395,1269,166,2830,56336
23-03-2016,18,21644,21602,9067,2492,54806,1380,1436,349,3165,57971
23-03-2016,19,21904,22029,8908,2704,55544,1389,1314,222,2925,58469
23-03-2016,20,21469,21712,8548,2369,54099,1012,1225,218,2455,56554
23-03-2016,21,21034,20876,8383,2073,52366,914,1011,191,2116,54482
23-03-2016,22,20186,20481,8103,2034,50804,871,849,202,1922,52726
23-03-2016,23,19064,19743,7933,1910,48650,830,615,181,1626,50276
24-03-2016,0,18739,18087,7845,1841,46511,739,520,118,1377,47888
24-03-2016,1,18107,17834,7830,1815,45586,739,511,158,1408,46994
24-03-2016,2,17453,17789,7826,1765,44832,725,509,143,1377,46209
24-03-2016,3,17476,17856,7930,1975,45238,704,503,90,1297,46535
24-03-2016,4,18459,17994,8277,2038,46769,733,513,132,1378,48147
24-03-2016,5,19887,18629,8778,2040,49336,960,1032,155,2147,51483
24-03-2016,6,20217,20805,8943,2064,52031,1231,1289,161,2681,54712
24-03-2016,7,20885,21810,9193,2201,54090,1252,1463,221,2936,57026
24-03-2016,8,21670,22040,9192,2487,55390,1251,1475,322,3048,58438
24-03-2016,9,21648,22093,9173,2681,55594,1274,1426,324,3024,58618
24-03-2016,10,20938,22028,9137,2879,54982,1289,1401,324,3014,57996
24-03-2016,11,20178,22019,9086,3019,54302,1287,1332,326,2945,57247
24-03-2016,12,19307,21771,9022,3123,53224,1283,1376,329,2988,56212
24-03-2016,13,18724,21559,8922,3188,52392,1294,1317,336,2947,55339
24-03-2016,14,18340,21332,8888,3206,51766,1251,1295,300,2846,54612
24-03-2016,15,18285,21346,8898,3082,51611,1222,1173,299,2694,54305
24-03-2016,16,18175,21568,8897,3140,51781,1216,1165,272,2653,54434
24-03-2016,17,18456,22017,9019,3299,52791,1270,1140,304,2714,55505
24-03-2016,18,18989,22194,9108,3240,53531,1268,1456,318,3042,56573
24-03-2016,19,18836,22471,8945,3293,53547,1269,1190,273,2732,56279
24-03-2016,20,18159,21975,8579,2834,51547,926,1204,316,2446,53993
24-03-2016,21,17499,21429,8253,2667,49849,889,1088,137,2114,51963
24-03-2016,22,16827,20463,8077,2762,48130,821,752,111,1684,49814
24-03-2016,23,16147,19582,7771,2714,46213,746,608,124,1478,47691
25-03-2016,0,16361,17295,7542,2830,44029,681,486,107,1274,45303
25-03-2016,1,15574,16773,7572,2633,42553,673,488,114,1275,43828
25-03-2016,2,15406,16583,7541,2727,42257,673,487,118,1278,43535
25-03-2016,3,14862,16598,7543,2766,41769,656,492,166,1314,43083
25-03-2016,4,15004,16552,7660,2697,41911,675,492,118,1285,43196
25-03-2016,5,15754,16983,7715,2833,43286,733,493,124,1350,44636
25-03-2016,6,15970,18071,7869,2866,44776,801,725,178,1704,46480
25-03-2016,7,16850,19056,7930,2775,46611,896,1026,163,2085,48696
25-03-2016,8,17717,20101,8173,2727,48717,900,1088,156,2144,50861
25-03-2016,9,18383,20822,8353,2797,50356,907,1150,345,2402,52758
25-03-2016,10,18461,21083,8466,2873,50883,913,1144,372,2429,53312
25-03-2016,11,18208,21330,8361,2944,50843,903,1116,378,2397,53240
25-03-2016,12,18018,21128,8374,2932,50452,909,1098,382,2389,52841
25-03-2016,13,17596,20930,8298,3049,49873,895,1074,366,2335,52208
25-03-2016,14,16895,20843,8357,3352,49447,891,1087,194,2172,51619
25-03-2016,15,16668,20456,8441,3593,49158,875,1088,161,2124,51282
25-03-2016,16,16825,20095,8497,3449,48867,858,1104,183,2145,51012
25-03-2016,17,17550,20245,8561,3344,49701,862,1165,179,2206,51907
25-03-2016,18,18002,20824,8837,3172,50837,860,1339,332,2531,53368
25-03-2016,19,17925,21213,8452,3246,50837,848,1280,321,2449,53286
25-03-2016,20,17437,20714,7783,3187,49121,781,1319,148,2248,51369
25-03-2016,21,17058,20259,7554,3064,47935,750,990,154,1894,49829
25-03-2016,22,16463,19689,7494,2956,46601,740,719,128,1587,48188
25-03-2016,23,15892,18794,7342,2822,44848,727,509,132,1368,46216
26-03-2016,0,16115,16863,7149,2765,42891,669,375,125,1169,44060
26-03-2016,1,15776,16557,7088,2715,42137,656,374,113,1143,43280
26-03-2016,2,15398,16033,7127,2551,41110,666,373,102,1141,42251
26-03-2016,3,14608,15732,7109,2341,39790,666,371,98,1135,40925
26-03-2016,4,14436,15532,7071,2246,39287,655,374,94,1123,40410
26-03-2016,5,14235,15587,7121,2347,39290,655,375,147,1177,40467
26-03-2016,6,14351,16360,7214,2487,40412,684,383,138,1205,41617
26-03-2016,7,15666,16972,7370,2823,42832,760,621,125,1506,44338
26-03-2016,8,16818,17823,7491,2995,45125,889,693,115,1697,46822
26-03-2016,9,17131,18186,7425,3364,46105,903,877,112,1892,47997
26-03-2016,10,16342,17865,7247,3712,45167,897,867,113,1877,47044
26-03-2016,11,14331,17501,7190,4016,43037,871,885,112,1868,44905
26-03-2016,12,12835,17308,7115,4258,41515,895,871,112,1878,43393
26-03-2016,13,12117,16809,7126,4163,40215,876,1033,112,2021,42236
26-03-2016,14,11501,16634,7115,4170,39419,871,828,112,1811,41230
26-03-2016,15,11509,16810,7119,4053,39491,1107,814,115,2036,41527
26-03-2016,16,11838,17365,7168,4031,40400,1136,840,115,2091,42491
26-03-2016,17,13364,18247,7529,4134,43275,953,944,114,2011,45286
26-03-2016,18,14838,19042,7862,4177,45920,907,1100,120,2127,48047
26-03-2016,19,14978,19289,7839,4363,46470,874,1102,119,2095,48565
26-03-2016,20,13793,19028,7692,4333,44846,871,1002,113,1986,46832
26-03-2016,21,12060,18441,7463,4351,42315,789,715,64,1568,43883
26-03-2016,22,10951,18015,7400,4561,40927,769,597,108,1474,42401
26-03-2016,23,10297,17421,7414,4549,39683,734,354,61,1149,40832
27-03-2016,0,9528,16670,7478,4311,37987,660,286,64,1010,38997
27-03-2016,1,8811,16309,7283,4281,36684,644,281,70,995,37679
27-03-2016,2,,,,,,666,,,,
27-03-2016,3,8873,15891,7388,4276,36427,668,280,82,1030,37457
27-03-2016,4,9052,16186,7380,4361,36979,680,280,86,1046,38025
27-03-2016,5,9141,16246,7395,4410,37192,688,284,90,1062,38254
27-03-2016,6,9660,16294,7435,4294,37683,730,292,147,1169,38852
27-03-2016,7,9428,16468,7585,4260,37742,713,309,155,1177,38919
27-03-2016,8,10103,16691,7613,4099,38506,697,353,151,1201,39707
27-03-2016,9,10931,17604,7601,3947,40083,699,352,157,1208,41291
27-03-2016,10,11205,18044,7675,3857,40781,731,354,194,1279,42060
27-03-2016,11,11294,18339,7693,3789,41114,751,348,207,1306,42420
27-03-2016,12,10694,18456,7636,3626,40412,755,354,209,1318,41730
27-03-2016,13,10158,18337,7559,3649,39702,752,305,225,1282,40984
27-03-2016,14,9791,18273,7546,3809,39420,738,301,238,1277,40697
27-03-2016,15,9866,18233,7600,3495,39193,725,350,233,1308,40501
27-03-2016,16,10248,18147,7700,3393,39490,697,347,225,1269,40759
27-03-2016,17,11004,18169,7805,3525,40503,720,391,222,1333,41836
27-03-2016,18,11611,18620,7752,3659,41641,703,396,210,1309,42950
27-03-2016,19,13723,19206,7922,3677,44528,710,414,232,1356,45884
27-03-2016,20,15236,19525,8172,3743,46677,742,391,270,1403,48080
27-03-2016,21,13798,19140,8025,3592,44556,847,372,298,1517,46073
27-03-2016,22,13067,18428,7953,3525,42972,844,370,260,1474,44446
27-03-2016,23,12010,17340,7682,3558,40590,841,427,261,1529,42119
28-03-2016,0,10196,15971,7401,3531,37100,758,222,256,1236,38336
28-03-2016,1,9253,15498,7339,3525,35617,731,213,254,1198,36815
28-03-2016,2,9068,15224,7333,3625,35249,734,214,267,1215,36464
28-03-2016,3,9067,15047,7373,3522,35008,723,216,249,1188,36196
28-03-2016,4,9725,15212,7443,3434,35813,748,215,229,1192,37005
28-03-2016,5,10445,15665,7479,3421,37010,754,389,219,1362,38372
28-03-2016,6,10212,16441,7536,3548,37737,754,540,256,1550,39287
28-03-2016,7,10352,16972,7599,3801,38725,736,607,246,1589,40314
28-03-2016,8,11138,17348,7683,4097,40265,680,798,203,1681,41946
28-03-2016,9,12056,18078,7767,4555,42456,720,878,157,1755,44211
28-03-2016,10,12626,18532,7784,4825,43767,743,879,164,1786,45553
28-03-2016,11,12983,18533,7717,5069,44302,753,888,194,1835,46137
28-03-2016,12,12490,18473,7697,4784,43443,743,892,205,1840,45283
28-03-2016,13,12272,18573,7655,4636,43136,728,842,205,1775,44911
28-03-2016,14,12217,18585,7613,4408,42823,708,813,190,1711,44534
28-03-2016,15,11989,18555,7693,4335,42571,685,798,187,1670,44241
28-03-2016,16,12118,18509,7712,4387,42726,656,731,203,1590,44316
28-03-2016,17,12325,18736,7805,4541,43406,641,668,190,1499,44905
28-03-2016,18,12783,19164,8100,5011,45057,634,668,212,1514,46571
28-03-2016,19,13215,19566,8354,5015,46149,690,855,248,1793,47942
28-03-2016,20,13315,19816,8029,5103,46261,788,735,291,1814,48075
28-03-2016,21,12678,19501,7793,4774,44747,788,420,294,1502,46249
28-03-2016,22,12266,18893,7840,4502,43501,794,424,307,1525,45026
28-03-2016,23,10939,18084,7495,4422,40940,811,376,326,1513,42453
29-03-2016,0,10209,16816,7373,4493,38890,810,221,355,1386,40276
29-03-2016,1,9830,15965,7269,4513,37577,821,226,323,1370,38947
29-03-2016,2,9326,15670,7174,4380,36550,826,239,316,1381,37931
29-03-2016,3,9470,15558,7234,4125,36388,831,289,293,1413,37801
29-03-2016,4,10094,15567,7429,3934,37025,850,291,274,1415,38440
29-03-2016,5,12664,16631,8167,3905,41367,892,449,265,1606,42973
29-03-2016,6,15952,19133,8669,4288,48041,1065,693,264,2022,50063
29-03-2016,7,18121,20851,8927,4191,52091,1149,1092,295,2536,54627
29-03-2016,8,19171,21304,8915,4418,53808,1130,1192,407,2729,56537
29-03-2016,9,19267,21158,8742,4408,53574,1142,1100,403,2645,56219
29-03-2016,10,18954,21507,8589,4559,53609,1166,1069,412,2647,56256
29-03-2016,11,18020,21491,8440,4693,52645,1202,1038,345,2585,55230
29-03-2016,12,16873,20969,8397,4850,51091,1217,1030,305,2552,53643
29-03-2016,13,16175,20385,8388,4887,49835,1145,1028,272,2445,52280
29-03-2016,14,15546,19962,8250,4792,48552,1057,1057,297,2411,50963
29-03-2016,15,15224,19700,8133,4396,47454,1103,832,261,2196,49650
29-03-2016,16,15741,19676,8150,4236,47804,1137,741,255,2133,49937
29-03-2016,17,17667,20124,8204,4095,50090,1039,727,438,2204,52294
29-03-2016,18,18473,20372,8388,3733,50967,1015,800,381,2196,53163
29-03-2016,19,19198,20341,8555,3257,51351,937,1114,361,2412,53763
29-03-2016,20,19204,20621,8385,3229,51439,836,902,232,1970,53409
29-03-2016,21,18463,20477,7993,3180,50112,815,724,130,1669,51781
29-03-2016,22,17099,19886,7671,3112,47768,791,340,106,1237,49005
29-03-2016,23,16025,18723,7499,2919,45165,763,366,107,1236,46401
30-03-2016,0,15519,17202,7483,2597,42802,760,369,121,1250,44052
30-03-2016,1,15507,16608,7398,2529,42043,757,403,134,1294,43337
30-03-2016,2,15578,16499,7357,2235,41669,782,402,143,1327,42996
30-03-2016,3,15132,16261,7306,2179,40878,802,381,176,1359,42237
30-03-2016,4,15973,16318,7442,2260,41992,842,373,226,1441,43433
30-03-2016,5,17555,17325,8098,2163,45141,989,462,196,1647,46788
30-03-2016,6,19929,19065,8275,2559,49829,1229,774,413,2416,52245
30-03-2016,7,22278,20499,8579,2795,54150,1383,961,404,2748,56898
30-03-2016,8,22954,21111,8612,3175,55852,1360,1183,397,2940,58792
30-03-2016,9,22482,20912,8462,3112,54969,1322,1664,343,3329,58298
30-03-2016,10,22222,20811,8469,3030,54532,1266,1567,304,3137,57669
30-03-2016,11,21638,21012,8264,3214,54127,1213,1564,319,3096,57223
30-03-2016,12,20711,21116,8167,3361,53355,1202,1472,252,2926,56281
30-03-2016,13,19959,20418,8232,3684,52295,1343,1373,221,2937,55232
30-03-2016,14,19859,20044,8359,3668,51931,1388,909,185,2482,54413
30-03-2016,15,19678,19838,8287,3651,51454,1398,855,167,2420,53874
30-03-2016,16,19107,20006,8169,3612,50893,1400,806,188,2394,53287
30-03-2016,17,19929,20085,8272,3413,51700,1368,880,192,2440,54140
30-03-2016,18,20289,20009,8395,3501,52194,1229,836,211,2276,54470
30-03-2016,19,21329,19968,8449,3139,52886,1079,1198,163,2440,55326
30-03-2016,20,21508,19990,8295,3090,52882,865,950,189,2004,54886
30-03-2016,21,20847,20077,8006,2788,51719,769,856,174,1799,53518
30-03-2016,22,19278,19723,7804,2843,49647,723,741,127,1591,51238
30-03-2016,23,18127,18740,7444,2760,47071,692,516,162,1370,48441
31-03-2016,0,17811,16778,7146,2613,44349,699,519,229,1447,45796
31-03-2016,1,17382,16295,7104,2446,43228,700,519,258,1477,44705
31-03-2016,2,17380,16283,7068,2281,43013,703,519,269,1491,44504
31-03-2016,3,17498,16219,7053,2318,43088,711,524,305,1540,44628
31-03-2016,4,17982,16340,7307,2316,43945,701,527,305,1533,45478
31-03-2016,5,20044,17803,7694,2390,47930,767,533,327,1627,49557
31-03-2016,6,22485,19557,8155,2490,52688,1004,538,531,2073,54761
31-03-2016,7,23778,20859,8401,2896,55934,1380,996,548,2924,58858
31-03-2016,8,24025,21289,8398,3170,56882,1397,1078,563,3038,59920
31-03-2016,9,24169,21197,8359,3004,56728,1399,1048,588,3035,59763
31-03-2016,10,23664,21213,8283,3434,56593,1408,1023,565,2996,59589
31-03-2016,11,22734,20890,8175,3672,55472,1407,938,560,2905,58377
31-03-2016,12,22004,20411,8048,4074,54536,1406,1045,541,2992,57528
31-03-2016,13,21634,19841,8032,4423,53931,1413,989,532,2934,56865
31-03-2016,14,21083,19605,7985,4367,53039,1414,949,508,2871,55910
31-03-2016,15,20382,19438,7887,4620,52327,1414,772,460,2646,54973
31-03-2016,16,20325,19041,7926,4639,51931,1419,764,449,2632,54563
31-03-2016,17,20281,18815,7927,4671,51693,1423,850,406,2679,54372
31-03-2016,18,20525,18896,8053,4323,51796,1402,973,387,2762,54558
31-03-2016,19,21233,19347,8300,3879,52761,1143,1283,358,2784,55545
31-03-2016,20,21703,20022,8170,3483,53380,991,746,345,2082,55462
31-03-2016,21,21053,20279,7945,3252,52530,815,649,161,1625,54155
31-03-2016,22,19543,19980,7595,3194,50312,767,529,156,1452,51764
31-03-2016,23,18096,19221,7262,3177,47755,747,531,147,1425,49180
01-04-2016,0,17194,17452,7209,3215,45072,741,526,140,1407,46479
01-04-2016,1,16723,16966,7171,3024,43885,742,526,133,1401,45286
01-04-2016,2,16731,16857,7041,2818,43447,740,527,133,1400,44847
01-04-2016,3,16271,16969,7173,2627,43041,734,528,139,1401,44442
01-04-2016,4,17278,17329,7452,2485,44544,719,529,146,1394,45938
01-04-2016,5,19199,18075,7910,2531,47716,870,663,167,1700,49416
01-04-2016,6,22033,19744,8139,2694,52610,1326,742,370,2438,55048
01-04-2016,7,23597,21729,8409,2790,56526,1386,1172,400,2958,59484
01-04-2016,8,23922,22421,8544,3115,58004,1391,1272,412,3075,61079
01-04-2016,9,23817,22401,8495,3374,58088,1396,1322,453,3171,61259
01-04-2016,10,23459,22170,8439,3470,57538,1397,1119,460,2976,60514
01-04-2016,11,22914,21865,8208,3484,56471,1394,1076,491,2961,59432
01-04-2016,12,22097,21048,8209,3439,54793,1390,988,518,2896,57689
01-04-2016,13,21792,20291,8013,3143,53237,1390,980,539,2909,56146
01-04-2016,14,20936,20227,7888,3132,52182,1377,898,484,2759,54941
01-04-2016,15,20527,19933,7551,3097,51108,1229,705,377,2311,53419
01-04-2016,16,20497,19910,7745,2866,51018,1167,696,395,2258,53276
01-04-2016,17,21250,20219,7851,2524,51844,1261,668,378,2307,54151
01-04-2016,18,21412,20322,8011,2553,52299,1306,640,538,2484,54783
01-04-2016,19,21450,20190,8129,2406,52176,1404,636,554,2594,54770
01-04-2016,20,21693,19994,7725,2573,51985,1213,689,492,2394,54379
01-04-2016,21,20555,19690,7406,2607,50259,751,846,277,1874,52133
01-04-2016,22,19631,18985,7295,2586,48499,698,818,280,1796,50295
01-04-2016,23,18673,18007,7217,2587,46485,694,554,235,1483,47968
02-04-2016,0,18089,15954,7165,2519,43727,655,264,174,1093,44820
02-04-2016,1,16886,15551,7095,2769,42303,651,239,187,1077,43380
02-04-2016,2,16354,15425,7093,2693,41566,648,240,183,1071,42637
02-04-2016,3,14541,15071,7000,2683,39294,635,243,190,1068,40362
02-04-2016,4,14872,15138,7097,2720,39828,661,245,183,1089,40917
02-04-2016,5,15387,15475,7194,2845,40902,653,336,161,1150,42052
02-04-2016,6,15610,16483,7348,3026,42468,715,340,156,1211,43679
02-04-2016,7,16954,17155,7493,3116,44717,914,425,193,1532,46249
02-04-2016,8,18481,17791,7592,3253,47117,930,838,147,1915,49032
02-04-2016,9,19270,18579,7633,3377,48859,912,1083,132,2127,50986
02-04-2016,10,18534,19181,7581,3799,49095,922,1070,142,2134,51229
02-04-2016,11,17234,18688,7539,4067,47529,930,1046,153,2129,49658
02-04-2016,12,15884,18187,7340,4119,45531,928,966,169,2063,47594
02-04-2016,13,15732,18207,7123,3850,44912,931,901,194,2026,46938
02-04-2016,14,15291,18148,7070,3597,44106,952,805,193,1950,46056
02-04-2016,15,15028,18129,7040,3253,43451,973,773,171,1917,45368
02-04-2016,16,15595,18150,7126,2952,43824,947,772,174,1893,45717
02-04-2016,17,18195,18910,7282,2791,47178,949,843,147,1939,49117
02-04-2016,18,20150,19247,7253,2464,49116,929,873,142,1944,51060
02-04-2016,19,20516,19274,7356,2243,49388,908,903,276,2087,51475
02-04-2016,20,20196,18948,7461,2135,48740,903,934,303,2140,50880
02-04-2016,21,19730,18689,7314,2011,47745,832,688,137,1657,49402
02-04-2016,22,18909,18096,7249,2008,46262,743,591,84,1418,47680
02-04-2016,23,17841,17350,7192,1905,44288,765,327,97,1189,45477
03-04-2016,0,15574,15416,7006,1474,39471,676,270,102,1048,40519
03-04-2016,1,13584,14682,6842,1391,36500,631,269,120,1020,37520
03-04-2016,2,12897,14295,6839,1435,35465,637,213,135,985,36450
03-04-2016,3,12802,14173,6820,1413,35207,646,282,211,1139,36346
03-04-2016,4,12403,14115,6806,1489,34815,743,443,167,1353,36168
03-04-2016,5,12557,14035,6882,1608,35081,859,468,146,1473,36554
03-04-2016,6,12407,13970,6936,1798,35112,866,445,124,1435,36547
03-04-2016,7,12924,14166,7090,2004,36184,901,708,122,1731,37915
03-04-2016,8,14225,14770,7059,2180,38234,896,394,132,1422,39656
03-04-2016,9,15110,15365,7202,2461,40139,905,344,96,1345,41484
03-04-2016,10,15598,15745,7212,2649,41205,914,435,101,1450,42655
03-04-2016,11,15333,15955,7155,2714,41155,902,704,94,1700,42855
03-04-2016,12,14672,16493,7093,2723,40981,897,703,99,1699,42680
03-04-2016,13,14586,16421,7029,2606,40642,908,649,115,1672,42314
03-04-2016,14,14737,16364,7119,2396,40615,907,634,108,1649,42264
03-04-2016,15,15460,16691,7165,2169,41485,853,447,111,1411,42896
03-04-2016,16,16217,17071,7149,2289,42725,853,444,120,1417,44142
03-04-2016,17,16928,17615,7111,2165,43819,872,445,101,1418,45237
03-04-2016,18,18805,17750,7273,2166,45994,899,446,104,1449,47443
03-04-2016,19,20569,18226,7456,2213,48462,891,715,104,1710,50172
03-04-2016,20,20921,18567,7477,2154,49120,889,789,307,1985,51105
03-04-2016,21,20186,18364,7370,2149,48070,859,692,80,1631,49701
03-04-2016,22,19154,17851,7252,1936,46193,786,479,90,1355,47548
03-04-2016,23,16863,16764,7209,1756,42592,782,269,106,1157,43749
04-04-2016,0,15963,15533,7181,1519,40198,648,373,122,1143,41341
04-04-2016,1,14308,15297,7108,1367,38080,669,376,106,1151,39231
04-04-2016,2,13220,15076,7125,1304,36724,673,380,94,1147,37871
04-04-2016,3,13002,15031,7155,1319,36507,750,366,84,1200,37707
04-04-2016,4,13503,15136,7354,1389,37382,796,418,59,1273,38655
04-04-2016,5,15450,15770,7795,1596,40612,958,490,80,1528,42140
04-04-2016,6,19965,17695,8126,2007,47795,1199,808,106,2113,49908
04-04-2016,7,21979,19589,8271,2693,52533,1479,1013,123,2615,55148
04-04-2016,8,22557,19887,8239,3289,53973,1484,1267,301,3052,57025
04-04-2016,9,21965,20102,8219,3445,53732,1497,1149,292,2938,56670
04-04-2016,10,21718,20175,8139,3413,53446,1477,1152,276,2905,56351
04-04-2016,11,21290,20050,7986,3336,52661,1494,1221,276,2991,55652
04-04-2016,12,20499,19609,7878,3123,51108,1498,1129,278,2905,54013
04-04-2016,13,20756,19624,7879,3123,51381,1484,996,267,2747,54128
04-04-2016,14,20811,19415,7818,2909,50954,1486,940,279,2705,53659
04-04-2016,15,20477,19108,7543,2871,49999,1505,692,112,2309,52308
04-04-2016,16,20913,19059,7769,2807,50550,1492,669,102,2263,52813
04-04-2016,17,21035,19428,7902,2779,51143,1493,738,118,2349,53492
04-04-2016,18,20538,19581,8042,2926,51087,1490,810,153,2453,53540
04-04-2016,19,20815,19013,7996,2809,50634,1473,872,327,2672,53306
04-04-2016,20,21316,19204,7560,2802,50884,1128,843,345,2316,53200
04-04-2016,21,20560,18705,7267,2652,49185,1032,798,189,2019,51204
04-04-2016,22,19376,17503,7258,2620,46759,973,549,156,1678,48437
04-04-2016,23,17810,16442,7211,2436,43899,890,532,163,1585,45484
05-04-2016,0,16634,15034,7169,2234,41073,761,508,198,1467,42540
05-04-2016,1,16021,15033,7135,2189,40378,751,503,204,1458,41836
05-04-2016,2,15819,14849,7138,1970,39776,766,500,196,1462,41238
05-04-2016,3,15330,14641,7150,1836,38957,747,500,172,1419,40376
05-04-2016,4,16205,14661,7326,1790,39983,761,521,138,1420,41403
05-04-2016,5,17931,15400,7781,1871,42983,920,533,162,1615,44598
05-04-2016,6,20269,17867,7946,2081,48163,1392,768,178,2338,50501
05-04-2016,7,21655,19822,8109,2947,52532,1504,988,198,2690,55222
05-04-2016,8,21764,20218,8185,3277,53444,1523,1495,353,3371,56815
05-04-2016,9,21655,20153,8141,3304,53253,1411,1543,351,3305,56558
05-04-2016,10,21822,20021,8139,3191,53173,1387,1271,316,2974,56147
05-04-2016,11,21678,20111,8075,3175,53039,1408,1242,211,2861,55900
05-04-2016,12,21234,20004,8017,3000,52255,1397,1165,143,2705,54960
05-04-2016,13,20988,19630,7928,2761,51308,1400,1157,183,2740,54048
05-04-2016,14,21057,19260,7892,2720,50928,1415,1084,201,2700,53628
05-04-2016,15,21042,19184,7548,2492,50265,1337,775,175,2287,52552
05-04-2016,16,21105,19295,7816,2286,50503,1288,779,179,2246,52749
05-04-2016,17,20999,19359,7963,2397,50719,1433,820,186,2439,53158
05-04-2016,18,21081,19285,7920,2158,50443,1455,957,191,2603,53046
05-04-2016,19,21247,19038,7919,2326,50529,1470,1011,414,2895,53424
05-04-2016,20,21190,19291,7630,2312,50422,1146,781,349,2276,52698
05-04-2016,21,20658,18589,7230,2130,48607,943,793,288,2024,50631
05-04-2016,22,19501,17631,7054,2041,46228,872,560,266,1698,47926
05-04-2016,23,17878,16382,6950,2312,43522,821,499,270,1590,45112
06-04-2016,0,15947,14492,6836,2306,39581,842,515,287,1644,41225
06-04-2016,1,14347,14187,6759,2341,37634,858,514,264,1636,39270
06-04-2016,2,13770,14097,6735,2471,37073,856,516,246,1618,38691
06-04-2016,3,12987,14162,6752,2495,36398,845,520,241,1606,38004
06-04-2016,4,13107,14386,6807,2602,36902,842,522,233,1597,38499
06-04-2016,5,14835,15165,7319,2798,40116,884,540,232,1656,41772
06-04-2016,6,18169,17217,7889,3202,46478,1115,965,250,2330,48808
06-04-2016,7,20246,19266,7995,3556,51063,1377,866,226,2469,53532
06-04-2016,8,21012,19549,7922,3838,52323,1359,1087,412,2858,55181
06-04-2016,9,20871,19695,7796,3901,52263,1358,1106,368,2832,55095
06-04-2016,10,20428,20076,7781,3922,52206,1395,1119,447,2961,55167
06-04-2016,11,19298,19949,7647,4052,50946,1416,1122,479,3017,53963
06-04-2016,12,18265,19742,7599,4140,49748,1442,1128,557,3127,52875
06-04-2016,13,17241,19264,7637,4099,48239,1520,1070,931,3521,51760
06-04-2016,14,17221,18897,7601,4377,48096,1522,1045,840,3407,51503
06-04-2016,15,16979,18617,7318,4231,47146,1348,936,795,3079,50225
06-04-2016,16,17406,18729,7471,4071,47678,1436,929,782,3147,50825
06-04-2016,17,18149,19236,7693,3782,48861,1415,930,605,2950,51811
06-04-2016,18,18735,19596,7881,3842,50053,1378,892,617,2887,52940
06-04-2016,19,18955,19838,8057,3683,50533,1374,909,481,2764,53297
06-04-2016,20,19114,19738,7753,3708,50313,1233,804,211,2248,52561
06-04-2016,21,18236,19248,7373,3679,48536,873,889,192,1954,50490
06-04-2016,22,16431,18755,7313,3464,45963,806,646,191,1643,47606
06-04-2016,23,13928,18030,7166,3197,42320,781,524,171,1476,43796
07-04-2016,0,11492,16913,7109,3155,38669,758,471,149,1378,40047
07-04-2016,1,10733,16695,7016,3242,37686,758,467,151,1376,39062
07-04-2016,2,10429,16495,7056,3374,37355,762,466,148,1376,38731
07-04-2016,3,9936,16159,7076,3657,36829,768,464,178,1410,38239
07-04-2016,4,10243,16275,7122,3812,37451,766,468,213,1447,38898
07-04-2016,5,12705,16948,7470,3822,40945,813,480,233,1526,42471
07-04-2016,6,15821,18735,7945,3802,46303,1032,833,264,2129,48432
07-04-2016,7,18108,20152,8270,4119,50648,1304,651,225,2180,52828
07-04-2016,8,18901,20414,8393,4356,52065,1310,930,377,2617,54682
07-04-2016,9,18550,20316,8348,4451,51666,1293,920,376,2589,54255
07-04-2016,10,17992,20327,8397,4609,51326,1302,889,432,2623,53949
07-04-2016,11,17844,20365,8366,4546,51122,1321,897,402,2620,53742
07-04-2016,12,17609,19936,8175,4711,50430,1331,890,427,2648,53078
07-04-2016,13,17305,19802,8089,4732,49926,1337,876,428,2641,52567
07-04-2016,14,17010,19798,8066,4645,49518,1348,869,330,2547,52065
07-04-2016,15,16491,19676,7675,4772,48613,1306,812,157,2275,50888
07-04-2016,16,16943,19487,7834,4701,48964,1364,734,115,2213,51177
07-04-2016,17,17536,19670,7660,4398,49263,1372,732,245,2349,51612
07-04-2016,18,17823,19992,7591,4309,49715,1360,734,274,2368,52083
07-04-2016,19,17912,19950,7758,3981,49601,1340,867,298,2505,52106
07-04-2016,20,18573,19823,7350,3897,49641,1154,821,288,2263,51904
07-04-2016,21,18200,19705,7097,3573,48574,1023,801,105,1929,50503
07-04-2016,22,16926,19006,6864,3619,46417,877,660,74,1611,48028
07-04-2016,23,15412,18271,6763,3142,43589,843,463,93,1399,44988
08-04-2016,0,13401,17095,6737,2966,40200,774,466,144,1384,41584
08-04-2016,1,12868,16792,6863,2832,39355,795,462,154,1411,40766
08-04-2016,2,12912,16582,6985,2912,39391,793,467,118,1378,40769
08-04-2016,3,13081,16528,7077,2832,39519,793,470,100,1363,40882
08-04-2016,4,13857,16716,7267,2858,40699,861,561,95,1517,42216
08-04-2016,5,15249,17623,7661,3003,43536,1141,615,161,1917,45453
08-04-2016,6,17544,18979,8101,3106,47731,1381,921,175,2477,50208
08-04-2016,7,19764,20746,8333,3542,52384,1413,1253,280,2946,55330
08-04-2016,8,21248,21189,8334,4022,54793,1402,1227,279,2908,57701
08-04-2016,9,21052,20985,8265,4387,54688,1397,1123,286,2806,57494
08-04-2016,10,20791,20413,8293,4662,54159,1387,1073,278,2738,56897
08-04-2016,11,20338,20158,8230,4634,53359,1403,995,264,2662,56021
08-04-2016,12,19819,19965,8053,4180,52019,1425,1000,282,2707,54726
08-04-2016,13,19060,19900,7997,4200,51156,1409,953,291,2653,53809
08-04-2016,14,18570,19508,7973,3987,50038,1412,972,159,2543,52581
08-04-2016,15,17832,19418,7743,4218,49212,1437,769,133,2339,51551
08-04-2016,16,18113,19360,7851,4198,49522,1423,721,107,2251,51773
08-04-2016,17,18770,19496,7835,3963,50064,1402,779,157,2338,52402
08-04-2016,18,19202,19638,7831,3662,50333,1381,709,278,2368,52701
08-04-2016,19,19208,19796,8012,3315,50331,1344,772,274,2390,52721
08-04-2016,20,18927,19817,7798,3015,49558,1203,783,269,2255,51813
08-04-2016,21,18670,19749,7591,2675,48686,1024,809,111,1944,50630
08-04-2016,22,17766,19287,7483,2524,47060,925,663,110,1698,48758
08-04-2016,23,16924,18379,7240,2387,44930,904,509,85,1498,46428
09-04-2016,0,16176,16999,7221,2430,42828,732,300,96,1128,43956
09-04-2016,1,15547,16648,7171,2355,41721,707,244,99,1050,42771
09-04-2016,2,15262,16484,7157,2287,41192,676,243,88,1007,42199
09-04-2016,3,15348,16386,7152,2292,41179,680,240,88,1008,42187
09-04-2016,4,15291,16408,7190,2256,41144,690,292,82,1064,42208
09-04-2016,5,15702,16553,7202,2217,41673,688,388,77,1153,42826
09-04-2016,6,16387,17203,7162,2151,42903,692,474,80,1246,44149
09-04-2016,7,17085,18362,7189,2055,44690,777,699,78,1554,46244
09-04-2016,8,18369,18953,7207,2277,46807,928,901,80,1909,48716
09-04-2016,9,19294,19180,7225,2573,48273,951,1088,68,2107,50380
09-04-2016,10,19016,18774,7294,2603,47688,931,1103,51,2085,49773
09-04-2016,11,18615,18454,7427,2457,46954,936,1050,52,2038,48992
09-04-2016,12,17936,17929,7463,2683,46011,943,995,56,1994,48005
09-04-2016,13,16407,17560,7316,2534,43818,943,955,63,1961,45779
09-04-2016,14,15305,17448,7182,2538,42473,894,953,67,1914,44387
09-04-2016,15,15547,17398,7190,2489,42625,857,951,64,1872,44497
09-04-2016,16,16076,17371,7178,2454,43080,812,850,76,1738,44818
09-04-2016,17,17371,17650,7104,2356,44481,822,740,91,1653,46134
09-04-2016,18,18643,18237,7114,2074,46069,816,643,111,1570,47639
09-04-2016,19,18642,18249,7078,2060,46029,923,645,123,1691,47720
09-04-2016,20,18589,18260,7167,2019,46034,905,849,125,1879,47913
09-04-2016,21,18273,18384,7268,2157,46081,786,674,128,1588,47669
09-04-2016,22,17394,18141,7199,2281,45015,629,668,155,1452,46467
09-04-2016,23,16481,17511,7121,2168,43282,629,244,157,1030,44312
10-04-2016,0,15137,15920,7056,2098,40211,611,234,187,1032,41243
10-04-2016,1,14218,15405,6879,1904,38408,601,223,186,1010,39418
10-04-2016,2,13425,15279,6866,1940,37508,594,225,194,1013,38521
10-04-2016,3,13100,15419,6921,2061,37501,588,225,205,1018,38519
10-04-2016,4,13060,15500,7003,2081,37643,594,227,224,1045,38688
10-04-2016,5,12810,15614,7041,2093,37557,586,199,237,1022,38579
10-04-2016,6,13157,16077,7016,2280,38532,625,227,252,1104,39636
10-04-2016,7,13419,16795,7012,2294,39522,703,231,216,1150,40672
10-04-2016,8,14791,17161,7031,2628,41613,803,266,191,1260,42873
10-04-2016,9,15612,17264,6996,2702,42576,835,279,183,1297,43873
10-04-2016,10,15579,17208,6906,2833,42527,868,227,192,1287,43814
10-04-2016,11,15131,17072,6832,2976,42012,874,277,208,1359,43371
10-04-2016,12,14188,16711,6683,2980,40562,891,264,207,1362,41924
10-04-2016,13,13767,16495,6757,2865,39883,845,239,196,1280,41163
10-04-2016,14,13471,16514,6778,2866,39629,852,229,191,1272,40901
10-04-2016,15,13530,16338,6729,2944,39542,849,238,182,1269,40811
10-04-2016,16,14358,16423,6818,2968,40567,851,363,186,1400,41967
10-04-2016,17,14993,16720,6942,2866,41522,844,362,199,1405,42927
10-04-2016,18,15683,17291,7079,2826,42880,857,358,195,1410,44290
10-04-2016,19,16752,17751,7247,2634,44384,865,524,215,1604,45988
10-04-2016,20,17607,17972,7414,2263,45255,837,797,223,1857,47112
10-04-2016,21,17489,18193,7348,2256,45287,852,543,236,1631,46918
10-04-2016,22,16068,17681,7250,2249,43248,834,377,219,1430,44678
10-04-2016,23,13921,16757,7074,2279,40031,791,381,219,1391,41422
11-04-2016,0,13113,15204,7060,2270,37649,703,211,223,1137,38786
11-04-2016,1,12404,14833,6927,2375,36539,675,207,234,1116,37655
11-04-2016,2,12268,14719,6954,2279,36220,695,252,231,1178,37398
11-04-2016,3,12715,14796,6784,2265,36560,731,321,239,1291,37851
11-04-2016,4,13618,15205,6610,2311,37746,836,379,241,1456,39202
11-04-2016,5,15312,16050,7106,2394,40863,1161,424,272,1857,42720
11-04-2016,6,18966,18524,7527,3136,48153,1353,623,255,2231,50384
11-04-2016,7,21732,19760,7735,3334,52562,1450,1000,304,2754,55316
11-04-2016,8,21932,20037,7722,3844,53536,1476,1415,351,3242,56778
11-04-2016,9,21537,19819,7625,3636,52616,1466,1354,363,3183,55799
11-04-2016,10,20999,19425,7596,3678,51698,1470,1194,371,3035,54733
11-04-2016,11,19842,19038,7453,3740,50074,1473,1131,355,2959,53033
11-04-2016,12,19498,18633,7424,3683,49239,1479,1195,215,2889,52128
11-04-2016,13,19157,18512,7431,3871,48971,1485,1046,216,2747,51718
11-04-2016,14,18260,18357,7276,4004,47899,1408,1018,192,2618,50517
11-04-2016,15,17402,18145,6937,3880,46363,1439,700,144,2283,48646
11-04-2016,16,17966,18401,7147,3505,47018,1455,624,143,2222,49240
11-04-2016,17,18238,18555,7197,3321,47310,1468,707,148,2323,49633
11-04-2016,18,18275,18478,7310,3284,47346,1451,796,139,2386,49732
11-04-2016,19,18411,18495,7371,3141,47419,1464,698,301,2463,49882
11-04-2016,20,18734,18565,7054,3081,47435,1337,752,166,2255,49690
11-04-2016,21,18608,18704,6691,3004,47007,1139,647,203,1989,48996
11-04-2016,22,17314,18260,6584,2905,45062,1104,403,181,1688,46750
11-04-2016,23,16073,17239,6619,2716,42647,980,401,177,1558,44205
12-04-2016,0,14400,16178,6568,2862,40010,803,619,196,1618,41628
12-04-2016,1,13878,15737,6605,2740,38959,794,632,188,1614,40573
12-04-2016,2,13979,15707,6502,2676,38863,766,632,166,1564,40427
12-04-2016,3,14247,15863,6574,2726,39410,769,629,160,1558,40968
12-04-2016,4,14511,16308,6765,2991,40576,764,627,163,1554,42130
12-04-2016,5,16228,17160,6922,3136,43447,1002,713,153,1868,45315
12-04-2016,6,18503,19036,7296,3272,48107,1304,801,139,2244,50351
12-04-2016,7,20732,20375,7633,3549,52288,1367,1069,148,2584,54872
12-04-2016,8,21064,20755,7626,3916,53362,1379,1157,334,2870,56232
12-04-2016,9,20787,20469,7467,3748,52471,1307,1260,302,2869,55340
12-04-2016,10,20076,20018,7332,3660,51085,1348,1252,305,2905,53990
12-04-2016,11,19477,19550,7341,3589,49958,1348,1149,279,2776,52734
12-04-2016,12,18963,19313,7331,3543,49149,1343,1163,289,2795,51944
12-04-2016,13,19173,19015,7307,3481,48976,1338,1125,127,2590,51566
12-04-2016,14,18945,19123,7387,3394,48849,1336,1068,111,2515,51364
12-04-2016,15,18560,19006,6935,3204,47705,1149,929,106,2184,49889
12-04-2016,16,18501,19102,7191,3032,47827,1124,925,108,2157,49984
12-04-2016,17,18813,19032,7356,2883,48086,1181,920,120,2221,50307
12-04-2016,18,18582,19153,7409,2880,48024,1239,879,135,2253,50277
12-04-2016,19,18756,18876,7373,2851,47856,1280,958,142,2380,50236
12-04-2016,20,19268,18967,6936,2721,47892,1223,805,134,2162,50054
12-04-2016,21,19202,18958,6693,2609,47462,1012,751,129,1892,49354
12-04-2016,22,17870,18552,6632,2430,45484,843,632,98,1573,47057
12-04-2016,23,16780,17578,6593,2249,43201,782,612,115,1509,44710
13-04-2016,0,15898,16135,6397,1959,40389,766,219,105,1090,41479
13-04-2016,1,15004,15626,6365,1989,38985,772,216,113,1101,40086
13-04-2016,2,14687,15555,6320,2015,38578,781,214,114,1109,39687
13-04-2016,3,14829,15487,6354,2144,38814,767,216,107,1090,39904
13-04-2016,4,15502,15745,6460,2065,39773,806,273,100,1179,40952
13-04-2016,5,16908,16493,6957,2262,42621,1043,473,103,1619,44240
13-04-2016,6,19160,18668,7352,2347,47526,1465,829,106,2400,49926
13-04-2016,7,21313,20155,7512,2969,51949,1481,1197,235,2913,54862
13-04-2016,8,21604,20567,7668,3107,52947,1485,1262,319,3066,56013
13-04-2016,9,21412,20618,7580,2951,52562,1489,1209,304,3002,55564
13-04-2016,10,21114,20343,7455,3022,51933,1496,1207,290,2993,54926
13-04-2016,11,20887,19825,7387,2839,50936,1502,1145,258,2905,53841
13-04-2016,12,20761,19571,7374,2675,50381,1496,1140,171,2807,53188
13-04-2016,13,20660,19706,7307,2621,50295,1496,1128,107,2731,53026
13-04-2016,14,20281,19700,7148,2648,49778,1495,1046,100,2641,52419
13-04-2016,15,19981,19341,6866,2241,48428,1434,830,84,2348,50776
13-04-2016,16,20005,19178,7063,2141,48387,1425,812,77,2314,50701
13-04-2016,17,20299,19221,7251,2216,48988,1499,818,72,2389,51377
13-04-2016,18,20204,19103,7383,2276,48966,1503,807,69,2379,51345
13-04-2016,19,20215,19095,7436,2173,48918,1502,867,80,2449,51367
13-04-2016,20,20338,19097,7102,2287,48824,1264,868,80,2212,51036
13-04-2016,21,20147,18881,6741,2249,48019,1061,751,99,1911,49930
13-04-2016,22,19218,18068,6630,2214,46128,1073,514,120,1707,47835
13-04-2016,23,17928,17129,6573,2091,43721,873,457,121,1451,45172
14-04-2016,0,16317,16022,6676,1824,40838,823,235,130,1188,42026
14-04-2016,1,15586,15745,6690,1709,39731,828,214,142,1184,40915
14-04-2016,2,15079,15710,6673,1687,39149,890,213,164,1267,40416
14-04-2016,3,14622,15745,6639,1680,38685,887,210,169,1266,39951
14-04-2016,4,14829,15764,6773,1678,39043,899,277,170,1346,40389
14-04-2016,5,16646,16368,7028,1729,41772,1021,469,158,1648,43420
14-04-2016,6,19717,18815,7571,2142,48246,1289,815,174,2278,50524
14-04-2016,7,21660,21031,7809,3100,53601,1323,1250,181,2754,56355
14-04-2016,8,21576,21212,7758,3700,54245,1315,1328,394,3037,57282
14-04-2016,9,20620,20378,7767,3255,52020,1422,1319,722,3463,55483
14-04-2016,10,20445,20093,7736,3081,51356,1303,1318,779,3400,54756
14-04-2016,11,20508,20045,7770,3216,51538,1299,1277,643,3219,54757
14-04-2016,12,20551,19883,7715,2869,51019,1304,1301,561,3166,54185
14-04-2016,13,20588,19789,7553,2721,50650,1302,1274,704,3280,53930
14-04-2016,14,20016,19891,7497,2351,49755,1293,1205,548,3046,52801
14-04-2016,15,19291,19863,7134,2156,48444,1249,1033,454,2736,51180
14-04-2016,16,19437,19779,7444,2059,48721,1230,967,424,2621,51342
14-04-2016,17,19994,20026,7494,2096,49608,1261,932,559,2752,52360
14-04-2016,18,19917,20226,7508,2089,49741,1255,933,553,2741,52482
14-04-2016,19,19856,20127,7539,2055,49577,1257,935,571,2763,52340
14-04-2016,20,20201,19930,7252,2060,49445,1256,840,447,2543,51988
14-04-2016,21,20018,19431,7027,2020,48498,1246,741,317,2304,50802
14-04-2016,22,18845,18535,6999,2033,46413,1239,555,208,2002,48415
14-04-2016,23,17058,18027,6969,1957,44011,1195,466,192,1853,45864
15-04-2016,0,15484,16698,6985,1799,40964,1015,449,158,1622,42586
15-04-2016,1,14156,16310,6900,1930,39297,927,445,137,1509,40806
15-04-2016,2,13429,16230,6983,2033,38676,932,439,133,1504,40180
15-04-2016,3,12952,16269,7004,2101,38327,980,445,121,1546,39873
15-04-2016,4,13122,16196,7224,2133,38676,1106,447,107,1660,40336
15-04-2016,5,15424,16606,7737,2121,41889,1335,532,90,1957,43846
15-04-2016,6,18330,18652,8016,2566,47564,1385,1145,304,2834,50398
15-04-2016,7,20588,20865,7992,2913,52360,1389,1417,475,3281,55641
15-04-2016,8,21142,21207,7988,3149,53486,1392,1586,479,3457,56943
15-04-2016,9,20954,21058,7928,3239,53178,1396,1486,478,3360,56538
15-04-2016,10,20700,20968,7885,3257,52811,1400,1406,465,3271,56082
15-04-2016,11,20317,20899,7877,3072,52165,1386,1339,301,3026,55191
15-04-2016,12,19604,20815,7833,2900,51154,1376,1233,302,2911,54065
15-04-2016,13,19351,20453,7825,2762,50391,1412,1173,277,2862,53253
15-04-2016,14,18299,20287,7806,2487,48879,1423,1158,282,2863,51742
15-04-2016,15,16667,19346,7443,2157,45612,1428,1057,280,2765,48377
15-04-2016,16,16735,19553,7601,2164,46053,1415,1003,307,2725,48778
15-04-2016,17,17415,19814,7647,2177,47053,1404,954,304,2662,49715
15-04-2016,18,18300,20339,7688,2295,48622,1394,964,439,2797,51419
15-04-2016,19,18344,20493,7714,2250,48801,1389,973,499,2861,51662
15-04-2016,20,18131,20461,7668,2134,48394,1033,876,555,2464,50858
15-04-2016,21,17906,20050,7472,2016,47445,813,781,237,1831,49276
15-04-2016,22,17289,19197,7400,1855,45740,690,485,277,1452,47192
15-04-2016,23,16062,18031,7065,1786,42943,635,386,316,1337,44280
16-04-2016,0,14309,16673,6789,1491,39262,591,381,290,1262,40524
16-04-2016,1,12829,15979,6425,1423,36656,597,418,255,1270,37926
16-04-2016,2,12202,15655,6426,1356,35638,605,433,236,1274,36912
16-04-2016,3,11625,15480,6496,1342,34943,625,434,232,1291,36234
16-04-2016,4,11597,15418,6646,1345,35007,624,433,233,1290,36297
16-04-2016,5,11655,15573,6757,1373,35358,628,437,244,1309,36667
16-04-2016,6,12521,16150,6749,1448,36867,619,531,202,1352,38219
16-04-2016,7,13446,16515,6809,1566,38337,657,706,160,1523,39860
16-04-2016,8,14687,17797,7152,1956,41594,743,735,184,1662,43256
16-04-2016,9,15234,18572,7327,2303,43435,788,901,148,1837,45272
16-04-2016,10,14790,18287,7256,2371,42704,796,920,245,1961,44665
16-04-2016,11,14600,18167,7104,2507,42379,777,920,135,1832,44211
16-04-2016,12,14007,18049,7002,2542,41600,712,918,122,1752,43352
16-04-2016,13,13584,17570,6987,2926,41068,711,914,98,1723,42791
16-04-2016,14,13186,17054,6831,3229,40300,678,838,95,1611,41911
16-04-2016,15,13082,16816,6895,3191,39983,679,825,96,1600,41583
16-04-2016,16,13337,16970,6834,3356,40495,687,773,85,1545,42040
16-04-2016,17,13583,17060,7054,3645,41343,702,755,78,1535,42878
16-04-2016,18,13823,17436,7083,3814,42156,689,751,114,1554,43710
16-04-2016,19,14689,18262,7207,3807,43965,693,813,169,1675,45640
16-04-2016,20,15060,18515,7321,4113,45007,741,844,239,1824,46831
16-04-2016,21,14796,18142,7359,4347,44644,676,769,257,1702,46346
16-04-2016,22,14196,17610,7328,4393,43526,632,697,198,1527,45053
16-04-2016,23,12944,16898,7271,4271,41385,622,512,132,1266,42651
17-04-2016,0,10916,15659,7208,4232,38014,605,589,105,1299,39313
17-04-2016,1,9825,15147,7158,4299,36430,608,588,74,1270,37700
17-04-2016,2,8956,14581,7034,4305,34875,623,577,80,1280,36155
17-04-2016,3,8705,14453,6984,4282,34425,607,578,88,1273,35698
17-04-2016,4,8843,14504,7024,4436,34809,611,582,92,1285,36094
17-04-2016,5,8875,14669,7002,4418,34964,608,580,95,1283,36247
17-04-2016,6,8961,15037,6971,4391,35360,591,654,78,1323,36683
17-04-2016,7,9465,15131,7062,4388,36048,592,751,53,1396,37444
17-04-2016,8,10857,15905,7217,4567,38546,637,812,63,1512,40058
17-04-2016,9,11735,16849,7275,4823,40683,657,886,105,1648,42331
17-04-2016,10,11878,17304,7300,5088,41570,661,880,152,1693,43263
17-04-2016,11,11987,17567,7371,5243,42169,639,885,165,1689,43858
17-04-2016,12,11952,17714,7384,5168,42216,607,969,146,1722,43938
17-04-2016,13,11899,18070,7291,4977,42238,586,964,135,1685,43923
17-04-2016,14,11460,17827,7277,5017,41579,571,958,127,1656,43235
17-04-2016,15,11105,17385,7392,5060,40939,589,949,91,1629,42568
17-04-2016,16,11105,17204,7301,5032,40640,615,958,116,1689,42329
17-04-2016,17,11652,17718,7420,5050,41840,595,1024,165,1784,43624
17-04-2016,18,11930,18568,7551,5241,43290,618,994,222,1834,45124
17-04-2016,19,13420,19017,7621,4794,44851,649,977,225,1851,46702
17-04-2016,20,14010,19114,7589,4755,45470,734,903,269,1906,47376
17-04-2016,21,14307,19040,7664,4391,45403,694,786,265,1745,47148
17-04-2016,22,13519,18856,7489,4151,44015,670,789,310,1769,45784
17-04-2016,23,12468,18379,7172,3968,41988,640,794,322,1756,43744
18-04-2016,0,11989,16662,6844,3641,39139,691,618,341,1650,40789
18-04-2016,1,11563,16234,6710,3498,38006,722,619,350,1691,39697
18-04-2016,2,10681,16059,6718,3532,36991,772,642,359,1773,38764
18-04-2016,3,10381,16020,6822,3651,36874,816,637,355,1808,38682
18-04-2016,4,10702,16174,7209,3684,37770,909,630,317,1856,39626
18-04-2016,5,12156,16998,7739,3745,40639,1150,705,278,2133,42772
18-04-2016,6,14177,18947,8172,3964,45259,1357,1063,275,2695,47954
18-04-2016,7,16384,20714,8115,4248,49461,1376,1678,478,3532,52993
18-04-2016,8,17176,21001,7982,4479,50637,1402,1711,502,3615,54252
18-04-2016,9,17102,20371,7954,4877,50304,1252,1590,492,3334,53638
18-04-2016,10,16874,20624,7985,4977,50461,1147,1554,513,3214,53675
18-04-2016,11,16128,20690,7910,5123,49852,1179,1559,499,3237,53089
18-04-2016,12,15202,20713,7757,5422,49094,1264,1700,448,3412,52506
18-04-2016,13,14758,21030,7710,5452,48951,1230,1715,435,3380,52331
18-04-2016,14,14442,21074,7881,5332,48730,1214,1640,396,3250,51980
18-04-2016,15,13691,21176,7841,5275,47983,1408,1134,396,2938,50921
18-04-2016,16,13318,21232,7972,5647,48169,1300,1228,393,2921,51090
18-04-2016,17,13896,21322,8033,5564,48814,1265,1153,361,2779,51593
18-04-2016,18,13812,21054,8011,5341,48219,1307,1138,321,2766,50985
18-04-2016,19,13829,21023,8095,4919,47867,1250,1158,237,2645,50512
18-04-2016,20,13795,20949,8118,4710,47573,1056,1134,250,2440,50013
18-04-2016,21,13773,20599,7947,4528,46847,968,997,263,2228,49075
18-04-2016,22,13078,19991,7645,4321,45036,930,754,258,1942,46978
18-04-2016,23,11907,19040,7209,4605,42760,818,739,260,1817,44577
19-04-2016,0,11200,17925,7095,4569,40788,767,435,301,1503,42291
19-04-2016,1,10649,17478,6888,4644,39660,750,431,335,1516,41176
19-04-2016,2,10715,17158,6776,4717,39367,756,427,323,1506,40873
19-04-2016,3,10607,17272,6843,4818,39539,763,428,325,1516,41055
19-04-2016,4,10597,17658,7084,4898,40237,763,434,311,1508,41745
19-04-2016,5,11641,18318,7628,4984,42571,988,687,312,1987,44558
19-04-2016,6,13477,19756,8053,5012,46298,1295,939,284,2518,48816
19-04-2016,7,15843,21317,8306,5094,50560,1299,1287,518,3104,53664
19-04-2016,8,16393,21209,8379,5684,51664,1297,1284,549,3130,54794
19-04-2016,9,15836,20760,8321,5951,50869,1309,1297,554,3160,54029
19-04-2016,10,14720,20636,8382,5933,49671,1304,1295,556,3155,52826
19-04-2016,11,13585,20276,8367,5828,48056,1306,1292,565,3163,51219
19-04-2016,12,13148,19763,8293,5710,46914,1318,1292,561,3171,50085
19-04-2016,13,13110,19768,8288,5837,47002,1300,1293,524,3117,50119
19-04-2016,14,13002,19726,8039,5688,46456,1283,1286,342,2911,49367
19-04-2016,15,12502,19708,7738,5659,45608,1241,1059,310,2610,48218
19-04-2016,16,12340,19688,7899,5595,45522,1221,1026,348,2595,48117
19-04-2016,17,12530,19668,8033,5706,45938,1238,920,401,2559,48497
19-04-2016,18,13037,20343,8115,5156,46651,1229,905,382,2516,49167
19-04-2016,19,13724,20430,8347,4818,47318,1170,860,393,2423,49741
19-04-2016,20,14275,20197,8272,4627,47371,773,757,319,1849,49220
19-04-2016,21,14600,20262,8000,4499,47361,724,685,274,1683,49044
19-04-2016,22,13664,20052,7677,4341,45735,637,668,232,1537,47272
19-04-2016,23,12089,19299,7458,4360,43206,653,663,206,1522,44728
20-04-2016,0,10582,17716,7443,4113,39854,661,421,192,1274,41128
20-04-2016,1,10248,17212,7510,4433,39403,692,416,205,1313,40716
20-04-2016,2,9919,17003,7465,4357,38743,702,406,217,1325,40068
20-04-2016,3,9704,17004,7420,4188,38318,674,408,200,1282,39600
20-04-2016,4,10243,17240,7580,4029,39093,669,413,193,1275,40368
20-04-2016,5,12306,17771,7968,3711,41756,780,662,261,1703,43459
20-04-2016,6,15002,20097,8494,3791,47384,1038,781,272,2091,49475
20-04-2016,7,17253,21747,8804,4017,51822,1101,1046,466,2613,54435
20-04-2016,8,17776,21590,8988,4506,52858,1153,1128,716,2997,55855
20-04-2016,9,17139,20470,9051,4575,51235,1244,1259,941,3444,54679
20-04-2016,10,16786,20315,8913,4077,50092,1150,1253,853,3256,53348
20-04-2016,11,15897,20110,8786,3959,48753,1157,1234,786,3177,51930
20-04-2016,12,14828,19323,8805,3894,46852,1163,1235,805,3203,50055
20-04-2016,13,14402,18913,8633,3608,45556,1157,1242,682,3081,48637
20-04-2016,14,14131,19045,8526,3492,45195,1162,1256,723,3141,48336
20-04-2016,15,14725,19119,8427,3458,45728,1069,860,450,2379,48107
20-04-2016,16,14790,19420,8491,3518,46218,1156,853,374,2383,48601
20-04-2016,17,15818,19967,8688,3592,48064,1139,791,359,2289,50353
20-04-2016,18,16147,20063,8717,3429,48358,1155,763,369,2287,50645
20-04-2016,19,16296,19906,8693,3374,48267,1165,820,285,2270,50537
20-04-2016,20,16865,20049,8387,3204,48506,897,892,236,2025,50531
20-04-2016,21,17227,20012,8063,3211,48513,780,691,255,1726,50239
20-04-2016,22,16166,19332,7949,3342,46790,771,539,238,1548,48338
20-04-2016,23,14874,18164,7751,2933,43723,759,467,240,1466,45189
21-04-2016,0,14199,16096,7841,2760,40896,722,403,253,1378,42274
21-04-2016,1,13120,15840,7790,2713,39464,699,397,245,1341,40805
21-04-2016,2,12100,15850,7685,2575,38210,715,397,243,1355,39565
21-04-2016,3,11346,15790,7603,2703,37443,734,414,243,1391,38834
21-04-2016,4,11855,15908,7751,2655,38168,774,561,203,1538,39706
21-04-2016,5,13827,16654,8160,2825,41466,941,934,179,2054,43520
21-04-2016,6,15972,19562,8463,3131,47129,1309,1169,144,2622,49751
21-04-2016,7,17923,21280,8625,3476,51305,1320,1695,141,3156,54461
21-04-2016,8,18090,21491,8548,3902,52031,1355,1893,201,3449,55480
21-04-2016,9,17312,21195,8507,4174,51187,1343,1835,134,3312,54499
21-04-2016,10,16772,20803,8466,4173,50216,1346,1772,253,3371,53587
21-04-2016,11,16197,20186,8367,4199,48951,1470,1707,617,3794,52745
21-04-2016,12,15859,20028,8221,4297,48405,1441,1604,638,3683,52088
21-04-2016,13,15610,19863,8219,4320,48011,1456,1491,655,3602,51613
21-04-2016,14,15275,19721,8055,4262,47313,1303,1287,669,3259,50572
21-04-2016,15,14950,19740,7894,4376,46960,1196,1253,345,2794,49754
21-04-2016,16,14463,19848,8014,4625,46952,1259,1291,396,2946,49898
21-04-2016,17,14604,19853,8057,4726,47240,1267,1284,583,3134,50374
21-04-2016,18,14399,20092,8030,4668,47189,1327,1241,608,3176,50365
21-04-2016,19,14337,20115,8122,4696,47271,1189,1303,589,3081,50352
21-04-2016,20,14613,19893,8101,4515,47121,1138,1194,219,2551,49672
21-04-2016,21,14824,19875,8076,4577,47353,914,870,239,2023,49376
21-04-2016,22,13800,19328,7999,4859,45985,754,583,291,1628,47613
21-04-2016,23,12433,18538,7687,4696,43355,601,472,315,1388,44743
22-04-2016,0,11421,17376,7604,4526,40927,590,346,289,1225,42152
22-04-2016,1,10946,17035,7567,4233,39783,658,346,267,1271,41054
22-04-2016,2,10685,17033,7537,4128,39384,664,349,252,1265,40649
22-04-2016,3,10648,16955,7534,4109,39245,676,351,256,1283,40528
22-04-2016,4,11292,16985,7609,4074,39960,633,741,231,1605,41565
22-04-2016,5,12952,17427,7976,3592,41947,778,760,276,1814,43761
22-04-2016,6,14727,19425,8381,3179,45713,1021,1182,326,2529,48242
22-04-2016,7,16950,20971,8626,3054,49599,1154,1286,416,2856,52455
22-04-2016,8,17632,20965,8625,3040,50262,1160,1449,492,3101,53363
22-04-2016,9,17722,20652,8560,3028,49961,1161,1509,507,3177,53138
22-04-2016,10,17648,20783,8515,2954,49902,1171,1484,498,3153,53055
22-04-2016,11,17086,20706,8574,2991,49357,1175,1470,476,3121,52478
22-04-2016,12,16604,20385,8464,3161,48614,1188,1459,487,3134,51748
22-04-2016,13,15785,19959,8508,3514,47767,1199,1460,381,3040,50807
22-04-2016,14,15200,19494,8486,3728,46908,1113,1424,354,2891,49799
22-04-2016,15,14409,19362,8087,3860,45718,1043,1020,383,2446,48164
22-04-2016,16,14505,19193,8333,3838,45868,1090,1027,391,2508,48376
22-04-2016,17,14744,19348,8336,3739,46167,1070,1133,360,2563,48730
22-04-2016,18,15076,19526,8355,3522,46480,1065,1143,287,2495,48975
22-04-2016,19,15146,19240,8416,3323,46125,1057,1246,273,2576,48701
22-04-2016,20,15424,19281,8327,3005,46037,923,885,185,1993,48030
22-04-2016,21,15724,19637,8211,2958,46531,731,582,187,1500,48031
22-04-2016,22,15021,19199,8184,3146,45550,652,377,178,1207,46757
22-04-2016,23,14555,18437,7966,2806,43763,580,371,103,1054,44817
23-04-2016,0,14208,16500,7734,2851,41293,536,489,108,1133,42426
23-04-2016,1,13932,15986,7710,2591,40220,523,457,104,1084,41304
23-04-2016,2,13372,16142,7607,2468,39591,523,461,113,1097,40688
23-04-2016,3,13172,16070,7565,2301,39108,512,461,119,1092,40200
23-04-2016,4,13237,15918,7574,2330,39060,513,460,119,1092,40152
23-04-2016,5,13143,15900,7563,2202,38807,510,701,130,1341,40148
23-04-2016,6,13698,16262,7584,2288,39834,505,743,141,1389,41223
23-04-2016,7,14637,17445,7719,2376,42178,610,857,111,1578,43756
23-04-2016,8,15808,18510,7825,2773,44917,622,993,100,1715,46632
23-04-2016,9,16061,19017,7908,3008,45994,630,1009,55,1694,47688
23-04-2016,10,16228,18923,7887,3115,46152,633,1008,254,1895,48047
23-04-2016,11,16046,18613,7838,3056,45553,631,1005,268,1904,47457
23-04-2016,12,15527,18265,7786,3172,44750,628,1005,185,1818,46568
23-04-2016,13,14353,17792,7681,3190,43017,626,1004,149,1779,44796
23-04-2016,14,13258,17151,7714,3212,41336,627,1006,136,1769,43105
23-04-2016,15,12744,16924,7786,3084,40538,595,1006,125,1726,42264
23-04-2016,16,13048,16808,7875,2842,40576,588,1001,112,1701,42277
23-04-2016,17,13392,17186,7950,2795,41325,580,1082,105,1767,43092
23-04-2016,18,14077,17670,8011,2656,42414,608,998,101,1707,44121
23-04-2016,19,15165,18028,8090,2659,43944,616,951,103,1670,45614
23-04-2016,20,15845,18500,8113,2412,44872,621,955,116,1692,46564
23-04-2016,21,16286,18829,8152,2509,45775,626,939,82,1647,47422
23-04-2016,22,15818,18692,8208,2664,45383,625,804,97,1526,46909
23-04-2016,23,14969,17776,7839,2365,42949,616,707,90,1413,44362
24-04-2016,0,13244,15644,7524,2037,38450,588,398,78,1064,39514
24-04-2016,1,12326,14964,7462,1870,36621,579,375,76,1030,37651
24-04-2016,2,12179,14998,7460,1893,36530,577,377,122,1076,37606
24-04-2016,3,12227,14955,7475,1842,36499,577,379,128,1084,37583
24-04-2016,4,12325,14983,7513,1753,36575,583,388,140,1111,37686
24-04-2016,5,12369,15057,7465,1654,36546,585,550,91,1226,37772
24-04-2016,6,12446,15219,7444,1685,36793,608,702,77,1387,38180
24-04-2016,7,13120,15539,7432,1780,37872,576,777,92,1445,39317
24-04-2016,8,13989,15920,7538,1822,39268,617,896,135,1648,40916
24-04-2016,9,14429,16605,7651,2135,40820,630,906,136,1672,42492
24-04-2016,10,14312,17104,7694,2568,41679,643,945,153,1741,43420
24-04-2016,11,13987,17211,7633,2613,41444,644,949,201,1794,43238
24-04-2016,12,13793,17041,7522,2520,40879,691,916,213,1820,42699
24-04-2016,13,13534,17014,7450,2602,40601,746,855,216,1817,42418
24-04-2016,14,13536,16782,7478,2585,40380,750,837,268,1855,42235
24-04-2016,15,13216,16723,7477,2597,40014,776,861,245,1882,41896
24-04-2016,16,13467,16795,7447,2714,40422,830,793,239,1862,42284
24-04-2016,17,13657,17231,7573,2786,41248,830,785,205,1820,43068
24-04-2016,18,13988,17637,7689,2785,42097,812,784,160,1756,43853
24-04-2016,19,15033,18260,7792,2970,44056,782,858,133,1773,45829
24-04-2016,20,16350,19144,7811,2795,46101,760,946,138,1844,47945
24-04-2016,21,16710,19655,7977,2667,47010,816,810,138,1764,48774
24-04-2016,22,16178,19247,7946,2583,45954,809,725,108,1642,47596
24-04-2016,23,15414,18480,7716,2541,44151,866,560,67,1493,45644
25-04-2016,0,14645,16118,7660,2368,40791,860,310,95,1265,42056
25-04-2016,1,13987,15176,7706,2071,38941,881,309,57,1247,40188
25-04-2016,2,13441,14802,7748,1910,37899,937,310,51,1298,39197
25-04-2016,3,13106,14955,7773,1862,37696,956,338,50,1344,39040
25-04-2016,4,13609,15048,8056,1984,38697,1005,493,84,1582,40279
25-04-2016,5,15491,16152,8435,2049,42127,1188,583,47,1818,43945
25-04-2016,6,18283,19216,8825,2751,49077,1364,1003,127,2494,51571
25-04-2016,7,20587,20929,9070,3061,53646,1371,1270,311,2952,56598
25-04-2016,8,20763,21474,9098,3454,54788,1422,1424,362,3208,57996
25-04-2016,9,20125,20910,9179,3250,53465,1378,1392,361,3131,56596
25-04-2016,10,19773,20858,9158,3405,53196,1390,1455,329,3174,56370
25-04-2016,11,19589,20720,9038,3435,52783,1420,1327,328,3075,55858
25-04-2016,12,19153,20225,9075,3300,51753,1407,1297,341,3045,54798
25-04-2016,13,18991,19966,9022,3334,51314,1383,1178,372,2933,54247
25-04-2016,14,18099,19746,8922,3416,50184,1314,1210,451,2975,53159
25-04-2016,15,17163,19155,8706,3485,48510,1205,1141,396,2742,51252
25-04-2016,16,17174,19143,8729,3404,48451,1276,1110,302,2688,51139
25-04-2016,17,18538,19214,8743,3254,49748,1277,1070,289,2636,52384
25-04-2016,18,18228,19436,8658,2931,49253,1360,1074,278,2712,51965
25-04-2016,19,18411,19264,8537,2850,49063,1418,1081,438,2937,52000
25-04-2016,20,18354,19121,8280,2856,48610,1182,1099,491,2772,51382
25-04-2016,21,18576,18915,8165,3242,48898,899,831,304,2034,50932
25-04-2016,22,17585,18827,7974,3020,47406,881,823,49,1753,49159
25-04-2016,23,16161,17681,7787,3156,44785,899,575,57,1531,46316
26-04-2016,0,14476,16408,7730,2735,41350,916,397,63,1376,42726
26-04-2016,1,13456,15885,7590,2888,39819,897,373,68,1338,41157
26-04-2016,2,13402,15901,7490,3061,39855,898,382,68,1348,41203
26-04-2016,3,12578,15933,7441,3423,39376,904,408,66,1378,40754
26-04-2016,4,13313,15918,7705,3520,40457,941,522,69,1532,41989
26-04-2016,5,14824,16532,8152,3941,43450,1277,791,72,2140,45590
26-04-2016,6,17247,18398,8472,4085,48202,1507,1018,114,2639,50841
26-04-2016,7,18537,20037,8476,4780,51829,1428,1538,200,3166,54995
26-04-2016,8,18534,20242,8592,5018,52386,1515,1599,297,3411,55797
26-04-2016,9,18383,19782,8539,5092,51795,1569,1650,300,3519,55314
26-04-2016,10,18278,19452,8460,5122,51311,1601,1653,302,3556,54867
26-04-2016,11,18073,19363,8473,5017,50926,1600,1631,305,3536,54462
26-04-2016,12,18046,19021,8610,4835,50511,1600,1578,296,3474,53985
26-04-2016,13,17858,19182,8695,4520,50255,1605,1384,302,3291,53546
26-04-2016,14,17393,19456,8772,4520,50141,1588,1241,281,3110,53251
26-04-2016,15,17396,19196,8563,4266,49422,1451,1184,117,2752,52174
26-04-2016,16,16967,19313,8566,4321,49168,1562,1241,107,2910,52078
26-04-2016,17,17321,19429,8609,4182,49541,1568,1169,108,2845,52386
26-04-2016,18,17173,19201,8612,3972,48957,1551,1108,108,2767,51724
26-04-2016,19,17319,19140,8701,3922,49080,1556,1034,253,2843,51923
26-04-2016,20,17577,19104,8507,3896,49084,1165,1126,285,2576,51660
26-04-2016,21,17802,19109,8287,3829,49028,1025,859,100,1984,51012
26-04-2016,22,16948,18456,7964,3859,47227,970,605,100,1675,48902
26-04-2016,23,15545,17717,7885,3449,44597,989,532,121,1642,46239
27-04-2016,0,13678,16667,7836,3088,41267,974,376,163,1513,42780
27-04-2016,1,13185,16374,7751,2789,40099,963,377,230,1570,41669
27-04-2016,2,13072,16412,7696,2758,39938,957,378,260,1595,41533
27-04-2016,3,12619,16478,7679,2839,39616,973,387,222,1582,41198
27-04-2016,4,12951,16586,7705,3010,40251,940,565,196,1701,41952
27-04-2016,5,14242,17134,7989,3553,42918,1044,874,139,2057,44975
27-04-2016,6,16332,18809,8549,3955,47646,1203,1176,165,2544,50190
27-04-2016,7,18385,20448,8724,4564,52120,1346,1284,389,3019,55139
27-04-2016,8,18584,20745,8741,5122,53191,1396,1345,507,3248,56439
27-04-2016,9,18132,20230,8747,5242,52351,1397,1326,399,3122,55473
27-04-2016,10,18008,19670,8795,5178,51651,1389,1346,319,3054,54705
27-04-2016,11,18048,19541,8743,5081,51413,1385,1248,326,2959,54372
27-04-2016,12,17597,19572,8682,5066,50917,1368,1279,323,2970,53887
27-04-2016,13,17029,19405,8514,4838,49785,1385,1271,314,2970,52755
27-04-2016,14,15906,18913,8357,4427,47603,1372,1264,343,2979,50582
27-04-2016,15,16015,18250,8185,4256,46705,1161,1197,348,2706,49411
27-04-2016,16,16757,18559,8125,4081,47523,1255,1180,342,2777,50300
27-04-2016,17,17192,19326,8340,3973,48831,1058,1010,342,2410,51241
27-04-2016,18,17678,19274,8386,3713,49053,1097,999,358,2454,51507
27-04-2016,19,18060,19470,7756,3460,48746,1092,935,392,2419,51165
27-04-2016,20,17399,19764,7796,3141,48099,978,929,397,2304,50403
27-04-2016,21,17810,19344,7802,3061,48017,1020,822,305,2147,50164
27-04-2016,22,17287,18606,7647,2852,46392,1092,731,62,1885,48277
27-04-2016,23,15978,17858,7610,2639,44085,1048,633,58,1739,45824
28-04-2016,0,14639,16838,7447,2497,41423,945,580,62,1587,43010
28-04-2016,1,14730,16404,7312,2481,40928,932,570,59,1561,42489
28-04-2016,2,14798,16200,7320,2488,40805,916,571,57,1544,42349
28-04-2016,3,14714,16022,7410,2577,40725,917,586,65,1568,42293
28-04-2016,4,14800,15967,7543,2687,40998,903,770,81,1754,42752
28-04-2016,5,16305,17042,7792,2651,43790,896,810,105,1811,45601
28-04-2016,6,17726,19726,8023,2922,48398,943,1020,298,2261,50659
28-04-2016,7,19487,20965,8176,3714,52342,1067,1119,511,2697,55039
28-04-2016,8,19903,20830,8263,3531,52527,1120,1548,506,3174,55701
28-04-2016,9,19670,21033,8192,3867,52763,1089,1212,404,2705,55468
28-04-2016,10,19464,20988,8026,3767,52246,1184,1178,429,2791,55037
28-04-2016,11,19602,21046,7902,3739,52289,1202,1162,351,2715,55004
28-04-2016,12,18885,20840,7780,3703,51209,1211,1183,349,2743,53952
28-04-2016,13,18274,20699,7766,3635,50376,1173,1194,343,2710,53086
28-04-2016,14,18952,20820,7676,3605,51054,1111,1175,137,2423,53477
28-04-2016,15,18396,20491,7642,3470,49999,1043,1152,134,2329,52328
28-04-2016,16,18087,20627,7653,3573,49941,1024,1130,129,2283,52224
28-04-2016,17,18213,20957,7775,3497,50442,1020,1083,131,2234,52676
28-04-2016,18,17818,21548,7771,3383,50520,1014,1008,67,2089,52609
28-04-2016,19,17901,21686,7819,3235,50642,998,984,109,2091,52733
28-04-2016,20,18007,21454,7782,3021,50265,992,959,81,2032,52297
28-04-2016,21,17922,21152,7802,2763,49640,938,929,127,1994,51634
28-04-2016,22,16813,20251,7779,2564,47407,909,867,153,1929,49336
28-04-2016,23,15899,18675,7830,2266,44672,864,626,173,1663,46335
29-04-2016,0,14595,17285,7903,2168,41950,923,457,168,1548,43498
29-04-2016,1,13132,17284,7928,2130,40475,930,413,156,1499,41974
29-04-2016,2,12659,17387,7872,2246,40164,931,396,133,1460,41624
29-04-2016,3,12600,17362,7875,2295,40133,937,454,130,1521,41654
29-04-2016,4,12704,17289,7866,2729,40588,941,586,128,1655,42243
29-04-2016,5,14205,17759,8030,2688,42681,931,719,124,1774,44455
29-04-2016,6,16241,19559,8102,3055,46957,931,885,141,1957,48914
29-04-2016,7,17702,21597,8173,3424,50896,927,1226,280,2433,53329
29-04-2016,8,17509,21628,8088,4458,51684,931,1488,273,2692,54376
29-04-2016,9,16132,20444,7992,4669,49237,941,1501,268,2710,51947
29-04-2016,10,15130,19848,7911,4841,47731,943,1494,245,2682,50413
29-04-2016,11,14971,19903,7831,4980,47684,943,1324,236,2503,50187
29-04-2016,12,14148,20311,7756,5203,47420,915,1312,273,2500,49920
29-04-2016,13,13899,20069,7780,4913,46661,946,1199,275,2420,49081
29-04-2016,14,13615,20379,7656,4692,46343,938,1094,273,2305,48648
29-04-2016,15,14058,20755,7497,4515,46824,837,1095,52,1984,48808
29-04-2016,16,14355,20583,7556,4257,46751,912,1041,74,2027,48778
29-04-2016,17,15621,21008,7503,4121,48253,850,985,50,1885,50138
29-04-2016,18,15685,21448,7430,4021,48583,845,994,51,1890,50473
29-04-2016,19,15627,21136,7481,3878,48122,857,937,53,1847,49969
29-04-2016,20,15483,20599,7388,3587,47056,664,843,57,1564,48620
29-04-2016,21,15505,19997,7446,3274,46222,588,737,63,1388,47610
29-04-2016,22,14830,19762,7400,3098,45088,513,687,59,1259,46347
29-04-2016,23,14071,18754,7404,3009,43238,534,460,54,1048,44286
30-04-2016,0,13536,17522,7368,2877,41303,492,412,51,955,42258
30-04-2016,1,13159,17143,7342,2812,40455,477,407,55,939,41394
30-04-2016,2,12935,16889,7324,2905,40052,476,409,65,950,41002
30-04-2016,3,12893,16688,7309,2994,39885,496,495,73,1064,40949
30-04-2016,4,12924,16363,7314,3183,39785,472,661,73,1206,40991
30-04-2016,5,12785,16348,7326,3028,39486,456,712,62,1230,40716
30-04-2016,6,13064,16638,7282,3011,39996,474,816,59,1349,41345
30-04-2016,7,14545,17133,7354,2921,41954,461,812,78,1351,43305
30-04-2016,8,16005,17935,7381,3058,44379,507,874,69,1450,45829
30-04-2016,9,16475,18949,7362,3299,46086,530,1025,69,1624,47710
30-04-2016,10,16599,18840,7295,3485,46220,521,1028,72,1621,47841
30-04-2016,11,15977,18758,7220,3416,45371,507,1030,76,1613,46984
30-04-2016,12,15163,17857,7120,3207,43346,460,1004,95,1559,44905
30-04-2016,13,14368,17741,7104,3060,42274,455,953,104,1512,43786
30-04-2016,14,13843,17584,7135,2843,41405,465,872,96,1433,42838
30-04-2016,15,13508,17485,7122,2779,40894,455,833,86,1374,42268
30-04-2016,16,13693,17489,7149,2645,40974,455,853,100,1408,42382
30-04-2016,17,15253,17891,7243,2620,43009,446,870,115,1431,44440
30-04-2016,18,16568,18712,7369,2702,45349,464,867,148,1479,46828
30-04-2016,19,16261,18837,7459,2557,45115,473,888,125,1486,46601
30-04-2016,20,16144,18299,7457,2131,44032,496,843,118,1457,45489
30-04-2016,21,16817,18522,7516,2122,44976,480,820,142,1442,46418
30-04-2016,22,16237,18231,7605,2100,44175,480,656,109,1245,45420
30-04-2016,23,15817,16851,7487,1900,42056,478,479,97,1054,43110
01-05-2016,0,12788,14985,7496,1243,36512,472,429,95,996,37508
01-05-2016,1,10918,14187,7364,1242,33712,476,426,87,989,34701
01-05-2016,2,10199,13929,7272,1249,32650,459,455,87,1001,33651
01-05-2016,3,10154,13905,7230,1219,32508,454,455,103,1012,33520
01-05-2016,4,10040,13865,7232,1243,32381,445,532,113,1090,33471
01-05-2016,5,9956,13883,7198,1213,32250,447,578,106,1131,33381
01-05-2016,6,10108,14082,7200,1273,32663,440,670,103,1213,33876
01-05-2016,7,10903,14126,7216,1295,33541,434,663,140,1237,34778
01-05-2016,8,11628,14934,7184,1385,35132,441,651,131,1223,36355
01-05-2016,9,12397,15242,7167,1472,36277,446,631,126,1203,37480
01-05-2016,10,12766,15601,7094,1626,37088,450,783,127,1360,38448
01-05-2016,11,12849,15657,7050,1710,37265,458,849,127,1434,38699
01-05-2016,12,12608,15611,6973,1723,36915,451,850,119,1420,38335
01-05-2016,13,12038,15611,6937,1752,36338,446,895,61,1402,37740
01-05-2016,14,11460,15538,6948,1772,35718,448,902,67,1417,37135
01-05-2016,15,11280,15455,6921,1718,35374,447,972,68,1487,36861
01-05-2016,16,11302,15516,6916,1617,35352,448,967,70,1485,36837
01-05-2016,17,12234,15679,6902,1456,36271,447,960,58,1465,37736
01-05-2016,18,13377,16172,6962,1473,37983,444,993,49,1486,39469
01-05-2016,19,15180,17018,7157,1716,41072,482,976,98,1556,42628
01-05-2016,20,16208,17458,7183,1693,42542,479,994,108,1581,44123
01-05-2016,21,16863,17778,7329,1736,43706,450,947,117,1514,45220
01-05-2016,22,16703,17873,7342,1869,43786,454,897,113,1464,45250
01-05-2016,23,15747,16217,7403,1568,40936,452,741,79,1272,42208
02-05-2016,0,13404,14852,7371,1067,36694,456,476,88,1020,37714
02-05-2016,1,11756,14500,7286,1058,34599,452,471,81,1004,35603
02-05-2016,2,11308,14226,7213,1112,33859,453,472,73,998,34857
02-05-2016,3,11453,14215,7165,1134,33969,441,499,75,1015,34984
02-05-2016,4,11772,14408,7133,1280,34594,436,559,66,1061,35655
02-05-2016,5,14500,15474,7292,1605,38869,503,663,84,1250,40119
02-05-2016,6,17713,17122,7452,2210,44499,585,717,82,1384,45883
02-05-2016,7,18746,19204,7756,3166,48873,636,919,77,1632,50505
02-05-2016,8,18480,19544,7750,3345,49119,633,1062,300,1995,51114
02-05-2016,9,18300,19389,7571,3563,48823,621,1074,399,2094,50917
02-05-2016,10,17949,19180,7437,3602,48167,593,1056,485,2134,50301
02-05-2016,11,17733,18865,7232,3624,47455,639,1051,262,1952,49407
02-05-2016,12,17797,18975,7220,3653,47643,624,1049,296,1969,49612
02-05-2016,13,17473,19054,7298,3806,47631,630,1050,269,1949,49580
02-05-2016,14,17094,18818,7266,3785,46963,613,1053,229,1895,48858
02-05-2016,15,17142,18516,7217,3499,46375,597,1071,89,1757,48132
02-05-2016,16,17157,18472,7182,3413,46224,549,983,100,1632,47856
02-05-2016,17,17124,18611,7184,3120,46040,538,1010,98,1646,47686
02-05-2016,18,17056,18757,7159,2902,45873,540,925,101,1566,47439
02-05-2016,19,17060,18820,7106,2893,45879,523,837,105,1465,47344
02-05-2016,20,16598,18714,7127,3025,45465,541,842,319,1702,47167
02-05-2016,21,16921,18661,7219,2907,45711,521,862,173,1556,47267
02-05-2016,22,15467,18251,7214,2881,43814,536,706,95,1337,45151
02-05-2016,23,13924,17157,7217,2790,41088,515,511,104,1130,42218
03-05-2016,0,12642,16187,7149,2730,38710,517,401,100,1018,39728
03-05-2016,1,11814,16103,7080,2815,37812,514,393,98,1005,38817
03-05-2016,2,11505,15932,7108,2706,37251,523,390,91,1004,38255
03-05-2016,3,11152,15792,7115,2639,36697,525,391,85,1001,37698
03-05-2016,4,11235,15790,7195,2528,36748,528,578,91,1197,37945
03-05-2016,5,12367,16105,7174,2637,38284,541,636,94,1271,39555
03-05-2016,6,15138,17904,7181,2840,43063,589,645,98,1332,44395
03-05-2016,7,17394,19597,7147,3215,47353,632,716,107,1455,48808
03-05-2016,8,18083,19833,7121,3113,48149,633,917,89,1639,49788
03-05-2016,9,18252,19685,7146,2958,48040,633,925,137,1695,49735
03-05-2016,10,18130,19605,7129,3023,47888,638,994,97,1729,49617
03-05-2016,11,18219,19475,6994,3023,47712,642,1002,78,1722,49434
03-05-2016,12,17648,19081,6871,3034,46634,583,1007,79,1669,48303
03-05-2016,13,17508,18736,6873,3212,46330,546,1051,77,1674,48004
03-05-2016,14,17045,18314,6908,3373,45643,552,1033,82,1667,47310
03-05-2016,15,16638,18149,6849,3355,44991,562,992,111,1665,46656
03-05-2016,16,16204,17731,6830,2978,43744,547,980,79,1606,45350
03-05-2016,17,17167,17892,6960,2879,44899,536,911,85,1532,46431
03-05-2016,18,17402,18102,7027,2635,45164,548,916,102,1566,46730
03-05-2016,19,17355,18090,6998,2679,45123,557,826,114,1497,46620
03-05-2016,20,17166,17945,7018,2596,44725,552,842,113,1507,46232
03-05-2016,21,17109,17928,7017,2504,44559,571,844,112,1527,46086
03-05-2016,22,16777,17551,6969,2290,43586,544,634,95,1273,44859
03-05-2016,23,15334,16645,6983,2089,41052,616,457,76,1149,42201
04-05-2016,0,13983,15728,6901,1995,38608,628,378,80,1086,39694
04-05-2016,1,13683,15505,6940,2006,38135,601,386,87,1074,39209
04-05-2016,2,13133,15848,6879,1968,37830,600,422,82,1104,38934
04-05-2016,3,12977,15893,6913,1997,37781,577,452,73,1102,38883
04-05-2016,4,13572,15984,6940,1790,38285,569,694,76,1339,39624
04-05-2016,5,15160,16547,7142,1857,40707,570,747,63,1380,42087
04-05-2016,6,17743,18244,7421,2428,45836,572,872,53,1497,47333
04-05-2016,7,19047,19993,7443,3236,49719,604,990,253,1847,51566
04-05-2016,8,18718,19967,7461,3446,49592,612,1157,351,2120,51712
04-05-2016,9,19001,19722,7479,3256,49458,590,1189,501,2280,51738
04-05-2016,10,19003,19598,7411,3222,49234,583,1165,504,2252,51486
04-05-2016,11,18647,19100,7341,3219,48308,599,1011,512,2122,50430
04-05-2016,12,18044,18616,7335,3054,47049,603,1010,520,2133,49182
04-05-2016,13,17506,17898,7345,2812,45560,602,1008,533,2143,47703
04-05-2016,14,16647,17697,7317,2708,44368,611,1001,357,1969,46337
04-05-2016,15,16133,17444,7078,2476,43131,607,1004,170,1781,44912
04-05-2016,16,16727,17610,6871,2360,43568,572,1002,201,1775,45343
04-05-2016,17,17901,17877,6975,2388,45141,597,991,198,1786,46927
04-05-2016,18,18464,18228,7076,2541,46306,603,933,318,1854,48160
04-05-2016,19,18317,18213,7089,2423,46043,617,924,317,1858,47901
04-05-2016,20,18084,18069,6891,1987,45032,556,912,283,1751,46783
04-05-2016,21,18434,17953,6776,1905,45067,553,784,271,1608,46675
04-05-2016,22,17583,17622,6829,1755,43791,549,688,136,1373,45164
04-05-2016,23,16411,16974,6783,1368,41536,526,547,128,1201,42737
05-05-2016,0,14594,15622,6652,1114,37982,525,415,199,1139,39121
05-05-2016,1,13047,15076,6560,1023,35707,539,420,138,1097,36804
05-05-2016,2,12128,14863,6554,1028,34573,537,421,160,1118,35691
05-05-2016,3,11242,14755,6568,1024,33588,534,422,160,1116,34704
05-05-2016,4,10844,14770,6555,1084,33253,519,598,179,1296,34549
05-05-2016,5,11186,14922,6551,1163,33822,517,651,142,1310,35132
05-05-2016,6,11815,15126,6581,1322,34844,536,747,118,1401,36245
05-05-2016,7,12492,15785,6594,1425,36295,573,919,466,1958,38253
05-05-2016,8,13251,16505,6653,1495,37904,588,1148,458,2194,40098
05-05-2016,9,13424,16697,6800,1636,38557,590,1123,468,2181,40738
05-05-2016,10,13428,16638,6890,1703,38659,583,1157,474,2214,40873
05-05-2016,11,13205,16693,6861,1746,38506,583,1134,451,2168,40674
05-05-2016,12,12947,16615,6759,1738,38059,597,1129,493,2219,40278
05-05-2016,13,12552,16670,6684,1769,37676,572,1111,478,2161,39837
05-05-2016,14,12190,16583,6701,1791,37265,570,1123,422,2115,39380
05-05-2016,15,11655,16436,6531,1690,36311,516,1124,177,1817,38128
05-05-2016,16,11629,16220,6491,1745,36085,526,1112,186,1824,37909
05-05-2016,17,12332,16503,6540,1664,37038,522,1046,193,1761,38799
05-05-2016,18,13271,17259,6688,1478,38695,518,981,188,1687,40382
05-05-2016,19,15797,17954,6684,1342,41777,526,918,175,1619,43396
05-05-2016,20,15793,17911,6600,1388,41694,510,944,210,1664,43358
05-05-2016,21,16084,17861,6609,1407,41963,525,917,235,1677,43640
05-05-2016,22,15558,17512,6590,1434,41094,493,735,193,1421,42515
05-05-2016,23,13375,16456,6541,1278,37652,535,641,188,1364,39016
06-05-2016,0,11262,15074,6498,1202,34035,565,538,176,1279,35314
06-05-2016,1,10092,14637,6556,1280,32563,593,539,161,1293,33856
06-05-2016,2,9744,14508,6554,1316,32122,578,543,167,1288,33410
06-05-2016,3,9714,14555,6575,1409,32253,567,547,171,1285,33538
06-05-2016,4,10289,14611,6640,1510,33049,565,641,156,1362,34411
06-05-2016,5,11898,14876,6804,1574,35154,561,809,160,1530,36684
06-05-2016,6,15167,16941,7080,1680,40867,550,1033,133,1716,42583
06-05-2016,7,17662,17796,7216,1701,44375,569,1151,183,1903,46278
06-05-2016,8,18576,18484,7182,2243,46485,641,1149,385,2175,48660
06-05-2016,9,18536,18535,7271,2500,46843,690,1165,312,2167,49010
06-05-2016,10,17239,18091,7187,2631,45149,692,1106,303,2101,47250
06-05-2016,11,15621,17519,7001,2455,42597,667,1088,263,2018,44615
06-05-2016,12,14579,17280,6935,2772,41568,657,1096,295,2048,43616
06-05-2016,13,13677,17075,6803,2906,40461,661,1128,253,2042,42503
06-05-2016,14,13383,16654,6740,3101,39877,655,1153,121,1929,41806
06-05-2016,15,12596,16449,6602,3236,38883,641,1093,108,1842,40725
06-05-2016,16,12163,16397,6604,3203,38368,723,1018,117,1858,40226
06-05-2016,17,13675,16697,6609,3269,40251,743,1001,111,1855,42106
06-05-2016,18,15504,17381,6650,2837,42373,725,1015,108,1848,44221
06-05-2016,19,15342,17494,6602,2614,42052,732,954,115,1801,43853
06-05-2016,20,14339,17246,6546,2433,40566,725,817,143,1685,42251
06-05-2016,21,14114,16920,6574,2461,40069,719,757,176,1652,41721
06-05-2016,22,13395,16803,6568,2776,39542,722,694,153,1569,41111
06-05-2016,23,11981,16170,6563,2882,37596,753,623,193,1569,39165
07-05-2016,0,10205,14779,6501,2671,34156,774,285,205,1264,35420
07-05-2016,1,8983,14436,6421,2610,32453,758,271,218,1247,33700
07-05-2016,2,8380,14186,6373,2634,31573,760,254,202,1216,32789
07-05-2016,3,8449,14085,6382,2631,31547,791,256,172,1219,32766
07-05-2016,4,8368,14050,6370,2552,31341,782,373,149,1304,32645
07-05-2016,5,8014,14073,6346,2496,30929,786,505,131,1422,32351
07-05-2016,6,8638,14503,6377,2261,31777,790,626,101,1517,33294
07-05-2016,7,10485,15403,6415,2101,34404,750,628,101,1479,35883
07-05-2016,8,11207,15784,6401,2475,35867,734,803,81,1618,37485
07-05-2016,9,11492,16208,6382,2606,36688,739,938,75,1752,38440
07-05-2016,10,11515,16172,6389,2630,36707,743,938,54,1735,38442
07-05-2016,11,10929,15873,6380,2910,36091,746,945,56,1747,37838
07-05-2016,12,10866,15473,6388,3192,35921,756,936,65,1757,37678
07-05-2016,13,10340,15597,6385,3413,35737,770,941,66,1777,37514
07-05-2016,14,9840,15315,6377,3332,34864,770,1015,65,1850,36714
07-05-2016,15,9688,15202,6348,3242,34480,761,1015,49,1825,36305
07-05-2016,16,9527,15299,6332,3162,34320,752,1018,52,1822,36142
07-05-2016,17,10254,15538,6338,3087,35217,753,1019,52,1824,37041
07-05-2016,18,10883,16051,6386,2988,36308,755,1006,80,1841,38149
07-05-2016,19,12059,16497,6452,2457,37464,768,996,82,1846,39310
07-05-2016,20,10921,15986,6485,2485,35877,718,849,89,1656,37533
07-05-2016,21,10804,15887,6548,2677,35915,670,760,93,1523,37438
07-05-2016,22,10940,15969,6625,2750,36283,661,663,103,1427,37710
07-05-2016,23,9251,15195,6734,2680,33860,670,492,139,1301,35161
08-05-2016,0,7875,14036,6724,2479,31114,680,381,169,1230,32344
08-05-2016,1,7837,13618,6699,2310,30464,683,378,167,1228,31692
08-05-2016,2,7633,13482,6644,2210,29969,693,388,154,1235,31204
08-05-2016,3,7443,13246,6618,2108,29416,692,383,142,1217,30633
08-05-2016,4,7401,12918,6512,1937,28768,694,386,115,1195,29963
08-05-2016,5,7322,12834,6405,1690,28253,689,560,96,1345,29598
08-05-2016,6,7506,13055,6302,1623,28486,674,606,78,1358,29844
08-05-2016,7,8244,13426,6331,1912,29913,683,605,96,1384,31297
08-05-2016,8,9707,14269,6366,1772,32114,679,660,79,1418,33532
08-05-2016,9,10716,15039,6400,1824,33979,681,667,77,1425,35404
08-05-2016,10,11351,15477,6467,1953,35246,655,738,88,1481,36727
08-05-2016,11,10900,15473,6451,2357,35182,670,941,91,1702,36884
08-05-2016,12,10646,15558,6436,2819,35459,667,948,94,1709,37168
08-05-2016,13,10234,15359,6441,3046,35080,650,950,96,1696,36776
08-05-2016,14,10002,15025,6372,3227,34625,654,1001,98,1753,36378
08-05-2016,15,9866,14943,6071,3216,34098,652,1006,98,1756,35854
08-05-2016,16,9824,15117,5839,3098,33878,637,1012,94,1743,35621
08-05-2016,17,9953,15427,5721,2926,34027,636,1014,98,1748,35775
08-05-2016,18,10136,15594,5762,2735,34227,636,1010,101,1747,35974
08-05-2016,19,11406,16017,5793,2467,35685,726,1015,116,1857,37542
08-05-2016,20,11164,16091,5763,2129,35148,752,1025,129,1906,37054
08-05-2016,21,11591,16302,5879,2107,35879,763,959,104,1826,37705
08-05-2016,22,11868,16434,5957,2202,36460,775,855,126,1756,38216
08-05-2016,23,10388,15331,5957,2115,33792,782,648,152,1582,35374
09-05-2016,0,8687,13545,5863,2060,30154,789,271,171,1231,31385
09-05-2016,1,8707,12970,5871,2067,29615,789,270,189,1248,30863
09-05-2016,2,8642,12905,5877,1980,29406,785,272,182,1239,30645
09-05-2016,3,8648,12846,5847,1896,29239,787,278,169,1234,30473
09-05-2016,4,9026,12976,5789,1774,29565,776,416,147,1339,30904
09-05-2016,5,11162,13909,5805,1850,32725,764,612,132,1508,34233
09-05-2016,6,15625,16284,5879,2105,39893,876,662,138,1676,41569
09-05-2016,7,19148,17262,6171,2315,44895,997,733,176,1906,46801
09-05-2016,8,19797,17681,6022,2552,46052,959,1018,304,2281,48333
09-05-2016,9,19554,17362,5945,2561,45421,971,1099,249,2319,47740
09-05-2016,10,18500,16998,5891,2518,43908,954,1019,124,2097,46005
09-05-2016,11,16891,16901,5912,2651,42355,905,957,125,1987,44342
09-05-2016,12,16359,16462,5780,2568,41169,847,943,167,1957,43126
09-05-2016,13,15915,16601,5598,2733,40846,826,942,137,1905,42751
09-05-2016,14,15535,16623,5591,2892,40640,829,924,143,1896,42536
09-05-2016,15,15487,16648,5699,2760,40595,831,868,281,1980,42575
09-05-2016,16,15822,16663,5702,2847,41034,816,857,284,1957,42991
09-05-2016,17,17101,16939,5621,2800,42462,820,869,157,1846,44308
09-05-2016,18,16821,16911,5683,2561,41977,806,868,146,1820,43797
09-05-2016,19,16881,16767,5671,2278,41597,805,796,216,1817,43414
09-05-2016,20,16347,16722,5689,1922,40679,788,703,320,1811,42490
09-05-2016,21,16549,16666,5735,1781,40732,794,663,121,1578,42310
09-05-2016,22,15108,16671,5735,1959,39472,804,503,100,1407,40879
09-05-2016,23,13398,15933,5671,1872,36874,812,429,112,1353,38227
10-05-2016,0,12559,14084,5580,1585,33808,811,234,148,1193,35001
10-05-2016,1,12076,13517,5579,1321,32492,820,244,69,1133,33625
10-05-2016,2,11452,13486,5583,1424,31944,824,248,150,1222,33166
10-05-2016,3,11270,13197,5588,1509,31564,818,253,151,1222,32786
10-05-2016,4,11529,13269,5614,1480,31891,846,273,64,1183,33074
10-05-2016,5,13318,14173,5775,1422,34687,877,366,77,1320,36007
10-05-2016,6,16654,15713,6135,1388,39890,1004,707,69,1780,41670
10-05-2016,7,19555,16920,6323,1546,44343,1082,1067,239,2388,46731
10-05-2016,8,19759,17351,6385,1956,45452,1109,1212,402,2723,48175
10-05-2016,9,19454,17326,6449,2393,45623,1100,1181,328,2609,48232
10-05-2016,10,18850,17394,6476,2694,45413,1133,1168,313,2614,48027
10-05-2016,11,18557,17183,6476,2376,44592,1123,1155,266,2544,47136
10-05-2016,12,17747,16912,6443,2341,43443,1148,1150,289,2587,46030
10-05-2016,13,17898,16723,6309,2298,43228,1154,1016,267,2437,45665
10-05-2016,14,18236,16890,6253,2414,43793,1122,946,313,2381,46174
10-05-2016,15,18183,16982,6156,2493,43813,913,984,115,2012,45825
10-05-2016,16,17472,17090,5933,2451,42946,866,925,108,1899,44845
10-05-2016,17,17478,17159,6102,2373,43110,1028,939,94,2061,45171
10-05-2016,18,17626,17131,6223,2122,43104,1029,926,150,2105,45209
10-05-2016,19,17626,17147,6273,1942,42988,1001,896,208,2105,45093
10-05-2016,20,17277,17011,6004,1711,42004,850,862,63,1775,43779
10-05-2016,21,17124,16916,5875,1496,41410,838,770,62,1670,43080
10-05-2016,22,16108,16572,5835,1589,40103,850,567,55,1472,41575
10-05-2016,23,14156,15980,5791,1390,37317,863,423,54,1340,38657
11-05-2016,0,12487,14497,5803,1308,34096,853,216,59,1128,35224
11-05-2016,1,11482,14126,5843,1303,32753,855,202,59,1116,33869
11-05-2016,2,11331,14107,5826,1204,32466,845,204,58,1107,33573
11-05-2016,3,11164,13993,5777,1240,32174,829,208,59,1096,33270
11-05-2016,4,11404,14090,5697,1260,32451,825,226,64,1115,33566
11-05-2016,5,13548,14533,5803,1339,35224,849,590,69,1508,36732
11-05-2016,6,17033,16202,6088,1453,40775,992,692,68,1752,42527
11-05-2016,7,18670,17590,6305,1846,44413,1210,908,62,2180,46593
11-05-2016,8,19006,17661,6323,2020,45009,1150,938,244,2332,47341
11-05-2016,9,18847,17560,6184,2103,44695,1165,921,228,2314,47009
11-05-2016,10,18563,17256,6241,2261,44320,1152,912,229,2293,46613
11-05-2016,11,18025,16613,6172,2695,43505,1165,1350,123,2638,46143
11-05-2016,12,17504,16500,6111,2711,42825,1165,1331,253,2749,45574
11-05-2016,13,17142,16388,6116,2794,42440,1141,1236,158,2535,44975
11-05-2016,14,16797,16215,6269,2939,42219,1144,966,102,2212,44431
11-05-2016,15,16580,16090,6060,2977,41707,905,805,119,1829,43536
11-05-2016,16,16098,16196,5889,2978,41162,892,823,121,1836,42998
11-05-2016,17,16929,16601,6087,2975,42593,959,810,121,1890,44483
11-05-2016,18,17254,16513,6217,2605,42589,979,793,134,1906,44495
11-05-2016,19,17233,16329,6133,2403,42098,952,731,177,1860,43958
11-05-2016,20,16941,16376,5911,2203,41432,834,670,239,1743,43175
11-05-2016,21,16545,16481,5744,2155,40925,799,622,219,1640,42565
11-05-2016,22,15100,16173,5713,2288,39274,826,531,209,1566,40840
11-05-2016,23,12653,15336,5677,2375,36040,848,429,196,1473,37513
12-05-2016,0,10774,14554,5776,2454,33558,790,238,197,1225,34783
12-05-2016,1,10032,14450,5797,2450,32729,795,230,186,1211,33940
12-05-2016,2,9665,14216,5833,2251,31965,788,228,194,1210,33175
12-05-2016,3,9677,14024,5904,2207,31812,809,239,221,1269,33081
12-05-2016,4,9904,13987,5945,2209,32045,828,273,222,1323,33368
12-05-2016,5,10823,14627,6167,2178,33794,873,507,200,1580,35374
12-05-2016,6,15343,16224,6459,2314,40341,1059,672,161,1892,42233
12-05-2016,7,17801,18075,6490,2767,45135,1243,865,256,2364,47499
12-05-2016,8,18119,17767,6483,2855,45224,1217,1028,289,2534,47758
12-05-2016,9,18301,17463,6551,2819,45136,1123,977,287,2387,47523
12-05-2016,10,18100,17344,6549,2720,44714,1118,1066,176,2360,47074
12-05-2016,11,17801,17169,6561,2616,44146,1091,1053,165,2309,46455
12-05-2016,12,17727,17203,6662,2686,44278,1079,1028,99,2206,46484
12-05-2016,13,17711,17125,6731,2769,44336,1132,861,91,2084,46420
12-05-2016,14,17747,16970,6730,2688,44136,1219,836,84,2139,46275
12-05-2016,15,17706,17220,6585,2502,44013,980,726,82,1788,45801
12-05-2016,16,17417,17639,6482,2273,43812,933,635,89,1657,45469
12-05-2016,17,17355,18116,6619,2138,44228,1001,622,98,1721,45949
12-05-2016,18,17461,18252,6663,1952,44328,1016,890,117,2023,46351
12-05-2016,19,17951,18099,6641,1686,44377,1022,669,136,1827,46204
12-05-2016,20,18462,17187,6425,1329,43404,859,610,167,1636,45040
12-05-2016,21,18604,16851,6256,1265,42975,846,591,207,1644,44619
12-05-2016,22,18548,16482,6201,1031,42262,798,418,201,1417,43679
12-05-2016,23,17164,15836,6077,985,40062,810,272,204,1286,41348
13-05-2016,0,15290,14415,6001,918,36624,811,241,217,1269,37893
13-05-2016,1,13397,13947,5941,858,34141,812,235,201,1248,35389
13-05-2016,2,12634,13473,5898,805,32812,811,234,171,1216,34028
13-05-2016,3,11995,13324,5873,792,31985,813,238,153,1204,33189
13-05-2016,4,12793,13329,5937,838,32898,808,513,166,1487,34385
13-05-2016,5,15191,13898,6044,960,36093,857,640,136,1633,37726
13-05-2016,6,18162,16145,6391,1304,42002,1057,738,109,1904,43906
13-05-2016,7,19845,17686,6535,1971,46038,1216,941,279,2436,48474
13-05-2016,8,20254,17946,6561,2211,46972,1215,1131,420,2766,49738
13-05-2016,9,20342,17492,6476,2380,46690,1228,1225,442,2895,49585
13-05-2016,10,20377,17660,6464,2600,47103,1243,1169,402,2814,49917
13-05-2016,11,20150,17626,6468,2722,46965,1243,1075,456,2774,49739
13-05-2016,12,19705,17543,6428,2764,46440,1247,987,482,2716,49156
13-05-2016,13,19389,16953,6437,2897,45676,1244,975,495,2714,48390
13-05-2016,14,18814,16252,6360,2704,44129,1227,990,330,2547,46676
13-05-2016,15,18047,16057,6121,2224,42449,1175,808,134,2117,44566
13-05-2016,16,17548,15794,6013,2204,41559,1141,747,134,2022,43581
13-05-2016,17,17977,15898,6253,2072,42201,1177,721,167,2065,44266
13-05-2016,18,18688,16118,6362,2151,43316,1136,811,138,2085,45401
13-05-2016,19,18636,16044,6342,2216,43239,1047,736,130,1913,45152
13-05-2016,20,18187,15710,6083,2228,42209,782,663,142,1587,43796
13-05-2016,21,17819,15563,5917,2010,41309,791,585,145,1521,42830
13-05-2016,22,17118,15881,5871,1809,40680,782,409,129,1320,42000
13-05-2016,23,15651,15378,5730,2097,38857,765,237,91,1093,39950
14-05-2016,0,12771,14012,5703,1939,34424,743,144,55,942,35366
14-05-2016,1,11327,13385,5686,1879,32277,754,140,58,952,33229
14-05-2016,2,10637,13093,5685,1789,31203,743,138,62,943,32146
14-05-2016,3,10395,12898,5683,1763,30739,735,143,62,940,31679
14-05-2016,4,10244,12898,5679,1724,30545,735,155,64,954,31499
14-05-2016,5,10336,12975,5653,1715,30680,741,329,45,1115,31795
14-05-2016,6,10501,13740,5666,1739,31646,715,521,34,1270,32916
14-05-2016,7,11771,14789,5643,1963,34167,699,534,27,1260,35427
14-05-2016,8,12825,15748,5643,2250,36466,698,617,50,1365,37831
14-05-2016,9,14177,16322,5679,2451,38631,685,825,49,1559,40190
14-05-2016,10,14503,16550,5654,2760,39466,704,842,50,1596,41062
14-05-2016,11,14369,16569,5721,2988,39646,736,822,52,1610,41256
14-05-2016,12,13789,16462,5735,3143,39129,745,827,56,1628,40757
14-05-2016,13,13322,16335,5693,3187,38538,743,831,55,1629,40167
14-05-2016,14,12748,16092,5723,3219,37782,737,813,59,1609,39391
14-05-2016,15,12366,15890,5778,3231,37266,710,749,61,1520,38786
14-05-2016,16,12404,15948,5813,3276,37440,675,749,71,1495,38935
14-05-2016,17,12786,16285,5867,3325,38263,671,739,102,1512,39775
14-05-2016,18,12765,16479,5936,3327,38506,681,755,122,1558,40064
14-05-2016,19,13181,16494,5930,3192,38798,703,771,138,1612,40410
14-05-2016,20,13366,16441,5962,2816,38585,742,639,140,1521,40106
14-05-2016,21,13563,16823,5939,2551,38876,696,553,128,1377,40253
14-05-2016,22,14776,16830,5869,2452,39927,642,410,119,1171,41098
14-05-2016,23,12991,15972,5791,2258,37012,727,228,120,1075,38087
15-05-2016,0,11937,14564,5774,2215,34490,760,146,110,1016,35506
15-05-2016,1,10404,13600,5681,2127,31812,830,137,299,1266,33078
15-05-2016,2,10221,13502,5735,2074,31533,842,139,300,1281,32814
15-05-2016,3,9798,13533,5739,2220,31291,833,141,285,1259,32550
15-05-2016,4,9294,13533,5747,2240,30814,834,143,241,1218,32032
15-05-2016,5,9103,13564,5776,2168,30611,839,146,155,1140,31751
15-05-2016,6,9918,14117,5832,2286,32154,756,161,83,1000,33154
15-05-2016,7,10437,14814,5839,2352,33442,727,241,75,1043,34485
15-05-2016,8,10850,15910,5889,2583,35232,716,391,121,1228,36460
15-05-2016,9,11800,16681,5933,2851,37266,730,396,187,1313,38579
15-05-2016,10,12219,16878,5940,3170,38207,766,656,241,1663,39870
15-05-2016,11,12064,17207,5930,3314,38516,771,666,270,1707,40223
15-05-2016,12,11954,17076,5923,3507,38462,738,591,278,1607,40069
15-05-2016,13,11649,16617,5920,3811,37997,719,587,266,1572,39569
15-05-2016,14,11453,16494,5898,3627,37473,714,585,220,1519,38992
15-05-2016,15,11355,16492,5916,3501,37265,715,599,225,1539,38804
15-05-2016,16,11461,16471,5940,3530,37402,715,641,229,1585,38987
15-05-2016,17,11959,16553,5980,3600,38092,721,644,235,1600,39692
15-05-2016,18,12313,16751,5990,3322,38375,729,701,196,1626,40001
15-05-2016,19,13421,16900,6028,3084,39433,715,793,148,1656,41089
15-05-2016,20,13946,17054,6010,2680,39691,725,767,125,1617,41308
15-05-2016,21,14819,17132,6086,2630,40666,800,688,178,1666,42332
15-05-2016,22,14580,17100,6114,2490,40286,747,494,210,1451,41737
15-05-2016,23,13578,16516,6009,2202,38304,713,161,227,1101,39405
16-05-2016,0,11760,14749,5871,2526,34905,696,225,276,1197,36102
16-05-2016,1,10175,14171,5803,2555,32703,704,236,259,1199,33902
16-05-2016,2,9449,14035,5830,2563,31879,754,265,250,1269,33148
16-05-2016,3,9381,13961,5819,2605,31765,802,271,259,1332,33097
16-05-2016,4,9340,13946,5872,2771,31928,848,279,270,1397,33325
16-05-2016,5,10212,14180,5998,2889,33279,887,485,290,1662,34941
16-05-2016,6,12161,15046,6330,2987,36524,1081,544,299,1924,38448
16-05-2016,7,13586,16162,6642,3094,39486,1161,813,345,2319,41805
16-05-2016,8,14730,16765,6592,3339,41426,1185,915,515,2615,44041
16-05-2016,9,15589,17032,6591,3750,42964,1201,963,471,2635,45599
16-05-2016,10,16012,17161,6611,3810,43595,1195,911,457,2563,46158
16-05-2016,11,16147,17170,6596,3896,43810,1186,1009,391,2586,46396
16-05-2016,12,15441,17092,6604,3886,43023,1215,1000,378,2593,45616
16-05-2016,13,15010,16218,6528,3905,41662,1197,938,379,2514,44176
16-05-2016,14,14676,15759,6541,3975,40952,1179,849,344,2372,43324
16-05-2016,15,14354,15572,6576,4008,40509,1176,713,350,2239,42748
16-05-2016,16,14397,15416,6420,3905,40138,1139,627,390,2156,42294
16-05-2016,17,15278,15617,6382,3903,41180,1118,626,382,2126,43306
16-05-2016,18,16222,16279,6367,3809,42676,1109,682,361,2152,44828
16-05-2016,19,16635,16662,6387,3653,43336,1092,641,346,2079,45415
16-05-2016,20,16642,16534,6343,3840,43358,892,592,307,1791,45149
16-05-2016,21,17066,16088,6341,3625,43122,873,529,321,1723,44845
16-05-2016,22,16531,15831,6107,3404,41873,783,451,307,1541,43414
16-05-2016,23,15274,14782,5949,3407,39412,787,435,303,1525,40937
17-05-2016,0,14344,12699,5926,3265,36234,751,256,271,1278,37512
17-05-2016,1,13711,12353,5926,3211,35201,758,256,254,1268,36469
17-05-2016,2,12933,12277,5901,3168,34278,760,259,256,1275,35553
17-05-2016,3,11787,12145,5936,3141,33009,753,296,245,1294,34303
17-05-2016,4,11735,12236,6059,3097,33127,741,389,227,1357,34484
17-05-2016,5,13493,12661,6293,3057,35503,826,515,215,1556,37059
17-05-2016,6,16406,14593,6597,2885,40482,1068,572,184,1824,42306
17-05-2016,7,17552,17114,6714,3039,44419,1215,758,395,2368,46787
17-05-2016,8,18079,17196,6778,3257,45311,1237,969,371,2577,47888
17-05-2016,9,18369,16553,6684,3359,44964,1242,1073,350,2665,47629
17-05-2016,10,18224,16513,6697,3261,44695,1244,905,361,2510,47205
17-05-2016,11,18077,16238,6690,3256,44262,1238,834,346,2418,46680
17-05-2016,12,17415,16242,6691,3211,43559,1242,815,330,2387,45946
17-05-2016,13,17513,16090,6648,3071,43322,1240,746,309,2295,45617
17-05-2016,14,17508,16136,6637,3144,43424,1224,737,281,2242,45666
17-05-2016,15,17115,15954,6430,3261,42761,1188,585,113,1886,44647
17-05-2016,16,16980,15632,6430,3302,42344,1127,515,85,1727,44071
17-05-2016,17,17299,15929,6538,3418,43184,1211,521,82,1814,44998
17-05-2016,18,17351,16156,6590,3329,43426,1201,674,71,1946,45372
17-05-2016,19,17385,16303,6597,3068,43353,1138,722,65,1925,45278
17-05-2016,20,17382,16008,6284,2839,42514,884,644,58,1586,44100
17-05-2016,21,17915,15620,6206,2683,42424,914,516,54,1484,43908
17-05-2016,22,17921,15130,6098,2661,41811,964,441,51,1456,43267
17-05-2016,23,17013,14172,5983,2384,39552,879,389,53,1321,40873
18-05-2016,0,15949,12798,5883,2050,36679,790,250,52,1092,37771
18-05-2016,1,15467,12480,5799,1934,35680,787,232,57,1076,36756
18-05-2016,2,15037,12561,5879,1915,35390,793,237,63,1093,36483
18-05-2016,3,14168,12655,6120,1973,34917,798,243,65,1106,36023
18-05-2016,4,14517,12449,6287,1928,35181,819,263,66,1148,36329
18-05-2016,5,16397,13112,6436,1867,37812,858,452,66,1376,39188
18-05-2016,6,18305,15450,6894,2280,42929,987,556,57,1600,44529
18-05-2016,7,19531,17588,7228,2819,47165,1154,646,395,2195,49360
18-05-2016,8,19945,17447,7256,3148,47797,1213,642,400,2255,50052
18-05-2016,9,20021,16455,7237,3289,47002,1219,876,265,2360,49362
18-05-2016,10,20120,17100,7378,3215,47813,1226,863,276,2365,50178
18-05-2016,11,19857,17334,7425,3233,47849,1223,849,282,2354,50203
18-05-2016,12,19680,17174,7332,3236,47424,1220,851,293,2364,49788
18-05-2016,13,19459,16944,7272,3126,46800,1177,837,266,2280,49080
18-05-2016,14,19556,16812,7123,3087,46578,1169,808,265,2242,48820
18-05-2016,15,19508,16528,6868,3031,45935,1172,680,90,1942,47877
18-05-2016,16,19651,16710,6509,2876,45744,1166,610,79,1855,47599
18-05-2016,17,19697,17184,6675,2924,46481,1175,577,67,1819,48300
18-05-2016,18,19675,17414,6744,2740,46574,1188,689,57,1934,48508
18-05-2016,19,19671,17234,6772,2690,46366,1173,624,247,2044,48410
18-05-2016,20,19560,17138,6489,2528,45715,1028,588,163,1779,47494
18-05-2016,21,18813,16673,6303,2390,44179,950,661,359,1970,46149
18-05-2016,22,18697,15469,6187,2291,42643,979,520,452,1951,44594
18-05-2016,23,18103,13596,5965,2010,39674,971,453,450,1874,41548
19-05-2016,0,16450,12248,5821,1610,36131,858,219,227,1304,37435
19-05-2016,1,14517,11979,5728,1288,33513,873,215,52,1140,34653
19-05-2016,2,13228,11879,5733,1304,32145,894,232,236,1362,33507
19-05-2016,3,12779,11747,5728,1226,31481,895,252,238,1385,32866
19-05-2016,4,13245,11850,5755,1113,31963,959,270,99,1328,33291
19-05-2016,5,15219,12647,6018,1407,35290,1061,415,482,1958,37248
19-05-2016,6,18461,15076,6563,2105,42205,1169,490,220,1879,44084
19-05-2016,7,19536,16869,6661,2709,45776,1175,768,407,2350,48126
19-05-2016,8,20191,16678,6657,2916,46441,1212,1164,388,2764,49205
19-05-2016,9,20245,16856,6600,2825,46526,1214,1271,232,2717,49243
19-05-2016,10,20095,16865,6739,2891,46591,1215,1157,248,2620,49211
19-05-2016,11,19926,17238,6734,3181,47080,1212,1140,250,2602,49682
19-05-2016,12,19814,17149,6755,3048,46766,1214,1158,246,2618,49384
19-05-2016,13,19347,17243,6764,2982,46337,1219,1027,242,2488,48825
19-05-2016,14,19455,16903,6820,2795,45972,1207,805,243,2255,48227
19-05-2016,15,19555,16783,6614,2755,45708,1186,558,237,1981,47689
19-05-2016,16,19181,16970,6586,2593,45330,1118,568,233,1919,47249
19-05-2016,17,19075,17018,6810,2488,45391,1171,567,232,1970,47361
19-05-2016,18,19264,17043,6839,2397,45541,1152,587,144,1883,47424
19-05-2016,19,19288,17150,6806,2309,45553,1145,582,220,1947,47500
19-05-2016,20,19031,16832,6622,2200,44686,969,595,219,1783,46469
19-05-2016,21,18880,16205,6594,2199,43880,951,611,118,1680,45560
19-05-2016,22,18708,15422,6423,2310,42864,961,555,50,1566,44430
19-05-2016,23,17944,13946,6084,2174,40149,902,404,52,1358,41507
20-05-2016,0,16152,12581,5947,1877,36557,801,293,54,1148,37705
20-05-2016,1,14666,12137,5902,1990,34693,776,281,62,1119,35812
20-05-2016,2,13216,11963,5873,2080,33133,772,248,73,1093,34226
20-05-2016,3,12931,11876,5951,1990,32748,767,238,81,1086,33834
20-05-2016,4,12983,11940,6138,1779,32839,837,354,76,1267,34106
20-05-2016,5,14962,12429,6611,1847,35849,982,465,81,1528,37377
20-05-2016,6,17940,14249,6998,2159,41346,1172,912,88,2172,43518
20-05-2016,7,19643,16660,7119,2571,45993,1177,1184,74,2435,48428
20-05-2016,8,20060,16805,7102,3029,46996,1173,1240,78,2491,49487
20-05-2016,9,19951,16898,7134,3108,47090,1167,1162,87,2416,49506
20-05-2016,10,19671,16743,7058,3205,46678,1138,1018,189,2345,49023
20-05-2016,11,19416,16532,7008,3226,46182,1137,1008,66,2211,48393
20-05-2016,12,19165,15867,6962,3193,45188,1142,936,61,2139,47327
20-05-2016,13,18021,15957,7002,3135,44117,1104,926,68,2098,46215
20-05-2016,14,17622,15914,6985,3180,43701,1115,875,81,2071,45772
20-05-2016,15,17334,15715,6385,3155,42589,983,693,81,1757,44346
20-05-2016,16,18339,15677,6093,2912,43021,997,619,246,1862,44883
20-05-2016,17,18701,15941,6221,2736,43601,1171,760,254,2185,45786
20-05-2016,18,18577,16162,6388,2718,43846,1172,862,98,2132,45978
20-05-2016,19,18498,16092,6398,2557,43546,1159,846,97,2102,45648
20-05-2016,20,18272,15915,6079,1869,42137,865,537,98,1500,43637
20-05-2016,21,18125,15655,5926,1680,41388,756,478,100,1334,42722
20-05-2016,22,17901,15170,5973,1652,40695,733,430,99,1262,41957
20-05-2016,23,16959,14541,5729,1714,38943,632,412,97,1141,40084
21-05-2016,0,16529,12884,5310,1369,36092,657,137,59,853,36945
21-05-2016,1,14928,12444,5421,1277,34070,621,131,48,800,34870
21-05-2016,2,13630,12029,5724,1198,32581,568,132,40,740,33321
21-05-2016,3,12853,11817,5678,1143,31491,558,135,65,758,32249
21-05-2016,4,12444,11616,5684,1135,30879,556,142,83,781,31660
21-05-2016,5,12322,11494,5627,1105,30549,559,231,105,895,31444
21-05-2016,6,12801,11657,5565,1157,31180,557,284,110,951,32131
21-05-2016,7,14711,12651,5616,1476,34455,643,350,119,1112,35567
21-05-2016,8,15435,13365,5618,1811,36230,705,562,126,1393,37623
21-05-2016,9,15563,14327,5622,1976,37487,725,628,113,1466,38953
21-05-2016,10,15237,14515,5580,2272,37603,680,633,140,1453,39056
21-05-2016,11,14974,14183,5650,2242,37050,652,609,186,1447,38497
21-05-2016,12,14334,13784,5692,2252,36061,647,477,225,1349,37410
21-05-2016,13,13983,13681,5678,2361,35703,645,420,237,1302,37005
21-05-2016,14,13602,13554,5712,2326,35195,589,418,244,1251,36446
21-05-2016,15,13411,13369,5720,2355,34856,583,344,201,1128,35984
21-05-2016,16,13296,13722,5724,2365,35106,579,346,151,1076,36182
21-05-2016,17,14026,14047,5722,2298,36093,663,345,112,1120,37213
21-05-2016,18,16326,15113,5708,2341,39488,709,356,101,1166,40654
21-05-2016,19,17577,15232,5550,2267,40627,689,355,82,1126,41753
21-05-2016,20,17458,15029,5614,1702,39803,660,387,75,1122,40925
21-05-2016,21,17308,14768,5578,1534,39188,709,316,47,1072,40260
21-05-2016,22,16957,14702,5556,1379,38595,734,147,63,944,39539
21-05-2016,23,15714,13355,5496,1492,36058,664,308,67,1039,37097
22-05-2016,0,12970,11825,5412,1546,31754,646,135,46,827,32581
22-05-2016,1,12019,11324,5391,1568,30302,608,133,43,784,31086
22-05-2016,2,11477,11018,5393,1596,29485,598,135,39,772,30257
22-05-2016,3,11487,10903,5371,1656,29416,599,136,34,769,30185
22-05-2016,4,11498,10875,5375,1636,29385,565,144,31,740,30125
22-05-2016,5,11418,10801,5393,1591,29202,562,232,29,823,30025
22-05-2016,6,11441,10838,5453,1707,29438,552,285,29,866,30304
22-05-2016,7,12172,11089,5516,1847,30623,556,346,29,931,31554
22-05-2016,8,13904,11619,5532,1969,33025,563,451,29,1043,34068
22-05-2016,9,15286,12103,5598,2355,35342,599,496,38,1133,36475
22-05-2016,10,15752,12752,5578,2464,36544,619,633,39,1291,37835
22-05-2016,11,15514,13194,5602,2545,36855,632,576,36,1244,38099
22-05-2016,12,15061,13370,5620,2646,36698,570,652,39,1261,37959
22-05-2016,13,14723,13302,5651,2868,36544,562,596,56,1214,37758
22-05-2016,14,14423,13399,5621,2695,36137,566,584,55,1205,37342
22-05-2016,15,14289,13371,5605,2702,35967,564,434,55,1053,37020
22-05-2016,16,14320,13693,5592,2628,36234,565,437,46,1048,37282
22-05-2016,17,14100,14455,5590,2387,36532,647,439,46,1132,37664
22-05-2016,18,15443,15304,5575,2204,38526,647,361,45,1053,39579
22-05-2016,19,16204,15953,5602,2131,39890,647,412,47,1106,40996
22-05-2016,20,16223,16122,5638,1878,39862,646,403,44,1093,40955
22-05-2016,21,16229,16105,5623,1507,39464,646,326,51,1023,40487
22-05-2016,22,16207,16103,5601,1248,39158,645,170,72,887,40045
22-05-2016,23,14699,15193,5609,1077,36579,631,160,97,888,37467
23-05-2016,0,13089,13569,5598,1229,33485,616,240,120,976,34461
23-05-2016,1,12168,13033,5615,892,31709,628,242,160,1030,32739
23-05-2016,2,11764,12851,5669,679,30963,647,244,200,1091,32054
23-05-2016,3,11521,12691,5696,640,30550,645,333,207,1185,31735
23-05-2016,4,11532,12512,5707,753,30502,702,455,218,1375,31877
23-05-2016,5,13052,12694,6025,903,32674,831,474,253,1558,34232
23-05-2016,6,17330,14311,6622,1248,39511,921,669,420,2010,41521
23-05-2016,7,19298,16643,6760,1547,44249,1002,948,498,2448,46697
23-05-2016,8,19609,17819,6739,1778,45945,1117,1115,509,2741,48686
23-05-2016,9,19718,17721,6745,1873,46055,1079,1065,515,2659,48714
23-05-2016,10,19778,17668,6682,2003,46133,1149,992,513,2654,48787
23-05-2016,11,19461,17473,6709,2128,45772,1061,994,489,2544,48316
23-05-2016,12,19390,17075,6716,2015,45197,1057,883,483,2423,47620
23-05-2016,13,19348,17051,6616,2060,45076,1051,893,476,2420,47496
23-05-2016,14,19499,16642,6507,2098,44747,1052,898,480,2430,47177
23-05-2016,15,19176,16700,6266,2129,44272,911,804,509,2224,46496
23-05-2016,16,19105,16244,6102,2174,43625,891,704,510,2105,45730
23-05-2016,17,19318,16219,6313,2153,44004,944,673,480,2097,46101
23-05-2016,18,19113,15869,6339,2043,43365,953,655,506,2114,45479
23-05-2016,19,18936,15630,6294,1921,42782,869,603,525,1997,44779
23-05-2016,20,18867,15074,6061,1877,41880,688,529,528,1745,43625
23-05-2016,21,18226,14917,5861,1770,40775,596,521,462,1579,42354
23-05-2016,22,17505,14551,5745,1529,39331,532,451,227,1210,40541
23-05-2016,23,14676,13673,5679,1500,35530,546,434,248,1228,36758
24-05-2016,0,13598,12559,5709,1655,33521,479,414,254,1147,34668
24-05-2016,1,13533,12634,5759,1449,33376,472,399,231,1102,34478
24-05-2016,2,12885,12548,5784,1322,32540,478,394,198,1070,33610
24-05-2016,3,12387,12512,5855,1498,32251,502,402,186,1090,33341
24-05-2016,4,12392,12411,5992,1623,32417,537,499,162,1198,33615
24-05-2016,5,13803,12801,6248,1575,34426,698,615,147,1460,35886
24-05-2016,6,16906,14665,6547,1743,39859,730,917,114,1761,41620
24-05-2016,7,18991,16203,6621,2088,43903,778,1094,274,2146,46049
24-05-2016,8,19021,17012,6743,2366,45142,774,1085,257,2116,47258
24-05-2016,9,19154,17168,6719,2508,45550,776,1199,342,2317,47867
24-05-2016,10,19232,17187,6746,2555,45719,780,1179,656,2615,48334
24-05-2016,11,19132,17160,6737,2526,45555,784,1206,670,2660,48215
24-05-2016,12,18995,16974,6743,2329,45041,794,1200,671,2665,47706
24-05-2016,13,18845,16787,6674,2410,44714,803,1142,749,2694,47408
24-05-2016,14,18537,16727,6587,2652,44504,815,1084,671,2570,47074
24-05-2016,15,18637,16461,6213,2632,43943,706,1016,489,2211,46154
24-05-2016,16,18537,16144,6001,2492,43175,669,951,473,2093,45268
24-05-2016,17,18695,16095,6228,2415,43434,681,885,62,1628,45062
24-05-2016,18,18362,15987,6346,2537,43233,676,919,558,2153,45386
24-05-2016,19,18377,15779,6309,2159,42623,662,927,507,2096,44719
24-05-2016,20,18123,15436,5916,1908,41385,557,795,518,1870,43255
24-05-2016,21,17975,15460,5686,1879,41000,534,665,549,1748,42748
24-05-2016,22,18029,15026,5598,1770,40423,479,713,381,1573,41996
24-05-2016,23,16139,14748,5500,1965,38353,459,608,470,1537,39890
25-05-2016,0,13846,14558,5507,1943,35855,483,412,531,1426,37281
25-05-2016,1,13111,14435,5498,1630,34674,474,401,504,1379,36053
25-05-2016,2,13008,14223,5536,1570,34336,470,400,520,1390,35726
25-05-2016,3,12380,14087,5560,1672,33699,475,398,517,1390,35089
25-05-2016,4,12684,13788,5646,1783,33901,472,409,495,1376,35277
25-05-2016,5,15049,14007,5955,1859,36870,532,479,479,1490,38360
25-05-2016,6,17711,14932,6439,2145,41227,676,856,507,2039,43266
25-05-2016,7,19238,16778,6567,2456,45041,679,870,670,2219,47260
25-05-2016,8,18867,17280,6668,2927,45745,679,912,715,2306,48051
25-05-2016,9,18929,17203,6655,3051,45839,679,989,815,2483,48322
25-05-2016,10,18865,17087,6762,3087,45801,687,987,832,2506,48307
25-05-2016,11,18782,17319,6757,3036,45894,695,1126,702,2523,48417
25-05-2016,12,18630,17300,6682,2968,45581,694,1202,763,2659,48240
25-05-2016,13,18482,17216,6675,3071,45445,696,1070,641,2407,47852
25-05-2016,14,18360,17155,6637,3122,45274,702,978,683,2363,47637
25-05-2016,15,18579,16775,6330,2924,44608,622,938,532,2092,46700
25-05-2016,16,18510,16520,6129,2874,44033,622,950,502,2074,46107
25-05-2016,17,18612,16714,6128,2833,44287,645,948,680,2273,46560
25-05-2016,18,18182,16513,6143,2475,43314,574,935,724,2233,45547
25-05-2016,19,17986,16220,6258,2221,42685,562,797,717,2076,44761
25-05-2016,20,17786,15728,5915,2147,41578,472,649,684,1805,43383
25-05-2016,21,17628,15518,5822,2066,41037,469,610,693,1772,42809
25-05-2016,22,16637,15288,5943,2057,39924,444,584,493,1521,41445
25-05-2016,23,15288,14854,5866,2051,38060,482,470,485,1437,39497
26-05-2016,0,14694,14337,5782,2011,36825,437,390,122,949,37774
26-05-2016,1,14214,13991,5823,1913,35942,418,385,122,925,36867
26-05-2016,2,14246,13933,5812,1697,35690,421,388,118,927,36617
26-05-2016,3,14211,13859,5749,1684,35504,436,395,122,953,36457
26-05-2016,4,14364,13815,5721,1555,35456,448,416,126,990,36446
26-05-2016,5,15519,14165,6038,1530,37250,565,529,111,1205,38455
26-05-2016,6,17261,15491,6585,1799,41135,742,973,138,1853,42988
26-05-2016,7,18760,17151,6932,2260,45102,839,1091,319,2249,47351
26-05-2016,8,19292,17678,7083,2419,46473,850,1230,309,2389,48862
26-05-2016,9,18889,17823,7136,2271,46118,838,1238,312,2388,48506
26-05-2016,10,17746,17481,7233,1908,44368,818,1138,347,2303,46671
26-05-2016,11,17636,17143,7091,1839,43709,821,1154,315,2290,45999
26-05-2016,12,17269,16936,7013,1846,43063,749,1159,382,2290,45353
26-05-2016,13,17031,16713,6993,1787,42524,715,1143,363,2221,44745
26-05-2016,14,17217,16687,6964,1742,42610,713,1067,340,2120,44730
26-05-2016,15,17523,16679,6540,1785,42527,682,947,307,1936,44463
26-05-2016,16,17862,16793,6336,1972,42962,696,850,315,1861,44823
26-05-2016,17,18155,17081,6568,2140,43944,848,858,317,2023,45967
26-05-2016,18,18253,17138,6616,2135,44142,790,914,304,2008,46150
26-05-2016,19,18457,16928,6631,2052,44068,797,885,301,1983,46051
26-05-2016,20,18212,16794,6123,1912,43042,675,755,299,1729,44771
26-05-2016,21,18251,16306,5932,1673,42161,674,649,140,1463,43624
26-05-2016,22,17954,15926,5871,1547,41298,673,613,76,1362,42660
26-05-2016,23,17282,14939,5835,1168,39224,580,616,80,1276,40500
27-05-2016,0,15662,14094,5834,1122,36712,524,401,74,999,37711
27-05-2016,1,13936,13942,5859,1087,34825,510,383,73,966,35791
27-05-2016,2,12390,13913,5871,1016,33190,527,391,75,993,34183
27-05-2016,3,11647,13725,5877,966,32216,572,475,64,1111,33327
27-05-2016,4,12346,13649,5965,1024,32984,594,508,78,1180,34164
27-05-2016,5,15105,14116,6164,1145,36530,698,697,183,1578,38108
27-05-2016,6,17678,15892,6509,1493,41572,897,954,454,2305,43877
27-05-2016,7,18989,17304,6639,2047,44978,969,1040,700,2709,47687
27-05-2016,8,19203,17819,6662,2386,46068,972,1214,705,2891,48959
27-05-2016,9,18933,17638,6689,2474,45733,984,1299,603,2886,48619
27-05-2016,10,18876,17655,6679,2565,45775,976,1208,623,2807,48582
27-05-2016,11,18749,17534,6634,2680,45598,987,1147,640,2774,48372
27-05-2016,12,18445,17301,6595,2669,45010,1020,1133,637,2790,47800
27-05-2016,13,18264,16904,6559,2393,44122,1018,1038,635,2691,46813
27-05-2016,14,18084,16278,6464,2338,43164,1005,913,630,2548,45712
27-05-2016,15,18196,15939,6286,2333,42754,924,896,459,2279,45033
27-05-2016,16,18062,16180,6250,2381,42872,890,896,463,2249,45121
27-05-2016,17,18045,16069,6362,2333,42809,910,710,466,2086,44895
27-05-2016,18,17862,16098,6468,2205,42632,904,811,476,2191,44823
27-05-2016,19,17787,15847,6426,1975,42036,916,763,489,2168,44204
27-05-2016,20,17533,15770,6044,1926,41272,651,666,505,1822,43094
27-05-2016,21,17523,15229,5852,1707,40310,613,637,530,1780,42090
27-05-2016,22,17566,15052,5781,1598,39997,667,599,407,1673,41670
27-05-2016,23,16930,14652,5648,1506,38737,626,577,111,1314,40051
28-05-2016,0,16219,13219,5475,1322,36233,562,430,101,1093,37326
28-05-2016,1,15388,12834,5442,1183,34848,554,419,115,1088,35936
28-05-2016,2,13680,12587,5369,1162,32800,548,416,152,1116,33916
28-05-2016,3,12563,12408,5342,1053,31366,526,419,187,1132,32498
28-05-2016,4,12058,12197,5300,1048,30603,561,430,213,1204,31807
28-05-2016,5,11991,12206,5257,1038,30491,610,529,201,1340,31831
28-05-2016,6,13064,12285,5278,1060,31687,667,546,130,1343,33030
28-05-2016,7,15476,13567,5389,1121,35552,665,655,65,1385,36937
28-05-2016,8,16612,14764,5532,1321,38229,746,1034,60,1840,40069
28-05-2016,9,17142,14881,5477,1432,38934,751,1169,64,1984,40918
28-05-2016,10,16889,14351,5442,1473,38154,732,1183,69,1984,40138
28-05-2016,11,15818,14103,5443,1543,36906,740,1172,96,2008,38914
28-05-2016,12,14941,13926,5388,1446,35701,727,1163,100,1990,37691
28-05-2016,13,14076,13890,5425,1430,34820,714,1158,213,2085,36905
28-05-2016,14,13632,13654,5364,1463,34112,734,1143,132,2009,36121
28-05-2016,15,13471,13231,5361,1456,33518,725,1047,139,1911,35429
28-05-2016,16,13922,13413,5364,1369,34069,720,761,159,1640,35709
28-05-2016,17,15094,13661,5405,1378,35539,720,740,187,1647,37186
28-05-2016,18,16656,14103,5479,1495,37733,779,764,148,1691,39424
28-05-2016,19,17176,14122,5475,1364,38138,789,706,149,1644,39782
28-05-2016,20,16647,13892,5492,1317,37348,760,675,187,1622,38970
28-05-2016,21,16206,13746,5468,1399,36819,745,596,221,1562,38381
28-05-2016,22,15479,13622,5431,1383,35913,711,569,271,1551,37464
28-05-2016,23,13423,13089,5381,1319,33212,716,567,321,1604,34816
29-05-2016,0,11328,11548,5208,1231,29313,724,444,323,1491,30804
29-05-2016,1,10832,11085,5235,1207,28359,716,425,318,1459,29818
29-05-2016,2,10145,10899,5241,1072,27359,719,368,301,1388,28747
29-05-2016,3,9828,10855,5225,1057,26965,711,368,292,1371,28336
29-05-2016,4,9751,10798,5198,1061,26807,712,462,285,1459,28266
29-05-2016,5,9339,10823,5148,1093,26403,689,471,259,1419,27822
29-05-2016,6,9710,10856,5156,1034,26756,679,588,172,1439,28195
29-05-2016,7,10832,11072,5225,1067,28196,680,636,119,1435,29631
29-05-2016,8,12335,11716,5248,1205,30505,678,757,97,1532,32037
29-05-2016,9,13237,12568,5244,1305,32354,680,789,86,1555,33909
29-05-2016,10,13860,12946,5244,1515,33567,691,843,113,1647,35214
29-05-2016,11,14013,13184,5261,1824,34283,690,844,127,1661,35944
29-05-2016,12,14020,13468,5212,2068,34768,704,795,129,1628,36396
29-05-2016,13,13913,13377,5262,2060,34613,707,795,132,1634,36247
29-05-2016,14,13559,13312,5232,2208,34312,714,790,128,1632,35944
29-05-2016,15,12917,13054,5259,2227,33459,718,791,117,1626,35085
29-05-2016,16,12897,13313,5273,2286,33770,710,789,115,1614,35384
29-05-2016,17,13764,13626,5276,2323,34991,722,760,112,1594,36585
29-05-2016,18,14082,13918,5298,2307,35605,714,755,123,1592,37197
29-05-2016,19,14196,14080,5286,2428,35990,750,755,149,1654,37644
29-05-2016,20,14802,14270,5346,2395,36813,805,748,166,1719,38532
29-05-2016,21,14920,14443,5312,2451,37127,822,678,219,1719,38846
29-05-2016,22,14345,14265,5274,2493,36376,835,633,260,1728,38104
29-05-2016,23,11848,13064,5304,2504,32721,824,629,256,1709,34430
30-05-2016,0,10494,11993,5308,2637,30433,816,423,242,1481,31914
30-05-2016,1,9680,11655,5217,2599,29151,823,359,244,1426,30577
30-05-2016,2,9100,11455,5226,2594,28377,814,375,247,1436,29813
30-05-2016,3,8940,11333,5211,2591,28074,835,358,241,1434,29508
30-05-2016,4,9142,11328,5342,2611,28423,855,426,228,1509,29932
30-05-2016,5,11002,11768,5829,2707,31306,999,630,225,1854,33160
30-05-2016,6,14914,13713,6230,2866,37723,1368,919,170,2457,40180
30-05-2016,7,17777,15376,6523,3137,42813,1439,1224,240,2903,45716
30-05-2016,8,18696,16104,6556,3198,44554,1454,1318,321,3093,47647
30-05-2016,9,18484,16167,6524,3363,44538,1461,1319,387,3167,47705
30-05-2016,10,18454,16180,6506,3469,44610,1475,1325,437,3237,47847
30-05-2016,11,18390,15980,6506,3496,44374,1494,1329,354,3177,47551
30-05-2016,12,18049,15838,6539,3507,43934,1509,1322,355,3186,47120
30-05-2016,13,17655,15642,6478,3645,43421,1513,1230,355,3098,46519
30-05-2016,14,17333,15502,6444,3762,43041,1521,1189,336,3046,46087
30-05-2016,15,16696,15466,6068,3700,41931,1443,1000,305,2748,44679
30-05-2016,16,16507,15421,5950,3606,41483,1363,872,297,2532,44015
30-05-2016,17,16877,15312,6074,3370,41631,1475,933,325,2733,44364
30-05-2016,18,16850,15233,6168,3202,41455,1491,923,354,2768,44223
30-05-2016,19,16952,15043,6209,3062,41266,1257,869,371,2497,43763
30-05-2016,20,16686,14807,5761,2807,40063,991,762,355,2108,42171
30-05-2016,21,16206,14371,5540,2662,38779,896,691,357,1944,40723
30-05-2016,22,15708,14155,5521,2765,38149,838,572,307,1717,39866
30-05-2016,23,13737,13674,5401,2742,35554,836,518,319,1673,37227
31-05-2016,0,12012,12257,5259,2767,32294,858,492,354,1704,33998
31-05-2016,1,11313,11884,5184,2732,31114,848,488,366,1702,32816
31-05-2016,2,10712,11773,5185,2621,30291,845,490,353,1688,31979
31-05-2016,3,10609,11676,5130,2552,29968,835,560,345,1740,31708
31-05-2016,4,10498,11470,5308,2456,29733,839,559,353,1751,31484
31-05-2016,5,12204,11832,5882,2437,32356,975,578,329,1882,34238
31-05-2016,6,15550,13386,6215,2337,37490,1203,914,284,2401,39891
31-05-2016,7,17600,16103,6429,2562,42696,1297,1161,375,2833,45529
31-05-2016,8,17803,16782,6498,3105,44190,1338,1205,705,3248,47438
31-05-2016,9,17860,16611,6528,3124,44125,1439,1195,641,3275,47400
31-05-2016,10,17593,16536,6403,3287,43818,1483,1329,775,3587,47405
31-05-2016,11,17506,16458,6447,3275,43686,1422,1342,795,3559,47245
31-05-2016,12,17747,16490,6410,3286,43934,1429,1386,849,3664,47598
31-05-2016,13,17787,16200,6488,3315,43790,1440,1249,773,3462,47252
31-05-2016,14,17783,16175,6462,3250,43671,1437,1173,667,3277,46948
31-05-2016,15,17581,16062,6197,3181,43021,1446,1146,532,3124,46145
31-05-2016,16,17566,15979,6009,2859,42416,1449,892,359,2700,45116
31-05-2016,17,17446,16509,6089,2819,42864,1469,877,364,2710,45574
31-05-2016,18,17298,16227,6137,2817,42480,1446,935,345,2726,45206
31-05-2016,19,17200,15914,6115,2815,42044,1441,912,336,2689,44733
31-05-2016,20,16987,15453,5841,2767,41048,1061,754,355,2170,43218
31-05-2016,21,16634,14959,5468,2665,39726,1011,612,390,2013,41739
31-05-2016,22,16548,14374,5333,2590,38845,991,582,401,1974,40819
31-05-2016,23,15765,13429,5188,2167,36547,871,561,428,1860,38407
01-06-2016,0,14445,12188,4981,1912,33526,864,400,436,1700,35226
01-06-2016,1,12922,11795,4875,1828,31421,856,378,403,1637,33058
01-06-2016,2,12656,11532,4877,1990,31056,848,381,421,1650,32706
01-06-2016,3,12115,11167,4851,1848,29981,822,396,413,1631,31612
01-06-2016,4,12146,10835,5012,1574,29567,875,542,389,1806,31373
01-06-2016,5,13277,10974,5528,1603,31382,1069,618,381,2068,33450
01-06-2016,6,15767,13184,6081,2139,37170,1343,936,389,2668,39838
01-06-2016,7,16945,15185,6336,2377,40842,1384,1161,515,3060,43902
01-06-2016,8,17659,15742,6315,2519,42235,1388,1226,683,3297,45532
01-06-2016,9,17842,15787,6338,2597,42564,1412,1353,742,3507,46071
01-06-2016,10,17697,15803,6306,2634,42441,1463,1336,849,3648,46089
01-06-2016,11,17584,15577,6215,2871,42247,1479,1391,808,3678,45925
01-06-2016,12,17737,15516,6202,3009,42464,1464,1287,894,3645,46109
01-06-2016,13,17804,15450,6172,3100,42526,1485,1253,899,3637,46163
01-06-2016,14,17570,15126,6107,3042,41844,1487,1179,770,3436,45280
01-06-2016,15,17429,14884,6062,2786,41161,1476,1137,701,3314,44475
01-06-2016,16,16978,14640,5809,2482,39909,1321,1061,521,2903,42812
01-06-2016,17,17087,14781,5843,2544,40257,1289,777,494,2560,42817
01-06-2016,18,17151,14902,6068,2457,40579,1472,636,489,2597,43176
01-06-2016,19,17068,14800,6088,2498,40452,1386,649,483,2518,42970
01-06-2016,20,16805,14664,5766,2336,39570,1072,609,491,2172,41742
01-06-2016,21,16487,13975,5517,2238,38219,946,631,547,2124,40343
01-06-2016,22,16667,13651,5335,2003,37658,956,606,285,1847,39505
01-06-2016,23,15996,12997,5211,1907,36112,983,590,224,1797,37909
02-06-2016,0,13748,11320,4937,1699,31703,847,380,149,1376,33079
02-06-2016,1,12708,10693,4833,1451,29686,810,330,124,1264,30950
02-06-2016,2,12310,10639,4820,1338,29107,810,318,98,1226,30333
02-06-2016,3,12010,10585,4764,1264,28623,804,316,84,1204,29827
02-06-2016,4,11991,10478,4892,1259,28621,851,324,84,1259,29880
02-06-2016,5,13242,10872,5196,1276,30586,1160,550,76,1786,32372
02-06-2016,6,15582,12614,5909,1600,35706,1408,677,408,2493,38199
02-06-2016,7,17214,14974,6252,1971,40412,1400,1062,473,2935,43347
02-06-2016,8,17668,15178,6283,1997,41125,1408,1262,844,3514,44639
02-06-2016,9,17936,15467,6366,2087,41856,1409,1263,858,3530,45386
02-06-2016,10,18018,15744,6382,2205,42349,1413,1303,816,3532,45881
02-06-2016,11,17778,15513,6372,2339,42002,1480,1268,732,3480,45482
02-06-2016,12,17368,14829,6359,2576,41131,1464,1241,687,3392,44523
02-06-2016,13,17551,14431,6422,2627,41031,1469,1205,683,3357,44388
02-06-2016,14,17315,14410,6371,2667,40762,1487,1136,678,3301,44063
02-06-2016,15,16983,14304,6250,2596,40132,1464,957,687,3108,43240
02-06-2016,16,16750,14392,6004,2801,39947,1320,702,657,2679,42626
02-06-2016,17,16632,14676,5943,2702,39951,1471,692,546,2709,42660
02-06-2016,18,16577,15258,6017,2758,40610,1452,648,553,2653,43263
02-06-2016,19,16761,15389,6028,2608,40787,1439,642,518,2599,43386
02-06-2016,20,16707,15131,5707,2315,39861,1097,623,532,2252,42113
02-06-2016,21,16614,14552,5647,2129,38942,1002,615,381,1998,40940
02-06-2016,22,16471,13676,5426,2018,37592,981,514,71,1566,39158
02-06-2016,23,15450,12737,5159,1665,35011,936,504,79,1519,36530
03-06-2016,0,14761,11325,4974,1501,32562,836,451,80,1367,33929
03-06-2016,1,13306,10741,4821,1417,30284,797,417,79,1293,31577
03-06-2016,2,13023,10868,4887,1323,30101,793,397,59,1249,31350
03-06-2016,3,12681,10884,4979,1306,29850,784,363,54,1201,31051
03-06-2016,4,12381,10788,5141,1353,29663,810,416,48,1274,30937
03-06-2016,5,12902,11044,5640,1315,30903,1196,516,48,1760,32663
03-06-2016,6,15518,13420,6110,1588,36637,1464,816,237,2517,39154
03-06-2016,7,16958,15674,6511,1772,40914,1471,1000,423,2894,43808
03-06-2016,8,17633,16486,6690,1838,42647,1472,1209,623,3304,45951
03-06-2016,9,17855,16562,6684,1915,43017,1482,1341,622,3445,46462
03-06-2016,10,17843,16568,6576,1942,42928,1493,1339,599,3431,46359
03-06-2016,11,17608,16535,6686,2001,42829,1505,1325,609,3439,46268
03-06-2016,12,17562,15867,6664,1982,42076,1512,1265,649,3426,45502
03-06-2016,13,17259,14943,6567,1892,40661,1490,1219,676,3385,44046
03-06-2016,14,17111,14543,6420,1816,39889,1482,1123,613,3218,43107
03-06-2016,15,16739,14665,6489,1690,39585,1168,1038,619,2825,42410
03-06-2016,16,16416,14656,6223,1467,38763,1027,648,632,2307,41070
03-06-2016,17,16494,14908,6056,1307,38764,1058,652,451,2161,40925
03-06-2016,18,16680,15576,6390,1209,39853,1148,566,443,2157,42010
03-06-2016,19,16616,15634,6266,1094,39609,1139,558,484,2181,41790
03-06-2016,20,16367,15330,5643,939,38280,974,576,528,2078,40358
03-06-2016,21,16175,14373,5581,891,37021,930,545,398,1873,38894
03-06-2016,22,16069,14259,5653,895,36875,922,476,120,1518,38393
03-06-2016,23,15557,13300,5544,843,35245,942,460,115,1517,36762
04-06-2016,0,15040,11498,5296,626,32459,928,374,110,1412,33871
04-06-2016,1,14147,11054,5121,557,30879,945,373,107,1425,32304
04-06-2016,2,12554,10711,5010,509,28784,925,314,142,1381,30165
04-06-2016,3,12345,10586,4868,510,28309,889,209,148,1246,29555
04-06-2016,4,12263,10466,4837,519,28084,880,269,191,1340,29424
04-06-2016,5,12415,10463,4884,505,28266,861,428,150,1439,29705
04-06-2016,6,12919,10582,5003,590,29093,860,529,111,1500,30593
04-06-2016,7,14459,11759,5113,707,32037,896,624,77,1597,33634
04-06-2016,8,15609,13352,5339,989,35289,930,1009,67,2006,37295
04-06-2016,9,16306,13946,5618,1100,36969,948,1161,62,2171,39140
04-06-2016,10,16669,14083,5618,1057,37427,960,1130,122,2212,39639
04-06-2016,11,16348,13118,5497,1116,36080,936,1116,103,2155,38235
04-06-2016,12,16158,12702,5342,1118,35322,954,1066,139,2159,37481
04-06-2016,13,15474,12384,5191,1120,34170,927,1059,115,2101,36271
04-06-2016,14,14997,12219,5160,1127,33503,933,724,157,1814,35317
04-06-2016,15,14798,12173,5088,1108,33166,936,612,189,1737,34903
04-06-2016,16,14914,12043,5095,1073,33125,930,621,168,1719,34844
04-06-2016,17,15797,12407,5238,1033,34476,966,575,150,1691,36167
04-06-2016,18,16216,13377,5321,1069,35983,941,574,131,1646,37629
04-06-2016,19,16270,14449,5274,1011,37002,931,728,129,1788,38790
04-06-2016,20,16029,14457,5258,905,36650,926,703,130,1759,38409
04-06-2016,21,15871,14344,5271,927,36414,887,558,121,1566,37980
04-06-2016,22,15892,14274,5215,1036,36417,912,578,132,1622,38039
04-06-2016,23,15508,13314,5224,828,34872,952,469,133,1554,36426
05-06-2016,0,14354,11222,5095,620,31291,905,291,130,1326,32617
05-06-2016,1,12452,10314,5038,538,28342,887,208,134,1229,29571
05-06-2016,2,11471,10040,4980,533,27023,893,279,157,1329,28352
05-06-2016,3,11016,9876,4842,538,26271,902,304,162,1368,27639
05-06-2016,4,10702,9940,4873,555,26070,888,306,154,1348,27418
05-06-2016,5,10663,9834,4811,599,25908,892,497,139,1528,27436
05-06-2016,6,10949,9823,4950,617,26338,876,511,102,1489,27827
05-06-2016,7,12079,9843,5179,711,27813,870,518,113,1501,29314
05-06-2016,8,12996,10417,5233,764,29412,869,582,116,1567,30979
05-06-2016,9,14092,10978,5290,880,31241,849,723,113,1685,32926
05-06-2016,10,14560,11425,5352,958,32295,883,667,122,1672,33967
05-06-2016,11,14441,11423,5469,1027,32360,879,686,136,1701,34061
05-06-2016,12,14547,11448,5451,1074,32522,850,635,137,1622,34144
05-06-2016,13,14382,11279,5474,1035,32169,841,594,158,1593,33762
05-06-2016,14,14363,11195,5457,1052,32066,785,597,180,1562,33628
05-06-2016,15,14106,11125,5495,1061,31787,770,601,188,1559,33346
05-06-2016,16,14036,11221,5454,1018,31729,786,601,200,1587,33316
05-06-2016,17,14484,11515,5326,948,32273,834,572,208,1614,33887
05-06-2016,18,15139,12325,5374,940,33778,849,547,230,1626,35404
05-06-2016,19,15568,12867,5409,981,34826,810,509,236,1555,36381
05-06-2016,20,15820,12944,5367,1097,35228,818,769,229,1816,37044
05-06-2016,21,15815,13167,5338,1018,35339,821,753,224,1798,37137
05-06-2016,22,15919,13725,5481,1057,36183,873,590,223,1686,37869
05-06-2016,23,15444,12316,5212,904,33877,887,454,210,1551,35428
06-06-2016,0,14908,10939,5070,676,31591,912,386,202,1500,33091
06-06-2016,1,13821,10357,4961,622,29761,895,386,201,1482,31243
06-06-2016,2,12491,10101,5029,791,28413,923,388,210,1521,29934
06-06-2016,3,12212,9941,4941,941,28033,975,392,186,1553,29586
06-06-2016,4,12302,9891,5170,1093,28455,1037,464,243,1744,30199
06-06-2016,5,13665,10249,5525,1183,30624,1179,510,363,2052,32676
06-06-2016,6,15427,12116,5977,1564,35084,1189,910,828,2927,38011
06-06-2016,7,16845,14061,6112,1985,39003,1187,1237,821,3245,42248
06-06-2016,8,17251,14390,6193,2138,39973,1183,1225,821,3229,43202
06-06-2016,9,17019,14035,6349,2275,39679,1119,1210,783,3112,42791
06-06-2016,10,17333,14075,6404,2464,40277,1123,1171,866,3160,43437
06-06-2016,11,16992,13872,6273,2514,39651,1158,1177,1234,3569,43220
06-06-2016,12,16543,13474,6244,2522,38782,1255,1065,1320,3640,42422
06-06-2016,13,16415,13008,6316,2503,38242,1332,1015,1246,3593,41835
06-06-2016,14,16749,13025,6223,2475,38471,1322,946,1097,3365,41836
06-06-2016,15,17095,13405,6070,2591,39161,1193,825,782,2800,41961
06-06-2016,16,17048,14074,5915,2524,39562,1215,537,339,2091,41653
06-06-2016,17,16809,14415,5758,2485,39466,1186,518,379,2083,41549
06-06-2016,18,16625,15074,5893,2406,39999,1185,521,563,2269,42268
06-06-2016,19,16749,15056,6117,2287,40210,1199,513,444,2156,42366
06-06-2016,20,16701,14555,5976,2100,39332,1174,519,146,1839,41171
06-06-2016,21,16586,14218,5664,1847,38314,1177,523,129,1829,40143
06-06-2016,22,16143,13888,5465,1891,37387,1168,496,123,1787,39174
06-06-2016,23,15600,12130,5208,1952,34889,1073,422,112,1607,36496
07-06-2016,0,14789,10878,5103,1624,32394,790,365,98,1253,33647
07-06-2016,1,13631,10397,4954,1370,30353,770,360,73,1203,31556
07-06-2016,2,12771,10410,5038,1252,29470,779,360,64,1203,30673
07-06-2016,3,12314,10414,5152,1170,29050,780,369,54,1203,30253
07-06-2016,4,12281,10335,5376,1157,29149,767,472,50,1289,30438
07-06-2016,5,13489,10913,5760,1160,31322,869,497,155,1521,32843
07-06-2016,6,15665,13049,6089,1645,36450,1142,527,355,2024,38474
07-06-2016,7,17003,16003,6357,1876,41239,1175,707,785,2667,43906
07-06-2016,8,17359,16378,6366,1988,42091,1183,907,786,2876,44967
07-06-2016,9,17310,15998,6366,2023,41696,1193,1171,790,3154,44850
07-06-2016,10,17568,15984,6377,2074,42002,1203,1168,798,3169,45171
07-06-2016,11,17501,16081,6402,2101,42085,1218,1021,804,3043,45128
07-06-2016,12,17234,16093,6351,1948,41625,1227,1010,810,3047,44672
07-06-2016,13,17297,15901,6317,1866,41380,1233,953,818,3004,44384
07-06-2016,14,17324,15957,6262,1796,41339,1251,951,646,2848,44187
07-06-2016,15,17447,15559,6290,1784,41081,1244,958,650,2852,43933
07-06-2016,16,17212,15491,5974,1991,40668,1134,642,507,2283,42951
07-06-2016,17,17274,15683,5995,1913,40866,1116,617,438,2171,43037
07-06-2016,18,17300,16468,6233,1889,41891,1151,612,491,2254,44145
07-06-2016,19,17207,16884,6363,1861,42314,1127,601,655,2383,44697
07-06-2016,20,16850,16605,6225,1842,41521,911,526,408,1845,43366
07-06-2016,21,16277,15445,6104,1753,39579,898,522,100,1520,41099
07-06-2016,22,16272,14433,5769,1754,38229,885,507,104,1496,39725
07-06-2016,23,15589,13171,5474,1853,36087,848,451,113,1412,37499
08-06-2016,0,14705,12136,5152,1974,33968,771,375,124,1270,35238
08-06-2016,1,13409,11900,4950,1923,32183,772,375,141,1288,33471
08-06-2016,2,12531,11782,4867,1954,31135,783,529,174,1486,32621
08-06-2016,3,11910,11759,4937,2115,30721,769,537,222,1528,32249
08-06-2016,4,11774,11760,5132,2182,30847,785,552,237,1574,32421
08-06-2016,5,12979,12140,5424,2308,32851,815,569,224,1608,34459
08-06-2016,6,15756,13636,6179,2617,38189,998,592,175,1765,39954
08-06-2016,7,17411,16352,6708,2789,43259,1100,580,349,2029,45288
08-06-2016,8,17682,17172,6890,2871,44617,1142,1015,342,2499,47116
08-06-2016,9,17732,17357,6916,2943,44949,1152,1155,346,2653,47602
08-06-2016,10,17614,17370,6906,2979,44869,1161,1217,344,2722,47591
08-06-2016,11,17552,17003,6844,3121,44521,1184,1179,344,2707,47228
08-06-2016,12,17721,16233,6977,3041,43972,1190,1162,351,2703,46675
08-06-2016,13,17693,15971,6980,2795,43438,1195,955,492,2642,46080
08-06-2016,14,17654,15911,6899,2721,43186,1220,914,334,2468,45654
08-06-2016,15,17514,15856,6814,2661,42846,1229,729,319,2277,45123
08-06-2016,16,17300,15639,6418,2725,42083,1218,441,145,1804,43887
08-06-2016,17,17177,15328,6301,2755,41562,1224,529,148,1901,43463
08-06-2016,18,16940,15496,6549,2731,41717,1188,538,606,2332,44049
08-06-2016,19,16913,15244,6610,2517,41284,1202,545,591,2338,43622
08-06-2016,20,16829,15026,6482,2356,40692,1034,457,304,1795,42487
08-06-2016,21,16936,14534,6420,2105,39995,908,442,215,1565,41560
08-06-2016,22,16659,14280,6174,1869,38981,919,501,184,1604,40585
08-06-2016,23,15745,13077,5911,1550,36283,926,457,355,1738,38021
09-06-2016,0,13973,12409,5672,1234,33289,927,382,187,1496,34785
09-06-2016,1,12197,12098,5487,1057,30840,925,382,122,1429,32269
09-06-2016,2,11659,11924,5537,798,29918,925,384,110,1419,31337
09-06-2016,3,11714,11759,5688,751,29912,923,394,116,1433,31345
09-06-2016,4,11888,11632,5959,652,30131,920,406,142,1468,31599
09-06-2016,5,13125,11964,6154,720,31965,1018,428,227,1673,33638
09-06-2016,6,15900,13562,6576,1188,37227,1176,438,248,1862,39089
09-06-2016,7,17428,16296,7295,1558,42577,1283,447,455,2185,44762
09-06-2016,8,17686,16850,7279,1771,43587,1297,988,320,2605,46192
09-06-2016,9,17743,16986,7281,1935,43945,1294,1044,348,2686,46631
09-06-2016,10,17549,17066,7305,2121,44042,1303,996,388,2687,46729
09-06-2016,11,17636,16529,7316,2310,43791,1311,810,378,2499,46290
09-06-2016,12,17533,16201,7297,2417,43447,1300,848,400,2548,45995
09-06-2016,13,17437,15852,7200,2483,42972,1282,797,401,2480,45452
09-06-2016,14,17353,15319,7124,2575,42370,1269,752,426,2447,44817
09-06-2016,15,17472,14920,7030,2617,42041,1268,744,439,2451,44492
09-06-2016,16,17253,14395,6773,2633,41055,1206,568,241,2015,43070
09-06-2016,17,17356,14352,6762,2908,41378,1202,553,222,1977,43355
09-06-2016,18,17149,14972,6811,2859,41791,1169,534,348,2051,43842
09-06-2016,19,17243,15199,6811,2771,42024,1173,653,437,2263,44287
09-06-2016,20,17284,14569,6520,2552,40924,1086,556,113,1755,42679
09-06-2016,21,17276,13617,6319,2428,39639,924,550,100,1574,41213
09-06-2016,22,16890,13001,6168,2542,38600,844,492,74,1410,40010
09-06-2016,23,15841,11881,5972,2748,36442,818,481,62,1361,37803
10-06-2016,0,14172,11206,5920,2760,34058,779,212,49,1040,35098
10-06-2016,1,12559,11158,5658,2875,32251,767,206,51,1024,33275
10-06-2016,2,11067,11125,5581,2848,30620,741,208,58,1007,31627
10-06-2016,3,10710,11084,5588,2905,30289,741,205,85,1031,31320
10-06-2016,4,11231,11089,5770,2834,30924,747,215,114,1076,32000
10-06-2016,5,12974,11707,6271,2800,33752,909,235,129,1273,35025
10-06-2016,6,15713,13444,6692,2841,38691,920,550,157,1627,40318
10-06-2016,7,17147,15678,6977,3022,42823,1003,951,231,2185,45008
10-06-2016,8,17653,16375,7144,3131,44303,992,948,276,2216,46519
10-06-2016,9,17692,16398,7209,3010,44309,996,945,295,2236,46545
10-06-2016,10,17386,16467,7229,2851,43933,957,898,327,2182,46115
10-06-2016,11,17047,15828,7159,2722,42756,1020,833,326,2179,44935
10-06-2016,12,16955,15486,7230,2571,42243,1018,879,352,2249,44492
10-06-2016,13,16932,15146,7080,2399,41557,1002,794,279,2075,43632
10-06-2016,14,16784,14893,6990,2319,40985,880,612,271,1763,42748
10-06-2016,15,16534,14579,6858,2323,40295,871,650,158,1679,41974
10-06-2016,16,16803,14136,6529,2160,39629,936,508,180,1624,41253
10-06-2016,17,17272,14175,6509,2050,40008,1019,440,185,1644,41652
10-06-2016,18,17058,14502,6780,2312,40652,1003,336,151,1490,42142
10-06-2016,19,17171,14306,6860,2219,40558,989,346,137,1472,42030
10-06-2016,20,16963,13700,6770,2013,39446,984,322,157,1463,40909
10-06-2016,21,16569,12648,6831,1846,37895,999,388,207,1594,39489
10-06-2016,22,16240,12131,6664,1838,36873,1021,251,255,1527,38400
10-06-2016,23,16108,11005,6363,1669,35146,962,253,283,1498,36644
11-06-2016,0,15278,9854,6005,1236,32373,897,302,270,1469,33842
11-06-2016,1,13925,9590,5795,1115,30426,894,298,274,1466,31892
11-06-2016,2,12814,9378,5536,1038,28765,864,208,292,1364,30129
11-06-2016,3,12480,9354,5425,1061,28321,840,216,282,1338,29659
11-06-2016,4,12426,9286,5427,1015,28156,850,225,279,1354,29510
11-06-2016,5,12640,9301,5487,1053,28481,903,319,275,1497,29978
11-06-2016,6,13298,9695,5768,1080,29841,989,362,315,1666,31507
11-06-2016,7,14735,10359,5735,1142,31972,916,352,336,1604,33576
11-06-2016,8,15885,11259,6031,1370,34545,926,398,311,1635,36180
11-06-2016,9,16648,11849,6279,1758,36535,1020,523,289,1832,38367
11-06-2016,10,16808,12413,6353,1857,37432,1059,519,296,1874,39306
11-06-2016,11,16715,12392,6364,1883,37355,1052,543,306,1901,39256
11-06-2016,12,16683,12010,6308,1844,36845,1049,553,270,1872,38717
11-06-2016,13,16413,11542,6259,1424,35638,976,551,520,2047,37685
11-06-2016,14,15739,11189,6195,1355,34478,1021,556,536,2113,36591
11-06-2016,15,15311,11156,6226,1292,33985,1016,611,337,1964,35949
11-06-2016,16,15751,11176,6022,1315,34262,973,607,384,1964,36226
11-06-2016,17,16376,11252,6132,1473,35232,979,659,366,2004,37236
11-06-2016,18,16359,11243,6191,1672,35464,985,653,346,1984,37448
11-06-2016,19,16312,11135,6236,1605,35288,987,646,365,1998,37286
11-06-2016,20,16146,11197,6139,1541,35024,1028,644,312,1984,37008
11-06-2016,21,16045,10767,6061,1487,34360,1032,637,235,1904,36264
11-06-2016,22,15937,10544,6011,1476,33968,1042,621,407,2070,36038
11-06-2016,23,15586,9902,5988,1221,32697,954,434,425,1813,34510
12-06-2016,0,14570,8870,5908,1028,30376,956,306,485,1747,32123
12-06-2016,1,13295,8456,5888,972,28613,941,225,462,1628,30241
12-06-2016,2,12377,8426,5820,972,27595,886,208,215,1309,28904
12-06-2016,3,12131,8244,5789,953,27117,897,212,207,1316,28433
12-06-2016,4,12246,8231,5755,936,27169,901,222,186,1309,28478
12-06-2016,5,12028,8221,5731,960,26940,890,230,160,1280,28220
12-06-2016,6,12574,8417,5861,958,27809,856,237,265,1358,29167
12-06-2016,7,12569,8862,5905,1022,28358,893,336,307,1536,29894
12-06-2016,8,14199,9425,6056,1155,30836,906,521,127,1554,32390
12-06-2016,9,14601,10211,6063,1316,32190,819,571,124,1514,33704
12-06-2016,10,15477,10762,6091,1451,33781,803,643,315,1761,35542
12-06-2016,11,16220,10979,6125,1575,34899,805,635,297,1737,36636
12-06-2016,12,15692,11236,6088,1565,34581,811,631,301,1743,36324
12-06-2016,13,15613,11008,6113,1626,34361,811,631,188,1630,35991
12-06-2016,14,15130,10914,6154,1685,33882,801,571,165,1537,35419
12-06-2016,15,15071,10790,6118,1683,33662,795,566,157,1518,35180
12-06-2016,16,15201,10911,6192,1652,33955,795,492,144,1431,35386
12-06-2016,17,15685,11289,6215,1634,34823,871,501,131,1503,36326
12-06-2016,18,16011,11423,6167,1807,35408,963,341,513,1817,37225
12-06-2016,19,16155,11005,6162,1921,35244,945,347,505,1797,37041
12-06-2016,20,16434,10662,6118,1805,35020,782,414,495,1691,36711
12-06-2016,21,16577,10716,6149,1608,35050,748,456,500,1704,36754
12-06-2016,22,16288,10509,6185,1667,34649,761,370,489,1620,36269
12-06-2016,23,15022,9854,6121,1381,32379,774,297,479,1550,33929
13-06-2016,0,13548,9395,6122,1330,30396,741,204,74,1019,31415
13-06-2016,1,12613,9125,6075,1391,29203,744,184,65,993,30196
13-06-2016,2,12087,9200,6055,1391,28734,759,190,58,1007,29741
13-06-2016,3,11858,9244,5984,1476,28562,765,194,55,1014,29576
13-06-2016,4,11892,9294,6010,1599,28794,817,237,61,1115,29909
13-06-2016,5,12940,9868,6076,1745,30629,928,289,62,1279,31908
13-06-2016,6,15745,11857,6137,2275,36014,996,358,225,1579,37593
13-06-2016,7,17423,14585,6612,2607,41227,1005,451,216,1672,42899
13-06-2016,8,17822,15383,6830,2862,42897,1000,915,215,2130,45027
13-06-2016,9,17692,15421,6806,3137,43055,1012,984,234,2230,45285
13-06-2016,10,17497,15462,6702,3457,43118,1028,1007,236,2271,45389
13-06-2016,11,17354,15660,6828,3632,43475,1020,1020,223,2263,45738
13-06-2016,12,16907,15474,6711,3731,42823,997,1053,219,2269,45092
13-06-2016,13,16766,14819,6571,3790,41945,1002,1033,218,2253,44198
13-06-2016,14,16889,14444,6544,3610,41489,1004,928,209,2141,43630
13-06-2016,15,16859,14210,6507,3574,41149,1001,825,224,2050,43199
13-06-2016,16,16722,13897,6430,3590,40639,989,537,217,1743,42382
13-06-2016,17,16824,13854,6382,3600,40661,996,477,215,1688,42349
13-06-2016,18,16844,13704,6383,3480,40411,1000,265,209,1474,41885
13-06-2016,19,16927,13572,6331,3190,40020,997,267,214,1478,41498
13-06-2016,20,16817,13239,6373,3106,39536,994,254,221,1469,41005
13-06-2016,21,16733,12371,6173,2878,38156,938,253,246,1437,39593
13-06-2016,22,16616,11503,6173,2695,36988,906,288,120,1314,38302
13-06-2016,23,15709,11025,6051,2359,35145,909,230,143,1282,36427
14-06-2016,0,13395,10219,5938,2159,31710,723,210,152,1085,32795
14-06-2016,1,11747,9728,5899,2082,29458,680,208,166,1054,30512
14-06-2016,2,10936,9660,5964,2025,28585,618,210,191,1019,29604
14-06-2016,3,10649,9650,5975,1972,28246,667,217,212,1096,29342
14-06-2016,4,11099,9682,6001,1869,28650,753,234,220,1207,29857
14-06-2016,5,12961,10276,6243,1869,31351,832,254,254,1340,32691
14-06-2016,6,15056,12467,6770,2324,36618,881,410,480,1771,38389
14-06-2016,7,15892,14859,6973,2580,40304,863,818,519,2200,42504
14-06-2016,8,16252,15333,7030,2824,41440,954,968,699,2621,44061
14-06-2016,9,16243,14901,7069,2937,41150,966,962,714,2642,43792
14-06-2016,10,16211,15334,7031,3037,41613,962,1014,716,2692,44305
14-06-2016,11,16137,15395,6924,3045,41500,966,1099,697,2762,44262
14-06-2016,12,16048,15114,6825,2934,40921,959,1184,701,2844,43765
14-06-2016,13,16317,14977,6843,2904,41042,965,1032,693,2690,43732
14-06-2016,14,16316,15133,6862,2889,41201,952,978,653,2583,43784
14-06-2016,15,16192,14973,6802,2742,40710,952,914,690,2556,43266
14-06-2016,16,15896,14636,6585,2750,39865,895,678,699,2272,42137
14-06-2016,17,15788,14611,6565,2638,39603,885,584,691,2160,41763
14-06-2016,18,15729,14657,6597,2545,39529,920,496,632,2048,41577
14-06-2016,19,16507,14504,6609,2421,40042,924,696,690,2310,42352
14-06-2016,20,16662,14554,6502,2333,40051,911,300,724,1935,41986
14-06-2016,21,16186,13483,6267,2155,38091,859,258,705,1822,39913
14-06-2016,22,15802,12406,6166,2033,36408,909,260,232,1401,37809
14-06-2016,23,15291,10996,6103,1813,34202,950,251,217,1418,35620
15-06-2016,0,13911,9893,5977,1413,31195,882,228,139,1249,32444
15-06-2016,1,12882,9533,5773,1271,29459,861,222,129,1212,30671
15-06-2016,2,12552,9400,5659,1079,28690,854,222,151,1227,29917
15-06-2016,3,12054,9476,5562,950,28041,852,222,165,1239,29280
15-06-2016,4,12303,9483,5599,905,28289,874,234,157,1265,29554
15-06-2016,5,13597,9885,5998,1011,30492,925,347,282,1554,32046
15-06-2016,6,15795,12182,6463,1349,35788,991,496,355,1842,37630
15-06-2016,7,17120,14413,6675,1563,39771,1010,1036,336,2382,42153
15-06-2016,8,17445,14989,6816,1611,40861,1099,994,472,2565,43426
15-06-2016,9,17466,14941,6889,1779,41074,988,1045,584,2617,43691
15-06-2016,10,17265,15291,6821,1895,41272,991,1033,650,2674,43946
15-06-2016,11,17340,15489,6783,1973,41584,1005,1048,656,2709,44293
15-06-2016,12,17089,15339,6810,1973,41211,1022,993,662,2677,43888
15-06-2016,13,17243,15094,6794,1874,41007,1022,1037,543,2602,43609
15-06-2016,14,17176,15013,6765,1830,40784,1023,989,490,2502,43286
15-06-2016,15,17346,14857,6653,1766,40622,1034,937,452,2423,43045
15-06-2016,16,17135,14099,6331,1581,39145,968,600,314,1882,41027
15-06-2016,17,17173,14286,6258,1630,39347,1012,450,323,1785,41132
15-06-2016,18,16957,14703,6399,1611,39671,1015,671,330,2016,41687
15-06-2016,19,16850,14735,6518,1574,39679,1032,716,328,2076,41755
15-06-2016,20,16639,14142,6402,1501,38683,1070,548,264,1882,40565
15-06-2016,21,16204,13233,6371,1407,37216,998,374,133,1505,38721
15-06-2016,22,16071,12656,6389,1327,36442,1006,275,61,1342,37784
15-06-2016,23,15095,11221,6184,1258,33758,923,257,59,1239,34997
16-06-2016,0,14074,9858,6039,871,30843,940,211,58,1209,32052
16-06-2016,1,12767,9635,6008,775,29185,910,259,65,1234,30419
16-06-2016,2,12363,9517,6052,705,28638,907,280,61,1248,29886
16-06-2016,3,11655,9435,6035,714,27839,934,203,79,1216,29055
16-06-2016,4,11902,9448,6018,742,28110,967,218,82,1267,29377
16-06-2016,5,13423,9807,6285,835,30349,970,273,78,1321,31670
16-06-2016,6,15700,11766,6708,1338,35512,976,626,292,1894,37406
16-06-2016,7,16383,14584,6924,1553,39445,972,975,482,2429,41874
16-06-2016,8,16590,15617,7174,1923,41304,997,978,675,2650,43954
16-06-2016,9,16362,15590,7291,2043,41286,1001,989,648,2638,43924
16-06-2016,10,15856,15950,7378,2142,41327,1015,1034,670,2719,44046
16-06-2016,11,16063,16012,7417,1966,41457,1010,990,697,2697,44154
16-06-2016,12,16461,15841,7320,1961,41583,1026,1012,690,2728,44311
16-06-2016,13,16656,15737,7350,1816,41560,1020,1007,701,2728,44288
16-06-2016,14,16602,15519,7358,1783,41261,1012,1001,690,2703,43964
16-06-2016,15,16637,15296,7262,1749,40943,1024,949,670,2643,43586
16-06-2016,16,16369,14773,7026,1751,39919,1024,907,503,2434,42353
16-06-2016,17,16457,14840,6978,1700,39976,1023,804,483,2310,42286
16-06-2016,18,16287,14949,7058,1649,39942,1004,826,464,2294,42236
16-06-2016,19,16644,14496,7062,1464,39666,983,889,458,2330,41996
16-06-2016,20,16451,13925,6854,1359,38590,974,833,446,2253,40843
16-06-2016,21,16309,13249,6702,1351,37610,968,437,398,1803,39413
16-06-2016,22,16024,12703,6480,1282,36489,945,348,105,1398,37887
16-06-2016,23,15366,10887,6301,967,33521,895,274,111,1280,34801
17-06-2016,0,13827,10107,6298,837,31069,786,234,105,1125,32194
17-06-2016,1,12785,9991,5980,791,29547,782,212,119,1113,30660
17-06-2016,2,12156,9747,5857,864,28624,773,221,99,1093,29717
17-06-2016,3,11779,9645,5815,865,28105,782,224,74,1080,29185
17-06-2016,4,11494,9770,5857,798,27920,840,233,67,1140,29060
17-06-2016,5,13277,10153,6178,894,30502,874,294,73,1241,31743
17-06-2016,6,15146,12428,6622,1346,35541,1017,759,97,1873,37414
17-06-2016,7,16263,15066,7028,1799,40157,1018,973,267,2258,42415
17-06-2016,8,16688,15637,7175,2052,41550,1060,973,349,2382,43932
17-06-2016,9,16790,15709,7254,2064,41816,1061,962,372,2395,44211
17-06-2016,10,16903,15802,7322,2198,42224,1040,965,571,2576,44800
17-06-2016,11,16850,15673,7277,2193,41993,1032,958,568,2558,44551
17-06-2016,12,16637,15507,7215,2277,41637,1034,1012,423,2469,44106
17-06-2016,13,16509,15064,7146,2300,41018,1027,954,449,2430,43448
17-06-2016,14,16511,14525,7078,2342,40456,1010,936,443,2389,42845
17-06-2016,15,16154,14347,7075,2369,39946,992,804,272,2068,42014
17-06-2016,16,15721,13374,6723,2247,38065,1002,442,348,1792,39857
17-06-2016,17,15582,12738,6498,2045,36863,1009,428,378,1815,38678
17-06-2016,18,15505,12948,6465,2377,37295,1015,371,347,1733,39028
17-06-2016,19,16019,13371,6563,2451,38406,1056,354,327,1737,40143
17-06-2016,20,15771,12449,6175,2610,37005,857,280,388,1525,38530
17-06-2016,21,15470,11250,6012,2665,35396,779,275,413,1467,36863
17-06-2016,22,15418,10934,5880,2634,34868,782,281,399,1462,36330
17-06-2016,23,14209,10570,5818,2630,33229,814,240,365,1419,34648
18-06-2016,0,12302,9933,5686,2332,30253,891,157,389,1437,31690
18-06-2016,1,10980,9681,5525,2269,28455,899,155,386,1440,29895
18-06-2016,2,10376,9605,5471,2226,27678,816,151,382,1349,29027
18-06-2016,3,9862,9574,5439,2227,27103,815,163,371,1349,28452
18-06-2016,4,8972,9568,5398,2366,26304,783,181,384,1348,27652
18-06-2016,5,8812,9752,5400,2446,26411,806,197,392,1395,27806
18-06-2016,6,10053,9892,5526,2548,28018,776,201,399,1376,29394
18-06-2016,7,11154,10355,5756,2590,29856,767,200,399,1366,31222
18-06-2016,8,12386,11128,5999,2851,32363,791,197,401,1389,33752
18-06-2016,9,12974,12069,6141,3088,34272,800,193,399,1392,35664
18-06-2016,10,13515,12299,6230,3154,35197,790,192,402,1384,36581
18-06-2016,11,13421,12343,6241,3135,35140,792,190,400,1382,36522
18-06-2016,12,14051,12380,6281,3368,36080,797,191,401,1389,37469
18-06-2016,13,13780,12844,6196,3407,36225,804,189,397,1390,37615
18-06-2016,14,12620,12761,6108,3273,34763,791,190,380,1361,36124
18-06-2016,15,12391,12646,6095,3268,34400,784,275,332,1391,35791
18-06-2016,16,12867,12474,6057,3214,34613,795,279,315,1389,36002
18-06-2016,17,13480,12437,6096,3145,35156,779,287,284,1350,36506
18-06-2016,18,14127,12890,6319,3001,36338,781,286,246,1313,37651
18-06-2016,19,14601,12837,6290,2943,36671,793,289,179,1261,37932
18-06-2016,20,14717,12606,6276,2719,36317,822,345,152,1319,37636
18-06-2016,21,14564,12142,6206,2644,35555,814,343,153,1310,36865
18-06-2016,22,14635,11937,6190,2722,35483,806,441,151,1398,36881
18-06-2016,23,13146,11427,5910,2547,33029,780,331,154,1265,34294
19-06-2016,0,11132,10835,5668,2497,30133,726,256,153,1135,31268
19-06-2016,1,9848,10417,5589,2462,28315,664,248,153,1065,29380
19-06-2016,2,9198,10183,5526,2503,27411,619,240,139,998,28409
19-06-2016,3,9006,10086,5463,2514,27068,633,239,141,1013,28081
19-06-2016,4,8790,9935,5381,2573,26680,636,242,142,1020,27700
19-06-2016,5,8880,9830,5338,2730,26779,626,251,137,1014,27793
19-06-2016,6,8929,9922,5329,2979,27158,609,254,119,982,28140
19-06-2016,7,9790,9968,5487,3196,28441,636,256,93,985,29426
19-06-2016,8,10889,10713,5678,3434,30715,685,278,112,1075,31790
19-06-2016,9,12059,11199,5985,3577,32819,698,365,99,1162,33981
19-06-2016,10,12552,11643,6175,3661,34032,206,380,98,684,34716
19-06-2016,11,12775,11871,6261,3724,34633,725,398,108,1231,35864
19-06-2016,12,12609,12005,6217,3740,34570,678,403,119,1200,35770
19-06-2016,13,12424,12035,6148,3752,34359,695,400,112,1207,35566
19-06-2016,14,12237,11920,6176,3785,34117,699,404,100,1203,35320
19-06-2016,15,12056,11718,6176,3807,33759,703,448,80,1231,34990
19-06-2016,16,12174,11678,6239,3682,33772,665,531,65,1261,35033
19-06-2016,17,12929,11778,6305,3517,34529,640,497,138,1275,35804
19-06-2016,18,13605,11905,6294,3191,34995,660,472,130,1262,36257
19-06-2016,19,14520,11999,6367,2923,35809,726,449,42,1217,37026
19-06-2016,20,15283,12159,6481,2834,36757,734,450,43,1227,37984
19-06-2016,21,15987,12044,6354,2568,36954,792,371,43,1206,38160
19-06-2016,22,15827,11874,6250,2269,36221,814,310,48,1172,37393
19-06-2016,23,14978,10651,6261,1752,33641,840,229,53,1122,34763
20-06-2016,0,13052,9699,6048,1492,30292,828,216,59,1103,31395
20-06-2016,1,11421,9544,5815,1397,28177,793,215,77,1085,29262
20-06-2016,2,10473,9521,5704,1422,27122,804,213,91,1108,28230
20-06-2016,3,10277,9510,5663,1489,26940,823,213,101,1137,28077
20-06-2016,4,10222,9487,5655,1697,27061,851,229,118,1198,28259
20-06-2016,5,11850,9993,5868,1924,29636,898,324,119,1341,30977
20-06-2016,6,14092,12386,6274,2617,35370,985,650,275,1910,37280
20-06-2016,7,16312,14795,6652,3116,40876,1030,897,254,2181,43057
20-06-2016,8,16918,14887,6912,3575,42292,1035,907,323,2265,44557
20-06-2016,9,16816,14749,6937,3846,42348,1017,1011,379,2407,44755
20-06-2016,10,16401,14586,6984,4042,42012,1016,1018,347,2381,44393
20-06-2016,11,16100,14737,6986,4210,42033,1010,1028,306,2344,44377
20-06-2016,12,15674,14694,7072,4241,41682,1007,1030,239,2276,43958
20-06-2016,13,15213,14855,7058,4132,41257,990,1004,243,2237,43494
20-06-2016,14,15489,14619,6965,4221,41294,980,977,246,2203,43497
20-06-2016,15,15332,14554,6976,4045,40908,975,979,255,2209,43117
20-06-2016,16,14930,14564,6747,3846,40087,958,688,250,1896,41983
20-06-2016,17,15327,14654,6646,4059,40686,958,617,257,1832,42518
20-06-2016,18,15952,14820,6653,3390,40816,955,504,258,1717,42533
20-06-2016,19,16012,15568,6616,3271,41467,903,748,264,1915,43382
20-06-2016,20,15865,14991,6451,3275,40581,857,435,273,1565,42146
20-06-2016,21,15573,14267,6199,3275,39315,878,389,286,1553,40868
20-06-2016,22,15000,13344,6066,2880,37291,835,376,129,1340,38631
20-06-2016,23,13830,12187,5855,1748,33621,825,271,126,1222,34843
21-06-2016,0,12123,11382,5935,1571,31013,820,231,133,1184,32197
21-06-2016,1,11508,10714,5838,1545,29605,711,189,114,1014,30619
21-06-2016,2,10568,10667,5725,1654,28615,711,192,94,997,29612
21-06-2016,3,9919,10471,5685,1716,27791,703,197,79,979,28770
21-06-2016,4,10386,10359,5660,1650,28056,690,208,79,977,29033
21-06-2016,5,12499,10890,5790,1523,30703,686,296,114,1096,31799
21-06-2016,6,14684,13084,6048,1785,35601,751,860,462,2073,37674
21-06-2016,7,16409,15057,6536,2339,40341,787,1003,704,2494,42835
21-06-2016,8,16807,16131,6648,2694,42280,913,922,811,2646,44926
21-06-2016,9,16749,16198,6629,2550,42127,923,905,804,2632,44759
21-06-2016,10,16786,15981,6629,2902,42299,931,954,804,2689,44988
21-06-2016,11,16672,15792,6580,2863,41908,932,952,816,2700,44608
21-06-2016,12,16523,15453,6530,2892,41398,935,926,839,2700,44098
21-06-2016,13,16690,15257,6455,2731,41134,944,894,816,2654,43788
21-06-2016,14,16644,15033,6463,2628,40768,996,885,815,2696,43464
21-06-2016,15,16523,14980,6375,2554,40430,1000,804,801,2605,43035
21-06-2016,16,16451,14768,6300,2520,40040,1012,827,766,2605,42645
21-06-2016,17,16263,14772,6320,2435,39791,1001,825,719,2545,42336
21-06-2016,18,16169,14602,6348,2226,39345,939,735,640,2314,41659
21-06-2016,19,16113,14585,6480,2066,39244,865,861,645,2371,41615
21-06-2016,20,16081,14100,6489,1889,38561,858,574,667,2099,40660
21-06-2016,21,16010,13414,6320,1708,37452,871,497,669,2037,39489
21-06-2016,22,15718,12906,6131,1647,36401,848,421,342,1611,38012
21-06-2016,23,15216,11497,5922,1616,34253,719,402,112,1233,35486
22-06-2016,0,14053,9953,5697,1012,30714,670,403,103,1176,31890
22-06-2016,1,13138,9674,5532,1034,29377,668,383,98,1149,30526
22-06-2016,2,12516,9595,5511,1005,28627,660,386,114,1160,29787
22-06-2016,3,11892,9502,5404,1001,27799,639,391,111,1141,28940
22-06-2016,4,11813,9448,5426,1008,27694,700,404,113,1217,28911
22-06-2016,5,13199,10141,5674,1187,30201,791,426,220,1437,31638
22-06-2016,6,14802,12411,6013,1859,35084,883,727,381,1991,37075
22-06-2016,7,15914,14814,6363,2278,39370,882,942,675,2499,41869
22-06-2016,8,16406,15041,6534,2298,40280,887,988,671,2546,42826
22-06-2016,9,16486,15041,6532,2363,40422,897,1058,706,2661,43083
22-06-2016,10,16603,15198,6493,2442,40736,915,1037,702,2654,43390
22-06-2016,11,16522,15417,6501,2238,40679,909,1040,709,2658,43337
22-06-2016,12,16575,15506,6484,2314,40877,910,946,849,2705,43582
22-06-2016,13,16589,15312,6393,2354,40648,908,943,828,2679,43327
22-06-2016,14,16176,15179,6364,2273,39992,903,928,741,2572,42564
22-06-2016,15,16103,14940,6328,2357,39728,885,910,657,2452,42180
22-06-2016,16,15883,14184,6057,2308,38432,881,690,628,2199,40631
22-06-2016,17,15828,14012,6101,2342,38285,872,671,615,2158,40443
22-06-2016,18,15973,14344,6195,2290,38802,881,638,603,2122,40924
22-06-2016,19,16191,14319,6256,1921,38688,895,836,619,2350,41038
22-06-2016,20,16220,13727,6196,1728,37873,903,591,596,2090,39963
22-06-2016,21,15862,12623,6199,1578,36263,906,535,425,1866,38129
22-06-2016,22,15650,12072,6148,1524,35394,896,428,359,1683,37077
22-06-2016,23,15082,11179,5855,1366,33482,753,389,247,1389,34871
23-06-2016,0,13996,9625,5759,1064,30446,753,380,425,1558,32004
23-06-2016,1,13550,9109,5634,866,29159,754,375,430,1559,30718
23-06-2016,2,12858,9216,5662,868,28605,761,376,422,1559,30164
23-06-2016,3,12305,9213,5500,923,27940,683,380,424,1487,29427
23-06-2016,4,12288,8812,5457,900,27456,618,392,450,1460,28916
23-06-2016,5,13149,9507,5598,963,29218,747,408,502,1657,30875
23-06-2016,6,14889,11849,5977,1285,34001,855,514,477,1846,35847
23-06-2016,7,16006,14085,6245,1787,38124,922,973,450,2345,40469
23-06-2016,8,16165,14984,6386,1887,39421,912,973,555,2440,41861
23-06-2016,9,16372,14903,6403,2011,39690,919,965,615,2499,42189
23-06-2016,10,16559,15340,6417,1972,40288,927,1008,396,2331,42619
23-06-2016,11,16578,15405,6331,1788,40102,925,1000,318,2243,42345
23-06-2016,12,16156,15218,6390,1846,39612,893,985,285,2163,41775
23-06-2016,13,16058,14827,6383,1832,39099,822,984,395,2201,41300
23-06-2016,14,15620,14633,6281,1916,38450,832,984,397,2213,40663
23-06-2016,15,16257,14461,6322,2045,39084,826,976,293,2095,41179
23-06-2016,16,16058,13329,6044,1830,37263,919,837,290,2046,39309
23-06-2016,17,16098,13883,6126,1825,37932,920,794,283,1997,39929
23-06-2016,18,16112,14620,6350,1988,39070,923,785,278,1986,41056
23-06-2016,19,16168,14406,6351,2061,38986,920,858,274,2052,41038
23-06-2016,20,16112,13921,6307,1985,38327,899,571,271,1741,40068
23-06-2016,21,16051,12940,6245,1479,36715,832,395,271,1498,38213
23-06-2016,22,15447,12402,6118,1383,35350,787,394,272,1453,36803
23-06-2016,23,14540,11134,5790,1084,32549,779,394,382,1555,34104
24-06-2016,0,13996,9983,5613,1059,30651,759,195,86,1040,31691
24-06-2016,1,13438,9436,5449,979,29301,769,193,135,1097,30398
24-06-2016,2,12913,9326,5373,925,28538,720,192,194,1106,29644
24-06-2016,3,12467,9263,5344,841,27914,703,196,230,1129,29043
24-06-2016,4,12846,9230,5328,913,28318,719,207,225,1151,29469
24-06-2016,5,13429,9523,5595,887,29433,848,216,191,1255,30688
24-06-2016,6,14728,11665,5924,1137,33454,902,253,131,1286,34740
24-06-2016,7,15971,13591,6232,1520,37315,627,319,252,1198,38513
24-06-2016,8,16657,14648,6404,1723,39433,622,533,262,1417,40850
24-06-2016,9,16443,14579,6283,1955,39260,624,591,277,1492,40752
24-06-2016,10,16478,14157,6215,2058,38907,633,651,303,1587,40494
24-06-2016,11,16548,13702,6199,2091,38540,654,672,313,1639,40179
24-06-2016,12,16520,13341,6181,1863,37905,694,676,322,1692,39597
24-06-2016,13,16304,12997,6022,2177,37500,784,530,320,1634,39134
24-06-2016,14,15903,12669,6049,2433,37054,736,519,305,1560,38614
24-06-2016,15,15866,12423,6033,2428,36750,790,502,297,1589,38339
24-06-2016,16,16254,12928,6077,2185,37445,780,276,209,1265,38710
24-06-2016,17,16398,13497,6016,2012,37923,872,267,186,1325,39248
24-06-2016,18,16384,13695,5949,1751,37779,831,374,72,1277,39056
24-06-2016,19,16297,13714,5719,1488,37218,769,663,62,1494,38712
24-06-2016,20,16040,13343,5312,1316,36012,748,343,72,1163,37175
24-06-2016,21,15928,13150,5166,1105,35350,764,236,87,1087,36437
24-06-2016,22,15531,12989,5231,963,34714,752,220,126,1098,35812
24-06-2016,23,15136,11901,5063,916,33016,758,215,164,1137,34153
25-06-2016,0,14060,10348,4609,744,29760,560,209,157,926,30686
25-06-2016,1,13573,9462,4446,723,28203,542,205,147,894,29097
25-06-2016,2,13148,9002,4473,603,27227,537,202,144,883,28110
25-06-2016,3,12537,8865,4374,518,26294,499,199,121,819,27113
25-06-2016,4,12169,8733,4366,525,25794,497,205,104,806,26600
25-06-2016,5,12033,8676,4378,558,25645,478,215,96,789,26434
25-06-2016,6,12558,8928,4418,581,26486,475,250,101,826,27312
25-06-2016,7,13072,9909,4495,655,28131,471,253,48,772,28903
25-06-2016,8,14167,12105,4601,832,31706,475,278,163,916,32622
25-06-2016,9,14965,13199,4892,1099,34155,432,406,230,1068,35223
25-06-2016,10,15280,13279,5058,1102,34720,466,413,231,1110,35830
25-06-2016,11,15285,13115,5124,1078,34601,460,362,249,1071,35672
25-06-2016,12,15254,12409,4956,1045,33664,456,334,274,1064,34728
25-06-2016,13,15082,11734,4840,1010,32666,455,320,280,1055,33721
25-06-2016,14,14796,11547,4893,1083,32318,455,283,289,1027,33345
25-06-2016,15,14567,11367,4976,1324,32234,458,249,257,964,33198
25-06-2016,16,14372,11143,4938,1357,31810,460,241,90,791,32601
25-06-2016,17,14568,11338,4945,1226,32077,461,241,89,791,32868
25-06-2016,18,14828,11820,4966,1224,32839,459,259,81,799,33638
25-06-2016,19,14853,12198,4993,1235,33280,455,268,99,822,34102
25-06-2016,20,14154,11636,4892,1511,32192,455,255,132,842,33034
25-06-2016,21,13514,11203,4814,1643,31175,450,221,180,851,32026
25-06-2016,22,13266,11048,4802,1671,30786,446,231,211,888,31674
25-06-2016,23,12919,10536,4697,1719,29870,472,254,264,990,30860
26-06-2016,0,12093,9809,4584,1533,28020,572,237,270,1079,29099
26-06-2016,1,10882,9683,4431,1358,26355,568,229,242,1039,27394
26-06-2016,2,10613,9580,4400,1339,25932,489,235,142,866,26798
26-06-2016,3,9841,9323,4288,1680,25132,455,243,84,782,25914
26-06-2016,4,9198,8981,4247,1934,24359,455,241,139,835,25194
26-06-2016,5,9216,8905,4224,1895,24239,481,247,190,918,25157
26-06-2016,6,10108,8922,4376,1912,25317,567,201,140,908,26225
26-06-2016,7,11857,9246,4679,1822,27603,566,203,95,864,28467
26-06-2016,8,12424,9978,4809,1967,29180,567,220,82,869,30049
26-06-2016,9,12647,10805,4976,2145,30574,570,259,81,910,31484
26-06-2016,10,13074,11495,5073,2306,31948,550,303,77,930,32878
26-06-2016,11,13175,12128,5114,2519,32935,557,326,65,948,33883
26-06-2016,12,13024,12236,5100,2599,32958,561,351,57,969,33927
26-06-2016,13,12844,12270,5027,2566,32707,553,338,52,943,33650
26-06-2016,14,12903,12170,4942,2494,32509,553,308,47,908,33417
26-06-2016,15,12847,12137,5014,2413,32410,542,308,64,914,33324
26-06-2016,16,13252,12266,4961,2240,32720,545,270,96,911,33631
26-06-2016,17,14081,12347,5063,2042,33532,550,231,111,892,34424
26-06-2016,18,14861,12341,5048,2012,34262,539,238,126,903,35165
26-06-2016,19,15079,12327,5152,1896,34454,549,225,98,872,35326
26-06-2016,20,15473,12430,5126,1758,34789,579,258,161,998,35787
26-06-2016,21,15296,12302,5135,1536,34268,599,267,158,1024,35292
26-06-2016,22,15222,12136,5167,1551,34076,610,417,159,1186,35262
26-06-2016,23,14355,11130,5181,1648,32316,595,243,117,955,33271
27-06-2016,0,12395,9674,4947,1556,28574,571,178,92,841,29415
27-06-2016,1,10481,9349,4858,1504,26191,524,173,95,792,26983
27-06-2016,2,9221,9174,4780,1579,24753,537,200,101,838,25591
27-06-2016,3,9272,9135,4717,1739,24864,573,206,109,888,25752
27-06-2016,4,9650,9119,4809,1815,25394,618,317,116,1051,26445
27-06-2016,5,11619,9735,5017,1836,28207,709,391,113,1213,29420
27-06-2016,6,14044,12596,5427,1856,33923,749,404,167,1320,35243
27-06-2016,7,15840,14422,5660,2309,38233,793,794,529,2116,40349
27-06-2016,8,16252,15077,5746,2439,39515,844,878,840,2562,42077
27-06-2016,9,16317,15205,5776,2398,39696,833,768,867,2468,42164
27-06-2016,10,16390,15456,5896,2720,40463,853,752,864,2469,42932
27-06-2016,11,16109,15165,5802,3203,40280,867,853,896,2616,42896
27-06-2016,12,16578,15203,5661,3375,40816,865,878,860,2603,43419
27-06-2016,13,16590,15318,5680,3417,41006,833,826,728,2387,43393
27-06-2016,14,16668,15226,5881,3337,41111,699,722,649,2070,43181
27-06-2016,15,16433,15188,5906,3232,40760,742,726,462,1930,42690
27-06-2016,16,16719,14848,5844,3212,40624,764,724,436,1924,42548
27-06-2016,17,16540,14767,5944,2949,40200,849,658,440,1947,42147
27-06-2016,18,16259,14503,6161,3150,40074,851,723,342,1916,41990
27-06-2016,19,16351,13991,6255,2977,39574,841,710,383,1934,41508
27-06-2016,20,16364,13057,6088,2584,38094,860,394,578,1832,39926
27-06-2016,21,16170,12595,6148,2165,37078,856,388,315,1559,38637
27-06-2016,22,15559,12233,6152,1843,35787,830,384,75,1289,37076
27-06-2016,23,15150,11512,5940,1780,34382,777,367,78,1222,35604
28-06-2016,0,14338,9567,5640,1553,31099,612,357,74,1043,32142
28-06-2016,1,13360,9137,5543,1454,29494,579,346,73,998,30492
28-06-2016,2,13127,8823,5481,1353,28783,570,348,72,990,29773
28-06-2016,3,12823,8763,5335,1208,28128,566,353,64,983,29111
28-06-2016,4,13023,8692,5412,1089,28214,562,365,57,984,29198
28-06-2016,5,13979,9533,5791,1050,30354,719,383,157,1259,31613
28-06-2016,6,15200,12073,6193,1271,34738,761,404,422,1587,36325
28-06-2016,7,16050,13450,6479,1728,37707,785,735,609,2129,39836
28-06-2016,8,16523,13829,6685,1875,38912,803,971,615,2389,41301
28-06-2016,9,16712,13762,6741,2047,39261,869,856,782,2507,41768
28-06-2016,10,16789,13861,6728,2141,39518,862,920,780,2562,42080
28-06-2016,11,16671,13982,6705,2246,39606,864,980,837,2681,42287
28-06-2016,12,16831,14353,6634,2237,40054,808,976,785,2569,42623
28-06-2016,13,16924,14424,6621,2223,40194,732,970,593,2295,42489
28-06-2016,14,16822,14489,6654,2237,40202,740,828,471,2039,42241
28-06-2016,15,16828,14397,6454,2145,39824,742,668,410,1820,41644
28-06-2016,16,16790,14040,6292,1975,39098,751,662,379,1792,40890
28-06-2016,17,16481,13636,6338,1917,38373,745,632,359,1736,40109
28-06-2016,18,16495,13630,6284,1810,38220,728,629,304,1661,39881
28-06-2016,19,16249,13569,6341,1659,37818,736,638,460,1834,39652
28-06-2016,20,16128,13207,6210,1331,36876,730,480,416,1626,38502
28-06-2016,21,16048,12464,6191,1147,35850,748,471,341,1560,37410
28-06-2016,22,15748,11785,6080,1096,34710,745,383,273,1401,36111
28-06-2016,23,15461,11016,5725,894,33096,751,364,44,1159,34255
29-06-2016,0,14287,9806,5763,763,30619,680,351,43,1074,31693
29-06-2016,1,13268,8988,5705,931,28893,674,345,42,1061,29954
29-06-2016,2,12598,8795,5725,1243,28362,665,347,41,1053,29415
29-06-2016,3,12291,8732,5592,1482,28097,666,350,45,1061,29158
29-06-2016,4,11849,8871,5608,1634,27962,702,364,57,1123,29085
29-06-2016,5,12327,10077,6042,1707,30153,807,393,177,1377,31530
29-06-2016,6,14554,11964,6389,2120,35027,874,661,290,1825,36852
29-06-2016,7,16301,13608,6574,2313,38796,913,809,620,2342,41138
29-06-2016,8,16781,14377,6788,2475,40421,924,894,790,2608,43029
29-06-2016,9,16856,14259,6815,2618,40548,925,975,833,2733,43281
29-06-2016,10,17285,14436,6846,2371,40938,916,978,836,2730,43668
29-06-2016,11,16972,14845,6985,2293,41094,925,971,627,2523,43617
29-06-2016,12,16458,15048,6937,2281,40723,939,860,675,2474,43197
29-06-2016,13,16337,14949,6835,2286,40407,945,856,807,2608,43015
29-06-2016,14,16301,14758,6604,2230,39893,937,857,652,2446,42339
29-06-2016,15,15983,14497,6556,2270,39308,944,773,606,2323,41631
29-06-2016,16,16348,13632,6437,2180,38597,939,767,344,2050,40647
29-06-2016,17,16954,13333,6542,2154,38984,945,432,414,1791,40775
29-06-2016,18,16799,13368,6584,2324,39075,941,561,427,1929,41004
29-06-2016,19,16740,13639,6725,2455,39559,928,494,432,1854,41413
29-06-2016,20,16529,13096,6774,2275,38676,954,386,362,1702,40378
29-06-2016,21,16392,12202,6525,1908,37026,948,394,67,1409,38435
29-06-2016,22,15848,12054,6413,1624,35939,959,387,83,1429,37368
29-06-2016,23,15275,11190,6040,1828,34333,949,387,109,1445,35778
30-06-2016,0,14805,9835,5736,1737,32114,812,384,140,1336,33450
30-06-2016,1,13940,9550,5587,1768,30845,795,368,110,1273,32118
30-06-2016,2,13278,9383,5550,1870,30081,788,365,70,1223,31304
30-06-2016,3,12741,9329,5408,2037,29515,778,365,76,1219,30734
30-06-2016,4,12552,9333,5496,2191,29571,773,374,59,1206,30777
30-06-2016,5,13201,10290,5980,2294,31765,901,393,158,1452,33217
30-06-2016,6,14387,12711,6294,2590,35982,961,416,274,1651,37633
30-06-2016,7,15661,13844,6631,2690,38826,1040,531,808,2379,41205
30-06-2016,8,16375,14247,6812,2696,40131,1061,1005,727,2793,42924
30-06-2016,9,16991,15006,6880,2609,41487,1107,1011,723,2841,44328
30-06-2016,10,17868,15407,6960,2626,42861,1065,1017,784,2866,45727
30-06-2016,11,17430,15601,6799,2669,42498,999,917,830,2746,45244
30-06-2016,12,17102,15623,6763,2732,42220,978,940,938,2856,45076
30-06-2016,13,16981,15363,6673,2618,41635,985,854,982,2821,44456
30-06-2016,14,17062,15112,6514,2269,40957,996,849,914,2759,43716
30-06-2016,15,16936,14921,6393,2250,40501,978,885,836,2699,43200
30-06-2016,16,16710,14313,6292,2304,39620,998,633,815,2446,42066
30-06-2016,17,16653,14217,6372,2492,39734,982,642,808,2432,42166
30-06-2016,18,16763,14409,6528,2321,40020,914,537,870,2321,42341
30-06-2016,19,16652,14531,6746,2144,40073,951,534,760,2245,42318
30-06-2016,20,16444,14217,6625,1995,39282,956,442,743,2141,41423
30-06-2016,21,15950,13002,6325,1861,37138,952,472,622,2046,39184
30-06-2016,22,15659,12140,6358,1922,36079,963,439,581,1983,38062
30-06-2016,23,14990,11140,6157,1753,34040,889,393,473,1755,35795
01-07-2016,0,14702,9782,5966,1518,31967,988,226,440,1654,33621
01-07-2016,1,13677,9679,5816,1278,30451,825,173,425,1423,31874
01-07-2016,2,13049,9441,5743,1218,29450,833,172,440,1445,30895
01-07-2016,3,12169,9384,5572,1267,28392,872,175,436,1483,29875
01-07-2016,4,11506,9211,5649,1469,27835,907,187,446,1540,29375
01-07-2016,5,13180,9433,5811,1610,30036,1072,255,445,1772,31808
01-07-2016,6,15037,11827,6105,1977,34945,1177,368,473,2018,36963
01-07-2016,7,16432,13937,6482,2427,39278,1187,560,654,2401,41679
01-07-2016,8,16607,14575,6716,2842,40739,1245,716,754,2715,43454
01-07-2016,9,16560,14820,6695,2983,41058,1253,749,810,2812,43870
01-07-2016,10,16475,14781,6720,3440,41416,1250,737,830,2817,44233
01-07-2016,11,16054,14742,6698,3757,41252,1247,736,782,2765,44017
01-07-2016,12,15555,14662,6571,3967,40755,1248,655,787,2690,43445
01-07-2016,13,14804,14511,6486,4164,39965,1255,654,792,2701,42666
01-07-2016,14,14614,14296,6549,3999,39459,1256,645,789,2690,42149
01-07-2016,15,14557,13823,6439,3764,38584,1248,565,794,2607,41191
01-07-2016,16,14847,13583,5963,3688,38080,1238,565,531,2334,40414
01-07-2016,17,15479,14001,5828,3148,38455,1234,564,441,2239,40694
01-07-2016,18,16370,14696,5813,2701,39579,1224,435,431,2090,41669
01-07-2016,19,16586,14707,5851,2185,39330,1232,352,428,2012,41342
01-07-2016,20,16499,13886,5771,1812,37968,1244,318,427,1989,39957
01-07-2016,21,16215,13108,5807,1696,36826,1249,276,412,1937,38763
01-07-2016,22,15677,12517,5873,1697,35764,1187,236,480,1903,37667
01-07-2016,23,14638,11514,5834,1748,33732,1172,199,502,1873,35605
02-07-2016,0,12891,10601,5825,1690,31008,933,181,484,1598,32606
02-07-2016,1,11516,10235,5626,1665,29042,805,179,512,1496,30538
02-07-2016,2,10943,10060,5592,1814,28409,784,186,558,1528,29937
02-07-2016,3,10019,9924,5490,1928,27362,675,198,584,1457,28819
02-07-2016,4,9380,9836,5509,2198,26923,688,212,557,1457,28380
02-07-2016,5,9206,9850,5496,2164,26716,691,219,556,1466,28182
02-07-2016,6,10021,10129,5554,2362,28067,757,217,526,1500,29567
02-07-2016,7,11299,10647,5867,2670,30483,750,307,486,1543,32026
02-07-2016,8,12459,11114,6018,2870,32461,766,402,474,1642,34103
02-07-2016,9,13812,11684,6216,3183,34895,855,449,580,1884,36779
02-07-2016,10,13710,12203,6196,3625,35733,843,469,618,1930,37663
02-07-2016,11,13137,12319,6107,4037,35599,887,451,627,1965,37564
02-07-2016,12,12971,12373,5940,4088,35372,886,452,562,1900,37272
02-07-2016,13,12407,12350,5974,3848,34579,831,449,548,1828,36407
02-07-2016,14,11770,12517,5999,3457,33742,808,377,593,1778,35520
02-07-2016,15,11440,12328,5992,3352,33112,809,318,597,1724,34836
02-07-2016,16,11682,12444,5999,3081,33207,770,320,562,1652,34859
02-07-2016,17,12827,12304,6009,3151,34291,778,353,505,1636,35927
02-07-2016,18,13944,12317,6137,2998,35397,860,356,505,1721,37118
02-07-2016,19,15089,12071,6093,2769,36022,874,356,555,1785,37807
02-07-2016,20,14974,12318,6163,2474,35929,852,361,569,1782,37711
02-07-2016,21,14808,11886,6340,2389,35423,873,278,547,1698,37121
02-07-2016,22,14167,11610,6403,2296,34476,866,231,551,1648,36124
02-07-2016,23,12865,11008,6162,2435,32469,864,204,488,1556,34025
03-07-2016,0,11414,10649,5941,2479,30485,811,209,63,1083,31568
03-07-2016,1,10520,10443,5819,2559,29339,775,167,52,994,30333
03-07-2016,2,9985,10240,5666,2385,28277,734,167,88,989,29266
03-07-2016,3,9078,10127,5521,2435,27162,716,175,121,1012,28174
03-07-2016,4,8529,9920,5371,2519,26339,684,181,108,973,27312
03-07-2016,5,8610,9853,5323,2518,26303,681,190,191,1062,27365
03-07-2016,6,9053,10104,5404,2429,26991,693,296,299,1288,28279
03-07-2016,7,10018,10716,5525,2322,28581,658,375,400,1433,30014
03-07-2016,8,10504,11084,5747,2340,29674,722,427,378,1527,31201
03-07-2016,9,11838,10979,5804,2502,31123,715,432,370,1517,32640
03-07-2016,10,12707,11470,5964,2644,32785,700,436,363,1499,34284
03-07-2016,11,13138,11861,5954,2711,33665,704,434,366,1504,35169
03-07-2016,12,13165,11902,5953,2744,33765,707,415,370,1492,35257
03-07-2016,13,13218,11791,5908,2833,33751,739,404,365,1508,35259
03-07-2016,14,12861,11418,5812,2767,32858,763,388,368,1519,34377
03-07-2016,15,12802,11386,5740,2641,32569,756,295,402,1453,34022
03-07-2016,16,12676,11431,5791,2568,32466,719,297,395,1411,33877
03-07-2016,17,13760,11415,5802,2528,33505,796,357,396,1549,35054
03-07-2016,18,15058,11941,5752,2492,35244,800,223,394,1417,36661
03-07-2016,19,15603,12071,5905,2464,36044,887,202,405,1494,37538
03-07-2016,20,16013,11929,5987,2493,36424,893,214,412,1519,37943
03-07-2016,21,16129,12324,5903,2387,36744,889,199,410,1498,38242
03-07-2016,22,15884,12306,5971,2443,36605,885,242,293,1420,38025
03-07-2016,23,15116,11165,5820,2633,34733,896,251,318,1465,36198
04-07-2016,0,14517,10533,5647,2332,33029,802,170,333,1305,34334
04-07-2016,1,13922,10343,5444,2017,31726,805,164,312,1281,33007
04-07-2016,2,13136,10152,5410,1940,30638,819,171,346,1336,31974
04-07-2016,3,12872,10169,5403,1903,30345,876,202,330,1408,31753
04-07-2016,4,12827,10336,5370,1895,30428,977,258,334,1569,31997
04-07-2016,5,13673,11103,5631,1874,32281,1155,338,331,1824,34105
04-07-2016,6,15034,13072,6102,2136,36344,1257,365,478,2100,38444
04-07-2016,7,16396,14628,6436,2409,39869,1287,766,469,2522,42391
04-07-2016,8,16256,15416,6550,2687,40908,1394,888,504,2786,43694
04-07-2016,9,16364,15149,6710,2925,41147,1391,890,512,2793,43940
04-07-2016,10,16354,14769,6735,3073,40931,1378,900,543,2821,43752
04-07-2016,11,16036,15102,6595,3076,40808,1382,848,652,2882,43690
04-07-2016,12,15867,14992,6558,3142,40558,1270,862,699,2831,43389
04-07-2016,13,15671,14944,6561,3040,40215,1267,862,742,2871,43086
04-07-2016,14,15789,14966,6598,3011,40365,1274,744,645,2663,43028
04-07-2016,15,15613,14883,6603,2939,40037,1288,669,640,2597,42634
04-07-2016,16,15428,14847,6371,2914,39561,1293,521,591,2405,41966
04-07-2016,17,15573,14958,6280,2785,39595,1289,517,622,2428,42023
04-07-2016,18,15672,15446,6226,2560,39903,1291,511,585,2387,42290
04-07-2016,19,15512,15530,6330,2244,39617,1302,337,577,2216,41833
04-07-2016,20,15285,15073,6414,2023,38796,1307,330,559,2196,40992
04-07-2016,21,15164,14558,6580,1975,38278,1297,325,555,2177,40455
04-07-2016,22,14698,14445,6636,1751,37528,1266,320,548,2134,39662
04-07-2016,23,14312,13379,6453,1702,35846,1270,318,533,2121,37967
05-07-2016,0,13861,11636,6164,1438,33101,1197,312,228,1737,34838
05-07-2016,1,13238,11326,6039,1275,31878,1148,310,182,1640,33518
05-07-2016,2,13118,11220,5937,908,31183,1064,312,195,1571,32754
05-07-2016,3,12922,11167,5856,866,30811,1081,317,197,1595,32406
05-07-2016,4,12864,11163,5902,800,30729,1085,318,190,1593,32322
05-07-2016,5,13299,11587,6101,852,31838,1096,327,157,1580,33418
05-07-2016,6,14606,13692,6268,1394,35959,1300,424,299,2023,37982
05-07-2016,7,15774,16231,6540,1695,40241,1354,734,317,2405,42646
05-07-2016,8,16423,16787,6731,1993,41935,1363,843,321,2527,44462
05-07-2016,9,16320,16592,6748,2098,41759,1364,882,321,2567,44326
05-07-2016,10,16364,16289,6814,2048,41515,1376,865,331,2572,44087
05-07-2016,11,16207,15670,7222,2046,41146,1418,803,351,2572,43718
05-07-2016,12,16270,15033,7319,1955,40578,1515,739,393,2647,43225
05-07-2016,13,16299,15299,7267,1742,40607,1505,734,397,2636,43243
05-07-2016,14,16041,15233,7148,1743,40163,1500,713,357,2570,42733
05-07-2016,15,15688,15928,6710,1628,39955,1398,679,384,2461,42416
05-07-2016,16,15543,15989,6408,1448,39388,1414,615,363,2392,41780
05-07-2016,17,16135,15628,6324,1478,39567,1411,611,310,2332,41899
05-07-2016,18,15800,15653,6322,1711,39485,1391,585,269,2245,41730
05-07-2016,19,15481,15009,6312,2143,38945,1384,581,237,2202,41147
05-07-2016,20,15280,14129,6140,2511,38061,1358,603,233,2194,40255
05-07-2016,21,15309,13181,6145,2287,36923,1324,502,198,2024,38947
05-07-2016,22,14681,12606,6098,2617,36003,1298,450,101,1849,37852
05-07-2016,23,13417,11933,5793,2789,33933,1305,455,154,1914,35847
06-07-2016,0,12000,11475,5760,2976,32210,977,435,209,1621,33831
06-07-2016,1,10411,11497,5627,3098,30634,902,424,185,1511,32145
06-07-2016,2,9269,11626,5551,3091,29537,880,422,190,1492,31029
06-07-2016,3,8790,11674,5462,3116,29041,884,408,195,1487,30528
06-07-2016,4,8581,11784,5464,3203,29032,885,387,145,1417,30449
06-07-2016,5,9570,11992,5806,3240,30608,940,397,92,1429,32037
06-07-2016,6,11307,12908,6156,3307,33679,1172,463,92,1727,35406
06-07-2016,7,13105,13778,6411,3552,36846,1252,646,98,1996,38842
06-07-2016,8,14331,14850,6525,3799,39505,1241,688,192,2121,41626
06-07-2016,9,13889,15541,6581,3790,39801,1250,705,283,2238,42039
06-07-2016,10,13905,16180,6625,3887,40598,1253,713,303,2269,42867
06-07-2016,11,13843,15957,6683,4018,40501,1223,672,330,2225,42726
06-07-2016,12,13629,15623,6667,4086,40005,1286,654,375,2315,42320
06-07-2016,13,13428,15597,6639,4158,39823,1207,605,415,2227,42050
06-07-2016,14,13639,15296,6636,4193,39764,1192,644,417,2253,42017
06-07-2016,15,13060,14914,6527,4148,38649,1171,603,396,2170,40819
06-07-2016,16,12674,14814,6473,4086,38047,1175,567,393,2135,40182
06-07-2016,17,12808,14655,6371,4080,37915,1178,530,367,2075,39990
06-07-2016,18,13468,14401,6367,4186,38423,1154,460,346,1960,40383
06-07-2016,19,14189,14758,6386,4039,39374,1149,455,320,1924,41298
06-07-2016,20,14261,14627,6224,3759,38870,1137,408,288,1833,40703
06-07-2016,21,14064,14254,6116,3418,37851,1157,393,92,1642,39493
06-07-2016,22,13805,13896,6118,3241,37063,1152,387,89,1628,38691
06-07-2016,23,13327,13031,5960,3094,35412,1137,368,100,1605,37017
07-07-2016,0,12201,12666,5773,2970,33610,888,372,122,1382,34992
07-07-2016,1,11884,12514,5710,2840,32949,808,449,151,1408,34357
07-07-2016,2,11546,12470,5609,2804,32430,769,574,150,1493,33923
07-07-2016,3,11080,12439,5697,2600,31815,780,547,188,1515,33330
07-07-2016,4,11152,12483,5609,2574,31818,805,506,217,1528,33346
07-07-2016,5,11735,12646,6018,2785,33184,852,385,189,1426,34610
07-07-2016,6,13216,14625,6370,2602,36813,1028,480,210,1718,38531
07-07-2016,7,14522,16520,6574,2657,40274,1183,671,262,2116,42390
07-07-2016,8,15377,17132,6747,2936,42192,1169,795,319,2283,44475
07-07-2016,9,15541,16916,6786,3104,42344,1198,852,336,2386,44730
07-07-2016,10,15250,16437,6800,3039,41525,1210,847,459,2516,44041
07-07-2016,11,15257,16364,6852,2944,41417,1235,743,444,2422,43839
07-07-2016,12,15396,15961,6915,2965,41236,1241,732,473,2446,43682
07-07-2016,13,15577,16008,6878,2959,41422,1224,726,407,2357,43779
07-07-2016,14,15307,16069,6850,2759,40985,1193,707,405,2305,43290
07-07-2016,15,14878,15760,6752,2868,40258,1156,641,406,2203,42461
07-07-2016,16,14779,15317,6603,2919,39618,1161,573,381,2115,41733
07-07-2016,17,15158,15890,6548,2856,40453,1230,555,367,2152,42605
07-07-2016,18,15185,16380,6664,2586,40815,1236,476,363,2075,42890
07-07-2016,19,15323,16242,6590,2417,40571,1230,380,392,2002,42573
07-07-2016,20,15294,16084,6363,2186,39927,1220,382,283,1885,41812
07-07-2016,21,15233,15705,6350,2114,39403,1232,380,258,1870,41273
07-07-2016,22,15227,15095,6303,2021,38646,1221,379,270,1870,40516
07-07-2016,23,14504,13958,6167,2007,36634,1220,371,264,1855,38489
08-07-2016,0,13705,12737,6025,1838,34306,1046,369,274,1689,35995
08-07-2016,1,13301,12204,5910,1570,32985,839,373,259,1471,34456
08-07-2016,2,13034,11912,5909,1478,32333,797,375,249,1421,33754
08-07-2016,3,12461,11735,5804,1235,31237,785,379,231,1395,32632
08-07-2016,4,12200,11670,5852,1325,31047,797,392,213,1402,32449
08-07-2016,5,12857,11924,5915,1550,32247,876,408,213,1497,33744
08-07-2016,6,14080,13771,6322,1563,35735,1086,492,296,1874,37609
08-07-2016,7,15433,16232,6631,1828,40124,1108,599,408,2115,42239
08-07-2016,8,15891,17017,6773,1932,41612,1069,714,522,2305,43917
08-07-2016,9,15974,17109,6756,2079,41917,1067,803,553,2423,44340
08-07-2016,10,15943,17154,6735,2235,42067,1092,841,561,2494,44561
08-07-2016,11,15905,16940,6775,2274,41893,1120,735,584,2439,44332
08-07-2016,12,15603,16064,6859,2170,40696,1208,769,441,2418,43114
08-07-2016,13,15508,15379,6714,2169,39772,1243,732,483,2458,42230
08-07-2016,14,15437,15077,6619,1857,38990,1215,671,485,2371,41361
08-07-2016,15,15118,14624,6474,1940,38157,1184,601,496,2281,40438
08-07-2016,16,15268,14435,6308,1984,37998,1183,357,343,1883,39881
08-07-2016,17,15166,14445,6198,2022,37833,1191,250,369,1810,39643
08-07-2016,18,14723,14457,6278,1960,37418,1181,240,182,1603,39021
08-07-2016,19,14788,14355,6320,1885,37348,1101,320,317,1738,39086
08-07-2016,20,14211,13425,6146,2070,35853,1059,213,117,1389,37242
08-07-2016,21,14068,12676,6091,2123,34958,1045,221,199,1465,36423
08-07-2016,22,13853,12223,6109,2268,34452,1077,218,119,1414,35866
08-07-2016,23,13466,11535,6103,1996,33099,973,199,93,1265,34364
09-07-2016,0,12474,10295,5896,1809,30475,837,172,97,1106,31581
09-07-2016,1,10984,10087,5756,1899,28728,800,168,76,1044,29772
09-07-2016,2,10230,9886,5716,1820,27651,782,166,95,1043,28694
09-07-2016,3,9792,9825,5757,1830,27204,791,170,114,1075,28279
09-07-2016,4,9370,9833,5717,1813,26733,754,167,128,1049,27782
09-07-2016,5,9798,9865,5688,1787,27140,743,179,119,1041,28181
09-07-2016,6,10449,10140,5764,1806,28158,745,201,90,1036,29194
09-07-2016,7,11932,10518,5940,2060,30451,761,550,60,1371,31822
09-07-2016,8,12170,11199,6068,2174,31611,1061,675,63,1799,33410
09-07-2016,9,12615,11657,6254,2445,32971,1097,648,56,1801,34772
09-07-2016,10,12806,11753,6161,2635,33355,1095,634,52,1781,35136
09-07-2016,11,12739,11934,6163,2848,33683,1111,497,51,1659,35342
09-07-2016,12,12337,11663,6185,2864,33049,1102,418,51,1571,34620
09-07-2016,13,11992,11617,6183,2880,32673,1105,321,56,1482,34155
09-07-2016,14,11702,11531,6186,3007,32427,1105,310,74,1489,33916
09-07-2016,15,11567,11489,6021,3001,32080,1110,300,83,1493,33573
09-07-2016,16,11735,11689,5922,2892,32237,1069,265,108,1442,33679
09-07-2016,17,12299,11872,5978,2795,32944,1071,242,133,1446,34390
09-07-2016,18,13550,12632,6043,2831,35057,1094,230,116,1440,36497
09-07-2016,19,14191,13026,6137,2418,35771,1086,218,131,1435,37206
09-07-2016,20,14183,13173,6145,2131,35633,1068,221,109,1398,37031
09-07-2016,21,14005,13132,6061,1979,35180,1068,222,100,1390,36570
09-07-2016,22,14034,13009,6060,1986,35089,1080,198,116,1394,36483
09-07-2016,23,13285,12286,5969,1783,33322,1100,181,133,1414,34736
10-07-2016,0,11793,11183,5728,1583,30286,859,189,151,1199,31485
10-07-2016,1,10510,10802,5569,1376,28258,775,186,176,1137,29395
10-07-2016,2,9423,10704,5493,1447,27068,758,185,198,1141,28209
10-07-2016,3,8860,10524,5492,1574,26450,745,185,215,1145,27595
10-07-2016,4,8588,10376,5462,1655,26083,737,193,201,1131,27214
10-07-2016,5,8451,10224,5457,1815,25948,720,204,195,1119,27067
10-07-2016,6,9166,10075,5410,1941,26592,707,217,192,1116,27708
10-07-2016,7,9908,10027,5480,1985,27400,730,550,190,1470,28870
10-07-2016,8,10785,10501,5610,1937,28832,790,711,228,1729,30561
10-07-2016,9,12247,10856,5825,2029,30957,887,762,273,1922,32879
10-07-2016,10,12692,11464,5898,2005,32059,1064,718,258,2040,34099
10-07-2016,11,13016,11694,5951,2197,32858,1113,609,242,1964,34822
10-07-2016,12,12962,11551,5978,2369,32861,1116,605,269,1990,34851
10-07-2016,13,12850,11479,5959,2470,32758,1135,465,232,1832,34590
10-07-2016,14,12755,11462,5950,2374,32542,1151,302,221,1674,34216
10-07-2016,15,12437,11353,5979,2247,32015,1121,312,174,1607,33622
10-07-2016,16,12665,11421,5974,1952,32013,1139,336,150,1625,33638
10-07-2016,17,13420,11602,5995,1619,32638,1124,373,150,1647,34285
10-07-2016,18,13930,11895,5938,1584,33349,1125,402,142,1669,35018
10-07-2016,19,14629,12472,6124,1696,34921,1114,440,135,1689,36610
10-07-2016,20,14709,12761,6117,1769,35356,1114,433,141,1688,37044
10-07-2016,21,14330,12719,6024,1941,35014,1127,231,129,1487,36501
10-07-2016,22,14157,12367,6068,1929,34521,1125,213,77,1415,35936
10-07-2016,23,13704,11365,5915,1948,32933,1111,199,83,1393,34326
11-07-2016,0,12514,10260,5775,1822,30371,838,169,105,1112,31483
11-07-2016,1,11127,10049,5585,1560,28322,705,165,108,978,29300
11-07-2016,2,10182,9963,5533,1620,27298,694,168,115,977,28275
11-07-2016,3,9716,9924,5485,1650,26775,702,171,121,994,27769
11-07-2016,4,9557,9887,5481,1582,26507,660,202,131,993,27500
11-07-2016,5,11070,10094,5654,1729,28548,804,223,163,1190,29738
11-07-2016,6,13212,11656,6041,2164,33073,1066,349,288,1703,34776
11-07-2016,7,14411,14013,6166,2287,36877,1069,747,483,2299,39176
11-07-2016,8,15118,14906,6221,2518,38764,1067,995,676,2738,41502
11-07-2016,9,15232,15385,6354,2640,39611,1083,1096,635,2814,42425
11-07-2016,10,15082,15334,6343,2772,39531,1090,1084,652,2826,42357
11-07-2016,11,14510,15176,6299,3058,39043,1091,1053,675,2819,41862
11-07-2016,12,13923,14964,6329,3281,38497,1088,995,686,2769,41266
11-07-2016,13,13229,14862,6170,3445,37704,1094,909,792,2795,40499
11-07-2016,14,12980,14581,6178,3669,37408,1097,749,767,2613,40021
11-07-2016,15,12929,14376,6274,3775,37354,977,631,737,2345,39699
11-07-2016,16,13730,14529,6241,3830,38330,1002,478,480,1960,40290
11-07-2016,17,13731,14605,6141,3791,38269,1095,480,361,1936,40205
11-07-2016,18,13826,15010,6101,3368,38306,1097,482,457,2036,40342
11-07-2016,19,13927,15048,6036,3408,38420,1109,473,387,1969,40389
11-07-2016,20,13835,14133,6061,3261,37288,1108,438,427,1973,39261
11-07-2016,21,13734,13833,5999,3103,36668,1092,433,433,1958,38626
11-07-2016,22,13038,13635,5997,3011,35680,1082,415,421,1918,37598
11-07-2016,23,12802,12312,6009,2887,34010,1087,395,179,1661,35671
12-07-2016,0,11499,11481,5595,2877,31452,794,386,182,1362,32814
12-07-2016,1,10838,11352,5364,2736,30289,721,384,219,1324,31613
12-07-2016,2,10606,11120,5479,2615,29820,721,383,239,1343,31163
12-07-2016,3,10198,11106,5360,2534,29199,733,385,241,1359,30558
12-07-2016,4,10486,11101,5400,2375,29362,736,392,220,1348,30710
12-07-2016,5,11580,11467,5545,2207,30799,816,404,184,1404,32203
12-07-2016,6,13074,13220,5838,2368,34501,1065,429,144,1638,36139
12-07-2016,7,14619,15361,6052,2531,38561,1077,631,126,1834,40395
12-07-2016,8,15238,16090,6240,2814,40382,1132,875,145,2152,42534
12-07-2016,9,15361,15762,6284,3035,40443,1169,888,318,2375,42818
12-07-2016,10,15341,15654,6237,3302,40535,1186,798,318,2302,42837
12-07-2016,11,15294,15682,6214,3410,40601,1175,652,336,2163,42764
12-07-2016,12,15253,15436,6280,3309,40280,1214,735,372,2321,42601
12-07-2016,13,15082,15399,6381,3208,40072,1215,568,353,2136,42208
12-07-2016,14,14956,15277,6307,3213,39752,1204,510,335,2049,41801
12-07-2016,15,15000,15188,6321,3150,39659,1198,510,180,1888,41547
12-07-2016,16,14817,15487,6279,3133,39716,1190,444,187,1821,41537
12-07-2016,17,15003,15981,6260,3167,40411,1182,507,160,1849,42260
12-07-2016,18,14896,16136,6363,3070,40466,1187,481,132,1800,42266
12-07-2016,19,14650,16224,6241,2890,40006,1167,467,107,1741,41747
12-07-2016,20,14487,15799,6192,2618,39095,1175,484,89,1748,40843
12-07-2016,21,14411,15522,6166,2445,38544,1163,462,84,1709,40253
12-07-2016,22,14142,14876,6067,2393,37479,1154,415,83,1652,39131
12-07-2016,23,13500,13463,5765,2174,34902,1081,389,91,1561,36463
13-07-2016,0,12299,11280,5603,1881,31064,1080,378,97,1555,32619
13-07-2016,1,12122,10747,5511,1765,30146,1082,377,96,1555,31701
13-07-2016,2,12055,10644,5510,1677,29888,935,374,90,1399,31287
13-07-2016,3,11867,10573,5472,1682,29595,787,371,91,1249,30844
13-07-2016,4,11779,10524,5442,1684,29429,777,380,89,1246,30675
13-07-2016,5,11831,10946,5659,1593,30030,933,394,78,1405,31435
13-07-2016,6,13230,12829,5939,1988,33986,987,514,62,1563,35549
13-07-2016,7,14304,15583,6213,2251,38350,1102,661,58,1821,40171
13-07-2016,8,14748,16405,6292,2491,39934,1091,823,125,2039,41973
13-07-2016,9,15292,16393,6329,2593,40606,1134,907,235,2276,42882
13-07-2016,10,15325,16517,6392,2714,40948,1133,908,229,2270,43218
13-07-2016,11,15147,16685,6331,2784,40947,1130,897,216,2243,43190
13-07-2016,12,14965,16223,6327,2868,40382,1130,859,387,2376,42758
13-07-2016,13,15196,15650,6382,2831,40061,1127,799,228,2154,42215
13-07-2016,14,15186,15414,6408,2817,39825,1133,720,236,2089,41914
13-07-2016,15,14901,15248,6308,2716,39173,1135,546,245,1926,41099
13-07-2016,16,14659,14755,6210,2671,38296,1090,454,225,1769,40065
13-07-2016,17,14817,14642,6133,2868,38461,1079,414,77,1570,40031
13-07-2016,18,14913,14813,6119,2693,38539,1075,423,68,1566,40105
13-07-2016,19,14781,14902,6114,2577,38373,1063,431,72,1566,39939
13-07-2016,20,14557,14441,6080,2480,37558,1052,432,71,1555,39113
13-07-2016,21,14195,13979,6009,2399,36582,1070,423,64,1557,38139
13-07-2016,22,13978,13356,5989,2392,35716,1084,401,57,1542,37258
13-07-2016,23,13090,12163,5805,2278,33335,1021,372,52,1445,34780
14-07-2016,0,12414,10802,5619,2158,30993,839,361,50,1250,32243
14-07-2016,1,11914,10561,5572,2079,30127,733,362,50,1145,31272
14-07-2016,2,11463,10488,5471,2140,29563,733,363,50,1146,30709
14-07-2016,3,11024,10387,5428,2030,28868,753,367,48,1168,30036
14-07-2016,4,10454,10336,5422,1879,28090,748,376,48,1172,29262
14-07-2016,5,11311,10719,5594,1810,29434,754,394,61,1209,30643
14-07-2016,6,13010,11937,5872,1645,32464,1030,497,72,1599,34063
14-07-2016,7,14141,13798,6076,1696,35711,1061,625,67,1753,37464
14-07-2016,8,14774,15224,6201,1921,38119,1080,759,57,1896,40015
14-07-2016,9,15191,15226,6301,2069,38788,1083,773,59,1915,40703
14-07-2016,10,15541,15149,6297,2014,39001,1086,758,150,1994,40995
14-07-2016,11,15610,15219,6346,2107,39284,1064,685,273,2022,41306
14-07-2016,12,15424,15352,6292,2139,39207,1066,677,281,2024,41231
14-07-2016,13,15341,15107,6392,2245,39083,1062,670,295,2027,41110
14-07-2016,14,14885,14925,6467,2188,38464,1052,622,168,1842,40306
14-07-2016,15,14800,14813,6386,2083,38080,1077,450,171,1698,39778
14-07-2016,16,14064,14244,6243,2264,36815,1063,449,203,1715,38530
14-07-2016,17,14285,13764,6254,2325,36629,1046,408,215,1669,38298
14-07-2016,18,14922,13035,6193,2394,36544,1035,398,255,1688,38232
14-07-2016,19,14717,12913,6136,2525,36291,1039,399,313,1751,38042
14-07-2016,20,14303,12687,6067,2315,35373,1036,419,341,1796,37169
14-07-2016,21,14168,12554,6072,2247,35041,1051,422,358,1831,36872
14-07-2016,22,13608,11973,6081,2123,33786,1047,400,357,1804,35590
14-07-2016,23,12395,10956,5791,2237,31380,1063,397,347,1807,33187
15-07-2016,0,11116,10561,5652,2342,29672,781,385,266,1432,31104
15-07-2016,1,9948,10338,5435,2349,28069,708,367,183,1258,29327
15-07-2016,2,9617,10360,5447,2327,27751,701,369,130,1200,28951
15-07-2016,3,9228,10361,5385,2474,27448,717,363,114,1194,28642
15-07-2016,4,8946,10363,5354,2518,27182,728,377,114,1219,28401
15-07-2016,5,10534,10565,5604,2559,29263,795,453,148,1396,30659
15-07-2016,6,12093,11699,5903,2543,32238,1079,579,124,1782,34020
15-07-2016,7,13924,13341,6145,2700,36110,1064,682,126,1872,37982
15-07-2016,8,14470,14448,6354,2897,38169,1179,615,303,2097,40266
15-07-2016,9,14980,15523,6420,2838,39761,1079,655,335,2069,41830
15-07-2016,10,14969,16012,6400,3083,40464,1128,649,308,2085,42549
15-07-2016,11,14798,15735,6472,3212,40219,1125,468,376,1969,42188
15-07-2016,12,15018,15283,6490,3007,39798,1114,458,418,1990,41788
15-07-2016,13,14427,15092,6412,3213,39144,1117,406,510,2033,41177
15-07-2016,14,14126,14804,6425,3356,38711,1117,296,471,1884,40595
15-07-2016,15,13370,14684,6488,3483,38025,1089,238,404,1731,39756
15-07-2016,16,13650,14400,6430,3672,38152,1070,247,383,1700,39852
15-07-2016,17,14030,14194,6429,3611,38264,1123,249,364,1736,40000
15-07-2016,18,14016,14388,6334,3544,38283,1132,253,275,1660,39943
15-07-2016,19,14283,14423,6370,3368,38445,1020,255,263,1538,39983
15-07-2016,20,14268,14160,6295,2969,37692,1081,249,227,1557,39249
15-07-2016,21,14153,13769,6289,2584,36795,1114,242,208,1564,38359
15-07-2016,22,14068,13338,6353,2359,36117,1122,235,215,1572,37689
15-07-2016,23,13356,12514,6152,2156,34179,1135,212,209,1556,35735
16-07-2016,0,12343,11362,5887,2205,31797,819,197,219,1235,33032
16-07-2016,1,11163,10846,5760,1948,29717,673,189,220,1082,30799
16-07-2016,2,10520,10435,5665,1869,28491,648,186,202,1036,29527
16-07-2016,3,10045,10476,5595,1671,27788,641,188,189,1018,28806
16-07-2016,4,10036,10456,5604,1586,27681,656,194,176,1026,28707
16-07-2016,5,9843,10400,5589,1697,27530,642,203,178,1023,28553
16-07-2016,6,10305,10507,5799,2033,28644,642,213,180,1035,29679
16-07-2016,7,11449,10787,5868,2282,30387,638,411,179,1228,31615
16-07-2016,8,12257,11567,5862,2427,32112,690,539,171,1400,33512
16-07-2016,9,12495,12155,6096,2443,33189,894,649,167,1710,34899
16-07-2016,10,12474,12625,6329,2283,33709,931,640,190,1761,35470
16-07-2016,11,12827,12794,6283,2100,34005,919,600,201,1720,35725
16-07-2016,12,12743,12893,6300,2101,34038,917,472,175,1564,35602
16-07-2016,13,12534,12691,6361,2061,33646,939,428,164,1531,35177
16-07-2016,14,12360,12563,6330,2027,33281,922,348,172,1442,34723
16-07-2016,15,12180,12375,6287,2078,32921,908,364,157,1429,34350
16-07-2016,16,12244,12301,6336,2210,33091,904,265,138,1307,34398
16-07-2016,17,13077,12477,6471,2270,34296,872,231,134,1237,35533
16-07-2016,18,13654,13066,6532,2303,35555,835,234,118,1187,36742
16-07-2016,19,13809,13162,6456,2281,35706,870,233,101,1204,36910
16-07-2016,20,13858,13003,6346,2104,35312,892,228,88,1208,36520
16-07-2016,21,13786,12866,6297,1975,34925,887,227,89,1203,36128
16-07-2016,22,13920,12745,6380,1995,35039,915,191,96,1202,36241
16-07-2016,23,12902,11769,6319,1956,32946,930,188,88,1206,34152
17-07-2016,0,11267,11241,6138,1890,30536,719,137,87,943,31479
17-07-2016,1,9628,11039,5963,1768,28399,676,137,118,931,29330
17-07-2016,2,8939,10928,5816,1615,27299,670,139,178,987,28286
17-07-2016,3,8425,10783,5847,1600,26653,685,137,197,1019,27672
17-07-2016,4,8281,10697,5825,1460,26264,669,140,178,987,27251
17-07-2016,5,8419,10548,5820,1349,26139,694,146,184,1024,27163
17-07-2016,6,8490,10498,5979,1219,26186,693,149,165,1007,27193
17-07-2016,7,9342,10441,6059,1257,27101,710,197,121,1028,28129
17-07-2016,8,10561,10762,6240,1366,28930,863,374,87,1324,30254
17-07-2016,9,11322,10949,6272,1565,30110,1125,446,93,1664,31774
17-07-2016,10,12383,11146,6371,1590,31489,1119,464,110,1693,33182
17-07-2016,11,12807,11291,6407,1578,32084,1132,362,101,1595,33679
17-07-2016,12,13045,11362,6319,1543,32268,1133,362,100,1595,33863
17-07-2016,13,12615,11409,6246,1542,31812,1123,187,100,1410,33222
17-07-2016,14,12769,11486,6087,1551,31894,1115,199,101,1415,33309
17-07-2016,15,12330,11565,5979,1656,31531,1098,167,101,1366,32897
17-07-2016,16,12406,11706,6025,1740,31877,1094,149,116,1359,33236
17-07-2016,17,13013,11846,6093,1791,32743,1071,150,126,1347,34090
17-07-2016,18,13662,12064,6143,1713,33583,1041,147,122,1310,34893
17-07-2016,19,14578,12061,6069,1557,34265,1022,142,109,1273,35538
17-07-2016,20,14869,11981,6187,1405,34442,993,138,100,1231,35673
17-07-2016,21,15246,12381,6172,1353,35153,991,134,121,1246,36399
17-07-2016,22,15201,12304,6097,1292,34894,984,131,100,1215,36109
17-07-2016,23,14465,11615,5912,1298,33291,967,140,87,1194,34485
18-07-2016,0,13305,11150,5719,1131,31305,709,175,80,964,32269
18-07-2016,1,11636,10935,5639,1260,29469,684,178,81,943,30412
18-07-2016,2,11091,10838,5590,1237,28756,715,179,115,1009,29765
18-07-2016,3,10448,10682,5604,1256,27990,786,185,120,1091,29081
18-07-2016,4,10711,10610,5669,1170,28161,838,198,103,1139,29300
18-07-2016,5,11321,10770,5817,1265,29173,893,213,81,1187,30360
18-07-2016,6,13510,12547,6007,1467,33530,1194,244,75,1513,35043
18-07-2016,7,14471,14795,6284,1704,37254,1224,557,69,1850,39104
18-07-2016,8,14986,15957,6525,1883,39353,1247,625,87,1959,41312
18-07-2016,9,15241,15738,6513,1899,39390,1266,644,101,2011,41401
18-07-2016,10,15200,15081,6555,2022,38859,1289,640,131,2060,40919
18-07-2016,11,15231,14877,6510,2078,38696,1359,559,167,2085,40781
18-07-2016,12,15308,14720,6549,1929,38507,1353,560,205,2118,40625
18-07-2016,13,15214,14595,6462,2060,38331,1327,379,217,1923,40254
18-07-2016,14,15204,14556,6422,2022,38204,1315,400,230,1945,40149
18-07-2016,15,15060,14133,6353,1972,37518,1297,391,228,1916,39434
18-07-2016,16,14812,14134,6188,1960,37094,1298,386,227,1911,39005
18-07-2016,17,14942,14323,6147,1986,37398,1309,386,211,1906,39304
18-07-2016,18,15270,15048,6317,2039,38674,1320,390,187,1897,40571
18-07-2016,19,15178,15432,6334,1914,38857,1314,393,164,1871,40728
18-07-2016,20,15310,15249,6094,1724,38377,1318,400,134,1852,40229
18-07-2016,21,15329,14361,6020,1567,37278,1350,399,113,1862,39140
18-07-2016,22,15153,13847,6007,1366,36372,1364,381,95,1840,38212
18-07-2016,23,14301,12292,5762,1186,33542,1374,337,79,1790,35332
19-07-2016,0,13160,11071,5670,1180,31082,1355,180,70,1605,32687
19-07-2016,1,12821,10954,5716,1152,30644,1235,176,66,1477,32121
19-07-2016,2,12446,10941,5741,1163,30290,1085,177,67,1329,31619
19-07-2016,3,12160,10785,5658,1111,29713,995,180,65,1240,30953
19-07-2016,4,11900,10757,5610,1165,29432,960,191,62,1213,30645
19-07-2016,5,12338,10893,5718,1142,30091,1056,205,60,1321,31412
19-07-2016,6,13960,12449,5978,1386,33773,1368,222,56,1646,35419
19-07-2016,7,14647,15328,6197,1623,37795,1376,369,50,1795,39590
19-07-2016,8,15327,16204,6473,1734,39738,1373,651,228,2252,41990
19-07-2016,9,15275,15926,6350,2023,39574,1380,673,224,2277,41851
19-07-2016,10,15167,15088,6354,2178,38788,1397,600,254,2251,41039
19-07-2016,11,15633,15128,6464,2082,39304,1412,616,275,2303,41607
19-07-2016,12,15717,14570,6502,2047,38837,1398,654,298,2350,41187
19-07-2016,13,15287,14227,6364,2065,37943,1405,481,324,2210,40153
19-07-2016,14,15013,14034,6276,1872,37195,1408,481,335,2224,39419
19-07-2016,15,15090,14257,6287,1848,37482,1418,465,333,2216,39698
19-07-2016,16,15115,14726,6429,1709,37981,1478,472,360,2310,40291
19-07-2016,17,15308,15416,6416,1961,39101,1458,468,376,2302,41403
19-07-2016,18,15111,15925,6371,1865,39271,1447,468,377,2292,41563
19-07-2016,19,14956,15999,6395,1730,39081,1438,452,368,2258,41339
19-07-2016,20,15409,15540,6354,1628,38932,1376,444,298,2118,41050
19-07-2016,21,15378,15385,6241,1517,38521,1364,444,262,2070,40591
19-07-2016,22,15192,14193,6022,1401,36808,1383,415,203,2001,38809
19-07-2016,23,13938,11986,5897,1449,33272,1334,391,210,1935,35207
20-07-2016,0,13342,10862,5692,1271,31167,1488,210,200,1898,33065
20-07-2016,1,12940,10719,5507,1014,30179,1188,196,211,1595,31774
20-07-2016,2,12254,10612,5425,897,29188,1039,174,200,1413,30601
20-07-2016,3,11657,10540,5396,871,28465,1015,182,200,1397,29862
20-07-2016,4,11622,10534,5450,888,28492,1015,196,199,1410,29902
20-07-2016,5,12375,10780,5672,1114,29941,1200,206,181,1587,31528
20-07-2016,6,13176,12348,6046,1465,33036,1345,246,124,1715,34751
20-07-2016,7,14125,14600,6374,1720,36821,1347,361,236,1944,38765
20-07-2016,8,14958,15620,6493,1951,39022,1354,525,260,2139,41161
20-07-2016,9,15174,15637,6460,2067,39337,1360,622,293,2275,41612
20-07-2016,10,15086,15348,6375,2135,38945,1381,649,330,2360,41305
20-07-2016,11,15021,14996,6312,2135,38463,1381,739,358,2478,40941
20-07-2016,12,14730,14535,6232,2115,37613,1381,769,369,2519,40132
20-07-2016,13,14604,14157,6117,2187,37064,1387,718,389,2494,39558
20-07-2016,14,14567,13921,6044,2022,36554,1375,485,400,2260,38814
20-07-2016,15,14555,13861,5974,2032,36423,1376,437,403,2216,38639
20-07-2016,16,14479,13903,5963,2108,36453,1375,440,273,2088,38541
20-07-2016,17,14646,14735,6076,2314,37772,1365,470,253,2088,39860
20-07-2016,18,14467,15279,6048,2434,38228,1364,479,234,2077,40305
20-07-2016,19,14380,15477,5932,2443,38232,1365,453,224,2042,40274
20-07-2016,20,14638,14765,5762,2202,37367,1376,447,219,2042,39409
20-07-2016,21,14388,13694,5800,2137,36020,1399,449,222,2070,38090
20-07-2016,22,13695,12602,5844,2171,34314,1385,432,234,2051,36365
20-07-2016,23,13033,11661,5634,2088,32418,1399,407,231,2037,34455
21-07-2016,0,12150,10957,5590,2210,30907,1087,215,229,1531,32438
21-07-2016,1,11749,10684,5609,2353,30396,964,189,224,1377,31773
21-07-2016,2,11465,10583,5529,2237,29815,960,193,235,1388,31203
21-07-2016,3,11715,10572,5476,1973,29736,918,199,256,1373,31109
21-07-2016,4,11771,10565,5375,1767,29478,899,219,270,1388,30866
21-07-2016,5,11932,10921,5626,1685,30163,1095,219,259,1573,31736
21-07-2016,6,13099,12698,5941,1727,33466,1295,231,212,1738,35204
21-07-2016,7,13685,14786,6155,1891,36516,1301,351,165,1817,38333
21-07-2016,8,14362,15782,6274,2394,38811,1151,618,314,2083,40894
21-07-2016,9,14664,16099,6373,2608,39744,1182,672,361,2215,41959
21-07-2016,10,14847,16190,6442,2712,40193,1284,522,368,2174,42367
21-07-2016,11,15091,16404,6511,2551,40557,1311,548,378,2237,42794
21-07-2016,12,15177,16511,6494,2421,40604,1319,523,374,2216,42820
21-07-2016,13,14966,16244,6496,2372,40076,1315,481,341,2137,42213
21-07-2016,14,14714,16199,6485,2367,39765,1322,472,334,2128,41893
21-07-2016,15,14410,16249,6437,2292,39390,1321,424,332,2077,41467
21-07-2016,16,14426,16318,6456,2296,39496,1314,412,190,1916,41412
21-07-2016,17,14694,16617,6373,2237,39923,1293,410,206,1909,41832
21-07-2016,18,14434,16822,6249,2209,39715,1285,401,189,1875,41590
21-07-2016,19,14282,16400,6201,2150,39033,1272,412,174,1858,40891
21-07-2016,20,14544,15754,6094,1968,38359,1194,447,202,1843,40202
21-07-2016,21,14464,15222,6216,1799,37702,1221,401,174,1796,39498
21-07-2016,22,14232,14370,6154,1667,36424,1228,386,166,1780,38204
21-07-2016,23,13791,12957,5880,1683,34310,1299,378,90,1767,36077
22-07-2016,0,13414,11389,5576,1493,31873,1176,202,91,1469,33342
22-07-2016,1,13127,10994,5431,1173,30724,1131,181,89,1401,32125
22-07-2016,2,13024,10915,5479,1396,30816,1020,177,85,1282,32098
22-07-2016,3,12868,10856,5380,1330,30435,903,179,86,1168,31603
22-07-2016,4,12739,10926,5350,1361,30378,899,184,79,1162,31540
22-07-2016,5,12605,11172,5697,1302,30776,1153,189,79,1421,32197
22-07-2016,6,13482,13631,6058,1652,34823,1234,211,76,1521,36344
22-07-2016,7,14141,15756,6348,1898,38143,1245,361,234,1840,39983
22-07-2016,8,14831,16674,6545,2102,40152,1265,569,245,2079,42231
22-07-2016,9,14966,16896,6551,2287,40700,1265,607,255,2127,42827
22-07-2016,10,14890,16603,6486,2339,40319,1261,550,254,2065,42384
22-07-2016,11,14941,16102,6483,2439,39965,1258,605,248,2111,42076
22-07-2016,12,14626,15346,6466,2438,38876,1260,602,258,2120,40996
22-07-2016,13,14354,14584,6344,2324,37607,1230,599,273,2102,39709
22-07-2016,14,14553,14658,6346,2295,37851,1221,442,245,1908,39759
22-07-2016,15,14726,14919,6286,2325,38255,1239,415,272,1926,40181
22-07-2016,16,14674,15184,6270,2315,38443,1215,396,259,1870,40313
22-07-2016,17,14703,15716,6388,2278,39084,1211,405,141,1757,40841
22-07-2016,18,14695,16035,6359,2142,39231,1214,388,88,1690,40921
22-07-2016,19,14369,15432,6277,1986,38065,1248,379,88,1715,39780
22-07-2016,20,14694,14403,6197,1863,37157,1195,378,77,1650,38807
22-07-2016,21,14312,13637,6181,1797,35928,1134,387,100,1621,37549
22-07-2016,22,14166,13062,6039,1779,35047,1134,203,107,1444,36491
22-07-2016,23,13507,12181,5844,1693,33225,1135,202,99,1436,34661
23-07-2016,0,13261,11468,5719,1452,31901,1015,185,85,1285,33186
23-07-2016,1,12940,10833,5573,1105,30450,1029,182,70,1281,31731
23-07-2016,2,12597,10322,5458,1121,29498,1044,181,57,1282,30780
23-07-2016,3,12415,10043,5270,830,28559,1042,183,66,1291,29850
23-07-2016,4,11742,10067,5143,862,27816,927,188,78,1193,29009
23-07-2016,5,11444,10017,5178,829,27468,922,186,81,1189,28657
23-07-2016,6,12097,10175,5401,927,28600,995,187,72,1254,29854
23-07-2016,7,12430,10991,5694,1253,30368,1056,191,55,1302,31670
23-07-2016,8,12922,12241,6098,1649,32911,1057,192,55,1304,34215
23-07-2016,9,13501,13675,6171,1826,35173,1062,192,56,1310,36483
23-07-2016,10,13860,13849,5958,1989,35656,1069,191,60,1320,36976
23-07-2016,11,13842,13589,5910,2029,35371,1055,192,60,1307,36678
23-07-2016,12,13846,12780,5709,1987,34323,1037,193,55,1285,35608
23-07-2016,13,13562,12401,5751,1999,33714,1046,195,53,1294,35008
23-07-2016,14,13025,12270,5744,1715,32754,1054,196,51,1301,34055
23-07-2016,15,13213,12146,5725,1593,32677,1053,197,54,1304,33981
23-07-2016,16,13472,12236,5667,1854,33229,1051,197,54,1302,34531
23-07-2016,17,13481,13048,5775,2133,34437,1051,207,56,1314,35751
23-07-2016,18,13577,13707,5884,2064,35233,1047,319,56,1422,36655
23-07-2016,19,13701,14151,5871,1945,35669,1039,309,61,1409,37078
23-07-2016,20,13768,13793,5788,1837,35187,1068,197,66,1331,36518
23-07-2016,21,13537,13445,5897,1860,34740,1068,196,59,1323,36063
23-07-2016,22,13812,13072,5850,1879,34613,1090,191,55,1336,35949
23-07-2016,23,13525,11565,5666,1880,32637,1084,184,53,1321,33958
24-07-2016,0,13322,10559,5557,1673,31111,874,180,53,1107,32218
24-07-2016,1,12733,10179,5343,1560,29817,799,177,51,1027,30844
24-07-2016,2,11930,9909,5160,1390,28389,728,177,49,954,29343
24-07-2016,3,11196,9814,5080,1182,27272,671,180,49,900,28172
24-07-2016,4,10555,9784,5034,1038,26411,630,186,49,865,27276
24-07-2016,5,10171,9720,5043,1189,26123,631,189,47,867,26990
24-07-2016,6,10374,9688,5073,1093,26230,635,191,45,871,27101
24-07-2016,7,11793,9969,5241,1271,28276,746,193,45,984,29260
24-07-2016,8,12642,10588,5429,1546,30204,865,196,42,1103,31307
24-07-2016,9,12928,11483,5533,1393,31337,1016,199,43,1258,32595
24-07-2016,10,12841,12137,5568,1343,31889,1038,201,43,1282,33171
24-07-2016,11,12697,12323,5638,1510,32168,1044,201,45,1290,33458
24-07-2016,12,12662,12271,5651,1533,32117,1015,202,44,1261,33378
24-07-2016,13,12012,12100,5683,1532,31329,1004,281,44,1329,32658
24-07-2016,14,11861,11848,5744,1565,31018,1008,240,45,1293,32311
24-07-2016,15,11987,11944,5654,1561,31146,966,203,46,1215,32361
24-07-2016,16,12361,12077,5684,1556,31680,1004,202,46,1252,32932
24-07-2016,17,13606,12272,5670,1639,33189,1013,202,48,1263,34452
24-07-2016,18,14095,12583,5743,2110,34530,1015,201,51,1267,35797
24-07-2016,19,14315,13689,5839,2109,35953,997,200,54,1251,37204
24-07-2016,20,14134,14054,5841,1950,35979,1013,199,60,1272,37251
24-07-2016,21,14208,14097,5968,1929,36203,1014,198,74,1286,37489
24-07-2016,22,14459,13836,6061,1987,36343,1040,194,88,1322,37665
24-07-2016,23,14024,12427,5705,1997,34153,1125,188,87,1400,35553
25-07-2016,0,13194,10950,5460,1920,31524,1148,183,85,1416,32940
25-07-2016,1,12815,10600,5319,1526,30260,1154,178,80,1412,31672
25-07-2016,2,12649,10627,5218,1335,29829,1024,179,72,1275,31104
25-07-2016,3,12416,10606,5182,1368,29570,1003,188,71,1262,30832
25-07-2016,4,12251,10806,5179,1242,29477,1016,308,68,1392,30869
25-07-2016,5,12177,11398,5141,1566,30283,1178,390,57,1625,31908
25-07-2016,6,12759,13480,5941,2024,34205,1328,475,53,1856,36061
25-07-2016,7,13502,14981,6413,2152,37048,1335,565,49,1949,38997
25-07-2016,8,14384,15983,6459,2402,39228,1334,698,228,2260,41488
25-07-2016,9,15101,16806,6193,2568,40670,1422,666,223,2311,42981
25-07-2016,10,15113,16850,6188,2633,40784,1432,675,250,2357,43141
25-07-2016,11,15318,16860,6210,2652,41042,1379,831,401,2611,43653
25-07-2016,12,14921,16534,6128,2537,40119,1358,1051,416,2825,42944
25-07-2016,13,14885,16210,6099,2417,39613,1343,848,395,2586,42199
25-07-2016,14,14966,15906,6118,2513,39504,1328,534,268,2130,41634
25-07-2016,15,15072,16180,6127,2489,39867,1332,457,277,2066,41933
25-07-2016,16,14812,16370,5954,2529,39666,1337,431,81,1849,41515
25-07-2016,17,14697,16582,5837,2455,39573,1333,510,56,1899,41472
25-07-2016,18,14682,16394,5771,2416,39264,1321,464,62,1847,41111
25-07-2016,19,14627,15992,5855,2346,38819,1237,485,60,1782,40601
25-07-2016,20,14481,15668,5645,2340,38134,1289,437,50,1776,39910
25-07-2016,21,14335,15355,5751,2065,37508,1297,408,49,1754,39262
25-07-2016,22,14234,14713,5569,1919,36435,1299,379,56,1734,38169
25-07-2016,23,13446,13365,5202,1846,33859,1301,373,61,1735,35594
26-07-2016,0,12734,11482,5072,1626,30914,1267,211,56,1534,32448
26-07-2016,1,12550,11182,5096,1509,30338,1211,207,62,1480,31818
26-07-2016,2,12374,11138,5092,1512,30114,1058,222,66,1346,31460
26-07-2016,3,12061,11108,5073,1383,29625,972,227,64,1263,30888
26-07-2016,4,11915,11085,5131,1416,29549,985,240,56,1281,30830
26-07-2016,5,12249,11246,5264,1722,30482,1080,242,50,1372,31854
26-07-2016,6,13055,12397,5508,2204,33164,1203,230,50,1483,34647
26-07-2016,7,14209,14381,5812,2389,36792,1213,452,193,1858,38650
26-07-2016,8,14890,15137,6017,2495,38540,1215,674,238,2127,40667
26-07-2016,9,15128,15357,6068,2671,39224,1228,729,268,2225,41449
26-07-2016,10,15405,15677,6143,2847,40071,1276,993,313,2582,42653
26-07-2016,11,15389,15910,6191,2948,40438,1324,1047,299,2670,43108
26-07-2016,12,15194,15907,6183,2982,40265,1327,1074,292,2693,42958
26-07-2016,13,15053,15757,6102,3045,39956,1321,991,309,2621,42577
26-07-2016,14,14674,15611,5972,2902,39160,1324,684,457,2465,41625
26-07-2016,15,14710,15369,5933,2842,38855,1324,553,317,2194,41049
26-07-2016,16,14362,15312,5952,3023,38648,1338,462,197,1997,40645
26-07-2016,17,14535,15252,5747,2830,38365,1350,467,99,1916,40281
26-07-2016,18,14868,15210,5557,2602,38237,1357,430,87,1874,40111
26-07-2016,19,14778,15181,5533,2393,37885,1360,431,203,1994,39879
26-07-2016,20,14872,15236,5402,2128,37639,1373,427,81,1881,39520
26-07-2016,21,14736,15003,5496,1905,37140,1393,424,119,1936,39076
26-07-2016,22,14338,14283,5625,1779,36025,1342,409,414,2165,38190
26-07-2016,23,13481,13644,5326,1588,34039,1362,391,353,2106,36145
27-07-2016,0,13029,12196,5276,1324,31825,1255,330,113,1698,33523
27-07-2016,1,12734,11708,5229,1348,31018,1223,325,118,1666,32684
27-07-2016,2,12409,11553,5110,1310,30383,1065,328,109,1502,31885
27-07-2016,3,11998,11571,5152,1435,30156,961,331,90,1382,31538
27-07-2016,4,11804,11456,5171,1459,29889,1015,342,76,1433,31322
27-07-2016,5,11991,11757,5177,1622,30546,1168,360,238,1766,32312
27-07-2016,6,12707,12989,5343,1859,32898,1307,384,444,2135,35033
27-07-2016,7,13681,14421,5800,2218,36121,1427,535,387,2349,38470
27-07-2016,8,14257,15129,5935,2457,37778,1500,738,389,2627,40405
27-07-2016,9,14702,15149,6027,2613,38489,1535,1120,546,3201,41690
27-07-2016,10,14880,15355,5945,2821,39001,1655,1182,356,3193,42194
27-07-2016,11,14985,15567,6020,2731,39302,1665,1149,195,3009,42311
27-07-2016,12,15099,15466,6121,2788,39474,1625,1001,230,2856,42330
27-07-2016,13,14849,15330,6099,2865,39142,1562,876,295,2733,41875
27-07-2016,14,14903,14949,6106,2858,38816,1559,720,589,2868,41684
27-07-2016,15,14658,14709,6144,2735,38247,1453,715,520,2688,40935
27-07-2016,16,14587,14711,5940,2717,37955,1408,539,495,2442,40397
27-07-2016,17,14669,15023,5640,2769,38102,1400,492,447,2339,40441
27-07-2016,18,14707,15506,5629,2626,38468,1314,507,194,2015,40483
27-07-2016,19,14440,15435,5713,2414,38002,1314,550,230,2094,40096
27-07-2016,20,14185,14827,5691,2337,37039,1241,538,54,1833,38872
27-07-2016,21,14379,13846,5670,2323,36217,1231,517,89,1837,38054
27-07-2016,22,14362,13533,5450,2245,35591,1317,396,100,1813,37404
27-07-2016,23,13391,12314,5262,2016,32983,1338,405,119,1862,34845
28-07-2016,0,12709,11761,5284,1737,31490,1052,434,124,1610,33100
28-07-2016,1,12648,11405,5398,1519,30969,917,454,159,1530,32499
28-07-2016,2,12434,11379,5357,1588,30758,906,447,181,1534,32292
28-07-2016,3,12035,11355,5246,1440,30077,914,454,200,1568,31645
28-07-2016,4,11806,11450,5192,1574,30024,917,477,147,1541,31565
28-07-2016,5,12151,11856,5264,1805,31075,1033,550,112,1695,32770
28-07-2016,6,12883,12576,5490,2039,32987,1330,756,83,2169,35156
28-07-2016,7,14005,14238,5890,2234,36367,1417,898,291,2606,38973
28-07-2016,8,14573,15328,5937,2438,38277,1434,1048,392,2874,41151
28-07-2016,9,14959,16445,6005,2480,39891,1435,1079,435,2949,42840
28-07-2016,10,14891,16355,6020,2496,39762,1442,1109,430,2981,42743
28-07-2016,11,14811,16093,6065,2568,39539,1543,1067,358,2968,42507
28-07-2016,12,14682,15936,6079,2684,39382,1550,1225,264,3039,42421
28-07-2016,13,14672,15566,6073,2623,38933,1546,1140,290,2976,41909
28-07-2016,14,14587,15457,6031,2595,38669,1560,1001,268,2829,41498
28-07-2016,15,14415,15298,6070,2571,38356,1509,860,176,2545,40901
28-07-2016,16,14475,15221,5840,2509,38048,1406,727,197,2330,40378
28-07-2016,17,14584,15611,5741,2401,38338,1351,697,168,2216,40554
28-07-2016,18,14562,16017,5856,2284,38719,1362,698,130,2190,40909
28-07-2016,19,14413,15794,5804,2162,38173,1381,851,111,2343,40516
28-07-2016,20,14222,15412,5595,2070,37300,1359,752,96,2207,39507
28-07-2016,21,14170,14799,5758,2044,36773,1405,578,92,2075,38848
28-07-2016,22,14420,14712,5631,1677,36439,1434,387,62,1883,38322
28-07-2016,23,13465,12634,5392,1651,33142,1427,360,61,1848,34990
29-07-2016,0,13117,10905,5338,1526,30887,1338,336,62,1736,32623
29-07-2016,1,12894,10582,5190,1614,30280,1254,385,57,1696,31976
29-07-2016,2,12741,10443,5107,1342,29633,1083,384,49,1516,31149
29-07-2016,3,12101,10291,5058,1142,28593,1045,412,49,1506,30099
29-07-2016,4,12321,10236,5071,1317,28945,1034,404,45,1483,30428
29-07-2016,5,12690,10420,5307,1735,30154,1138,418,46,1602,31756
29-07-2016,6,13103,11936,5652,2131,32823,1386,779,78,2243,35066
29-07-2016,7,14284,14196,5984,2157,36621,1417,933,78,2428,39049
29-07-2016,8,14776,15106,6059,2289,38230,1418,1202,78,2698,40928
29-07-2016,9,15188,15614,6144,2522,39468,1425,1282,138,2845,42313
29-07-2016,10,15460,15837,6129,2552,39979,1423,1322,179,2924,42903
29-07-2016,11,15392,15711,6148,2612,39863,1417,1320,128,2865,42728
29-07-2016,12,15172,14816,6101,2691,38781,1412,1309,202,2923,41704
29-07-2016,13,15003,13946,6168,2735,37853,1420,1196,114,2730,40583
29-07-2016,14,14817,13128,6094,2585,36625,1429,1170,80,2679,39304
29-07-2016,15,14443,12889,6051,2315,35698,1422,1083,77,2582,38280
29-07-2016,16,14429,12923,5958,2295,35605,1419,884,51,2354,37959
29-07-2016,17,14485,13569,5843,2463,36361,1416,826,47,2289,38650
29-07-2016,18,14876,14057,5845,2492,37270,1431,688,44,2163,39433
29-07-2016,19,15028,14431,5757,2327,37544,1432,927,44,2403,39947
29-07-2016,20,14580,14052,5254,2172,36058,1422,595,44,2061,38119
29-07-2016,21,14474,13469,5272,2024,35240,1433,572,54,2059,37299
29-07-2016,22,14204,13117,5238,1843,34403,1441,344,48,1833,36236
29-07-2016,23,13760,12042,5322,1548,32673,1467,327,45,1839,34512
30-07-2016,0,13175,10903,5250,1589,30918,1322,194,57,1573,32491
30-07-2016,1,12804,9768,5188,1306,29067,1184,191,64,1439,30506
30-07-2016,2,12477,9573,5092,1121,28262,1059,192,64,1315,29577
30-07-2016,3,11728,9504,5036,1122,27388,1004,195,94,1293,28681
30-07-2016,4,11550,9460,5015,1160,27184,1008,186,67,1261,28445
30-07-2016,5,11659,9452,4985,1249,27345,995,197,61,1253,28598
30-07-2016,6,11882,9571,5057,1380,27890,1009,215,55,1279,29169
30-07-2016,7,12551,9722,5113,1499,28887,1044,511,57,1612,30499
30-07-2016,8,13205,10571,5349,1801,30926,1358,638,59,2055,32981
30-07-2016,9,13758,11241,5569,1901,32469,1395,698,71,2164,34633
30-07-2016,10,13766,11336,5554,1991,32646,1382,599,108,2089,34735
30-07-2016,11,13720,11224,5484,2265,32693,1402,577,98,2077,34770
30-07-2016,12,13616,11235,5415,2391,32658,1373,542,113,2028,34686
30-07-2016,13,13591,11137,5415,2236,32379,1359,508,116,1983,34362
30-07-2016,14,13178,11033,5423,2297,31930,1325,461,102,1888,33818
30-07-2016,15,13085,11064,5417,2416,31981,1326,446,108,1880,33861
30-07-2016,16,13172,11272,5357,2528,32329,1342,437,98,1877,34206
30-07-2016,17,13292,11593,5303,2759,32947,1372,416,96,1884,34831
30-07-2016,18,13563,12502,5373,2781,34220,1405,385,97,1887,36107
30-07-2016,19,13781,13198,5391,2667,35037,1398,388,86,1872,36909
30-07-2016,20,13656,13046,5348,2444,34495,1405,391,97,1893,36388
30-07-2016,21,13566,13053,5477,2227,34322,1415,286,99,1800,36122
30-07-2016,22,13565,13072,5547,2252,34437,1410,212,119,1741,36178
30-07-2016,23,12925,12064,5374,2170,32535,1404,201,136,1741,34276
31-07-2016,0,12348,10920,5356,1843,30467,1255,185,128,1568,32035
31-07-2016,1,11671,10695,5135,1518,29019,1089,179,134,1402,30421
31-07-2016,2,10725,10582,5107,1343,27756,1062,180,125,1367,29123
31-07-2016,3,10426,10505,5115,1410,27457,1054,186,132,1372,28829
31-07-2016,4,10118,10494,5094,1440,27147,1039,197,129,1365,28512
31-07-2016,5,9904,10454,5098,1404,26860,1035,206,125,1366,28226
31-07-2016,6,9655,10360,5099,1370,26484,1028,214,133,1375,27859
31-07-2016,7,10403,10491,5124,1402,27420,1039,394,115,1548,28968
31-07-2016,8,11394,11013,5337,1434,29178,1044,533,104,1681,30859
31-07-2016,9,12199,11099,5423,1731,30452,1038,736,107,1881,32333
31-07-2016,10,12565,11468,5367,2032,31431,1073,738,115,1926,33357
31-07-2016,11,13210,11699,5368,2284,32561,1173,735,116,2024,34585
31-07-2016,12,13189,11840,5430,2273,32733,1178,735,108,2021,34754
31-07-2016,13,12892,11831,5413,2134,32271,1081,733,100,1914,34185
31-07-2016,14,12401,12023,5514,1871,31809,1054,607,103,1764,33573
31-07-2016,15,11959,11961,5393,1704,31018,1065,615,87,1767,32785
31-07-2016,16,12059,11896,5213,1619,30787,1079,637,75,1791,32578
31-07-2016,17,12874,12078,5463,1616,32031,1087,578,58,1723,33754
31-07-2016,18,13048,12224,5494,1640,32406,1233,582,41,1856,34262
31-07-2016,19,13394,12606,5515,1826,33343,1240,602,55,1897,35240
31-07-2016,20,13822,12785,5553,1553,33712,1242,518,55,1815,35527
31-07-2016,21,13840,13416,5643,1613,34511,1259,369,71,1699,36210
31-07-2016,22,13891,13284,5679,1693,34548,1316,207,45,1568,36116
31-07-2016,23,13137,11941,5417,1678,32175,1204,189,58,1451,33626
01-08-2016,0,11889,10900,5272,1362,29424,1034,179,79,1292,30716
01-08-2016,1,10924,10560,5263,1293,28039,1028,171,94,1293,29332
01-08-2016,2,10536,10513,5242,1340,27631,1008,173,114,1295,28926
01-08-2016,3,10547,10516,5278,1369,27711,1002,202,119,1323,29034
01-08-2016,4,10442,10547,5346,1436,27773,1000,212,98,1310,29083
01-08-2016,5,11021,10683,5405,1582,28691,1129,333,86,1548,30239
01-08-2016,6,12857,12147,5791,1782,32577,1554,759,79,2392,34969
01-08-2016,7,14101,13942,6135,2182,36361,1589,951,74,2614,38975
01-08-2016,8,14874,15134,6247,2630,38885,1578,1131,70,2779,41664
01-08-2016,9,14580,14756,6157,3158,38652,1557,1367,108,3032,41684
01-08-2016,10,14203,14259,6134,3380,37977,1547,1369,126,3042,41019
01-08-2016,11,14391,14053,6238,3284,37965,1558,1319,97,2974,40939
01-08-2016,12,14619,14069,6216,3256,38162,1568,1362,88,3018,41180
01-08-2016,13,14606,14063,6205,3183,38057,1577,1338,94,3009,41066
01-08-2016,14,14451,13978,6130,3334,37893,1576,1222,109,2907,40800
01-08-2016,15,14290,14078,6062,3266,37697,1575,1150,127,2852,40549
01-08-2016,16,14012,13941,5838,3030,36822,1525,855,136,2516,39338
01-08-2016,17,14340,14892,5819,3211,38262,1541,1003,139,2683,40945
01-08-2016,18,14808,15487,5899,3087,39281,1546,966,176,2688,41969
01-08-2016,19,14796,15175,5925,2989,38884,1511,869,135,2515,41399
01-08-2016,20,14421,14567,5826,2719,37533,1496,677,95,2268,39801
01-08-2016,21,14329,14340,5634,2553,36857,1469,567,90,2126,38983
01-08-2016,22,14333,13984,5493,2519,36329,1536,373,84,1993,38322
01-08-2016,23,13751,12724,5439,2410,34325,1391,358,96,1845,36170
02-08-2016,0,13251,11161,5443,2172,32027,1147,347,126,1620,33647
02-08-2016,1,12315,11015,5411,1865,30607,995,337,138,1470,32077
02-08-2016,2,12139,10959,5318,1730,30146,997,340,150,1487,31633
02-08-2016,3,12102,10968,5308,1692,30069,1013,340,162,1515,31584
02-08-2016,4,11880,10864,5285,1538,29568,1047,350,171,1568,31136
02-08-2016,5,12597,11062,5446,1645,30750,1144,369,152,1665,32415
02-08-2016,6,13760,12893,5785,1893,34332,1431,657,158,2246,36578
02-08-2016,7,14918,14697,6179,2085,37881,1464,767,286,2517,40398
02-08-2016,8,15588,15602,6321,2270,39781,1484,1015,304,2803,42584
02-08-2016,9,15789,16015,6348,2415,40568,1448,1121,335,2904,43472
02-08-2016,10,15934,16361,6388,2465,41148,1514,1122,341,2977,44125
02-08-2016,11,15716,16507,6384,2520,41126,1517,1159,320,2996,44122
02-08-2016,12,15773,16220,6465,2605,41063,1531,1101,336,2968,44031
02-08-2016,13,15517,16353,6415,2579,40864,1476,1028,326,2830,43694
02-08-2016,14,15397,16071,6430,2623,40519,1482,1026,319,2827,43346
02-08-2016,15,15260,15730,6312,2541,39843,1455,950,307,2712,42555
02-08-2016,16,15003,15416,6303,2514,39236,1428,648,167,2243,41479
02-08-2016,17,15250,15662,6225,2499,39637,1444,824,269,2537,42174
02-08-2016,18,15232,15633,6140,2309,39312,1435,828,254,2517,41829
02-08-2016,19,15275,15254,6024,2105,38658,1428,789,240,2457,41115
02-08-2016,20,14967,14558,5888,1981,37394,1415,521,237,2173,39567
02-08-2016,21,14791,13936,5954,1893,36575,1421,473,312,2206,38781
02-08-2016,22,14455,13215,5889,1943,35502,1441,366,111,1918,37420
02-08-2016,23,13853,11708,5699,1680,32940,1459,341,70,1870,34810
03-08-2016,0,12970,10974,5678,1176,30799,1144,349,81,1574,32373
03-08-2016,1,12291,10608,5517,1067,29484,1052,348,69,1469,30953
03-08-2016,2,12098,10217,5525,1081,28922,1042,355,69,1466,30388
03-08-2016,3,11749,9967,5540,1241,28498,1030,356,68,1454,29952
03-08-2016,4,11581,9699,5471,1352,28104,1031,348,71,1450,29554
03-08-2016,5,12588,9756,5520,1657,29521,1155,371,61,1587,31108
03-08-2016,6,13619,10796,5777,2127,32319,1443,694,55,2192,34511
03-08-2016,7,14753,12882,6104,2538,36277,1444,918,147,2509,38786
03-08-2016,8,15379,13945,6233,2868,38425,1458,1078,262,2798,41223
03-08-2016,9,15330,14007,6129,3056,38523,1453,1123,342,2918,41441
03-08-2016,10,15248,14011,6261,3325,38846,1472,1193,267,2932,41778
03-08-2016,11,15555,13965,6264,3432,39218,1472,1178,269,2919,42137
03-08-2016,12,15443,13966,6323,3281,39014,1521,1104,322,2947,41961
03-08-2016,13,15560,13643,6259,3251,38713,1529,1160,277,2966,41679
03-08-2016,14,15410,13492,6150,3361,38413,1567,1067,273,2907,41320
03-08-2016,15,15274,13549,6017,3481,38321,1574,991,256,2821,41142
03-08-2016,16,15159,13340,5916,3370,37784,1571,851,63,2485,40269
03-08-2016,17,15152,13406,5966,3508,38031,1565,943,194,2702,40733
03-08-2016,18,15045,13361,5984,3620,38008,1549,934,60,2543,40551
03-08-2016,19,15032,13314,5934,3395,37673,1417,869,102,2388,40061
03-08-2016,20,14557,12829,5851,3299,36536,1411,599,212,2222,38758
03-08-2016,21,14303,12437,5833,3199,35771,1467,565,132,2164,37935
03-08-2016,22,13905,11533,5751,2979,34167,1500,374,147,2021,36188
03-08-2016,23,13258,10662,5757,2675,32353,1491,370,178,2039,34392
04-08-2016,0,12063,10424,5851,2512,30850,1139,366,194,1699,32549
04-08-2016,1,11729,10270,5821,2379,30199,1111,367,183,1661,31860
04-08-2016,2,10795,10095,5777,2397,29063,1086,372,218,1676,30739
04-08-2016,3,10129,10040,5751,2356,28275,1116,369,237,1722,29997
04-08-2016,4,10339,10079,5721,2188,28328,1063,390,242,1695,30023
04-08-2016,5,11586,10193,5873,2161,29813,1263,414,234,1911,31724
04-08-2016,6,13479,10745,6035,2369,32630,1404,516,362,2282,34912
04-08-2016,7,14882,12110,6169,2491,35653,1526,700,504,2730,38383
04-08-2016,8,15697,13571,6369,2824,38461,1549,901,428,2878,41339
04-08-2016,9,15388,13663,6386,3467,38905,1551,1039,437,3027,41932
04-08-2016,10,15398,13691,6414,3609,39113,1556,1096,346,2998,42111
04-08-2016,11,15307,13750,6468,3798,39324,1552,942,400,2894,42218
04-08-2016,12,15056,13748,6474,3988,39266,1540,1044,449,3033,42299
04-08-2016,13,15003,13719,6456,4049,39226,1538,926,446,2910,42136
04-08-2016,14,14959,13516,6435,3868,38778,1547,965,326,2838,41616
04-08-2016,15,14829,13342,6357,3895,38422,1546,942,299,2787,41209
04-08-2016,16,14729,13097,6284,3836,37947,1543,609,287,2439,40386
04-08-2016,17,15056,13968,6442,3670,39137,1539,835,259,2633,41770
04-08-2016,18,15295,14515,6463,3446,39718,1527,823,241,2591,42309
04-08-2016,19,15086,14525,6328,3242,39182,1604,806,239,2649,41831
04-08-2016,20,14938,13709,6187,3067,37902,1635,566,179,2380,40282
04-08-2016,21,15044,13443,6145,2668,37301,1610,491,146,2247,39548
04-08-2016,22,14781,13135,6043,2527,36487,1604,392,126,2122,38609
04-08-2016,23,13941,11492,5855,2286,33573,1588,343,118,2049,35622
05-08-2016,0,13506,10081,5750,2038,31374,1504,217,142,1863,33237
05-08-2016,1,13329,9893,5597,1706,30524,1376,229,124,1729,32253
05-08-2016,2,12929,9887,5566,1667,30048,1213,230,118,1561,31609
05-08-2016,3,12424,9699,5508,1650,29281,1176,214,111,1501,30782
05-08-2016,4,12339,9679,5580,1627,29225,1221,226,108,1555,30780
05-08-2016,5,12995,9991,5602,1655,30243,1357,259,105,1721,31964
05-08-2016,6,14119,11725,5889,1993,33725,1506,741,91,2338,36063
05-08-2016,7,15219,13786,6121,2309,37435,1576,872,263,2711,40146
05-08-2016,8,15852,15188,6224,2411,39675,1589,1008,261,2858,42533
05-08-2016,9,16133,15326,6200,2629,40288,1576,1136,263,2975,43263
05-08-2016,10,16103,15314,6188,2685,40291,1587,1149,265,3001,43292
05-08-2016,11,16160,15166,6135,2625,40087,1597,1280,262,3139,43226
05-08-2016,12,15839,14923,6280,2699,39741,1588,1143,353,3084,42825
05-08-2016,13,15644,14236,6210,2846,38937,1570,1048,440,3058,41995
05-08-2016,14,15552,13576,6188,2762,38078,1593,1082,386,3061,41139
05-08-2016,15,15195,13172,6185,2718,37271,1579,1169,148,2896,40167
05-08-2016,16,14740,12895,6072,2675,36382,1566,696,309,2571,38953
05-08-2016,17,15110,13199,5987,2764,37061,1576,928,294,2798,39859
05-08-2016,18,15100,13238,5921,2695,36954,1582,746,306,2634,39588
05-08-2016,19,15211,12922,5945,2737,36815,1583,704,314,2601,39416
05-08-2016,20,14929,12570,5940,2586,36025,1559,626,135,2320,38345
05-08-2016,21,15044,12298,5863,2488,35693,1552,503,168,2223,37916
05-08-2016,22,14538,11863,5808,2352,34561,1544,273,204,2021,36582
05-08-2016,23,13700,10752,5727,2486,32665,1448,273,142,1863,34528
06-08-2016,0,12716,9970,5598,2501,30785,1083,211,120,1414,32199
06-08-2016,1,12078,9565,5501,2468,29613,1013,202,137,1352,30965
06-08-2016,2,11349,9462,5475,2422,28706,951,202,122,1275,29981
06-08-2016,3,10664,9428,5447,2398,27936,954,227,114,1295,29231
06-08-2016,4,10542,9468,5445,2391,27847,989,222,102,1313,29160
06-08-2016,5,10490,9512,5375,2332,27708,959,212,71,1242,28950
06-08-2016,6,10835,9551,5418,2364,28168,973,318,59,1350,29518
06-08-2016,7,11945,9750,5517,2368,29579,996,508,55,1559,31138
06-08-2016,8,12835,10427,5525,2621,31407,988,630,59,1677,33084
06-08-2016,9,13246,11432,5531,3010,33219,1013,702,56,1771,34990
06-08-2016,10,13372,11833,5529,3312,34044,1049,690,68,1807,35851
06-08-2016,11,13195,11828,5581,3556,34160,1068,666,90,1824,35984
06-08-2016,12,12641,11883,5504,3693,33723,1056,686,100,1842,35565
06-08-2016,13,12001,11841,5510,3780,33133,1049,688,96,1833,34966
06-08-2016,14,11405,11814,5487,3978,32683,1052,598,103,1753,34436
06-08-2016,15,11205,11869,5491,4095,32659,1034,538,135,1707,34366
06-08-2016,16,11395,11768,5526,4258,32947,1024,540,127,1691,34638
06-08-2016,17,12232,11917,5558,4264,33971,1026,548,109,1683,35654
06-08-2016,18,12638,12238,5508,4123,34507,1027,541,87,1655,36162
06-08-2016,19,12885,12405,5587,3833,34711,1026,503,100,1629,36340
06-08-2016,20,13085,12550,5536,3398,34569,1024,546,103,1673,36242
06-08-2016,21,13583,12716,5602,3009,34911,1031,422,103,1556,36467
06-08-2016,22,13511,12846,5609,2946,34912,1048,296,102,1446,36358
06-08-2016,23,13038,11827,5505,2685,33056,1059,196,95,1350,34406
07-08-2016,0,11871,10743,5371,2478,30464,982,193,87,1262,31726
07-08-2016,1,10085,10585,5288,2179,28137,922,190,119,1231,29368
07-08-2016,2,9099,10509,5205,2072,26884,828,186,149,1163,28047
07-08-2016,3,8174,10437,5111,2038,25760,814,189,102,1105,26865
07-08-2016,4,7718,10390,4975,1907,24991,812,194,96,1102,26093
07-08-2016,5,7716,10290,4929,1866,24801,820,198,103,1121,25922
07-08-2016,6,7868,10266,4992,1849,24975,806,244,107,1157,26132
07-08-2016,7,8366,10292,5118,1785,25562,847,387,123,1357,26919
07-08-2016,8,9484,10477,5221,2100,27281,939,509,119,1567,28848
07-08-2016,9,10474,11044,5227,2484,29230,1053,672,140,1865,31095
07-08-2016,10,11371,11612,5139,2876,30999,1049,673,155,1877,32876
07-08-2016,11,11910,12133,5111,3159,32313,1096,623,186,1905,34218
07-08-2016,12,11984,12225,5130,3419,32759,1089,608,258,1955,34714
07-08-2016,13,11862,12130,5116,3484,32593,1072,567,353,1992,34585
07-08-2016,14,12279,11880,5118,3400,32676,1041,463,386,1890,34566
07-08-2016,15,12363,11911,5075,3389,32740,1085,335,411,1831,34571
07-08-2016,16,12294,12299,5140,3297,33031,1067,301,406,1774,34805
07-08-2016,17,12679,12569,5160,3278,33686,1085,320,385,1790,35476
07-08-2016,18,13229,12935,5168,3308,34639,1075,292,315,1682,36321
07-08-2016,19,13656,13268,5112,3264,35302,1153,300,243,1696,36998
07-08-2016,20,13837,13667,5057,2974,35536,1159,259,233,1651,37187
07-08-2016,21,13995,13960,5055,2884,35892,1212,217,238,1667,37559
07-08-2016,22,13759,13812,5073,2750,35396,1159,214,240,1613,37009
07-08-2016,23,12751,12610,5056,2618,33036,1092,207,235,1534,34570
08-08-2016,0,9831,11875,4935,2430,29073,1066,205,220,1491,30564
08-08-2016,1,8258,11447,4915,2482,27102,974,199,198,1371,28473
08-08-2016,2,7603,11263,4915,2681,26461,981,200,194,1375,27836
08-08-2016,3,7554,11301,4958,2726,26539,1040,202,172,1414,27953
08-08-2016,4,7406,11288,5029,2820,26543,1075,253,167,1495,28038
08-08-2016,5,7867,11383,5300,3164,27715,1261,289,184,1734,29449
08-08-2016,6,10592,12297,5684,3720,32292,1642,591,178,2411,34703
08-08-2016,7,13361,13753,5792,3660,36567,1724,906,154,2784,39351
08-08-2016,8,14316,14639,6010,3775,38739,1756,1091,165,3012,41751
08-08-2016,9,14154,14877,6056,4175,39261,1774,1242,199,3215,42476
08-08-2016,10,13577,14917,6171,4359,39026,1779,1285,253,3317,42343
08-08-2016,11,12995,15007,6189,4919,39110,1745,1174,293,3212,42322
08-08-2016,12,12653,15069,6027,4960,38710,1767,1059,299,3125,41835
08-08-2016,13,12513,15183,6028,4859,38583,1758,925,333,3016,41599
08-08-2016,14,12392,15145,6067,4786,38390,1734,876,323,2933,41323
08-08-2016,15,12722,15130,5939,4674,38465,1833,833,253,2919,41384
08-08-2016,16,13158,14709,5910,4686,38463,1732,696,225,2653,41116
08-08-2016,17,13808,14965,5882,4594,39250,1795,727,210,2732,41982
08-08-2016,18,14066,15079,5890,4387,39421,1801,584,184,2569,41990
08-08-2016,19,14114,15429,5864,4102,39511,1762,523,233,2518,42029
08-08-2016,20,13689,15305,5755,3825,38576,1709,540,157,2406,40982
08-08-2016,21,13763,14976,5659,3587,37985,1759,421,179,2359,40344
08-08-2016,22,13408,14381,5700,3431,36923,1788,387,136,2311,39234
08-08-2016,23,12024,13350,5688,3321,34382,1534,369,153,2056,36438
09-08-2016,0,11040,12694,5544,3155,32432,1294,227,170,1691,34123
09-08-2016,1,10604,12602,5438,3197,31841,1141,224,183,1548,33389
09-08-2016,2,10525,12507,5493,3297,31823,1142,226,195,1563,33386
09-08-2016,3,10453,12300,5554,3286,31592,1144,230,198,1572,33164
09-08-2016,4,10778,12396,5574,3324,32072,1249,241,186,1676,33748
09-08-2016,5,11472,12545,5755,3202,32974,1365,279,172,1816,34790
09-08-2016,6,13362,13331,6114,3292,36099,1665,316,171,2152,38251
09-08-2016,7,15460,15451,6492,3449,40852,1699,338,182,2219,43071
09-08-2016,8,15886,16436,6578,3717,42618,1618,635,180,2433,45051
09-08-2016,9,15858,16407,6731,3532,42530,1603,681,221,2505,45035
09-08-2016,10,16281,16390,6650,4085,43407,1603,699,218,2520,45927
09-08-2016,11,15752,16260,6627,4250,42888,1594,713,233,2540,45428
09-08-2016,12,14819,15938,6610,4311,41678,1597,714,220,2531,44209
09-08-2016,13,14793,15485,6519,4345,41141,1593,721,218,2532,43673
09-08-2016,14,14998,15057,6496,4478,41028,1582,726,202,2510,43538
09-08-2016,15,14872,14857,6508,4459,40696,1597,580,193,2370,43066
09-08-2016,16,14782,14598,6328,4565,40274,1607,485,221,2313,42587
09-08-2016,17,15133,14443,6331,4514,40421,1591,478,198,2267,42688
09-08-2016,18,15124,14894,6332,4134,40483,1566,474,193,2233,42716
09-08-2016,19,15356,14915,6342,3966,40579,1550,451,197,2198,42777
09-08-2016,20,15219,14834,6206,3720,39978,1550,451,200,2201,42179
09-08-2016,21,15194,14941,6169,3573,39878,1524,350,183,2057,41935
09-08-2016,22,14590,14433,6087,3367,38476,1552,227,165,1944,40420
09-08-2016,23,13626,13233,6042,3149,36049,1489,239,153,1881,37930
10-08-2016,0,11985,12343,5872,3105,33304,1230,210,175,1615,34919
10-08-2016,1,11454,12113,5637,3081,32285,1125,201,191,1517,33802
10-08-2016,2,11420,12166,5509,3054,32149,1118,202,178,1498,33647
10-08-2016,3,11053,12047,5420,3030,31550,1108,199,178,1485,33035
10-08-2016,4,10973,12063,5336,3033,31404,1141,204,175,1520,32924
10-08-2016,5,11823,12052,5713,3091,32679,1177,256,164,1597,34276
10-08-2016,6,13982,13539,6051,2923,36494,1460,299,144,1903,38397
10-08-2016,7,15933,16043,6294,3088,41357,1479,403,289,2171,43528
10-08-2016,8,16786,16111,6315,3280,42492,1513,498,493,2504,44996
10-08-2016,9,16896,15744,6301,3324,42265,1518,648,413,2579,44844
10-08-2016,10,17214,15744,6278,3496,42732,1527,760,436,2723,45455
10-08-2016,11,17032,15766,6228,3530,42557,1572,823,494,2889,45446
10-08-2016,12,16899,15843,6283,3686,42711,1580,761,433,2774,45485
10-08-2016,13,16533,15596,6376,3576,42079,1544,657,474,2675,44754
10-08-2016,14,16330,15141,6365,3630,41466,1515,561,427,2503,43969
10-08-2016,15,16101,15022,6414,3656,41194,1500,564,302,2366,43560
10-08-2016,16,15773,14865,6282,3610,40531,1489,481,149,2119,42650
10-08-2016,17,16219,14678,6282,3567,40746,1485,473,126,2084,42830
10-08-2016,18,16123,14878,6205,3313,40518,1471,409,135,2015,42533
10-08-2016,19,16098,15016,6165,3051,40329,1470,355,140,1965,42294
10-08-2016,20,15967,14448,6150,2846,39410,1422,372,112,1906,41316
10-08-2016,21,16366,14047,6161,2702,39277,1432,212,132,1776,41053
10-08-2016,22,16233,13646,6074,2609,38561,1385,206,93,1684,40245
10-08-2016,23,15108,12180,5904,2567,35761,1391,204,90,1685,37446
11-08-2016,0,13312,11305,5960,2477,33054,1049,199,96,1344,34398
11-08-2016,1,11939,11086,5762,2481,31271,1005,197,110,1312,32583
11-08-2016,2,11601,11017,5660,2427,30705,1018,198,131,1347,32052
11-08-2016,3,11522,11032,5666,2296,30516,1034,197,136,1367,31883
11-08-2016,4,11555,11189,5702,2160,30606,1058,200,148,1406,32012
11-08-2016,5,13067,11584,5798,2065,32515,1082,252,133,1467,33982
11-08-2016,6,14788,13342,6061,2228,36419,1409,289,141,1839,38258
11-08-2016,7,16460,14579,6388,2733,40160,1439,434,126,1999,42159
11-08-2016,8,16730,15788,6450,2945,41912,1460,528,324,2312,44224
11-08-2016,9,16715,15432,6518,3114,41779,1512,604,376,2492,44271
11-08-2016,10,16702,15543,6355,3073,41672,1496,871,380,2747,44419
11-08-2016,11,16439,15579,6239,3011,41268,1593,893,445,2931,44199
11-08-2016,12,16543,15379,6183,2870,40976,1571,894,555,3020,43996
11-08-2016,13,16632,15074,6169,2635,40508,1586,913,546,3045,43553
11-08-2016,14,16481,14941,6105,2558,40085,1600,709,499,2808,42893
11-08-2016,15,16442,14736,6191,2470,39839,1609,670,347,2626,42465
11-08-2016,16,16489,14635,6144,2229,39497,1608,491,150,2249,41746
11-08-2016,17,16071,14811,6094,2100,39076,1596,474,134,2204,41280
11-08-2016,18,15999,14650,6103,1979,38731,1588,476,142,2206,40937
11-08-2016,19,16041,14521,5943,2020,38526,1580,384,147,2111,40637
11-08-2016,20,15856,14077,5787,1902,37624,1496,382,178,2056,39680
11-08-2016,21,15855,13736,5784,1820,37194,1460,296,180,1936,39130
11-08-2016,22,15660,13479,5732,1754,36625,1449,209,150,1808,38433
11-08-2016,23,14717,12421,5631,1351,34120,1425,198,184,1807,35927
12-08-2016,0,13428,11622,5492,900,31441,1145,196,152,1493,32934
12-08-2016,1,12773,11465,5347,845,30430,1112,192,121,1425,31855
12-08-2016,2,12437,11347,5307,877,29970,1103,198,116,1417,31387
12-08-2016,3,11803,11362,5355,890,29410,1142,203,85,1430,30840
12-08-2016,4,11954,11294,5505,849,29602,1172,232,98,1502,31104
12-08-2016,5,13601,11704,5803,883,31991,1207,236,135,1578,33569
12-08-2016,6,15158,13934,6230,1326,36649,1472,340,108,1920,38569
12-08-2016,7,16539,15033,6495,1806,39873,1478,530,147,2155,42028
12-08-2016,8,17022,15603,6545,1897,41069,1481,1146,287,2914,43983
12-08-2016,9,16741,15286,6671,2052,40752,1485,1184,331,3000,43752
12-08-2016,10,17014,15585,6815,2159,41573,1486,1252,309,3047,44620
12-08-2016,11,16836,15680,6815,2441,41772,1480,1256,401,3137,44909
12-08-2016,12,16475,15496,6779,2775,41526,1487,1252,403,3142,44668
12-08-2016,13,16466,15279,6823,2944,41513,1475,1055,344,2874,44387
12-08-2016,14,16388,14870,6864,2936,41061,1473,1080,314,2867,43928
12-08-2016,15,15954,14718,6902,2971,40544,1478,674,246,2398,42942
12-08-2016,16,15765,14498,6915,2948,40126,1451,497,115,2063,42189
12-08-2016,17,15870,14430,6844,3290,40433,1436,549,130,2115,42548
12-08-2016,18,15774,14713,6883,3413,40785,1449,448,107,2004,42789
12-08-2016,19,15164,14645,6636,3388,39833,1459,429,94,1982,41815
12-08-2016,20,14667,14389,6221,3383,38659,1470,302,95,1867,40526
12-08-2016,21,14567,14236,6077,3523,38404,1475,241,85,1801,40205
12-08-2016,22,13933,14248,5941,3537,37658,1515,218,134,1867,39525
12-08-2016,23,12575,13143,5790,3504,35010,1299,213,190,1702,36712
13-08-2016,0,10928,12672,5617,3282,32500,1113,159,224,1496,33996
13-08-2016,1,10402,12542,5443,3180,31569,999,154,261,1414,32983
13-08-2016,2,9930,12449,5359,3018,30757,995,154,243,1392,32149
13-08-2016,3,9538,12321,5321,2770,29951,946,159,243,1348,31299
13-08-2016,4,9406,12193,5327,2615,29540,930,167,262,1359,30899
13-08-2016,5,9103,12229,5320,2558,29211,982,179,266,1427,30638
13-08-2016,6,9765,12266,5414,2390,29835,932,190,270,1392,31227
13-08-2016,7,11185,12739,5538,2249,31712,1044,270,263,1577,33289
13-08-2016,8,12521,13547,5635,2251,33954,1048,274,271,1593,35547
13-08-2016,9,13202,13762,5829,2472,35267,1178,362,281,1821,37088
13-08-2016,10,13284,13998,5890,2767,35938,1215,360,286,1861,37799
13-08-2016,11,13331,13953,5908,3048,36241,1106,365,256,1727,37968
13-08-2016,12,12994,13846,5887,3273,36002,1194,368,249,1811,37813
13-08-2016,13,12538,13832,5847,3510,35727,1196,369,231,1796,37523
13-08-2016,14,11681,13876,5779,3954,35290,1138,390,212,1740,37030
13-08-2016,15,11013,13748,5633,4152,34547,1190,551,216,1957,36504
13-08-2016,16,11317,13632,5561,4276,34786,1116,487,199,1802,36588
13-08-2016,17,11890,13687,5581,4339,35496,1049,567,182,1798,37294
13-08-2016,18,12770,13781,5646,4179,36377,1025,648,164,1837,38214
13-08-2016,19,13325,13794,5697,3999,36814,1126,648,136,1910,38724
13-08-2016,20,13442,14121,5768,3666,36996,1086,586,118,1790,38786
13-08-2016,21,13838,14310,5816,3444,37410,1148,534,157,1839,39249
13-08-2016,22,13540,14189,5630,3300,36660,1149,263,195,1607,38267
13-08-2016,23,12654,12821,5484,3018,33976,1008,168,170,1346,35322
14-08-2016,0,11293,12009,5244,2858,31404,966,157,164,1287,32691
14-08-2016,1,10881,11932,5029,2735,30576,991,153,168,1312,31888
14-08-2016,2,10316,11822,4933,2567,29638,946,156,177,1279,30917
14-08-2016,3,10173,11868,4918,2451,29409,904,160,186,1250,30659
14-08-2016,4,9669,11844,4878,2306,28695,835,158,196,1189,29884
14-08-2016,5,9762,11854,4923,2168,28708,816,161,193,1170,29878
14-08-2016,6,9809,11911,5013,2010,28743,798,165,217,1180,29923
14-08-2016,7,10919,12030,5227,1975,30151,864,172,206,1242,31393
14-08-2016,8,12011,12331,5416,2059,31817,890,183,201,1274,33091
14-08-2016,9,12253,13052,5456,2151,32911,904,264,247,1415,34326
14-08-2016,10,12866,13156,5492,2236,33751,1054,281,313,1648,35399
14-08-2016,11,13050,13248,5485,2275,34059,1078,351,298,1727,35786
14-08-2016,12,12548,13266,5461,2296,33573,1097,350,300,1747,35320
14-08-2016,13,11755,13239,5493,2261,32747,1094,347,289,1730,34477
14-08-2016,14,11374,13236,5542,2328,32480,1005,349,265,1619,34099
14-08-2016,15,11142,12934,5556,2487,32120,969,349,287,1605,33725
14-08-2016,16,12017,13033,5554,2403,33008,952,348,312,1612,34620
14-08-2016,17,12835,13288,5585,2432,34139,982,529,314,1825,35964
14-08-2016,18,14032,13511,5619,2392,35553,1098,525,262,1885,37438
14-08-2016,19,14692,14050,5800,2447,36990,1226,525,189,1940,38930
14-08-2016,20,14971,14557,5868,2394,37792,1204,615,187,2006,39798
14-08-2016,21,15054,15159,5877,2458,38546,1225,609,182,2016,40562
14-08-2016,22,14460,14927,5814,2407,37608,1214,600,161,1975,39583
14-08-2016,23,13942,13349,5545,2195,35030,1104,415,141,1660,36690
15-08-2016,0,12351,11789,5468,1889,31496,959,199,129,1287,32783
15-08-2016,1,11599,11608,5360,1751,30318,980,196,122,1298,31616
15-08-2016,2,11143,11563,5260,1697,29662,994,198,80,1272,30934
15-08-2016,3,10958,11582,5315,1725,29581,1031,204,73,1308,30889
15-08-2016,4,10389,11710,5427,1808,29333,1073,297,67,1437,30770
15-08-2016,5,10715,12179,5497,1948,30337,1170,398,62,1630,31967
15-08-2016,6,12812,13717,5823,2325,34677,1500,518,66,2084,36761
15-08-2016,7,14399,15500,6131,2523,38553,1491,771,253,2515,41068
15-08-2016,8,14591,16039,6275,2594,39499,1537,835,379,2751,42250
15-08-2016,9,14726,15812,6417,2823,39778,1529,818,422,2769,42547
15-08-2016,10,14528,16168,6430,2953,40078,1546,821,510,2877,42955
15-08-2016,11,14412,16256,6555,2888,40112,1553,822,528,2903,43015
15-08-2016,12,14709,16408,6590,2730,40438,1539,752,552,2843,43281
15-08-2016,13,14425,16364,6602,2689,40079,1538,740,426,2704,42783
15-08-2016,14,14329,16223,6628,2610,39789,1524,638,441,2603,42392
15-08-2016,15,14169,15711,6664,2515,39059,1508,547,477,2532,41591
15-08-2016,16,14011,14670,6503,2501,37684,1522,543,281,2346,40030
15-08-2016,17,14159,14958,6600,2564,38282,1549,533,276,2358,40640
15-08-2016,18,14057,16404,6660,2464,39583,1502,525,284,2311,41894
15-08-2016,19,14108,16169,6752,2269,39298,1511,440,247,2198,41496
15-08-2016,20,14562,15976,6790,1951,39280,1537,384,217,2138,41418
15-08-2016,21,14735,15710,6747,2010,39203,1525,352,198,2075,41278
15-08-2016,22,14384,15058,6608,2045,38096,1486,245,204,1935,40031
15-08-2016,23,13326,13827,6192,1639,34985,1391,228,242,1861,36846
16-08-2016,0,12282,12861,6085,1080,32306,1225,219,228,1672,33978
16-08-2016,1,11470,12431,5930,1042,30874,1131,206,225,1562,32436
16-08-2016,2,11381,12382,5904,1024,30691,1138,202,243,1583,32274
16-08-2016,3,11357,12347,5922,1023,30650,1168,201,276,1645,32295
16-08-2016,4,11381,12356,5982,1004,30723,1164,199,265,1628,32351
16-08-2016,5,11443,12501,6214,1000,31157,1264,302,219,1785,32942
16-08-2016,6,13084,13745,6465,1657,34950,1471,440,169,2080,37030
16-08-2016,7,14632,15655,6900,2147,39335,1613,557,155,2325,41660
16-08-2016,8,15240,16336,7143,2066,40785,1752,574,336,2662,43447
16-08-2016,9,15369,16357,7275,2139,41140,1765,479,414,2658,43798
16-08-2016,10,15423,16042,7438,2264,41165,1758,530,419,2707,43872
16-08-2016,11,15512,16113,7288,2347,41262,1742,635,489,2866,44128
16-08-2016,12,15359,15968,7252,2554,41133,1731,643,539,2913,44046
16-08-2016,13,15344,15896,7172,2499,40910,1721,644,476,2841,43751
16-08-2016,14,15226,15570,7067,2489,40352,1723,643,391,2757,43109
16-08-2016,15,15047,15409,7104,2524,40083,1739,487,360,2586,42669
16-08-2016,16,14934,14985,6952,2508,39379,1593,609,333,2535,41914
16-08-2016,17,15578,15579,7072,2555,40783,1616,602,354,2572,43355
16-08-2016,18,15293,16239,7143,2506,41181,1612,594,311,2517,43698
16-08-2016,19,15380,16377,7118,2358,41233,1602,508,284,2394,43627
16-08-2016,20,15183,16346,7082,2185,40797,1595,353,261,2209,43006
16-08-2016,21,15090,15855,6961,2060,39967,1596,264,251,2111,42078
16-08-2016,22,14112,14246,6648,1852,36858,1592,258,221,2071,38929
16-08-2016,23,13119,13360,6380,1344,34202,1616,221,207,2044,36246
17-08-2016,0,11915,12685,6213,1008,31821,1207,215,194,1616,33437
17-08-2016,1,11329,12456,6072,976,30833,1152,211,218,1581,32414
17-08-2016,2,11110,12381,6037,970,30496,1145,211,242,1598,32094
17-08-2016,3,11131,12391,6021,972,30516,1163,206,275,1644,32160
17-08-2016,4,11380,12480,6047,988,30894,1154,206,259,1619,32513
17-08-2016,5,11856,12873,6160,968,31858,1209,221,239,1669,33527
17-08-2016,6,13282,14300,6396,1379,35356,1534,240,237,2011,37367
17-08-2016,7,14879,16469,6756,2073,40178,1546,342,230,2118,42296
17-08-2016,8,15688,17585,6855,2068,42197,1540,567,369,2476,44673
17-08-2016,9,15703,17944,6814,2245,42706,1520,582,339,2441,45147
17-08-2016,10,15569,17938,6768,2360,42635,1514,668,530,2712,45347
17-08-2016,11,15269,17959,6799,2495,42523,1551,585,523,2659,45182
17-08-2016,12,15057,17986,6788,2543,42374,1548,579,380,2507,44881
17-08-2016,13,14923,17934,6695,2656,42207,1578,578,367,2523,44730
17-08-2016,14,15150,17579,6592,2681,42002,1605,578,372,2555,44557
17-08-2016,15,15353,17026,6625,2589,41593,1595,538,216,2349,43942
17-08-2016,16,15344,16124,6580,2679,40729,1562,433,181,2176,42905
17-08-2016,17,14972,16463,6563,2629,40626,1564,417,170,2151,42777
17-08-2016,18,15322,16424,6614,2491,40853,1574,417,169,2160,43013
17-08-2016,19,15269,16247,6630,2342,40487,1595,434,350,2379,42866
17-08-2016,20,15129,15951,6700,2258,40039,1570,341,332,2243,42282
17-08-2016,21,15094,15443,6727,2321,39585,1595,322,120,2037,41622
17-08-2016,22,14302,13827,6536,2185,36851,1646,216,143,2005,38856
17-08-2016,23,13316,12782,6360,1636,34094,1594,195,160,1949,36043
18-08-2016,0,12344,11966,6131,1477,31918,1127,195,167,1489,33407
18-08-2016,1,11731,11796,6133,1428,31090,1048,192,190,1430,32520
18-08-2016,2,11497,11848,6065,1510,30921,1054,194,196,1444,32365
18-08-2016,3,11462,11821,6017,1444,30744,1089,196,189,1474,32218
18-08-2016,4,11539,11937,5906,1476,30858,1135,198,174,1507,32365
18-08-2016,5,12149,12290,6086,1539,32065,1213,206,161,1580,33645
18-08-2016,6,13443,13587,6392,2293,35715,1590,404,160,2154,37869
18-08-2016,7,14954,15704,6664,2715,40038,1605,475,142,2222,42260
18-08-2016,8,15379,16687,6696,2953,41716,1605,565,363,2533,44249
18-08-2016,9,15659,16573,6682,3254,42167,1615,664,392,2671,44838
18-08-2016,10,15788,16904,6743,3272,42708,1614,581,390,2585,45293
18-08-2016,11,15839,16866,6755,3150,42611,1615,583,390,2588,45199
18-08-2016,12,15881,16926,6766,3164,42737,1604,584,390,2578,45315
18-08-2016,13,15832,16909,6868,3083,42693,1560,586,387,2533,45226
18-08-2016,14,15750,16570,6814,3062,42197,1461,542,480,2483,44680
18-08-2016,15,15878,16299,6795,2924,41896,1472,544,271,2287,44183
18-08-2016,16,15493,16177,6728,2911,41309,1457,356,184,1997,43306
18-08-2016,17,15638,16512,6757,2839,41746,1483,437,175,2095,43841
18-08-2016,18,15298,16787,6716,2678,41479,1471,434,187,2092,43571
18-08-2016,19,15167,16516,6763,2512,40959,1474,421,233,2128,43087
18-08-2016,20,15348,16311,6919,2224,40802,1480,327,270,2077,42879
18-08-2016,21,15228,15636,6935,2084,39883,1479,278,281,2038,41921
18-08-2016,22,14267,14062,6702,1996,37027,1469,225,270,1964,38991
18-08-2016,23,13253,12466,6491,1737,33947,1468,205,221,1894,35841
19-08-2016,0,12221,11389,6004,1254,30868,1398,208,229,1835,32703
19-08-2016,1,11811,10920,5876,1351,29960,1250,203,233,1686,31646
19-08-2016,2,11649,10753,5848,1370,29621,1098,204,241,1543,31164
19-08-2016,3,11606,10635,5808,1269,29320,1089,201,219,1509,30829
19-08-2016,4,11737,10635,5971,1185,29529,1171,217,210,1598,31127
19-08-2016,5,12309,11356,6408,1113,31186,1318,238,199,1755,32941
19-08-2016,6,13898,13140,6597,1727,35363,1456,325,204,1985,37348
19-08-2016,7,15272,15735,6770,1991,39768,1464,812,160,2436,42204
19-08-2016,8,15711,16821,6793,2046,41370,1469,1021,332,2822,44192
19-08-2016,9,15713,16905,6769,2133,41519,1458,1158,347,2963,44482
19-08-2016,10,15765,16832,6800,2191,41589,1469,1352,431,3252,44841
19-08-2016,11,15845,16765,6802,2226,41639,1485,1352,420,3257,44896
19-08-2016,12,15669,16741,6726,2196,41333,1500,1400,335,3235,44568
19-08-2016,13,15620,16482,6733,2170,41006,1508,1142,323,2973,43979
19-08-2016,14,15500,16180,6731,2106,40517,1497,714,311,2522,43039
19-08-2016,15,15377,15925,6729,2196,40228,1487,601,109,2197,42425
19-08-2016,16,15066,15515,6724,2084,39390,1472,442,118,2032,41422
19-08-2016,17,15077,15823,6729,2020,39649,1445,556,109,2110,41759
19-08-2016,18,15379,15553,6727,1960,39621,1432,530,107,2069,41690
19-08-2016,19,15425,15492,6764,1872,39554,1433,339,291,2063,41617
19-08-2016,20,15196,14986,6817,1816,38815,1400,248,302,1950,40765
19-08-2016,21,15143,14103,6810,1806,37863,1427,241,115,1783,39646
19-08-2016,22,14574,12635,6652,1849,35711,1409,206,86,1701,37412
19-08-2016,23,14101,11556,6436,1337,33429,1330,197,60,1587,35016
20-08-2016,0,12956,10511,6354,999,30818,786,196,64,1046,31864
20-08-2016,1,12391,10131,6134,1009,29664,644,193,66,903,30567
20-08-2016,2,11754,10055,6002,1141,28953,640,190,70,900,29853
20-08-2016,3,11444,9986,5949,1145,28526,657,191,72,920,29446
20-08-2016,4,10913,9981,5811,1193,27899,642,193,69,904,28803
20-08-2016,5,10746,9957,5654,1254,27612,640,196,69,905,28517
20-08-2016,6,11573,10164,5776,1271,28784,723,199,68,990,29774
20-08-2016,7,13162,11020,5866,1361,31409,876,301,68,1245,32654
20-08-2016,8,12905,12676,6130,1466,33178,941,569,62,1572,34750
20-08-2016,9,13525,13789,6219,1670,35204,942,660,53,1655,36859
20-08-2016,10,13950,14218,6290,1821,36279,946,671,68,1685,37964
20-08-2016,11,13959,14313,6255,1958,36485,946,756,85,1787,38272
20-08-2016,12,13640,14225,6204,1781,35849,943,669,100,1712,37561
20-08-2016,13,12894,13872,6184,1677,34626,939,687,98,1724,36350
20-08-2016,14,12782,13305,6180,1841,34108,918,676,92,1686,35794
20-08-2016,15,12554,13153,6191,1968,33867,942,493,83,1518,35385
20-08-2016,16,12626,13347,6178,1937,34088,943,487,71,1501,35589
20-08-2016,17,13397,13840,6163,1881,35280,944,305,62,1311,36591
20-08-2016,18,13724,13747,6120,1830,35422,921,304,58,1283,36705
20-08-2016,19,13735,13368,6198,1685,34986,926,300,61,1287,36273
20-08-2016,20,13783,13047,6240,1566,34637,923,253,96,1272,35909
20-08-2016,21,13620,13048,6164,1617,34449,923,217,171,1311,35760
20-08-2016,22,13246,12168,5910,1473,32799,923,221,240,1384,34183
20-08-2016,23,12548,11229,5799,1441,31019,896,211,278,1385,32404
21-08-2016,0,10527,10719,5816,1415,28476,666,212,275,1153,29629
21-08-2016,1,9476,10378,5737,1420,27009,659,212,266,1137,28146
21-08-2016,2,8957,10198,5634,1426,26215,672,219,224,1115,27330
21-08-2016,3,8877,10020,5597,1478,25971,692,222,175,1089,27060
21-08-2016,4,8865,9950,5565,1476,25856,698,221,161,1080,26936
21-08-2016,5,8675,9898,5606,1399,25579,704,235,202,1141,26720
21-08-2016,6,8993,9909,5662,1390,25953,664,233,233,1130,27083
21-08-2016,7,9648,10043,5744,1570,27007,748,237,209,1194,28201
21-08-2016,8,10702,10769,5907,1661,29039,904,272,162,1338,30377
21-08-2016,9,11404,12154,5998,1832,31388,940,271,128,1339,32727
21-08-2016,10,11849,12490,6043,1990,32372,1026,356,176,1558,33930
21-08-2016,11,11865,12771,6148,2142,32927,1054,362,193,1609,34536
21-08-2016,12,12200,13002,6192,2267,33662,1032,367,165,1564,35226
21-08-2016,13,11839,12997,6083,2298,33219,1035,364,174,1573,34792
21-08-2016,14,11656,12632,6135,2288,32711,1042,365,171,1578,34289
21-08-2016,15,11707,12645,6056,2155,32562,1033,368,167,1568,34130
21-08-2016,16,11902,12564,6037,2054,32557,1011,449,214,1674,34231
21-08-2016,17,12427,12838,6007,2005,33277,1001,382,205,1588,34865
21-08-2016,18,13106,13214,5942,1852,34114,1012,459,199,1670,35784
21-08-2016,19,13816,13254,6058,1670,34796,1034,542,179,1755,36551
21-08-2016,20,14243,13259,6176,1564,35244,1057,512,178,1747,36991
21-08-2016,21,14392,13171,6168,1707,35439,1081,563,133,1777,37216
21-08-2016,22,14046,12372,6102,1597,34116,1069,238,148,1455,35571
21-08-2016,23,12952,11126,5864,1405,31347,1041,200,40,1281,32628
22-08-2016,0,11225,9714,5647,1366,27952,987,198,47,1232,29184
22-08-2016,1,10247,9289,5445,1335,26318,973,196,53,1222,27540
22-08-2016,2,9803,9262,5346,1427,25839,981,196,53,1230,27069
22-08-2016,3,9877,9262,5390,1417,25946,1005,208,53,1266,27212
22-08-2016,4,10414,9312,5603,1363,26690,1089,204,51,1344,28034
22-08-2016,5,11552,10275,6052,1339,29219,1338,230,55,1623,30842
22-08-2016,6,13755,12808,6465,1547,34575,1394,350,122,1866,36441
22-08-2016,7,15366,15228,6951,2169,39714,1374,589,324,2287,42001
22-08-2016,8,15831,16251,7050,2448,41581,1359,802,295,2456,44037
22-08-2016,9,15773,16192,7031,2676,41671,1358,931,436,2725,44396
22-08-2016,10,15741,16365,7098,2865,42069,1361,974,467,2802,44871
22-08-2016,11,15634,16395,7103,2911,42043,1355,1027,466,2848,44891
22-08-2016,12,15446,16507,7152,3001,42106,1355,986,325,2666,44772
22-08-2016,13,15328,16380,7239,3121,42069,1368,1046,346,2760,44829
22-08-2016,14,15154,15896,7196,3100,41346,1343,995,269,2607,43953
22-08-2016,15,15519,15299,7319,3036,41173,1341,613,227,2181,43354
22-08-2016,16,15706,15117,7234,2934,40990,1356,357,107,1820,42810
22-08-2016,17,15437,15738,7269,2702,41146,1376,435,279,2090,43236
22-08-2016,18,15191,15151,7338,2591,40271,1452,428,248,2128,42399
22-08-2016,19,15126,15001,7328,2869,40324,1442,408,278,2128,42452
22-08-2016,20,15007,14877,7366,2767,40017,1416,381,280,2077,42094
22-08-2016,21,14853,13898,7206,2587,38545,1422,238,58,1718,40263
22-08-2016,22,14256,12622,6902,2240,36019,1427,213,46,1686,37705
22-08-2016,23,13171,11290,6673,1802,32937,1422,205,50,1677,34614
23-08-2016,0,11619,10591,6418,1605,30233,1155,201,55,1411,31644
23-08-2016,1,11459,10339,6269,1500,29568,1103,200,58,1361,30929
23-08-2016,2,11070,10232,6191,1423,28917,1110,201,50,1361,30278
23-08-2016,3,10685,10212,6098,1458,28453,1126,205,50,1381,29834
23-08-2016,4,11205,10342,6227,1451,29226,1141,210,50,1401,30627
23-08-2016,5,12313,11031,6668,1427,31439,1327,213,48,1588,33027
23-08-2016,6,13784,13007,7175,1841,35807,1566,220,75,1861,37668
23-08-2016,7,15071,15244,7471,2175,39960,1586,249,234,2069,42029
23-08-2016,8,15662,16330,7494,2202,41688,1559,548,418,2525,44213
23-08-2016,9,15668,16267,7476,2271,41682,1568,879,402,2849,44531
23-08-2016,10,15800,16204,7529,2295,41827,1570,851,446,2867,44694
23-08-2016,11,15770,16291,7534,2318,41913,1573,817,401,2791,44704
23-08-2016,12,15789,16269,7452,2310,41820,1564,831,416,2811,44631
23-08-2016,13,15797,16460,7356,2268,41882,1618,421,441,2480,44362
23-08-2016,14,15823,16320,7345,2182,41669,1644,348,354,2346,44015
23-08-2016,15,15764,15883,7288,2105,41041,1665,328,273,2266,43307
23-08-2016,16,15610,15620,7106,2021,40357,1663,245,94,2002,42359
23-08-2016,17,15697,16000,7126,2036,40860,1657,243,283,2183,43043
23-08-2016,18,15442,16134,7114,1947,40638,1633,242,280,2155,42793
23-08-2016,19,15396,16092,7171,1816,40477,1609,233,269,2111,42588
23-08-2016,20,15486,16031,7176,1753,40446,1592,225,254,2071,42517
23-08-2016,21,15256,15273,6852,1728,39108,1646,215,263,2124,41232
23-08-2016,22,14922,13538,6804,1657,36920,1647,214,82,1943,38863
23-08-2016,23,13664,11901,6589,1306,33459,1589,204,71,1864,35323
24-08-2016,0,12611,10701,6359,1274,30945,1333,198,62,1593,32538
24-08-2016,1,12185,10087,6175,975,29422,1147,197,52,1396,30818
24-08-2016,2,12037,9996,6007,893,28932,1134,195,50,1379,30311
24-08-2016,3,12113,9880,5997,889,28879,1127,197,56,1380,30259
24-08-2016,4,12010,9845,6129,931,28916,1130,202,91,1423,30339
24-08-2016,5,12349,10677,6456,1110,30593,1528,207,151,1886,32479
24-08-2016,6,13583,12854,6930,1682,35048,1608,213,192,2013,37061
24-08-2016,7,15055,15313,7266,2027,39661,1610,324,401,2335,41996
24-08-2016,8,15168,16174,7270,2197,40809,1588,774,426,2788,43597
24-08-2016,9,15363,16122,7226,2271,40983,1506,1062,521,3089,44072
24-08-2016,10,15571,16427,7191,2401,41590,1513,1014,452,2979,44569
24-08-2016,11,15232,16486,7238,2521,41477,1521,971,525,3017,44494
24-08-2016,12,15074,16494,7193,2664,41425,1529,955,591,3075,44500
24-08-2016,13,15204,16481,7178,2665,41530,1452,872,556,2880,44410
24-08-2016,14,15429,16414,7186,2613,41641,1343,653,506,2502,44143
24-08-2016,15,15272,16416,7108,2621,41417,1335,512,588,2435,43852
24-08-2016,16,15094,15755,7051,2634,40534,1440,391,208,2039,42573
24-08-2016,17,14969,15910,7021,2637,40537,1535,551,217,2303,42840
24-08-2016,18,15161,15928,7009,2575,40674,1544,442,347,2333,43007
24-08-2016,19,15234,16308,7021,2563,41126,1523,594,555,2672,43798
24-08-2016,20,15011,16258,6884,2528,40682,1525,433,505,2463,43145
24-08-2016,21,14698,15074,6820,2667,39260,1549,230,231,2010,41270
24-08-2016,22,13873,13484,6275,2189,35821,1538,208,218,1964,37785
24-08-2016,23,12997,11953,5920,1993,32863,1532,202,207,1941,34804
25-08-2016,0,11523,11197,5712,1922,30354,1262,198,195,1655,32009
25-08-2016,1,11388,10970,5759,1855,29973,1113,196,185,1494,31467
25-08-2016,2,11009,10904,5835,1780,29528,1109,195,176,1480,31008
25-08-2016,3,10780,10889,5898,1767,29335,1121,197,175,1493,30828
25-08-2016,4,10944,10950,6088,1688,29669,1134,204,177,1515,31184
25-08-2016,5,11665,11606,6472,1592,31335,1283,206,180,1669,33004
25-08-2016,6,13896,13346,7011,2106,36360,1601,225,184,2010,38370
25-08-2016,7,15237,15605,7188,2578,40607,1619,390,182,2191,42798
25-08-2016,8,15892,16628,7143,2592,42255,1624,412,197,2233,44488
25-08-2016,9,15901,16622,7188,2772,42483,1637,660,426,2723,45206
25-08-2016,10,16076,16666,7319,2827,42888,1651,667,521,2839,45727
25-08-2016,11,16052,16670,7288,2892,42904,1699,665,473,2837,45741
25-08-2016,12,15780,16691,7234,2923,42628,1693,620,545,2858,45486
25-08-2016,13,15771,16371,7235,2981,42357,1716,618,551,2885,45242
25-08-2016,14,15578,16153,7223,3049,42003,1721,587,546,2854,44857
25-08-2016,15,15432,16018,7117,2912,41480,1725,580,452,2757,44237
25-08-2016,16,15636,15722,6976,2790,41126,1737,416,267,2420,43546
25-08-2016,17,15572,16324,7217,2674,41786,1708,503,203,2414,44200
25-08-2016,18,15597,16487,7168,2491,41744,1710,488,196,2394,44138
25-08-2016,19,15638,16777,7226,2347,41989,1704,488,182,2374,44363
25-08-2016,20,15485,16449,7341,2382,41657,1703,310,183,2196,43853
25-08-2016,21,14835,14773,6940,2474,39023,1669,229,190,2088,41111
25-08-2016,22,13853,13038,6364,2045,35299,1566,215,208,1989,37288
25-08-2016,23,12850,11444,6112,2064,32470,1400,211,247,1858,34328
26-08-2016,0,12528,10780,6188,2143,31639,1237,214,307,1758,33397
26-08-2016,1,11701,10546,6153,2141,30543,1183,210,359,1752,32295
26-08-2016,2,11437,10436,6159,2057,30089,1149,212,384,1745,31834
26-08-2016,3,11422,10480,6070,1869,29840,1177,216,393,1786,31626
26-08-2016,4,11664,10630,6129,1897,30321,1205,224,390,1819,32140
26-08-2016,5,12807,11633,6298,2099,32836,1340,224,381,1945,34781
26-08-2016,6,13948,13703,6540,2344,36536,1520,281,366,2167,38703
26-08-2016,7,15545,15932,7012,2926,41415,1472,491,366,2329,43744
26-08-2016,8,16314,16654,7145,3112,43224,1431,549,495,2475,45699
26-08-2016,9,16024,16676,7031,3291,43022,1430,933,619,2982,46004
26-08-2016,10,15844,16195,7106,3618,42763,1449,916,640,3005,45768
26-08-2016,11,15579,15835,7177,3828,42419,1636,831,559,3026,45445
26-08-2016,12,14995,15686,7208,4017,41906,1659,711,484,2854,44760
26-08-2016,13,14384,15525,7139,4240,41288,1669,640,497,2806,44094
26-08-2016,14,14572,15254,7133,4022,40981,1667,594,417,2678,43659
26-08-2016,15,14421,15091,7012,3851,40374,1663,550,378,2591,42965
26-08-2016,16,14416,15267,6948,3747,40379,1669,457,364,2490,42869
26-08-2016,17,14814,15934,6957,3597,41302,1694,532,232,2458,43760
26-08-2016,18,14785,16226,7006,3326,41343,1679,435,217,2331,43674
26-08-2016,19,14843,16202,7060,3018,41122,1708,335,224,2267,43389
26-08-2016,20,14486,16061,6857,2682,40086,1722,303,262,2287,42373
26-08-2016,21,14221,15601,6877,2485,39184,1756,263,324,2343,41527
26-08-2016,22,13730,14691,6537,2112,37071,1651,250,348,2249,39320
26-08-2016,23,13255,13537,6201,1798,34793,1410,226,387,2023,36816
27-08-2016,0,12409,12817,6179,1715,33120,1073,217,390,1680,34800
27-08-2016,1,11652,12500,6313,1675,32140,1091,219,359,1669,33809
27-08-2016,2,11410,12405,6321,1601,31739,1094,222,337,1653,33392
27-08-2016,3,11482,12431,6365,1554,31833,1076,220,317,1613,33446
27-08-2016,4,11673,12425,6463,1455,32017,1081,217,298,1596,33613
27-08-2016,5,11688,12562,6648,1368,32266,1100,213,280,1593,33859
27-08-2016,6,11722,12607,6505,1324,32158,1164,210,248,1622,33780
27-08-2016,7,12704,13065,6668,1350,33789,1266,244,181,1691,35480
27-08-2016,8,13269,14293,6872,1818,36253,1309,336,116,1761,38014
27-08-2016,9,13473,14550,6845,2125,36992,1324,592,90,2006,38998
27-08-2016,10,13302,14159,6671,1725,35858,1174,595,106,1875,37733
27-08-2016,11,12981,14107,6599,1668,35356,1152,594,113,1859,37215
27-08-2016,12,12805,13969,6575,1676,35025,1164,681,131,1976,37001
27-08-2016,13,12465,13603,6496,1604,34167,1173,688,136,1997,36164
27-08-2016,14,12606,13495,6458,1481,34040,1150,601,141,1892,35932
27-08-2016,15,12607,13843,6561,1408,34419,1184,408,138,1730,36149
27-08-2016,16,12724,14292,6668,1313,34998,1159,401,135,1695,36693
27-08-2016,17,13567,14615,6792,1505,36479,1349,396,113,1858,38337
27-08-2016,18,14103,15798,6969,1909,38779,1390,318,97,1805,40584
27-08-2016,19,14103,15859,6995,1860,38816,1369,312,96,1777,40593
27-08-2016,20,14158,15574,7005,1837,38577,1314,297,91,1702,40279
27-08-2016,21,14143,14937,6779,1769,37630,1350,286,85,1721,39351
27-08-2016,22,13145,13625,6609,1718,35096,1296,198,85,1579,36675
27-08-2016,23,12291,12008,6403,1372,32075,1126,195,80,1401,33476
28-08-2016,0,11532,10837,6161,1562,30093,983,192,66,1241,31334
28-08-2016,1,10793,10305,5936,1648,28683,985,190,59,1234,29917
28-08-2016,2,11034,10185,5893,1675,28787,968,190,50,1208,29995
28-08-2016,3,11300,10145,5993,1709,29147,967,192,47,1206,30353
28-08-2016,4,10864,10022,5923,1978,28788,949,195,47,1191,29979
28-08-2016,5,10250,9927,5908,2009,28095,932,208,51,1191,29286
28-08-2016,6,10629,10213,5866,2129,28839,903,199,60,1162,30001
28-08-2016,7,10627,10946,5668,2358,29601,901,202,71,1174,30775
28-08-2016,8,11702,11739,5783,2615,31841,914,215,64,1193,33034
28-08-2016,9,12466,12769,5882,2773,33890,985,302,57,1344,35234
28-08-2016,10,12788,13172,5993,2763,34716,1059,359,56,1474,36190
28-08-2016,11,12835,13344,6004,2638,34821,1057,413,56,1526,36347
28-08-2016,12,12879,13300,6026,2466,34672,1071,449,66,1586,36258
28-08-2016,13,13147,13324,5954,2272,34698,1066,397,81,1544,36242
28-08-2016,14,13381,13336,5888,2023,34630,1031,302,104,1437,36067
28-08-2016,15,13249,13282,5841,2075,34445,990,259,104,1353,35798
28-08-2016,16,12983,13532,5793,2197,34506,984,255,93,1332,35838
28-08-2016,17,13304,13712,5929,2320,35265,1061,208,84,1353,36618
28-08-2016,18,13966,14330,5927,2184,36407,1106,219,109,1434,37841
28-08-2016,19,14543,15518,5984,2328,38373,1126,220,152,1498,39871
28-08-2016,20,14950,16318,6121,2413,39803,1119,221,247,1587,41390
28-08-2016,21,15251,15178,6025,2238,38693,1168,188,264,1620,40313
28-08-2016,22,14952,13882,5868,1928,36630,1075,211,260,1546,38176
28-08-2016,23,13274,12595,5696,2129,33695,1041,207,222,1470,35165
29-08-2016,0,12066,10911,5790,2159,30924,1002,211,189,1402,32326
29-08-2016,1,12127,10489,5764,2053,30431,1021,209,174,1404,31835
29-08-2016,2,11918,10491,5760,2137,30306,1022,208,190,1420,31726
29-08-2016,3,11789,10604,5769,2200,30362,1040,204,197,1441,31803
29-08-2016,4,11668,10820,5731,2594,30812,1088,204,236,1528,32340
29-08-2016,5,12747,11992,6054,2827,33621,1377,222,251,1850,35471
29-08-2016,6,14550,14650,6468,3248,38916,1703,265,276,2244,41160
29-08-2016,7,15909,16126,6790,3517,42341,1713,455,475,2643,44984
29-08-2016,8,16034,16404,6794,3644,42875,1733,719,604,3056,45931
29-08-2016,9,15843,16324,6792,3826,42787,1738,746,600,3084,45871
29-08-2016,10,15854,16581,6798,3996,43230,1687,783,662,3132,46362
29-08-2016,11,15847,16751,6771,4101,43473,1650,731,583,2964,46437
29-08-2016,12,15316,16791,6777,4231,43115,1635,544,773,2952,46067
29-08-2016,13,15195,16485,6774,4342,42795,1659,512,804,2975,45770
29-08-2016,14,14954,17198,6784,4290,43226,1648,457,747,2852,46078
29-08-2016,15,14953,16389,6703,4324,42369,1651,414,584,2649,45018
29-08-2016,16,14687,15626,6583,4241,41137,1639,426,423,2488,43625
29-08-2016,17,15265,16025,6603,4177,42071,1660,392,405,2457,44528
29-08-2016,18,15681,16311,6582,4212,42787,1656,303,421,2380,45167
29-08-2016,19,16158,16187,6704,3978,43027,1622,271,443,2336,45363
29-08-2016,20,16229,16214,6651,3758,42852,1621,269,645,2535,45387
29-08-2016,21,15851,15600,6463,3765,41679,1611,275,507,2393,44072
29-08-2016,22,15006,14580,6122,3442,39152,1590,267,502,2359,41511
29-08-2016,23,13694,13643,5920,3093,36352,1328,245,502,2075,38427
30-08-2016,0,12815,12343,5810,2608,33576,1199,243,484,1926,35502
30-08-2016,1,12205,11884,5719,2450,32258,1195,235,454,1884,34142
30-08-2016,2,12318,11591,5685,2304,31899,1200,247,417,1864,33763
30-08-2016,3,12246,11669,5668,2258,31842,1189,229,425,1843,33685
30-08-2016,4,12204,11883,5659,2228,31973,1188,260,452,1900,33873
30-08-2016,5,12952,12662,5943,2216,33772,1258,249,425,1932,35704
30-08-2016,6,14917,14405,6365,2716,38402,1567,290,424,2281,40683
30-08-2016,7,16214,16172,6565,2883,41834,1595,389,640,2624,44458
30-08-2016,8,16495,16527,6561,2833,42415,1605,843,857,3305,45720
30-08-2016,9,16279,16477,6616,3019,42391,1626,526,896,3048,45439
30-08-2016,10,16152,16025,6591,3217,41988,1634,624,802,3060,45048
30-08-2016,11,16012,15769,6630,3361,41770,1637,534,784,2955,44725
30-08-2016,12,15890,15746,6715,3511,41862,1646,444,783,2873,44735
30-08-2016,13,15730,15631,6704,3621,41685,1655,413,739,2807,44492
30-08-2016,14,15144,15757,6695,3466,41062,1657,413,657,2727,43789
30-08-2016,15,15174,15542,6513,3571,40800,1665,408,532,2605,43405
30-08-2016,16,15368,15719,6463,3414,40964,1605,397,500,2502,43466
30-08-2016,17,15956,16453,6562,3144,42116,1569,389,401,2359,44475
30-08-2016,18,15962,17051,6728,3029,42771,1644,360,386,2390,45161
30-08-2016,19,15847,16994,6769,2757,42368,1640,754,618,3012,45380
30-08-2016,20,15772,16857,6781,2557,41968,1628,801,590,3019,44987
30-08-2016,21,15872,16142,6761,2383,41158,1618,235,316,2169,43327
30-08-2016,22,15081,14853,6544,2191,38669,1580,228,275,2083,40752
30-08-2016,23,14124,13361,6189,1599,35273,1348,221,270,1839,37112
31-08-2016,0,13260,12088,6039,1414,32802,1262,216,262,1740,34542
31-08-2016,1,12535,11631,6007,1303,31475,1196,213,249,1658,33133
31-08-2016,2,12252,11431,5918,1320,30922,1174,239,243,1656,32578
31-08-2016,3,12274,11333,5938,1300,30844,1173,240,247,1660,32504
31-08-2016,4,12403,11498,5955,1316,31174,1180,245,246,1671,32845
31-08-2016,5,13314,12586,6162,1298,33360,1233,265,251,1749,35109
31-08-2016,6,14355,14752,6490,2015,37612,1563,506,328,2397,40009
31-08-2016,7,15532,16928,6638,2327,41425,1583,721,404,2708,44133
31-08-2016,8,15761,17362,6707,2332,42161,1584,1048,412,3044,45205
31-08-2016,9,15581,17194,6720,2445,41940,1583,1085,578,3246,45186
31-08-2016,10,15463,17064,6773,2651,41951,1594,1033,589,3216,45167
31-08-2016,11,15396,16862,6756,2832,41848,1597,949,593,3139,44987
31-08-2016,12,15311,16495,6688,2890,41385,1605,956,609,3170,44555
31-08-2016,13,15314,16557,6661,2893,41425,1605,838,430,2873,44298
31-08-2016,14,15690,16642,6591,2839,41762,1609,739,419,2767,44529
31-08-2016,15,15761,16491,6572,2834,41658,1613,729,354,2696,44354
31-08-2016,16,15771,16436,6501,2912,41621,1600,310,298,2208,43829
31-08-2016,17,16554,17292,6778,2875,43499,1572,245,271,2088,45587
31-08-2016,18,16339,17824,7034,2794,43991,1595,245,358,2198,46189
31-08-2016,19,16250,17975,7260,2635,44121,1592,234,461,2287,46408
31-08-2016,20,16277,17783,7335,2569,43962,1577,236,432,2245,46207
31-08-2016,21,15991,16999,7139,2579,42710,1601,236,270,2107,44817
31-08-2016,22,15024,15606,6932,2243,39806,1540,230,278,2048,41854
31-08-2016,23,13529,14868,6667,1969,37033,1284,221,291,1796,38829
01-09-2016,0,12735,13466,6465,1659,34326,1214,218,309,1741,36067
01-09-2016,1,12305,13138,6474,1491,33409,1203,219,338,1760,35169
01-09-2016,2,12301,13005,6525,1371,33202,1218,220,348,1786,34988
01-09-2016,3,12510,12867,6578,1379,33335,1223,228,382,1833,35168
01-09-2016,4,13033,12842,6659,1387,33921,1210,234,374,1818,35739
01-09-2016,5,13814,13741,6772,1394,35722,1300,233,374,1907,37629
01-09-2016,6,14517,16096,7130,2023,39766,1635,249,379,2263,42029
01-09-2016,7,15930,17567,7506,2360,43363,1639,389,433,2461,45824
01-09-2016,8,16105,18503,7597,2367,44574,1646,393,496,2535,47109
01-09-2016,9,16019,18410,7472,2481,44382,1620,440,468,2528,46910
01-09-2016,10,16101,17958,7272,2777,44107,1633,409,474,2516,46623
01-09-2016,11,16079,17422,7079,2915,43494,1663,590,501,2754,46248
01-09-2016,12,16082,16537,6942,2738,42300,1666,638,524,2828,45128
01-09-2016,13,16273,16417,6736,2656,42083,1655,569,548,2772,44855
01-09-2016,14,16135,16283,6586,2409,41414,1637,389,362,2388,43802
01-09-2016,15,16204,16296,6632,2437,41570,1641,388,354,2383,43953
01-09-2016,16,16081,16627,6692,2580,41980,1650,404,338,2392,44372
01-09-2016,17,16129,17972,6857,2668,43625,1599,378,310,2287,45912
01-09-2016,18,16281,18356,7011,2562,44209,1614,237,294,2145,46354
01-09-2016,19,16288,18391,7196,2477,44352,1635,250,399,2284,46636
01-09-2016,20,16291,18031,7277,2194,43794,1638,255,394,2287,46081
01-09-2016,21,15923,17290,7049,2096,42358,1640,255,320,2215,44573
01-09-2016,22,15417,15678,6679,2051,39827,1629,238,346,2213,42040
01-09-2016,23,14567,14754,6304,1781,37407,1291,232,382,1905,39312
02-09-2016,0,13445,12716,6119,1624,33904,1164,226,370,1760,35664
02-09-2016,1,12828,12222,5983,1566,32599,1137,206,360,1703,34302
02-09-2016,2,12782,12280,5997,1519,32577,1149,206,363,1718,34295
02-09-2016,3,12482,12255,6040,1561,32337,1161,209,351,1721,34058
02-09-2016,4,12165,12575,6010,1586,32338,1164,229,356,1749,34087
02-09-2016,5,12958,13785,6143,1528,34415,1315,233,353,1901,36316
02-09-2016,6,14769,16205,6551,1837,39362,1607,219,325,2151,41513
02-09-2016,7,16037,18118,6831,2138,43123,1615,242,396,2253,45376
02-09-2016,8,16268,18366,6826,2022,43481,1641,258,862,2761,46242
02-09-2016,9,16641,17986,6649,2184,43458,1665,401,700,2766,46224
02-09-2016,10,16573,17481,6687,2169,42909,1661,450,712,2823,45732
02-09-2016,11,16295,16944,6831,2400,42471,1690,544,613,2847,45318
02-09-2016,12,16014,16152,6733,2664,41564,1735,562,571,2868,44432
02-09-2016,13,15899,15570,6651,2869,40989,1734,558,565,2857,43846
02-09-2016,14,15674,15243,6512,2923,40353,1709,389,411,2509,42862
02-09-2016,15,15981,15284,6577,2792,40634,1746,406,340,2492,43126
02-09-2016,16,16137,16034,6649,2913,41733,1744,404,182,2330,44063
02-09-2016,17,15950,16759,6660,2872,42243,1715,379,183,2277,44520
02-09-2016,18,16018,16996,6646,2727,42387,1694,366,159,2219,44606
02-09-2016,19,15936,16911,6664,2469,41980,1716,347,347,2410,44390
02-09-2016,20,15880,16419,6545,2272,41117,1692,246,364,2302,43419
02-09-2016,21,15584,15853,6485,2131,40053,1698,196,123,2017,42070
02-09-2016,22,15017,14793,6312,1783,37904,1589,204,123,1916,39820
02-09-2016,23,14236,13796,6207,1741,35980,1398,218,125,1741,37721
03-09-2016,0,13857,11882,5899,1658,33295,1174,211,140,1525,34820
03-09-2016,1,13274,11365,5682,1642,31963,995,209,133,1337,33300
03-09-2016,2,13023,11145,5694,1626,31489,982,209,130,1321,32810
03-09-2016,3,13166,11156,5708,1653,31683,991,212,130,1333,33016
03-09-2016,4,12874,11192,5776,1757,31601,1074,213,120,1407,33008
03-09-2016,5,13019,11353,5749,1787,31908,1076,210,122,1408,33316
03-09-2016,6,13343,11860,5724,1690,32618,1071,223,105,1399,34017
03-09-2016,7,14004,12843,5792,1775,34414,1240,234,103,1577,35991
03-09-2016,8,14587,14133,5758,2227,36705,1220,406,130,1756,38461
03-09-2016,9,15092,14834,5805,2367,38100,1218,500,123,1841,39941
03-09-2016,10,15098,14650,5834,2704,38286,1234,501,127,1862,40148
03-09-2016,11,15058,14179,5614,2696,37546,1248,516,108,1872,39418
03-09-2016,12,14794,14015,5598,2460,36869,1224,479,103,1806,38675
03-09-2016,13,14382,13838,5605,2411,36237,1146,469,100,1715,37952
03-09-2016,14,13924,13818,5573,2190,35505,1123,414,120,1657,37162
03-09-2016,15,14120,13729,5639,2286,35775,1138,403,135,1676,37451
03-09-2016,16,14670,13917,5715,2213,36515,1234,257,145,1636,38151
03-09-2016,17,15224,14831,5796,2025,37876,1258,264,159,1681,39557
03-09-2016,18,15245,16704,5965,1781,39694,1229,259,177,1665,41359
03-09-2016,19,15172,16672,6048,1560,39452,1227,298,176,1701,41153
03-09-2016,20,15222,16513,6170,1529,39434,1267,298,156,1721,41155
03-09-2016,21,15030,16165,6071,1491,38758,1256,292,183,1731,40489
03-09-2016,22,14691,14838,5975,1433,36937,1254,252,194,1700,38637
03-09-2016,23,13829,13279,5856,1201,34167,1221,244,196,1661,35828
04-09-2016,0,13811,12399,5817,890,32916,1048,157,184,1389,34305
04-09-2016,1,13486,11679,5734,661,31561,993,141,181,1315,32876
04-09-2016,2,12141,11339,5624,592,29697,943,152,176,1271,30968
04-09-2016,3,11503,11169,5636,512,28820,947,150,141,1238,30058
04-09-2016,4,11271,11038,5648,548,28505,996,152,127,1275,29780
04-09-2016,5,11309,10976,5653,640,28577,1005,153,120,1278,29855
04-09-2016,6,11125,10919,5702,767,28513,964,152,112,1228,29741
04-09-2016,7,11752,11012,5623,854,29240,955,156,103,1214,30454
04-09-2016,8,13156,12024,5580,946,31705,1009,173,84,1266,32971
04-09-2016,9,14151,12468,5639,976,33233,1211,257,78,1546,34779
04-09-2016,10,14530,12737,5701,958,33927,1315,284,78,1677,35604
04-09-2016,11,15233,13025,5816,865,34939,1357,285,80,1722,36661
04-09-2016,12,14349,13110,5845,942,34247,1412,283,78,1773,36020
04-09-2016,13,14185,12832,5781,1090,33888,1426,279,79,1784,35672
04-09-2016,14,13708,12735,5740,1145,33327,1410,266,79,1755,35082
04-09-2016,15,13577,12712,5775,1161,33225,1427,154,72,1653,34878
04-09-2016,16,13946,12841,5723,1123,33633,1409,152,58,1619,35252
04-09-2016,17,14340,13105,5697,1015,34157,1389,151,57,1597,35754
04-09-2016,18,15111,13646,5903,1088,35749,1371,150,51,1572,37321
04-09-2016,19,15338,14700,5919,1236,37192,1353,200,43,1596,38788
04-09-2016,20,15487,15618,5952,1339,38396,1377,304,40,1721,40117
04-09-2016,21,15256,14993,5858,1435,37543,1364,254,40,1658,39201
04-09-2016,22,14743,14155,5715,1412,36025,1351,147,41,1539,37564
04-09-2016,23,13401,12797,5532,1339,33068,1236,158,42,1436,34504
05-09-2016,0,11940,12097,5482,1365,30883,1120,212,46,1378,32261
05-09-2016,1,11479,11828,5431,1332,30071,1135,208,45,1388,31459
05-09-2016,2,11516,11793,5535,1226,30070,1168,200,49,1417,31487
05-09-2016,3,11225,11892,5727,1162,30004,1224,203,62,1489,31493
05-09-2016,4,11541,12118,5759,1265,30683,1306,208,80,1594,32277
05-09-2016,5,12964,13262,6116,1230,33573,1446,218,99,1763,35336
05-09-2016,6,14411,15921,6471,1387,38189,1726,353,320,2399,40588
05-09-2016,7,15270,18084,6908,1796,42060,1764,442,562,2768,44828
05-09-2016,8,15352,18423,6897,2066,42739,1738,935,627,3300,46039
05-09-2016,9,15329,17826,6720,1965,41841,1732,1040,819,3591,45432
05-09-2016,10,15395,17565,6666,2015,41642,1755,1047,841,3643,45285
05-09-2016,11,14992,17709,6604,2101,41407,1779,1019,796,3594,45001
05-09-2016,12,14939,17070,6563,2307,40878,1775,1026,821,3622,44500
05-09-2016,13,15062,16982,6674,2267,40986,1789,1024,634,3447,44433
05-09-2016,14,14804,17427,6588,2180,40999,1803,475,617,2895,43894
05-09-2016,15,14783,17282,6594,2129,40789,1795,369,630,2794,43583
05-09-2016,16,14925,17160,6575,2016,40676,1789,453,517,2759,43435
05-09-2016,17,14532,17301,6585,1928,40346,1786,455,438,2679,43025
05-09-2016,18,15060,16968,6542,1828,40399,1782,451,408,2641,43040
05-09-2016,19,15881,16886,6609,1579,40954,1785,528,699,3012,43966
05-09-2016,20,16187,17331,6688,1736,41942,1801,481,756,3038,44980
05-09-2016,21,15866,16821,6610,1554,40852,1808,305,439,2552,43404
05-09-2016,22,15310,15156,6365,1524,38355,1790,256,139,2185,40540
05-09-2016,23,14551,13429,6134,1093,35206,1685,249,124,2058,37264
06-09-2016,0,14363,11961,5978,964,33266,1599,224,111,1934,35200
06-09-2016,1,13964,11575,5884,1158,32583,1494,216,105,1815,34398
06-09-2016,2,13498,11528,5806,1318,32150,1270,214,82,1566,33716
06-09-2016,3,13105,11399,5859,1425,31788,1237,244,73,1554,33342
06-09-2016,4,13251,11548,5961,1413,32171,1225,246,60,1531,33702
06-09-2016,5,13912,12564,6246,1499,34220,1461,269,163,1893,36113
06-09-2016,6,14803,15536,6625,2139,39103,1503,526,338,2367,41470
06-09-2016,7,15826,17608,6769,2588,42791,1499,857,640,2996,45787
06-09-2016,8,16381,17826,6719,2693,43619,1492,961,741,3194,46813
06-09-2016,9,16397,17736,6622,2773,43527,1509,908,831,3248,46775
06-09-2016,10,16414,17533,6564,2936,43448,1516,905,772,3193,46641
06-09-2016,11,16371,16960,6535,3459,43326,1528,850,736,3114,46440
06-09-2016,12,16104,16193,6628,3821,42746,1540,853,823,3216,45962
06-09-2016,13,15965,15758,6604,3334,41660,1537,848,738,3123,44783
06-09-2016,14,16189,15668,6535,3266,41657,1578,357,496,2431,44088
06-09-2016,15,16467,16247,6535,3122,42372,1592,344,477,2413,44785
06-09-2016,16,16266,16978,6731,2806,42782,1676,379,562,2617,45399
06-09-2016,17,16089,17476,6791,2696,43054,1687,369,495,2551,45605
06-09-2016,18,15986,17574,6837,2674,43071,1612,280,462,2354,45425
06-09-2016,19,15965,17792,7022,2435,43215,1666,612,681,2959,46174
06-09-2016,20,16124,17737,6780,2695,43336,1621,277,426,2324,45660
06-09-2016,21,15687,17108,6594,2492,41881,1630,252,111,1993,43874
06-09-2016,22,14737,15789,6267,2074,38868,1524,249,118,1891,40759
06-09-2016,23,13336,14886,6092,1908,36222,1310,292,135,1737,37959
07-09-2016,0,11580,13846,5976,1892,33294,1260,248,160,1668,34962
07-09-2016,1,11282,13631,5966,1822,32700,1186,248,191,1625,34325
07-09-2016,2,10880,13577,5912,1810,32181,1139,250,221,1610,33791
07-09-2016,3,11016,13768,5788,1686,32258,1131,254,232,1617,33875
07-09-2016,4,11547,13867,5761,1589,32764,1277,258,241,1776,34540
07-09-2016,5,12948,14571,6060,1545,35124,1472,265,262,1999,37123
07-09-2016,6,14663,16263,6605,1564,39096,1610,274,381,2265,41361
07-09-2016,7,16026,17983,6834,2178,43021,1652,431,601,2684,45705
07-09-2016,8,16429,18407,6909,2286,44032,1649,612,915,3176,47208
07-09-2016,9,16379,18387,6828,2389,43985,1637,705,1005,3347,47332
07-09-2016,10,16491,17465,6850,2148,42954,1646,686,979,3311,46265
07-09-2016,11,16363,17388,6819,2073,42645,1644,506,1061,3211,45856
07-09-2016,12,16028,16938,6872,1970,41807,1664,507,1052,3223,45030
07-09-2016,13,15984,16636,6847,1942,41410,1665,687,912,3264,44674
07-09-2016,14,16032,16491,6535,1862,40921,1641,397,701,2739,43660
07-09-2016,15,16058,16480,6603,1904,41044,1614,399,689,2702,43746
07-09-2016,16,16311,17099,6953,1890,42252,1637,395,678,2710,44962
07-09-2016,17,16406,18374,7008,1938,43725,1593,400,662,2655,46380
07-09-2016,18,15977,18289,7038,1874,43177,1579,401,632,2612,45789
07-09-2016,19,16084,17717,7141,1760,42702,1562,834,934,3330,46032
07-09-2016,20,16129,17644,7202,1720,42695,1556,311,898,2765,45460
07-09-2016,21,15943,17092,6878,1672,41586,1542,255,519,2316,43902
07-09-2016,22,15426,15293,6628,1211,38558,1480,247,210,1937,40495
07-09-2016,23,14330,13895,6400,801,35427,1429,254,197,1880,37307
08-09-2016,0,13720,12454,6272,838,33285,1259,235,175,1669,34954
08-09-2016,1,13178,12016,6254,805,32253,1171,226,158,1555,33808
08-09-2016,2,12656,11867,6160,891,31573,1137,222,152,1511,33084
08-09-2016,3,12487,11734,6001,901,31123,1141,225,150,1516,32639
08-09-2016,4,12367,11805,6074,832,31077,1147,227,137,1511,32588
08-09-2016,5,13118,12670,6334,1060,33181,1348,227,118,1693,34874
08-09-2016,6,14770,15129,6816,1580,38296,1534,235,246,2015,40311
08-09-2016,7,15817,17198,6897,1860,41772,1532,337,493,2362,44134
08-09-2016,8,16493,17109,6758,2018,42379,1536,626,827,2989,45368
08-09-2016,9,16721,16618,6776,2001,42117,1519,929,875,3323,45440
08-09-2016,10,16739,16215,6754,2180,41888,1499,930,858,3287,45175
08-09-2016,11,16538,15806,6864,2454,41662,1507,908,804,3219,44881
08-09-2016,12,16111,15400,6864,2547,40922,1519,859,859,3237,44159
08-09-2016,13,16255,15008,6712,2625,40601,1516,940,797,3253,43854
08-09-2016,14,16259,14772,6623,2572,40226,1519,439,632,2590,42816
08-09-2016,15,16212,14870,6755,2523,40360,1515,330,668,2513,42873
08-09-2016,16,16066,15160,6816,2697,40739,1496,429,670,2595,43334
08-09-2016,17,16111,16629,6764,2538,42042,1480,359,665,2504,44546
08-09-2016,18,16013,17179,6673,2417,42282,1459,320,744,2523,44805
08-09-2016,19,16076,17292,6682,2250,42301,1465,693,839,2997,45298
08-09-2016,20,16119,17582,6693,2245,42638,1493,259,743,2495,45133
08-09-2016,21,15922,17028,6353,2149,41453,1487,241,371,2099,43552
08-09-2016,22,15332,14853,6162,1797,38145,1466,236,48,1750,39895
08-09-2016,23,14445,13546,6051,1582,35623,1365,228,48,1641,37264
09-09-2016,0,13569,11956,5944,1237,32707,1194,224,51,1469,34176
09-09-2016,1,12951,11565,5882,1146,31544,1069,220,57,1346,32890
09-09-2016,2,12450,11585,5761,1081,30878,1056,218,58,1332,32210
09-09-2016,3,12375,11589,5675,1003,30643,1075,224,63,1362,32005
09-09-2016,4,12543,11724,5787,1031,31086,1092,252,68,1412,32498
09-09-2016,5,13207,12961,6199,1271,33640,1337,260,217,1814,35454
09-09-2016,6,14779,15967,6527,1885,39158,1412,639,393,2444,41602
09-09-2016,7,15667,17840,6844,2154,42505,1434,697,664,2795,45300
09-09-2016,8,15502,17744,6876,2110,42234,1417,794,839,3050,45284
09-09-2016,9,15754,17920,6890,2237,42802,1415,794,823,3032,45834
09-09-2016,10,16646,17980,6986,2169,43782,1443,806,644,2893,46675
09-09-2016,11,16256,17763,6876,2350,43246,1473,807,734,3014,46260
09-09-2016,12,16102,16924,6784,2351,42160,1458,1004,821,3283,45443
09-09-2016,13,15595,16155,6719,2399,40869,1472,841,727,3040,43909
09-09-2016,14,15322,16104,6582,2360,40368,1476,253,607,2336,42704
09-09-2016,15,15706,16158,6748,2312,40924,1468,243,567,2278,43202
09-09-2016,16,15794,16552,6760,2267,41374,1457,623,531,2611,43985
09-09-2016,17,15903,17418,6860,2099,42278,1448,320,449,2217,44495
09-09-2016,18,15631,17780,6849,2026,42287,1455,237,550,2242,44529
09-09-2016,19,15690,17827,6942,1933,42394,1445,539,754,2738,45132
09-09-2016,20,15645,17645,6923,1924,42139,1402,259,478,2139,44278
09-09-2016,21,15451,16390,6594,1909,40344,1414,245,102,1761,42105
09-09-2016,22,14796,14708,6430,1837,37772,1376,235,118,1729,39501
09-09-2016,23,14166,13241,6082,1317,34805,1342,227,116,1685,36490
10-09-2016,0,13897,11805,6078,1292,33073,1078,217,96,1391,34464
10-09-2016,1,13311,11039,5889,1375,31614,1056,214,82,1352,32966
10-09-2016,2,13099,10837,5823,1412,31172,921,217,0,1138,32310
10-09-2016,3,12615,10641,5694,1497,30446,877,219,62,1158,31604
10-09-2016,4,12316,10697,5647,1587,30247,909,222,61,1192,31439
10-09-2016,5,12568,11089,5580,1599,30837,922,224,55,1201,32038
10-09-2016,6,12830,11572,5603,1726,31730,885,226,47,1158,32888
10-09-2016,7,13772,12275,5788,1802,33638,972,227,44,1243,34881
10-09-2016,8,14790,13589,5881,2152,36412,984,227,41,1252,37664
10-09-2016,9,14976,14220,6052,2364,37612,1014,232,41,1287,38899
10-09-2016,10,14880,13671,6021,2209,36781,1024,570,47,1641,38422
10-09-2016,11,14707,13504,6048,2329,36589,1025,425,0,1450,38039
10-09-2016,12,14499,13281,6020,2311,36112,1030,405,0,1435,37547
10-09-2016,13,14382,13166,5938,2298,35786,1046,370,0,1416,37202
10-09-2016,14,14243,13116,5906,2176,35442,1022,231,0,1253,36695
10-09-2016,15,14579,13277,5990,1990,35837,1019,209,0,1228,37065
10-09-2016,16,15086,14227,6106,2000,37419,1002,207,0,1209,38628
10-09-2016,17,15299,15465,6173,2084,39022,990,219,0,1209,40231
10-09-2016,18,15348,16353,6208,2001,39911,971,223,0,1194,41105
10-09-2016,19,15414,16231,6302,1878,39824,966,223,0,1189,41013
10-09-2016,20,15259,16343,6337,1953,39892,968,210,0,1178,41070
10-09-2016,21,15191,15143,6037,2142,38513,990,208,0,1198,39711
10-09-2016,22,14703,13927,5713,2001,36344,978,220,0,1198,37542
10-09-2016,23,14085,12903,5575,1870,34433,969,220,0,1189,35622
11-09-2016,0,12849,11656,5300,2064,31870,911,216,43,1170,33040
11-09-2016,1,11809,11303,5264,2187,30564,921,213,43,1177,31741
11-09-2016,2,11226,11539,5233,2327,30325,935,214,46,1195,31520
11-09-2016,3,10867,11512,5087,2346,29812,945,217,44,1206,31018
11-09-2016,4,10719,11615,5065,2390,29790,970,222,43,1235,31025
11-09-2016,5,10504,11978,5082,2365,29928,975,224,42,1241,31169
11-09-2016,6,10176,12554,5189,2479,30398,981,227,43,1251,31649
11-09-2016,7,10259,12744,5308,2380,30690,964,228,42,1234,31924
11-09-2016,8,12218,13219,5347,2245,33029,967,228,42,1237,34266
11-09-2016,9,14194,13529,5434,2229,35384,1055,228,41,1324,36708
11-09-2016,10,14187,14181,5447,2295,36111,1283,229,43,1555,37666
11-09-2016,11,14149,14018,5391,2329,35886,1300,228,42,1570,37456
11-09-2016,12,14064,14025,5454,2344,35885,1293,227,42,1562,37447
11-09-2016,13,13880,14219,5495,2206,35799,1275,219,44,1538,37337
11-09-2016,14,13274,14518,5561,1869,35223,1269,212,44,1525,36748
11-09-2016,15,13459,14365,5587,1601,35013,1292,211,48,1551,36564
11-09-2016,16,14283,14432,5660,1452,35828,1216,214,49,1479,37307
11-09-2016,17,15080,15158,6015,1272,37526,1239,215,46,1500,39026
11-09-2016,18,15209,16474,6265,1244,39193,1262,221,48,1531,40724
11-09-2016,19,15441,16956,6445,1109,39952,1287,220,52,1559,41511
11-09-2016,20,15758,17363,6415,1085,40622,1337,215,64,1616,42238
11-09-2016,21,15513,16478,6304,1039,39335,1459,212,65,1736,41071
11-09-2016,22,15034,15369,6174,936,37514,1441,211,53,1705,39219
11-09-2016,23,14061,14183,6004,666,34916,1366,206,55,1627,36543
12-09-2016,0,12626,12994,5929,632,32181,1152,201,54,1407,33588
12-09-2016,1,11776,12596,5946,655,30972,1107,195,52,1354,32326
12-09-2016,2,11646,12415,5992,759,30814,1126,194,55,1375,32189
12-09-2016,3,11519,12329,5899,925,30673,1139,195,57,1391,32064
12-09-2016,4,11535,12559,5917,1112,31123,1167,199,54,1420,32543
12-09-2016,5,12878,13928,6258,1243,34307,1343,209,53,1605,35912
12-09-2016,6,14628,15843,6835,1614,38921,1648,396,56,2100,41021
12-09-2016,7,16187,17306,7056,2124,42674,1665,734,244,2643,45317
12-09-2016,8,16650,17859,7080,2402,43992,1631,832,401,2864,46856
12-09-2016,9,16575,17882,7090,2561,44109,1647,750,468,2865,46974
12-09-2016,10,16406,17326,7077,2678,43486,1644,812,462,2918,46404
12-09-2016,11,16310,16631,6985,2790,42716,1652,745,464,2861,45577
12-09-2016,12,16404,16287,6949,2815,42456,1675,571,477,2723,45179
12-09-2016,13,16195,16368,6902,2882,42349,1656,606,473,2735,45084
12-09-2016,14,16355,16569,6760,2996,42680,1663,307,75,2045,44725
12-09-2016,15,16499,16871,6823,2985,43178,1654,221,128,2003,45181
12-09-2016,16,16303,17136,6897,2887,43222,1649,434,264,2347,45569
12-09-2016,17,16228,17430,6846,2792,43297,1587,312,160,2059,45356
12-09-2016,18,15772,17533,6871,2730,42906,1587,229,417,2233,45139
12-09-2016,19,15913,17437,6905,2615,42870,1602,525,466,2593,45463
12-09-2016,20,15977,17351,6690,2562,42579,1601,225,148,1974,44553
12-09-2016,21,16138,16059,6383,2576,41156,1596,209,87,1892,43048
12-09-2016,22,15289,14325,6034,2287,37934,1588,205,77,1870,39804
12-09-2016,23,14377,12957,5764,1942,35041,1571,201,64,1836,36877
13-09-2016,0,13786,12132,5733,1556,33207,1383,197,67,1647,34854
13-09-2016,1,13629,11856,5632,1493,32611,1209,192,64,1465,34076
13-09-2016,2,13348,11877,5535,1316,32075,1168,192,67,1427,33502
13-09-2016,3,13102,11818,5495,1185,31603,1157,195,77,1429,33032
13-09-2016,4,13023,11879,5676,1166,31744,1216,199,84,1499,33243
13-09-2016,5,13452,13441,6038,1306,34236,1600,213,129,1942,36178
13-09-2016,6,15039,15616,6509,2077,39241,1663,563,319,2545,41786
13-09-2016,7,16551,17445,6593,2394,42984,1653,723,585,2961,45945
13-09-2016,8,16954,17791,6533,2489,43765,1670,808,626,3104,46869
13-09-2016,9,17141,17655,6531,2453,43779,1612,802,752,3166,46945
13-09-2016,10,17591,17511,6575,2552,44230,1618,758,665,3041,47271
13-09-2016,11,17314,17446,6514,2611,43884,1611,613,686,2910,46794
13-09-2016,12,17202,17166,6521,2553,43443,1582,541,780,2903,46346
13-09-2016,13,17067,16693,6462,2473,42693,1563,597,650,2810,45503
13-09-2016,14,16919,16383,6331,2540,42172,1591,237,340,2168,44340
13-09-2016,15,16819,16275,6407,2570,42072,1584,225,388,2197,44269
13-09-2016,16,16692,16583,6544,2816,42636,1577,225,680,2482,45118
13-09-2016,17,16833,17173,6550,2780,43337,1578,224,653,2455,45792
13-09-2016,18,16616,17082,6603,2813,43115,1593,332,660,2585,45700
13-09-2016,19,16578,17038,6656,2747,43021,1603,725,675,3003,46024
13-09-2016,20,16705,16951,6443,2875,42972,1591,255,370,2216,45188
13-09-2016,21,16509,15247,6100,2534,40390,1617,211,129,1957,42347
13-09-2016,22,14894,13669,5780,2132,36474,1614,206,142,1962,38436
13-09-2016,23,13572,12802,5700,2095,34170,1437,204,149,1790,35960
14-09-2016,0,12720,11949,5693,1861,32223,1158,199,150,1507,33730
14-09-2016,1,12337,11560,5548,1840,31284,1139,195,109,1443,32727
14-09-2016,2,12019,11561,5541,1814,30936,1144,196,93,1433,32369
14-09-2016,3,12008,11578,5574,1688,30848,1134,202,79,1415,32263
14-09-2016,4,12427,11702,5694,1698,31522,1132,230,78,1440,32962
14-09-2016,5,13163,13322,6049,1658,34192,1356,255,186,1797,35989
14-09-2016,6,14996,15684,6655,1973,39308,1370,599,466,2435,41743
14-09-2016,7,16535,17003,6758,2366,42661,1369,811,659,2839,45500
14-09-2016,8,17237,16979,6785,2559,43559,1352,843,750,2945,46504
14-09-2016,9,17293,16759,6734,2600,43386,1359,799,838,2996,46382
14-09-2016,10,17348,16768,6828,2719,43663,1328,837,806,2971,46634
14-09-2016,11,17175,16684,6675,2700,43234,1314,756,824,2894,46128
14-09-2016,12,17125,16473,6618,2435,42651,1350,718,725,2793,45444
14-09-2016,13,17150,16223,6603,2336,42311,1354,647,690,2691,45002
14-09-2016,14,17005,16006,6320,2200,41531,1359,386,612,2357,43888
14-09-2016,15,17103,15863,6427,2232,41625,1348,365,559,2272,43897
14-09-2016,16,16980,16277,6610,2699,42566,1350,423,681,2454,45020
14-09-2016,17,16652,16882,6631,2747,42912,1338,371,678,2387,45299
14-09-2016,18,16611,16694,6677,2682,42665,1336,382,678,2396,45061
14-09-2016,19,17009,16690,6867,2604,43171,1346,755,679,2780,45951
14-09-2016,20,16632,16530,6745,2525,42434,1344,316,412,2072,44506
14-09-2016,21,15975,14911,6396,2076,39359,1334,212,270,1816,41175
14-09-2016,22,14852,13669,6114,1786,36422,1348,207,268,1823,38245
14-09-2016,23,13198,12906,6044,1683,33831,1242,201,262,1705,35536
15-09-2016,0,11926,12114,5958,1640,31638,982,198,265,1445,33083
15-09-2016,1,11129,12065,5797,1617,30609,939,197,268,1404,32013
15-09-2016,2,10911,12072,5805,1526,30314,938,197,263,1398,31712
15-09-2016,3,11024,12055,5785,1481,30345,940,197,259,1396,31741
15-09-2016,4,11634,12198,5893,1452,31179,950,201,258,1409,32588
15-09-2016,5,12390,13166,6215,1479,33251,1206,210,258,1674,34925
15-09-2016,6,15092,14591,6764,1710,38157,1409,363,437,2209,40366
15-09-2016,7,16787,16873,6948,2298,42907,0,644,640,1284,44191
15-09-2016,8,17360,17092,7065,2530,44047,0,642,729,1371,45418
15-09-2016,9,17546,16956,7035,2482,44020,0,606,703,1309,45329
15-09-2016,10,17302,16902,7077,2373,43654,0,660,606,1266,44920
15-09-2016,11,17219,16469,7162,2351,43201,0,620,502,1122,44323
15-09-2016,12,17203,16147,7206,2312,42867,1406,615,455,2476,45343
15-09-2016,13,17223,16038,7228,2314,42803,1409,751,278,2438,45241
15-09-2016,14,17143,15806,6917,2189,42054,1398,225,264,1887,43941
15-09-2016,15,17271,15876,6905,2269,42321,1409,220,289,1918,44239
15-09-2016,16,16958,15784,7049,2220,42010,1401,437,284,2122,44132
15-09-2016,17,16917,16198,7045,2606,42768,1382,213,448,2043,44811
15-09-2016,18,16940,16569,7084,2578,43171,1391,231,554,2176,45347
15-09-2016,19,17008,16456,7218,2398,43078,1390,678,449,2517,45595
15-09-2016,20,16952,16652,6939,2418,42960,1408,234,295,1937,44897
15-09-2016,21,16289,14865,6611,2223,39988,1380,210,290,1880,41868
15-09-2016,22,14764,13558,6468,1821,36611,1383,205,278,1866,38477
15-09-2016,23,13670,12551,6470,1746,34437,1164,198,274,1636,36073
16-09-2016,0,12540,11729,6491,1580,32340,1038,195,268,1501,33841
16-09-2016,1,11904,11456,6439,1353,31152,1021,193,265,1479,32631
16-09-2016,2,11745,11452,6423,1307,30928,1026,192,266,1484,32412
16-09-2016,3,11724,11497,6385,1302,30909,1027,196,267,1490,32399
16-09-2016,4,11885,11833,6429,1308,31455,1068,202,261,1531,32986
16-09-2016,5,13119,13000,6769,1421,34310,1297,208,261,1766,36076
16-09-2016,6,15423,15316,7029,1832,39600,1458,218,533,2209,41809
16-09-2016,7,16497,17436,7242,2155,43330,1452,358,634,2444,45774
16-09-2016,8,17095,17547,7220,2291,44152,1442,401,729,2572,46724
16-09-2016,9,17430,17379,7176,2427,44413,1448,283,827,2558,46971
16-09-2016,10,17489,17307,7169,2476,44441,1424,317,788,2529,46970
16-09-2016,11,17181,17166,7141,2606,44094,1428,221,796,2445,46539
16-09-2016,12,16781,16794,7070,2805,43451,1433,212,786,2431,45882
16-09-2016,13,16391,16638,6987,2982,42997,1418,233,694,2345,45342
16-09-2016,14,16262,16318,6417,3136,42132,1360,216,283,1859,43991
16-09-2016,15,16018,16123,6621,3016,41779,1357,207,283,1847,43626
16-09-2016,16,16383,16048,6903,2819,42155,1403,203,407,2013,44168
16-09-2016,17,16578,16164,6874,2594,42210,1388,212,424,2024,44234
16-09-2016,18,16360,16489,6947,2584,42381,1391,251,518,2160,44541
16-09-2016,19,16389,16512,7042,2500,42444,1370,363,732,2465,44909
16-09-2016,20,16300,16177,6633,2246,41357,1309,207,419,1935,43292
16-09-2016,21,15578,14971,6111,2158,38818,1286,203,398,1887,40705
16-09-2016,22,15060,13973,5832,2129,36995,998,201,387,1586,38581
16-09-2016,23,14516,13269,5911,2040,35735,790,205,383,1378,37113
17-09-2016,0,14006,12369,5812,1978,34165,713,145,198,1056,35221
17-09-2016,1,13512,11848,5726,1988,33074,708,140,188,1036,34110
17-09-2016,2,13013,11752,5681,1996,32444,685,143,177,1005,33449
17-09-2016,3,12114,11724,5599,1892,31329,690,145,171,1006,32335
17-09-2016,4,11973,11763,5468,1874,31077,701,148,181,1030,32107
17-09-2016,5,12304,11887,5571,1891,31652,671,150,185,1006,32658
17-09-2016,6,13367,12454,5720,1835,33376,658,150,186,994,34370
17-09-2016,7,13871,13505,5771,1867,35013,779,147,161,1087,36100
17-09-2016,8,15153,14584,5879,1904,37521,864,145,89,1098,38619
17-09-2016,9,15697,15081,6005,2221,39005,849,146,225,1220,40225
17-09-2016,10,15876,15196,6014,2176,39262,818,147,66,1031,40293
17-09-2016,11,15790,15191,5882,2163,39027,846,146,82,1074,40101
17-09-2016,12,15771,15027,5797,2152,38746,856,145,82,1083,39829
17-09-2016,13,15388,14756,5690,2241,38075,826,145,94,1065,39140
17-09-2016,14,15019,14563,5584,2185,37351,807,146,110,1063,38414
17-09-2016,15,14288,14393,5622,2114,36416,830,146,111,1087,37503
17-09-2016,16,14970,14454,5666,2131,37222,831,146,119,1096,38318
17-09-2016,17,15371,15082,5859,2276,38587,842,146,116,1104,39691
17-09-2016,18,15765,15253,6096,2250,39364,885,147,120,1152,40516
17-09-2016,19,16089,15744,6289,2196,40318,907,176,134,1217,41535
17-09-2016,20,15633,15545,6116,2155,39449,893,173,135,1201,40650
17-09-2016,21,15041,14751,5739,2041,37572,904,146,128,1178,38750
17-09-2016,22,13907,13494,5515,1920,34837,747,144,124,1015,35852
17-09-2016,23,12856,12460,5500,1844,32661,671,141,125,937,33598
18-09-2016,0,11419,11373,5421,1456,29668,708,139,113,960,30628
18-09-2016,1,11456,11167,5392,1453,29466,709,135,115,959,30425
18-09-2016,2,11102,11167,5388,1360,29016,710,139,114,963,29979
18-09-2016,3,10605,11140,5378,1217,28340,705,143,104,952,29292
18-09-2016,4,10146,11131,5440,1201,27919,713,145,117,975,28894
18-09-2016,5,10462,11182,5312,1218,28174,707,147,122,976,29150
18-09-2016,6,10866,11316,5318,1219,28719,720,148,116,984,29703
18-09-2016,7,11749,11789,5431,1247,30217,724,147,111,982,31199
18-09-2016,8,12825,12817,5542,1384,32567,707,146,74,927,33494
18-09-2016,9,14026,13681,5520,1557,34784,863,144,35,1042,35826
18-09-2016,10,14507,14028,5601,1618,35756,877,144,42,1063,36819
18-09-2016,11,14967,14029,5630,1786,36411,873,143,48,1064,37475
18-09-2016,12,14229,14064,5631,1741,35665,878,144,49,1071,36736
18-09-2016,13,14325,13960,5588,1637,35510,900,144,46,1090,36600
18-09-2016,14,13565,13863,5561,1570,34558,910,145,48,1103,35661
18-09-2016,15,13471,13914,5602,1571,34558,903,145,48,1096,35654
18-09-2016,16,14061,14053,5550,1510,35175,873,147,50,1070,36245
18-09-2016,17,15135,14472,5682,1744,37034,881,152,34,1067,38101
18-09-2016,18,15621,16004,5864,1760,39248,918,221,37,1176,40424
18-09-2016,19,16351,16897,6001,1722,40972,926,339,41,1306,42278
18-09-2016,20,16425,16949,5912,1730,41016,927,590,41,1558,42574
18-09-2016,21,15751,16054,5847,1717,39371,915,237,45,1197,40568
18-09-2016,22,15125,14907,5646,1452,37130,906,149,46,1101,38231
18-09-2016,23,14167,13224,5559,1238,34188,893,155,93,1141,35329
19-09-2016,0,13104,11330,5550,1065,31048,754,204,250,1208,32256
19-09-2016,1,12764,11203,5644,1043,30656,757,188,245,1190,31846
19-09-2016,2,12254,11179,5675,916,30025,851,192,241,1284,31309
19-09-2016,3,11505,11131,5709,887,29232,899,224,247,1370,30602
19-09-2016,4,11754,11350,5826,925,29855,995,229,248,1472,31327
19-09-2016,5,13304,13018,6228,1012,33562,1288,306,248,1842,35404
19-09-2016,6,15804,16367,6577,1332,40082,1402,381,436,2219,42301
19-09-2016,7,17279,17758,6953,1780,43770,1407,389,650,2446,46216
19-09-2016,8,17280,17616,7039,1927,43891,1412,1039,649,3100,46991
19-09-2016,9,17344,17213,7180,1917,43655,1413,997,696,3106,46761
19-09-2016,10,17319,17544,7220,1997,44080,1420,937,689,3046,47126
19-09-2016,11,16945,17571,7198,1974,43689,1408,965,654,3027,46716
19-09-2016,12,16996,17437,7195,1985,43614,1419,724,665,2808,46422
19-09-2016,13,17172,17353,7199,1928,43651,1397,603,642,2642,46293
19-09-2016,14,16917,17307,7035,1879,43139,1417,597,637,2651,45790
19-09-2016,15,16446,17436,6965,1868,42716,1414,390,679,2483,45199
19-09-2016,16,16376,17279,7016,1808,42479,1415,380,561,2356,44835
19-09-2016,17,16326,16966,7034,1839,42166,1397,381,480,2258,44424
19-09-2016,18,16280,16938,7065,1825,42110,1397,388,455,2240,44350
19-09-2016,19,16613,17095,7134,1798,42639,1389,764,653,2806,45445
19-09-2016,20,16582,17101,7033,1720,42437,1421,528,267,2216,44653
19-09-2016,21,16179,15208,6676,1639,39702,1429,221,270,1920,41622
19-09-2016,22,15440,14361,6294,1362,37457,1418,209,273,1900,39357
19-09-2016,23,14453,13481,6052,1244,35231,1285,201,274,1760,36991
20-09-2016,0,13336,11921,5791,781,31831,998,198,270,1466,33297
20-09-2016,1,13182,11698,5681,767,31326,899,196,260,1355,32681
20-09-2016,2,12092,11673,5587,729,30081,900,196,261,1357,31438
20-09-2016,3,12000,11572,5565,739,29875,903,198,260,1361,31236
20-09-2016,4,12285,11683,5651,758,30378,957,200,264,1421,31799
20-09-2016,5,13538,12872,5977,798,33184,1247,239,269,1755,34939
20-09-2016,6,15728,15626,6622,1531,39506,1421,303,376,2100,41606
20-09-2016,7,16625,17592,7113,1779,43110,1394,444,690,2528,45638
20-09-2016,8,17107,16986,7231,1876,43200,1430,987,690,3107,46307
20-09-2016,9,17032,16661,7255,1923,42871,1410,824,690,2924,45795
20-09-2016,10,17004,17320,7311,2047,43685,1400,669,682,2751,46436
20-09-2016,11,16599,17408,7276,2204,43486,1424,571,690,2685,46171
20-09-2016,12,16420,17163,7143,2166,42893,1379,604,659,2642,45535
20-09-2016,13,16341,16956,6993,2113,42403,1375,585,665,2625,45028
20-09-2016,14,16301,16323,6820,2176,41620,1365,560,680,2605,44225
20-09-2016,15,16248,15964,6809,2180,41201,1365,441,662,2468,43669
20-09-2016,16,16203,17131,6902,2171,42407,1392,431,524,2347,44754
20-09-2016,17,16059,17527,6915,2079,42582,1421,451,540,2412,44994
20-09-2016,18,15995,17588,7119,1994,42697,1422,472,512,2406,45103
20-09-2016,19,16351,17527,7228,1971,43078,1440,911,658,3009,46087
20-09-2016,20,16818,17254,7031,1911,43014,1447,629,520,2596,45610
20-09-2016,21,16573,16193,6634,1794,41195,1414,241,358,2013,43208
20-09-2016,22,15576,14715,6195,1454,37939,1346,213,361,1920,39859
20-09-2016,23,14689,13640,5889,1228,35446,1221,210,355,1786,37232
21-09-2016,0,13805,11978,5896,989,32668,1121,208,365,1694,34362
21-09-2016,1,13613,11688,5800,928,32028,978,205,337,1520,33548
21-09-2016,2,12893,11715,5744,923,31273,940,204,316,1460,32733
21-09-2016,3,12889,11680,5676,928,31173,934,204,317,1455,32628
21-09-2016,4,13048,11855,5757,932,31592,960,205,312,1477,33069
21-09-2016,5,14054,12917,6028,1017,34016,1236,236,321,1793,35809
21-09-2016,6,15732,15699,6642,1790,39862,1293,350,403,2046,41908
21-09-2016,7,16628,17208,6981,2095,42912,1258,409,672,2339,45251
21-09-2016,8,16825,17354,7107,2175,43461,1249,652,848,2749,46210
21-09-2016,9,16822,17222,7047,2144,43236,1244,708,855,2807,46043
21-09-2016,10,16827,16954,7010,2192,42982,1266,583,833,2682,45664
21-09-2016,11,16591,16854,6908,2203,42557,1328,524,785,2637,45194
21-09-2016,12,16387,16181,6934,2170,41672,1342,493,831,2666,44338
21-09-2016,13,16725,15796,6752,2099,41372,1404,538,785,2727,44099
21-09-2016,14,16252,15888,6443,2059,40641,1410,576,685,2671,43312
21-09-2016,15,16458,15933,6441,2099,40931,1403,642,508,2553,43484
21-09-2016,16,16607,16148,6611,2075,41441,1375,599,497,2471,43912
21-09-2016,17,16503,16822,6668,2021,42014,1374,599,489,2462,44476
21-09-2016,18,16419,17096,6831,2003,42350,1418,545,517,2480,44830
21-09-2016,19,16747,17285,7111,2124,43267,1460,716,627,2803,46070
21-09-2016,20,17078,16787,6768,2017,42651,1445,429,447,2321,44972
21-09-2016,21,16741,15426,6315,2089,40571,1403,254,382,2039,42610
21-09-2016,22,15791,14379,6098,1635,37902,1333,233,380,1946,39848
21-09-2016,23,14731,13211,5922,1433,35297,1204,210,350,1764,37061
22-09-2016,0,14002,11591,5846,1419,32858,1209,210,152,1571,34429
22-09-2016,1,13730,11338,5822,1436,32328,1236,204,120,1560,33888
22-09-2016,2,13399,11462,5742,1432,32036,1099,204,94,1397,33433
22-09-2016,3,12928,11438,5751,1432,31551,1076,208,97,1381,32932
22-09-2016,4,12956,11512,5854,1428,31751,1109,216,103,1428,33179
22-09-2016,5,13824,13105,6265,1520,34714,1417,240,95,1752,36466
22-09-2016,6,15109,15794,6710,2337,39949,1360,288,142,1790,41739
22-09-2016,7,15992,17130,6999,2457,42577,1249,871,467,2587,45164
22-09-2016,8,16453,17205,7165,2550,43373,1407,861,303,2571,45944
22-09-2016,9,16471,17061,7136,2523,43192,1448,906,240,2594,45786
22-09-2016,10,16279,17033,7045,2443,42801,1449,972,250,2671,45472
22-09-2016,11,15624,16780,6964,2431,41799,1467,938,275,2680,44479
22-09-2016,12,15608,16905,6874,2396,41785,1444,921,268,2633,44418
22-09-2016,13,15331,16812,6813,2414,41370,1255,949,465,2669,44039
22-09-2016,14,15115,16464,6606,2348,40533,1372,930,201,2503,43036
22-09-2016,15,15884,16527,6576,2298,41284,1475,810,81,2366,43650
22-09-2016,16,16363,16684,6677,2343,42067,1477,663,90,2230,44297
22-09-2016,17,16311,16950,6746,2227,42234,1457,742,79,2278,44512
22-09-2016,18,16111,17091,7042,2157,42401,1469,773,270,2512,44913
22-09-2016,19,16306,17114,7117,2189,42727,1449,877,459,2785,45512
22-09-2016,20,16178,16584,6685,2199,41646,1466,788,273,2527,44173
22-09-2016,21,16036,15478,6399,2200,40113,1495,361,91,1947,42060
22-09-2016,22,15723,14442,6082,1833,38079,1481,217,85,1783,39862
22-09-2016,23,14896,13166,6037,1586,35684,1362,200,64,1626,37310
23-09-2016,0,14233,11558,5969,1473,33234,1368,198,51,1617,34851
23-09-2016,1,13861,11365,5857,1676,32758,1201,195,39,1435,34193
23-09-2016,2,13739,11381,5809,1647,32575,1204,195,42,1441,34016
23-09-2016,3,13658,11400,5863,1552,32473,1227,197,41,1465,33938
23-09-2016,4,13477,11582,5948,1731,32739,1282,198,44,1524,34263
23-09-2016,5,14042,12981,6295,1983,35302,1478,205,48,1731,37033
23-09-2016,6,15049,15999,6933,2471,40453,1504,251,57,1812,42265
23-09-2016,7,16255,17238,7137,2583,43212,1502,433,247,2182,45394
23-09-2016,8,16526,17586,7263,2574,43950,1514,828,240,2582,46532
23-09-2016,9,16633,17719,7316,2732,44401,1521,723,214,2458,46859
23-09-2016,10,16509,17626,7268,2808,44211,1532,750,213,2495,46706
23-09-2016,11,15994,17264,7203,3007,43470,1525,704,229,2458,45928
23-09-2016,12,15852,16913,7098,3002,42866,1523,702,247,2472,45338
23-09-2016,13,15696,16444,7071,2951,42164,1481,596,255,2332,44496
23-09-2016,14,15447,15965,6637,2863,40913,1424,539,266,2229,43142
23-09-2016,15,15363,15783,6714,2968,40829,1435,569,106,2110,42939
23-09-2016,16,15223,15695,6991,2843,40753,1472,373,134,1979,42732
23-09-2016,17,15576,16073,7064,2594,41309,1466,397,132,1995,43304
23-09-2016,18,16174,16258,7310,2332,42074,1485,499,130,2114,44188
23-09-2016,19,16221,16636,7451,2180,42488,1504,793,311,2608,45096
23-09-2016,20,15744,16162,6820,2397,41124,1494,688,287,2469,43593
23-09-2016,21,15105,14956,6315,2494,38870,1475,295,83,1853,40723
23-09-2016,22,15250,14175,5825,2102,37351,1380,260,81,1721,39072
23-09-2016,23,14672,13418,5596,2027,35711,1080,252,107,1439,37150
24-09-2016,0,14266,12174,5740,1865,34045,971,243,130,1344,35389
24-09-2016,1,13683,11867,5781,1743,33074,910,246,122,1278,34352
24-09-2016,2,13203,11758,5661,1657,32280,886,245,113,1244,33524
24-09-2016,3,13550,11680,5646,1598,32475,859,246,62,1167,33642
24-09-2016,4,13581,11689,5671,1547,32489,869,250,53,1172,33661
24-09-2016,5,13627,12248,5672,1735,33283,902,252,60,1214,34497
24-09-2016,6,13988,13090,5671,1732,34481,959,256,65,1280,35761
24-09-2016,7,14510,13629,5868,1999,36006,1127,255,115,1497,37503
24-09-2016,8,15436,14611,6037,2145,38229,1076,252,118,1446,39675
24-09-2016,9,16037,15134,6046,2331,39550,1099,238,81,1418,40968
24-09-2016,10,15647,14796,5920,2125,38486,1103,204,80,1387,39873
24-09-2016,11,15282,14173,5970,2036,37462,1109,202,80,1391,38853
24-09-2016,12,14509,13854,5934,2222,36518,1069,201,79,1349,37867
24-09-2016,13,14346,13393,5925,2313,35978,1114,202,93,1409,37387
24-09-2016,14,14312,13466,5915,2153,35846,1169,203,117,1489,37335
24-09-2016,15,14971,13695,5943,2105,36715,1130,204,124,1458,38173
24-09-2016,16,15169,13953,5905,2036,37063,1113,204,106,1423,38486
24-09-2016,17,16152,14923,5919,2361,39354,1114,206,84,1404,40758
24-09-2016,18,15945,15542,6120,2370,39976,1111,394,83,1588,41564
24-09-2016,19,15996,15849,6308,2220,40374,1106,678,174,1958,42332
24-09-2016,20,15539,15026,6099,2106,38772,1108,546,70,1724,40496
24-09-2016,21,15090,14409,5822,1873,37194,1106,206,59,1371,38565
24-09-2016,22,14610,13788,5723,1801,35922,1000,203,48,1251,37173
24-09-2016,23,13826,13071,5679,1781,34358,811,200,37,1048,35406
25-09-2016,0,12464,11881,5578,1646,31568,789,198,37,1024,32592
25-09-2016,1,10725,11614,5503,1639,29483,796,196,35,1027,30510
25-09-2016,2,9470,11486,5385,1605,27945,797,199,33,1029,28974
25-09-2016,3,8820,11388,5352,1785,27346,801,202,33,1036,28382
25-09-2016,4,8851,11379,5439,1813,27482,802,203,34,1039,28521
25-09-2016,5,9111,11389,5451,1813,27765,789,204,14,1007,28772
25-09-2016,6,9337,11561,5491,1868,28256,794,206,33,1033,29289
25-09-2016,7,10117,11963,5536,1825,29443,811,210,34,1055,30498
25-09-2016,8,11164,12841,5648,1859,31512,797,208,33,1038,32550
25-09-2016,9,12323,13334,5661,1935,33255,820,205,33,1058,34313
25-09-2016,10,12122,13615,5727,2043,33508,867,206,35,1108,34616
25-09-2016,11,12373,13709,5784,2251,34118,874,206,125,1205,35323
25-09-2016,12,12081,13599,5793,2548,34023,847,206,35,1088,35111
25-09-2016,13,11957,13642,5764,2959,34323,796,206,35,1037,35360
25-09-2016,14,11187,13611,5777,3076,33652,793,209,38,1040,34692
25-09-2016,15,10995,13558,5728,3077,33359,784,209,36,1029,34388
25-09-2016,16,11675,13722,5815,3129,34342,809,209,35,1053,35395
25-09-2016,17,12581,14418,5880,2989,35869,869,210,33,1112,36981
25-09-2016,18,13874,15133,6036,2840,37884,928,210,45,1183,39067
25-09-2016,19,14668,15341,6162,2539,38710,946,209,293,1448,40158
25-09-2016,20,14304,15157,6072,2507,38042,933,208,194,1335,39377
25-09-2016,21,14692,14274,5843,2460,37268,894,206,74,1174,38442
25-09-2016,22,14251,13719,5575,2468,36013,878,203,100,1181,37194
25-09-2016,23,13216,13226,5430,2367,34239,911,201,117,1229,35468
26-09-2016,0,12040,12090,5465,2137,31734,933,199,113,1245,32979
26-09-2016,1,11638,11750,5418,2044,30849,986,223,103,1312,32161
26-09-2016,2,11664,11736,5394,1777,30571,1005,238,113,1356,31927
26-09-2016,3,11490,11792,5456,1639,30378,1062,256,101,1419,31797
26-09-2016,4,11688,11927,5607,1574,30797,1102,320,95,1517,32314
26-09-2016,5,13423,13331,6020,1550,34324,1326,402,83,1811,36135
26-09-2016,6,15058,15722,6555,2097,39433,1575,385,241,2201,41634
26-09-2016,7,16353,17062,6748,2501,42662,1740,418,362,2520,45182
26-09-2016,8,16868,17506,6745,2460,43580,1750,757,423,2930,46510
26-09-2016,9,16622,17863,6799,2611,43895,1741,762,395,2898,46793
26-09-2016,10,16615,17913,6726,2477,43732,1751,754,384,2889,46621
26-09-2016,11,16646,17782,6721,2472,43621,1721,752,368,2841,46462
26-09-2016,12,16865,17606,6715,2406,43594,1743,734,406,2883,46477
26-09-2016,13,16793,17703,6718,2256,43471,1746,778,287,2811,46282
26-09-2016,14,16520,17585,6504,2219,42830,1724,418,149,2291,45121
26-09-2016,15,16322,17404,6419,2395,42539,1743,416,81,2240,44779
26-09-2016,16,16322,17292,6539,2365,42518,1701,416,114,2231,44749
26-09-2016,17,16360,17324,6591,2365,42639,1731,433,196,2360,44999
26-09-2016,18,16282,17322,6697,2461,42763,1736,647,392,2775,45538
26-09-2016,19,16566,17719,6837,2447,43570,1738,1028,436,3202,46772
26-09-2016,20,16288,17170,6610,2362,42430,1709,364,244,2317,44747
26-09-2016,21,16043,15882,6206,2161,40292,1747,265,36,2048,42340
26-09-2016,22,15323,14688,5939,1768,37719,1747,246,35,2028,39747
26-09-2016,23,14509,13244,5797,1226,34777,1733,237,33,2003,36780
27-09-2016,0,14297,12015,5801,1683,33796,1424,207,33,1664,35460
27-09-2016,1,14071,11657,5800,1595,33123,1313,193,33,1539,34662
27-09-2016,2,13900,11512,5924,1331,32668,1296,197,32,1525,34193
27-09-2016,3,13896,11458,5881,1169,32404,1313,218,32,1563,33967
27-09-2016,4,14052,11955,5957,1094,33057,1561,215,31,1807,34864
27-09-2016,5,14502,13799,6241,1406,35948,1653,272,44,1969,37917
27-09-2016,6,15838,16314,6635,1821,40609,1699,405,192,2296,42905
27-09-2016,7,16713,17717,7015,2259,43703,1757,407,478,2642,46345
27-09-2016,8,16784,17943,7198,2435,44360,1742,937,625,3304,47664
27-09-2016,9,16709,17738,7213,2665,44325,1762,872,624,3258,47583
27-09-2016,10,16775,17471,7128,2698,44072,1749,795,590,3134,47206
27-09-2016,11,16747,17174,7012,2596,43528,1743,731,592,3066,46594
27-09-2016,12,16358,16839,7005,2599,42802,1772,669,614,3055,45857
27-09-2016,13,15886,16614,6942,2633,42074,1769,674,582,3025,45099
27-09-2016,14,15684,16290,6489,2818,41282,1739,432,417,2588,43870
27-09-2016,15,15531,16235,6499,2884,41095,1736,433,417,2586,43681
27-09-2016,16,15583,16588,6742,3061,41974,1725,430,559,2714,44688
27-09-2016,17,15708,16869,6819,3187,42582,1714,422,571,2707,45289
27-09-2016,18,15580,17368,6992,3199,43140,1723,418,618,2759,45899
27-09-2016,19,15386,17681,7127,3327,43521,1738,506,631,2875,46396
27-09-2016,20,14471,17197,6636,3519,41822,1729,349,313,2391,44213
27-09-2016,21,13345,16261,6139,3610,39355,1532,284,310,2126,41481
27-09-2016,22,12303,15484,6030,3804,37622,1262,268,367,1897,39519
27-09-2016,23,10784,14800,6015,3824,35423,1226,255,375,1856,37279
28-09-2016,0,9878,14404,5919,3751,33952,1076,237,177,1490,35442
28-09-2016,1,9499,14457,5758,3658,33373,1090,241,241,1572,34945
28-09-2016,2,9029,14588,5759,3553,32930,1103,240,256,1599,34529
28-09-2016,3,8682,14630,5719,3764,32795,1123,247,268,1638,34433
28-09-2016,4,8516,14662,5785,3941,32903,1160,262,292,1714,34617
28-09-2016,5,10155,15458,6169,4022,35804,1489,291,290,2070,37874
28-09-2016,6,12198,16915,6726,3962,39801,1754,453,282,2489,42290
28-09-2016,7,13888,17803,7267,4338,43297,1836,508,261,2605,45902
28-09-2016,8,14680,17946,7414,4192,44232,1938,505,244,2687,46919
28-09-2016,9,14283,18041,7546,4151,44021,1852,494,374,2720,46741
28-09-2016,10,14231,17840,7427,4354,43851,1872,493,285,2650,46501
28-09-2016,11,14020,17751,7338,4738,43847,1906,504,227,2637,46484
28-09-2016,12,13552,17230,7266,4676,42724,1903,513,256,2672,45396
28-09-2016,13,12872,16995,7017,4662,41546,1897,485,281,2663,44209
28-09-2016,14,12957,16790,6708,4561,41016,1896,302,306,2504,43520
28-09-2016,15,13028,16838,6840,4629,41335,1805,287,336,2428,43763
28-09-2016,16,13358,16919,7053,4571,41901,1883,287,380,2550,44451
28-09-2016,17,14441,17334,7139,4443,43357,1894,288,353,2535,45892
28-09-2016,18,14855,17538,7296,4026,43714,1878,291,552,2721,46435
28-09-2016,19,15498,17498,7311,3877,44185,1867,337,675,2879,47064
28-09-2016,20,15239,17335,6799,3574,42945,1771,302,327,2400,45345
28-09-2016,21,14929,16532,6373,3426,41259,1428,293,296,2017,43276
28-09-2016,22,13791,15440,6070,3255,38556,1361,280,304,1945,40501
28-09-2016,23,11551,14261,5856,2981,34649,1373,271,313,1957,36606
29-09-2016,0,10784,13790,5651,2801,33027,1186,273,280,1739,34766
29-09-2016,1,10275,13455,5411,2986,32127,1128,262,267,1657,33784
29-09-2016,2,10414,13045,5446,3354,32259,1115,255,241,1611,33870
29-09-2016,3,10265,12857,5297,3580,31998,1100,253,222,1575,33573
29-09-2016,4,10409,12779,5479,3841,32507,1143,265,225,1633,34140
29-09-2016,5,10952,13510,6254,4088,34804,1488,291,231,2010,36814
29-09-2016,6,13044,15406,6673,4197,39320,1760,438,214,2412,41732
29-09-2016,7,14647,17089,6987,4171,42894,1780,618,382,2780,45674
29-09-2016,8,14897,17468,6999,4178,43543,1783,671,554,3008,46551
29-09-2016,9,14665,17276,6932,4273,43145,1776,627,535,2938,46083
29-09-2016,10,14561,17089,6961,4422,43034,1777,599,543,2919,45953
29-09-2016,11,13764,17308,7002,4604,42679,1775,604,447,2826,45505
29-09-2016,12,13300,17207,6963,4567,42038,1808,566,395,2769,44807
29-09-2016,13,13278,17209,6916,4666,42070,1816,559,375,2750,44820
29-09-2016,14,12956,17271,6647,4629,41502,1853,523,280,2656,44158
29-09-2016,15,13173,17107,6723,4633,41635,1887,523,284,2694,44329
29-09-2016,16,13065,17127,6731,4642,41567,1877,471,316,2664,44231
29-09-2016,17,13626,17332,6893,4497,42347,1880,443,333,2656,45003
29-09-2016,18,14995,17680,7166,4367,44210,1873,509,545,2927,47137
29-09-2016,19,15062,17963,7395,4379,44799,1877,491,648,3016,47815
29-09-2016,20,14753,17608,6966,4218,43545,1707,331,380,2418,45963
29-09-2016,21,13732,16640,6551,4067,40990,1494,324,384,2202,43192
29-09-2016,22,12112,15462,6266,3939,37778,1445,314,360,2119,39897
29-09-2016,23,10514,14903,5998,3910,35325,1427,283,328,2038,37363
30-09-2016,0,9895,14617,6046,3903,34461,1233,281,329,1843,36304
30-09-2016,1,9941,14544,6047,3729,34207,1162,274,358,1794,36001
30-09-2016,2,9924,14479,6123,3682,34209,1160,274,362,1796,36005
30-09-2016,3,9746,14460,6194,3608,34010,1173,281,353,1807,35817
30-09-2016,4,10273,14662,6247,3443,34625,1285,303,322,1910,36535
30-09-2016,5,11790,15479,6404,3163,36836,1555,305,336,2196,39032
30-09-2016,6,13798,16908,6985,3326,41018,1847,367,368,2582,43600
30-09-2016,7,16056,17825,7522,3062,44465,1851,374,551,2776,47241
30-09-2016,8,16643,18365,7568,3170,45746,1829,425,600,2854,48600
30-09-2016,9,16430,18220,7559,3271,45480,1824,423,644,2891,48371
30-09-2016,10,16250,18011,7444,3281,44986,1851,414,664,2929,47915
30-09-2016,11,15930,17694,7429,3407,44462,1826,412,621,2859,47321
30-09-2016,12,15495,17338,7377,3631,43840,1801,415,608,2824,46664
30-09-2016,13,15100,17090,7299,3668,43157,1800,395,603,2798,45955
30-09-2016,14,14428,16637,7062,3763,41892,1646,344,403,2393,44285
30-09-2016,15,14295,16553,7078,3951,41877,1795,342,386,2523,44400
30-09-2016,16,14790,16679,7154,3873,42496,1793,397,421,2611,45107
30-09-2016,17,15227,16849,7255,3551,42882,1784,437,463,2684,45566
30-09-2016,18,15424,17105,7536,3291,43356,1790,422,477,2689,46045
30-09-2016,19,15858,17355,7610,3087,43910,1812,639,408,2859,46769
30-09-2016,20,15252,16904,7004,3012,42172,1692,359,235,2286,44458
30-09-2016,21,14563,15980,6592,2978,40114,1205,356,253,1814,41928
30-09-2016,22,14236,15231,6428,3021,38916,1142,297,293,1732,40648
30-09-2016,23,13299,14590,6275,2840,37006,1107,250,280,1637,38643
01-10-2016,0,12131,14247,6275,2533,35185,981,264,256,1501,36686
01-10-2016,1,11513,14168,6193,2388,34262,951,263,289,1503,35765
01-10-2016,2,11346,13955,6187,2141,33630,962,262,303,1527,35157
01-10-2016,3,11653,13912,6192,1967,33724,967,266,305,1538,35262
01-10-2016,4,12182,13801,6191,1716,33891,985,269,286,1540,35431
01-10-2016,5,13043,13725,6206,1515,34489,976,271,230,1477,35966
01-10-2016,6,13845,13987,6297,1560,35688,980,272,245,1497,37185
01-10-2016,7,14538,14599,6359,1633,37130,1097,275,225,1597,38727
01-10-2016,8,15301,15254,6576,1874,39006,1133,273,163,1569,40575
01-10-2016,9,15716,15726,6786,2113,40343,1131,256,334,1721,42064
01-10-2016,10,16024,16017,6940,2094,41076,1119,352,329,1800,42876
01-10-2016,11,15849,15772,6924,1993,40537,1109,410,243,1762,42299
01-10-2016,12,15730,15464,6853,1792,39840,1116,388,238,1742,41582
01-10-2016,13,15621,15187,6657,1642,39107,1095,237,136,1468,40575
01-10-2016,14,15670,15032,6722,1625,39048,1076,224,106,1406,40454
01-10-2016,15,15681,14840,6836,1597,38953,1044,225,64,1333,40286
01-10-2016,16,15804,14908,7068,1738,39518,1007,214,44,1265,40783
01-10-2016,17,15982,15384,7285,2135,40785,959,208,45,1212,41997
01-10-2016,18,16156,15941,7443,2270,41812,951,214,317,1482,43294
01-10-2016,19,16230,16555,7493,2259,42537,968,586,319,1873,44410
01-10-2016,20,15914,16244,7223,2104,41485,1012,208,52,1272,42757
01-10-2016,21,15739,15206,6980,1860,39786,1007,203,57,1267,41053
01-10-2016,22,15602,14494,6726,1515,38337,998,201,64,1263,39600
01-10-2016,23,15174,14008,6362,1753,37297,941,197,88,1226,38523
02-10-2016,0,13927,12621,6299,1627,34474,945,147,97,1189,35663
02-10-2016,1,13500,12126,6258,1593,33479,862,141,201,1204,34683
02-10-2016,2,13467,11962,6205,1438,33073,832,142,222,1196,34269
02-10-2016,3,13313,11956,6137,1252,32658,844,146,220,1210,33868
02-10-2016,4,12777,12014,6123,1257,32172,871,150,232,1253,33425
02-10-2016,5,12979,12067,6020,1348,32415,876,154,233,1263,33678
02-10-2016,6,13118,12574,6103,1476,33271,920,155,188,1263,34534
02-10-2016,7,13473,12962,6139,1668,34242,996,155,157,1308,35550
02-10-2016,8,14512,14100,6183,1732,36526,1164,152,112,1428,37954
02-10-2016,9,14964,14732,6235,2010,37941,1352,153,111,1616,39557
02-10-2016,10,15122,15005,6318,2108,38552,1369,154,109,1632,40184
02-10-2016,11,15222,15009,6284,2211,38726,1374,159,99,1632,40358
02-10-2016,12,14959,14832,6210,2070,38070,1391,159,96,1646,39716
02-10-2016,13,14505,14493,6224,2077,37301,1375,169,74,1618,38919
02-10-2016,14,14150,14297,6241,1973,36660,1380,165,61,1606,38266
02-10-2016,15,13815,14215,6279,1884,36193,1382,167,53,1602,37795
02-10-2016,16,14329,14629,6273,1847,37077,1365,170,74,1609,38686
02-10-2016,17,15046,15568,6523,2251,39388,1374,197,44,1615,41003
02-10-2016,18,15118,16600,6870,2438,41026,1376,377,136,1889,42915
02-10-2016,19,15308,17011,6988,2550,41856,1372,648,399,2419,44275
02-10-2016,20,15000,16637,6739,2665,41041,1389,364,269,2022,43063
02-10-2016,21,14954,15676,6457,2534,39621,1370,226,59,1655,41276
02-10-2016,22,14999,15335,6252,2298,38885,1376,153,42,1571,40456
02-10-2016,23,13836,14148,6034,2247,36264,1303,149,38,1490,37754
03-10-2016,0,13797,13399,5893,2154,35244,1060,149,41,1250,36494
03-10-2016,1,13186,13088,5771,2141,34186,1006,147,44,1197,35383
03-10-2016,2,12481,12946,5872,2166,33465,1027,151,51,1229,34694
03-10-2016,3,12324,12907,5944,2238,33414,1048,178,47,1273,34687
03-10-2016,4,12268,13037,6326,2277,33909,1336,206,47,1589,35498
03-10-2016,5,13362,14093,6881,2545,36881,1617,211,48,1876,38757
03-10-2016,6,15818,16610,7551,2826,42805,1608,477,253,2338,45143
03-10-2016,7,16974,18445,7643,3254,46315,1653,664,423,2740,49055
03-10-2016,8,17575,18939,7667,3283,47464,1623,767,458,2848,50312
03-10-2016,9,17744,19045,7609,3598,47996,1596,933,495,3024,51020
03-10-2016,10,17558,18729,7454,3668,47409,1598,870,537,3005,50414
03-10-2016,11,17110,18398,7378,3625,46511,1622,1043,544,3209,49720
03-10-2016,12,15803,17521,7258,3531,44114,1616,1110,541,3267,47381
03-10-2016,13,15527,17090,7233,3550,43399,1626,1145,523,3294,46693
03-10-2016,14,15210,16980,7298,3553,43042,1634,780,351,2765,45807
03-10-2016,15,16123,16906,7324,3790,44143,1630,579,343,2552,46695
03-10-2016,16,16229,16823,7362,3721,44134,1614,571,362,2547,46681
03-10-2016,17,16705,17095,7265,3438,44503,1606,672,365,2643,47146
03-10-2016,18,16808,17878,7461,3336,45482,1612,894,586,3092,48574
03-10-2016,19,16994,18281,7807,3505,46587,1657,808,614,3079,49666
03-10-2016,20,16282,17705,7513,3421,44921,1781,399,441,2621,47542
03-10-2016,21,15439,15981,7093,3072,41587,1833,347,637,2817,44404
03-10-2016,22,14111,14702,6867,2992,38672,1716,355,512,2583,41255
03-10-2016,23,12539,13990,6843,2607,35980,1325,337,255,1917,37897
04-10-2016,0,12729,13325,6739,2643,35436,1155,333,256,1744,37180
04-10-2016,1,12217,12956,6774,2496,34444,1117,333,261,1711,36155
04-10-2016,2,10744,12929,6788,2333,32795,1140,337,260,1737,34532
04-10-2016,3,10274,12805,6706,2263,32048,1146,341,257,1744,33792
04-10-2016,4,10678,12876,6745,2161,32461,1238,343,240,1821,34282
04-10-2016,5,12701,13717,7144,2297,35859,1530,349,236,2115,37974
04-10-2016,6,15558,16647,7667,2512,42385,1862,376,213,2451,44836
04-10-2016,7,17049,19177,7936,3047,47210,1897,458,396,2751,49961
04-10-2016,8,17365,19749,7850,3072,48036,1903,746,381,3030,51066
04-10-2016,9,17591,19536,7685,3435,48247,1931,766,393,3090,51337
04-10-2016,10,17314,18451,7627,3405,46799,1932,765,459,3156,49955
04-10-2016,11,16519,17833,7585,3556,45492,1929,636,458,3023,48515
04-10-2016,12,16741,17521,7556,3890,45708,1935,513,476,2924,48632
04-10-2016,13,16916,17759,7480,3467,45623,1935,393,503,2831,48454
04-10-2016,14,16678,17545,7453,3285,44960,1939,387,424,2750,47710
04-10-2016,15,16386,17459,7380,3336,44560,1916,383,321,2620,47180
04-10-2016,16,15886,16819,7317,3163,43185,1880,387,312,2579,45764
04-10-2016,17,16752,17350,7411,3629,45142,1871,430,361,2662,47804
04-10-2016,18,17168,18025,7634,3539,46366,1872,701,582,3155,49521
04-10-2016,19,17333,18400,7664,3535,46932,1897,766,579,3242,50174
04-10-2016,20,16554,17488,7244,3248,44535,1889,388,305,2582,47117
04-10-2016,21,15358,16187,6777,2845,41168,1915,367,294,2576,43744
04-10-2016,22,13964,15227,6439,2730,38360,1908,364,292,2564,40924
04-10-2016,23,12076,13975,6297,2706,35055,1472,359,281,2112,37167
05-10-2016,0,10888,13613,6301,2764,33565,1350,360,293,2003,35568
05-10-2016,1,9841,13562,6308,2634,32345,1352,359,306,2017,34362
05-10-2016,2,9247,13613,6233,2451,31544,1359,361,309,2029,33573
05-10-2016,3,9217,13680,6345,2411,31653,1364,360,314,2038,33691
05-10-2016,4,10115,14169,6532,2504,33321,1388,365,312,2065,35386
05-10-2016,5,12769,15175,6932,2664,37540,1622,370,327,2319,39859
05-10-2016,6,15507,17629,7500,3301,43939,1951,391,342,2684,46623
05-10-2016,7,17366,19857,7633,3743,48600,2086,418,539,3043,51643
05-10-2016,8,17696,20225,7531,3873,49324,2072,567,650,3289,52613
05-10-2016,9,17266,19173,7542,3745,47727,2079,393,585,3057,50784
05-10-2016,10,16582,18728,7374,4170,46854,1986,435,548,2969,49823
05-10-2016,11,15824,18546,7268,4446,46085,1910,410,543,2863,48948
05-10-2016,12,15349,17746,7172,4405,44672,1931,409,531,2871,47543
05-10-2016,13,16286,17810,7107,4229,45431,1869,393,404,2666,48097
05-10-2016,14,16360,17842,7105,4018,45326,1849,432,355,2636,47962
05-10-2016,15,16113,17633,7008,3818,44573,1855,414,404,2673,47246
05-10-2016,16,16235,17517,7020,3673,44446,1840,459,355,2654,47100
05-10-2016,17,16777,18193,7166,3575,45711,1825,461,407,2693,48404
05-10-2016,18,16851,18901,7469,3431,46653,1844,693,549,3086,49739
05-10-2016,19,16951,19531,7525,3640,47647,1834,699,548,3081,50728
05-10-2016,20,16566,18601,7240,3561,45969,1827,231,362,2420,48389
05-10-2016,21,15679,17081,6862,3585,43208,1833,200,358,2391,45599
05-10-2016,22,13817,16166,6616,3590,40189,1647,194,357,2198,42387
05-10-2016,23,11963,15134,6536,3553,37186,1336,192,356,1884,39070
06-10-2016,0,10761,14358,6305,3564,34988,1298,189,353,1840,36828
06-10-2016,1,9965,14189,6224,3456,33837,1282,186,347,1815,35652
06-10-2016,2,9532,14150,6134,3383,33200,1297,188,341,1826,35026
06-10-2016,3,9725,14131,6163,3433,33453,1296,213,337,1846,35299
06-10-2016,4,10580,14319,6254,3473,34627,1373,223,336,1932,36559
06-10-2016,5,12109,15578,6754,3603,38044,1816,278,330,2424,40468
06-10-2016,6,14450,17996,7295,3752,43492,1831,399,545,2775,46267
06-10-2016,7,15812,19752,7282,3969,46816,1797,553,694,3044,49860
06-10-2016,8,16672,20151,7366,4080,48269,1812,741,690,3243,51512
06-10-2016,9,17042,20103,7404,4339,48887,1831,715,689,3235,52122
06-10-2016,10,16844,20125,7344,4427,48738,1836,794,531,3161,51899
06-10-2016,11,16333,19846,7257,4601,48038,1813,652,515,2980,51018
06-10-2016,12,16060,19450,7252,4664,47426,1775,574,515,2864,50290
06-10-2016,13,16023,19287,7177,4642,47129,1790,556,525,2871,50000
06-10-2016,14,15809,19043,7191,4406,46450,1789,454,503,2746,49196
06-10-2016,15,15735,18942,7208,4259,46144,1789,458,327,2574,48718
06-10-2016,16,15767,18597,7270,4008,45642,1767,453,318,2538,48180
06-10-2016,17,16306,19015,7461,3841,46624,1724,467,298,2489,49113
06-10-2016,18,16376,19534,7796,3586,47293,1760,822,619,3201,50494
06-10-2016,19,16792,19596,7987,3644,48019,1796,812,576,3184,51203
06-10-2016,20,16137,18812,7923,3470,46343,1818,439,210,2467,48810
06-10-2016,21,15387,17447,7609,3382,43826,1787,356,136,2279,46105
06-10-2016,22,14342,16485,7313,3529,41670,1767,306,110,2183,43853
06-10-2016,23,13128,15618,7084,3451,39281,1758,297,98,2153,41434
07-10-2016,0,12448,14305,6735,3303,36791,1640,289,98,2027,38818
07-10-2016,1,12657,13960,6748,3228,36594,1387,284,92,1763,38357
07-10-2016,2,12716,13784,6657,3107,36264,1394,294,99,1787,38051
07-10-2016,3,12216,13950,6716,3074,35956,1407,302,86,1795,37751
07-10-2016,4,12819,14487,6882,3149,37339,1662,315,83,2060,39399
07-10-2016,5,13690,15646,7335,3331,40003,1798,361,88,2247,42250
07-10-2016,6,15112,18313,7844,3564,44833,1794,402,309,2505,47338
07-10-2016,7,17035,19699,8066,3885,48685,1782,421,503,2706,51391
07-10-2016,8,17740,20109,8056,3961,49865,1817,867,516,3200,53065
07-10-2016,9,17303,20424,7956,3981,49663,1814,852,493,3159,52822
07-10-2016,10,17234,20585,7738,3931,49490,1855,902,506,3263,52753
07-10-2016,11,17032,19499,7573,3801,47905,1863,988,332,3183,51088
07-10-2016,12,16346,19140,7651,3852,46989,1875,893,347,3115,50104
07-10-2016,13,15780,18915,7617,3891,46204,1865,855,357,3077,49281
07-10-2016,14,15458,18269,7431,3768,44926,1862,808,351,3021,47947
07-10-2016,15,15155,17901,7405,3528,43989,1892,766,223,2881,46870
07-10-2016,16,15599,17904,7472,3236,44212,1810,614,152,2576,46788
07-10-2016,17,16577,18719,7666,3045,46007,1869,541,263,2673,48680
07-10-2016,18,16898,19359,7930,2955,47142,1867,759,512,3138,50280
07-10-2016,19,16993,19173,7904,3131,47202,1863,649,553,3065,50267
07-10-2016,20,16341,18045,7540,3057,44984,1851,445,326,2622,47606
07-10-2016,21,15943,16461,7137,3043,42584,1839,299,174,2312,44896
07-10-2016,22,15231,15810,6665,3012,40719,1843,212,181,2236,42955
07-10-2016,23,14611,14937,6375,2881,38803,1672,216,176,2064,40867
08-10-2016,0,13467,13917,6347,2945,36676,1432,184,180,1796,38472
08-10-2016,1,12951,13575,6304,2856,35687,1328,176,177,1681,37368
08-10-2016,2,12573,13468,6246,2991,35279,1275,176,168,1619,36898
08-10-2016,3,12454,13389,6272,3020,35135,1269,171,147,1587,36722
08-10-2016,4,12743,13367,6265,3072,35447,1244,174,152,1570,37017
08-10-2016,5,13198,13485,6283,3092,36058,1294,173,147,1614,37672
08-10-2016,6,13673,14198,6465,2927,37263,1378,178,148,1704,38967
08-10-2016,7,13991,15066,6615,3181,38854,1388,197,160,1745,40599
08-10-2016,8,14792,16105,6906,3436,41239,1414,432,234,2080,43319
08-10-2016,9,15472,16858,7125,3528,42984,1418,403,323,2144,45128
08-10-2016,10,15347,17336,7055,3793,43531,1440,481,231,2152,45683
08-10-2016,11,15156,17282,7056,3849,43344,1446,464,230,2140,45484
08-10-2016,12,14644,16849,6914,3699,42107,1467,470,245,2182,44289
08-10-2016,13,14307,16555,6923,3554,41339,1464,508,122,2094,43433
08-10-2016,14,14304,16581,6904,3371,41161,1453,469,120,2042,43203
08-10-2016,15,14527,16666,6898,3308,41398,1457,384,95,1936,43334
08-10-2016,16,14852,17307,6874,3271,42305,1448,354,100,1902,44207
08-10-2016,17,15826,18080,7113,3294,44312,1447,372,108,1927,46239
08-10-2016,18,16708,18562,7310,3300,45880,1413,564,278,2255,48135
08-10-2016,19,16576,18464,7286,3242,45569,1388,450,341,2179,47748
08-10-2016,20,15835,17768,7165,2933,43714,1397,465,164,2026,45740
08-10-2016,21,15727,16919,6971,2826,42443,1381,318,84,1783,44226
08-10-2016,22,15323,15631,6960,2730,40644,1367,171,106,1644,42288
08-10-2016,23,15024,13881,6767,2649,38321,1347,169,125,1641,39962
09-10-2016,0,14440,13326,6582,2697,37043,1315,171,163,1649,38692
09-10-2016,1,13684,12339,6425,2668,35116,1271,170,194,1635,36751
09-10-2016,2,12945,12558,6324,2698,34525,1280,171,235,1686,36211
09-10-2016,3,12471,12739,6361,2777,34347,1302,174,258,1734,36081
09-10-2016,4,12343,12763,6355,2821,34285,1305,177,243,1725,36010
09-10-2016,5,12554,12620,6307,2854,34335,1307,180,235,1722,36057
09-10-2016,6,13302,12993,6360,2887,35542,1263,179,230,1672,37214
09-10-2016,7,13850,13316,6554,2859,36578,1364,176,233,1773,38351
09-10-2016,8,14579,14474,6840,3026,38920,1395,180,228,1803,40723
09-10-2016,9,15474,15365,6882,3226,40947,1497,320,210,2027,42974
09-10-2016,10,15941,15644,6860,3316,41759,1523,326,188,2037,43796
09-10-2016,11,16071,16119,6864,3593,42646,1538,349,176,2063,44709
09-10-2016,12,15825,15940,6827,3698,42290,1534,340,134,2008,44298
09-10-2016,13,15492,15005,6629,3463,40589,1555,340,80,1975,42564
09-10-2016,14,14996,14780,6599,3279,39655,1577,323,66,1966,41621
09-10-2016,15,15180,15044,6691,3298,40214,1572,315,62,1949,42163
09-10-2016,16,15585,15472,6759,3244,41060,1575,363,76,2014,43074
09-10-2016,17,16836,16853,7122,3186,43998,1572,369,83,2024,46022
09-10-2016,18,17643,18354,7436,3162,46594,1578,700,161,2439,49033
09-10-2016,19,17648,18627,7564,3241,47081,1573,604,242,2419,49500
09-10-2016,20,16985,17373,7492,3338,45188,1582,551,153,2286,47474
09-10-2016,21,16586,16536,7338,3358,43818,1575,321,88,1984,45802
09-10-2016,22,15948,15526,7192,3170,41835,1556,179,85,1820,43655
09-10-2016,23,15425,13974,7012,2632,39044,1512,172,84,1768,40812
10-10-2016,0,14969,12880,6800,2506,37156,1595,227,88,1910,39066
10-10-2016,1,14669,12531,6817,2420,36437,1592,227,101,1920,38357
10-10-2016,2,14256,12420,6887,2385,35948,1593,226,107,1926,37874
10-10-2016,3,14338,12430,6938,2220,35926,1588,222,108,1918,37844
10-10-2016,4,14383,13066,7084,2151,36685,1633,239,121,1993,38678
10-10-2016,5,14389,14353,7550,2293,38587,1790,282,140,2212,40799
10-10-2016,6,17032,17302,8117,3048,45498,1850,772,153,2775,48273
10-10-2016,7,18473,18827,8541,3386,49228,1859,874,573,3306,52534
10-10-2016,8,19041,19314,8640,3692,50687,1861,935,620,3416,54103
10-10-2016,9,18976,19385,8543,3744,50648,1848,1194,605,3647,54295
10-10-2016,10,18748,19380,8498,3762,50387,1832,1070,373,3275,53662
10-10-2016,11,18738,19201,8456,3844,50238,1844,1083,373,3300,53538
10-10-2016,12,18583,18872,8492,4006,49953,1839,1093,377,3309,53262
10-10-2016,13,18534,18939,8465,3983,49921,1832,1039,355,3226,53147
10-10-2016,14,18322,18972,8428,4052,49773,1842,1069,538,3449,53222
10-10-2016,15,18172,19071,8376,4118,49738,1852,998,183,3033,52771
10-10-2016,16,17916,18793,8279,3971,48959,1824,949,185,2958,51917
10-10-2016,17,17879,18938,8507,3987,49312,1835,978,421,3234,52546
10-10-2016,18,18355,19150,8582,3917,50005,1818,1455,599,3872,53877
10-10-2016,19,18380,19037,8559,4073,50049,1822,1260,573,3655,53704
10-10-2016,20,18077,18369,8499,3786,48733,1819,759,154,2732,51465
10-10-2016,21,17395,16939,8048,3741,46124,1797,411,160,2368,48492
10-10-2016,22,16595,15193,7484,3653,42925,1768,391,177,2336,45261
10-10-2016,23,15578,13753,7090,3510,39931,1709,372,195,2276,42207
11-10-2016,0,14347,12529,6963,3396,37234,1690,308,206,2204,39438
11-10-2016,1,14379,12005,6944,3535,36864,1675,307,185,2167,39031
11-10-2016,2,13943,11893,6931,3618,36384,1674,312,179,2165,38549
11-10-2016,3,14072,11874,6904,3771,36621,1664,310,191,2165,38786
11-10-2016,4,14403,12330,7082,3751,37567,1666,330,185,2181,39748
11-10-2016,5,15420,13750,7430,3758,40359,1692,361,194,2247,42606
11-10-2016,6,17457,16012,8055,3969,45493,1714,423,200,2337,47830
11-10-2016,7,19069,17855,8390,4013,49325,1732,746,187,2665,51990
11-10-2016,8,19094,18600,8562,4241,50497,1712,855,365,2932,53429
11-10-2016,9,19133,18543,8524,4226,50426,1710,943,393,3046,53472
11-10-2016,10,18988,18475,8500,4466,50430,1723,834,428,2985,53415
11-10-2016,11,18612,18235,8482,4589,49919,1732,901,427,3060,52979
11-10-2016,12,18080,17861,8396,4433,48770,1732,901,264,2897,51667
11-10-2016,13,18285,17427,8374,4452,48538,1735,896,248,2879,51417
11-10-2016,14,18448,17102,8365,4158,48071,1738,708,259,2705,50776
11-10-2016,15,18384,17227,8377,3984,47971,1731,560,253,2544,50515
11-10-2016,16,18161,17403,8420,4087,48072,1717,558,251,2526,50598
11-10-2016,17,18313,17579,8520,4361,48774,1692,549,238,2479,51253
11-10-2016,18,18594,18182,8557,4420,49753,1693,822,299,2814,52567
11-10-2016,19,18303,18123,8586,4427,49440,1685,834,230,2749,52189
11-10-2016,20,17811,16876,8405,4094,47186,1706,615,220,2541,49727
11-10-2016,21,17472,15027,7978,3846,44323,1721,473,192,2386,46709
11-10-2016,22,16229,14083,7405,3836,41555,1704,473,165,2342,43897
11-10-2016,23,15046,13017,7131,3603,38797,1684,491,164,2339,41136
12-10-2016,0,13703,11385,6881,3440,35410,1454,619,176,2249,37659
12-10-2016,1,13272,11023,6655,3382,34333,1449,488,178,2115,36448
12-10-2016,2,12952,10963,6653,3361,33929,1443,447,173,2063,35992
12-10-2016,3,13063,11110,6709,3449,34331,1435,449,164,2048,36379
12-10-2016,4,13734,11623,6957,3417,35732,1521,608,187,2316,38048
12-10-2016,5,14957,12832,7439,3218,38446,1649,654,209,2512,40958
12-10-2016,6,17617,15967,8339,3388,45312,1655,690,190,2535,47847
12-10-2016,7,18894,17399,8602,3829,48726,1678,1054,195,2927,51653
12-10-2016,8,18899,18229,8569,3978,49675,1676,1116,589,3381,53056
12-10-2016,9,19020,18053,8486,4244,49803,1675,1061,514,3250,53053
12-10-2016,10,19191,17812,8374,4373,49751,1675,1008,554,3237,52988
12-10-2016,11,19131,17639,8521,4446,49736,1674,993,413,3080,52816
12-10-2016,12,18798,17720,8499,4280,49298,1685,915,231,2831,52129
12-10-2016,13,18577,17774,8466,4324,49141,1686,1004,178,2868,52009
12-10-2016,14,18390,17699,8516,4247,48853,1688,744,171,2603,51456
12-10-2016,15,18234,17527,8615,4032,48408,1688,739,205,2632,51040
12-10-2016,16,18272,17599,8553,3947,48372,1681,721,188,2590,50962
12-10-2016,17,18593,17952,8700,3851,49096,1684,867,217,2768,51864
12-10-2016,18,18753,18147,8852,3821,49574,1676,970,648,3294,52868
12-10-2016,19,18735,17993,8791,3847,49367,1692,1019,664,3375,52742
12-10-2016,20,18179,17145,8532,3941,47798,1702,566,229,2497,50295
12-10-2016,21,18072,15785,8343,3554,45754,1698,548,199,2445,48199
12-10-2016,22,17460,14450,7872,3442,43225,1694,518,163,2375,45600
12-10-2016,23,15931,13255,7304,3253,39744,1692,514,162,2368,42112
13-10-2016,0,14867,11933,7139,3098,37037,1476,604,147,2227,39264
13-10-2016,1,13769,11894,7019,3005,35688,1461,627,132,2220,37908
13-10-2016,2,13073,11727,6959,2947,34706,1458,630,124,2212,36918
13-10-2016,3,13188,11733,6981,2996,34898,1453,649,109,2211,37109
13-10-2016,4,13844,11962,7231,3019,36055,1471,673,106,2250,38305
13-10-2016,5,14974,13195,7850,3107,39127,1582,746,96,2424,41551
13-10-2016,6,17639,16206,8409,3448,45701,1610,800,105,2515,48216
13-10-2016,7,18785,18297,8819,3822,49722,1690,1094,358,3142,52864
13-10-2016,8,18742,18485,8825,3816,49867,1690,1563,527,3780,53647
13-10-2016,9,18985,18335,8660,3625,49607,1697,1518,503,3718,53325
13-10-2016,10,19263,18487,8781,3685,50218,1709,1532,496,3737,53955
13-10-2016,11,18910,18428,8766,3846,49949,1702,1528,353,3583,53532
13-10-2016,12,18770,18288,8566,3921,49544,1701,1449,273,3423,52967
13-10-2016,13,18711,18032,8394,4083,49221,1701,1494,476,3671,52892
13-10-2016,14,18770,17836,8422,4068,49096,1705,1395,67,3167,52263
13-10-2016,15,18961,17622,8385,4086,49054,1687,1063,63,2813,51867
13-10-2016,16,18984,17519,8470,4111,49085,1676,996,64,2736,51821
13-10-2016,17,19070,17895,8638,4436,50039,1678,1319,94,3091,53130
13-10-2016,18,19343,18239,8732,4584,50900,1664,1456,326,3446,54346
13-10-2016,19,19091,18281,8826,4647,50846,1648,1340,217,3205,54051
13-10-2016,20,17912,17252,8226,4581,47972,1675,952,232,2859,50831
13-10-2016,21,16746,16022,7834,4530,45132,1681,946,214,2841,47973
13-10-2016,22,15259,15029,7500,4256,42042,1667,945,178,2790,44832
13-10-2016,23,13763,13641,7172,4254,38830,1638,961,140,2739,41569
14-10-2016,0,12631,12655,7204,3892,36382,1372,661,116,2149,38531
14-10-2016,1,11953,12328,7170,3974,35424,1360,638,82,2080,37504
14-10-2016,2,11516,12238,7180,3785,34720,1359,629,71,2059,36779
14-10-2016,3,11811,12288,7154,3747,35001,1356,625,63,2044,37045
14-10-2016,4,12133,12557,7290,3764,35745,1348,627,59,2034,37779
14-10-2016,5,13884,13854,7712,3999,39449,1393,631,54,2078,41527
14-10-2016,6,16369,16996,8520,4349,46234,1483,639,116,2238,48472
14-10-2016,7,18261,18600,8710,4695,50268,1481,942,258,2681,52949
14-10-2016,8,18830,19010,8735,4891,51467,1473,1038,157,2668,54135
14-10-2016,9,18664,19095,8580,5080,51420,1480,1104,183,2767,54187
14-10-2016,10,18859,18834,8520,5166,51379,1484,988,97,2569,53948
14-10-2016,11,18585,18764,8474,5546,51368,1486,981,97,2564,53932
14-10-2016,12,17650,18274,8532,5688,50145,1537,971,88,2596,52741
14-10-2016,13,17320,17983,8534,5589,49427,1618,958,87,2663,52090
14-10-2016,14,16974,18297,8495,5697,49463,1662,903,69,2634,52097
14-10-2016,15,16947,17768,8267,5498,48481,1667,856,84,2607,51088
14-10-2016,16,17477,16858,8363,5227,47925,1661,898,95,2654,50579
14-10-2016,17,18142,17595,8369,5001,49107,1628,922,122,2672,51779
14-10-2016,18,18361,18383,8323,4992,50062,1639,972,145,2756,52818
14-10-2016,19,18609,18580,8262,4830,50280,1652,916,154,2722,53002
14-10-2016,20,17536,16844,7668,4621,46668,1678,695,173,2546,49214
14-10-2016,21,15995,14900,7206,4645,42747,1682,678,191,2551,45298
14-10-2016,22,14594,14470,6815,4869,40747,1681,659,194,2534,43281
14-10-2016,23,12891,13880,6648,4708,38127,1559,669,184,2412,40539
15-10-2016,0,11501,13180,6736,4514,35931,1060,681,194,1935,37866
15-10-2016,1,10665,13090,6670,4552,34978,951,680,210,1841,36819
15-10-2016,2,10127,13018,6679,4524,34349,890,682,230,1802,36151
15-10-2016,3,9829,13121,6718,4513,34180,876,686,215,1777,35957
15-10-2016,4,9770,13338,6605,4629,34342,847,687,208,1742,36084
15-10-2016,5,10703,13430,6491,4796,35421,951,694,223,1868,37289
15-10-2016,6,11934,13653,6546,5023,37157,1012,698,232,1942,39099
15-10-2016,7,13318,14072,6719,5316,39425,1010,699,237,1946,41371
15-10-2016,8,14608,14827,6849,5427,41712,997,706,237,1940,43652
15-10-2016,9,16109,15267,6973,5312,43663,1009,663,266,1938,45601
15-10-2016,10,16378,15517,7121,5469,44486,1023,639,280,1942,46428
15-10-2016,11,16355,15891,7044,5491,44781,970,604,312,1886,46667
15-10-2016,12,16210,15525,6978,5375,44088,911,571,371,1853,45941
15-10-2016,13,16206,15498,6858,5333,43895,912,553,381,1846,45741
15-10-2016,14,15847,15533,6668,5173,43220,925,565,322,1812,45032
15-10-2016,15,15956,15752,6578,5107,43394,933,550,309,1792,45186
15-10-2016,16,16357,16428,6830,4926,44540,935,562,297,1794,46334
15-10-2016,17,17058,17046,7036,4765,45904,947,604,283,1834,47738
15-10-2016,18,17873,17563,7266,4611,47314,948,645,413,2006,49320
15-10-2016,19,17639,17288,7102,4411,46440,940,671,406,2017,48457
15-10-2016,20,16991,16494,6825,4185,44495,935,682,320,1937,46432
15-10-2016,21,16584,15358,6789,3799,42531,955,679,311,1945,44476
15-10-2016,22,16190,14592,6860,3668,41310,979,678,314,1971,43281
15-10-2016,23,14967,14114,6803,3366,39251,1006,674,320,2000,41251
16-10-2016,0,14309,13762,6781,3157,38011,987,674,310,1971,39982
16-10-2016,1,13401,13639,6770,3048,36859,1009,668,299,1976,38835
16-10-2016,2,13151,13469,6795,3113,36530,996,664,311,1971,38501
16-10-2016,3,13003,13401,6826,3010,36239,991,666,311,1968,38207
16-10-2016,4,13144,13427,6821,2889,36279,1008,674,294,1976,38255
16-10-2016,5,13752,13535,6827,2844,36957,1008,685,289,1982,38939
16-10-2016,6,14464,13762,7030,2884,38140,1007,677,269,1953,40093
16-10-2016,7,15675,13922,7035,2869,39503,999,671,232,1902,41405
16-10-2016,8,16875,14126,7208,2973,41182,984,654,214,1852,43034
16-10-2016,9,17759,14612,7246,3260,42877,996,621,244,1861,44738
16-10-2016,10,18095,14785,7336,3241,43456,971,590,329,1890,45346
16-10-2016,11,18209,14884,7380,3295,43768,961,573,347,1881,45649
16-10-2016,12,18068,14587,7317,3209,43181,963,560,341,1864,45045
16-10-2016,13,17754,14244,7186,3431,42616,930,548,291,1769,44385
16-10-2016,14,16679,14130,7100,3306,41214,914,565,273,1752,42966
16-10-2016,15,16560,14189,7254,3330,41334,934,587,245,1766,43100
16-10-2016,16,17075,14468,7385,3415,42342,899,603,215,1717,44059
16-10-2016,17,18376,16147,7656,3442,45623,915,621,162,1698,47321
16-10-2016,18,18810,16744,7702,3562,46820,971,837,256,2064,48884
16-10-2016,19,18758,16647,7697,3530,46632,984,931,241,2156,48788
16-10-2016,20,18054,15750,7432,3406,44641,986,733,230,1949,46590
16-10-2016,21,17051,14624,7284,3307,42264,978,679,209,1866,44130
16-10-2016,22,15836,13693,7047,3355,39930,944,674,231,1849,41779
16-10-2016,23,13561,13228,6961,3143,36893,975,686,257,1918,38811
17-10-2016,0,13321,13000,6823,3294,36437,1090,694,286,2070,38507
17-10-2016,1,12441,13034,6749,3192,35416,1145,694,289,2128,37544
17-10-2016,2,11831,12830,6738,3157,34556,1153,694,281,2128,36684
17-10-2016,3,11164,12758,6736,3251,33908,1145,697,271,2113,36021
17-10-2016,4,11969,12904,6926,3211,35011,1213,704,272,2189,37200
17-10-2016,5,13795,14156,7558,3212,38722,1310,709,265,2284,41006
17-10-2016,6,17254,17208,8195,3332,45989,1325,717,251,2293,48282
17-10-2016,7,18668,19050,8525,3558,49801,1353,910,414,2677,52478
17-10-2016,8,19101,19267,8519,3814,50701,1403,1100,476,2979,53680
17-10-2016,9,19006,18810,8676,3953,50448,1412,1068,414,2894,53342
17-10-2016,10,18732,19006,8548,4250,50536,1403,1069,421,2893,53429
17-10-2016,11,18561,19378,8428,4122,50492,1417,1050,416,2883,53375
17-10-2016,12,18754,19049,8411,4039,50253,1411,1075,572,3058,53311
17-10-2016,13,18936,18626,8442,3981,49986,1389,1077,570,3036,53022
17-10-2016,14,19063,18380,8309,3984,49736,1404,1090,424,2918,52654
17-10-2016,15,19021,18398,8376,3735,49532,1391,983,438,2812,52344
17-10-2016,16,19170,18515,8428,3641,49753,1392,984,257,2633,52386
17-10-2016,17,19542,18911,8470,3717,50643,1406,1015,305,2726,53369
17-10-2016,18,19795,19437,8515,3676,51423,1426,1155,557,3138,54561
17-10-2016,19,19580,18816,8462,3661,50520,1431,1062,539,3032,53552
17-10-2016,20,18940,17472,8322,3415,48149,1441,889,305,2635,50784
17-10-2016,21,18491,16320,8029,3017,45859,1418,718,306,2442,48301
17-10-2016,22,17343,15645,7510,2988,43484,1399,695,303,2397,45881
17-10-2016,23,15848,14493,7168,2762,40272,1383,720,306,2409,42681
18-10-2016,0,14970,13415,7155,2548,38088,1292,750,306,2348,40436
18-10-2016,1,13684,13013,7130,2269,36095,1280,757,304,2341,38436
18-10-2016,2,13163,12825,7119,2116,35224,1274,743,300,2317,37541
18-10-2016,3,12995,12722,7048,2095,34860,1288,748,297,2333,37193
18-10-2016,4,13940,12802,7250,2147,36139,1285,757,303,2345,38484
18-10-2016,5,15110,14177,7583,2435,39305,1302,763,305,2370,41675
18-10-2016,6,17768,16675,8262,3070,45776,1277,812,309,2398,48174
18-10-2016,7,18754,18605,8551,3522,49433,1385,1165,447,2997,52430
18-10-2016,8,18571,19107,8686,3514,49878,1442,1176,623,3241,53119
18-10-2016,9,18533,19044,8693,3483,49752,1374,1170,684,3228,52980
18-10-2016,10,18517,18746,8650,3718,49633,1364,1170,653,3187,52820
18-10-2016,11,18524,18746,8577,3735,49582,1432,1119,650,3201,52783
18-10-2016,12,18716,18258,8401,3814,49190,1434,1189,623,3246,52436
18-10-2016,13,18496,18377,8379,3873,49125,1437,992,430,2859,51984
18-10-2016,14,18354,18333,8342,3925,48954,1438,792,237,2467,51421
18-10-2016,15,18614,18077,8320,3449,48461,1440,609,158,2207,50668
18-10-2016,16,18284,18022,8448,3372,48124,1441,687,291,2419,50543
18-10-2016,17,18161,18530,8629,3334,48655,1440,790,458,2688,51343
18-10-2016,18,18434,18784,8674,3540,49432,1478,989,642,3109,52541
18-10-2016,19,18035,18479,8622,3451,48587,1525,921,656,3102,51689
18-10-2016,20,17623,17130,8299,3461,46513,1533,665,187,2385,48898
18-10-2016,21,17067,15653,8055,3278,44051,1503,663,173,2339,46390
18-10-2016,22,16242,14430,7530,3027,41230,1483,653,151,2287,43517
18-10-2016,23,14359,13386,7041,2644,37430,1356,632,145,2133,39563
19-10-2016,0,13366,12526,7050,2576,35518,1049,598,136,1783,37301
19-10-2016,1,12086,12409,6972,2441,33908,960,604,129,1693,35601
19-10-2016,2,12273,12376,6936,2311,33897,983,624,139,1746,35643
19-10-2016,3,12491,12334,7010,2167,34003,989,643,130,1762,35765
19-10-2016,4,12791,12454,7097,2140,34482,995,658,148,1801,36283
19-10-2016,5,13945,13536,7506,2496,37482,1230,669,154,2053,39535
19-10-2016,6,16106,16200,8255,3093,43654,1416,690,237,2343,45997
19-10-2016,7,17868,18608,8721,3428,48627,1439,999,347,2785,51412
19-10-2016,8,18133,18560,8842,3474,49008,1425,1000,507,2932,51940
19-10-2016,9,18132,18106,8880,3638,48757,1410,999,513,2922,51679
19-10-2016,10,18236,18444,8877,3662,49218,1405,1103,429,2937,52155
19-10-2016,11,18142,18473,8783,3586,48985,1395,1096,596,3087,52072
19-10-2016,12,17898,18106,8722,3570,48296,1387,1074,404,2865,51161
19-10-2016,13,17855,17675,8694,3686,47911,1401,990,409,2800,50711
19-10-2016,14,17834,17596,8522,3629,47579,1360,793,398,2551,50130
19-10-2016,15,17874,17808,8485,3597,47765,1370,798,192,2360,50125
19-10-2016,16,18254,17950,8463,3590,48257,1368,808,217,2393,50650
19-10-2016,17,18534,18237,8605,3608,48986,1410,1100,395,2905,51891
19-10-2016,18,18531,18446,8873,3724,49576,1417,1360,597,3374,52950
19-10-2016,19,18539,18480,8866,3671,49555,1449,1095,577,3121,52676
19-10-2016,20,17579,17092,8311,3686,46668,1453,821,233,2507,49175
19-10-2016,21,16664,15500,8150,3592,43905,1428,674,239,2341,46246
19-10-2016,22,15926,14569,7770,3626,41892,1417,670,232,2319,44211
19-10-2016,23,14492,13383,7054,3568,38499,1173,668,223,2064,40563
20-10-2016,0,12983,12833,6919,3103,35837,1002,689,205,1896,37733
20-10-2016,1,12399,12661,6846,3186,35093,979,698,205,1882,36975
20-10-2016,2,11630,12606,6839,3190,34264,995,699,201,1895,36159
20-10-2016,3,11825,12600,6866,3226,34518,997,699,204,1900,36418
20-10-2016,4,12481,12744,7045,3315,35585,998,695,215,1908,37493
20-10-2016,5,13352,13949,7603,3393,38299,1189,701,222,2112,40411
20-10-2016,6,16274,16034,8140,3779,44227,1386,748,219,2353,46580
20-10-2016,7,18274,18113,8781,4046,49214,1397,1255,434,3086,52300
20-10-2016,8,19104,18792,9029,4144,51070,1389,1247,440,3076,54146
20-10-2016,9,19293,18916,9007,4106,51322,1380,1321,610,3311,54633
20-10-2016,10,19093,19211,9028,3961,51293,1365,1281,409,3055,54348
20-10-2016,11,19289,19309,9045,3871,51514,1367,1248,603,3218,54732
20-10-2016,12,19070,19060,8827,3752,50709,1373,1249,424,3046,53755
20-10-2016,13,19177,18416,8844,3747,50183,1374,1272,340,2986,53169
20-10-2016,14,19171,18190,8891,3661,49913,1382,1267,199,2848,52761
20-10-2016,15,18762,18567,8684,3478,49491,1382,1268,203,2853,52344
20-10-2016,16,18761,18385,8686,3540,49371,1369,1356,220,2945,52316
20-10-2016,17,19134,18927,8618,3767,50446,1366,1448,449,3263,53709
20-10-2016,18,19307,19197,8778,3943,51225,1378,1874,699,3951,55176
20-10-2016,19,19283,19079,8670,4014,51046,1393,1436,516,3345,54391
20-10-2016,20,18594,18008,8245,3796,48643,1424,867,294,2585,51228
20-10-2016,21,18184,16440,7943,3614,46179,1431,673,311,2415,48594
20-10-2016,22,17152,15216,7443,3400,43210,1384,640,306,2330,45540
20-10-2016,23,15864,14145,7137,3174,40320,1194,641,318,2153,42473
21-10-2016,0,14416,13178,7022,3343,37959,1137,629,317,2083,40042
21-10-2016,1,13372,13023,6892,3118,36405,993,636,308,1937,38342
21-10-2016,2,12537,12950,6861,3017,35365,986,659,304,1949,37314
21-10-2016,3,12303,13039,6850,3143,35335,995,665,290,1950,37285
21-10-2016,4,13265,13273,7054,3446,37040,1146,679,296,2121,39161
21-10-2016,5,14302,14255,7713,3913,40185,1233,683,306,2222,42407
21-10-2016,6,16611,16598,8263,4086,45558,1376,697,377,2450,48008
21-10-2016,7,18843,18920,8754,4540,51058,1398,831,554,2783,53841
21-10-2016,8,19328,19542,8858,4855,52583,1387,927,588,2902,55485
21-10-2016,9,19460,19647,8855,5057,53020,1389,1017,571,2977,55997
21-10-2016,10,19190,19474,8857,5067,52587,1420,1117,816,3353,55940
21-10-2016,11,19024,19154,8847,5113,52140,1531,1194,734,3459,55599
21-10-2016,12,19162,18574,8921,4648,51306,1549,1195,370,3114,54420
21-10-2016,13,18879,18277,8916,4738,50809,1555,898,473,2926,53735
21-10-2016,14,18637,18051,8883,4620,50191,1425,676,797,2898,53089
21-10-2016,15,18288,18109,8690,4780,49866,1412,627,369,2408,52274
21-10-2016,16,18639,17989,8697,4593,49918,1396,629,355,2380,52298
21-10-2016,17,19090,18740,8835,4558,51222,1389,928,375,2692,53914
21-10-2016,18,19519,19896,8847,4483,52744,1392,1271,350,3013,55757
21-10-2016,19,18925,19638,8782,4358,51702,1393,1070,336,2799,54501
21-10-2016,20,17764,18063,8391,4331,48549,1375,628,341,2344,50893
21-10-2016,21,17514,16537,7981,4141,46172,1352,629,330,2311,48483
21-10-2016,22,16516,15329,7516,4070,43432,1358,625,335,2318,45750
21-10-2016,23,15364,14194,7193,3955,40706,1046,624,329,1999,42705
22-10-2016,0,14925,13190,6978,3754,38846,836,592,311,1739,40585
22-10-2016,1,14546,12956,6956,3693,38151,747,592,329,1668,39819
22-10-2016,2,14178,12797,6962,3579,37517,755,596,328,1679,39196
22-10-2016,3,14110,12861,6978,3557,37505,766,602,337,1705,39210
22-10-2016,4,14234,12926,6990,3552,37703,776,607,325,1708,39411
22-10-2016,5,14547,13167,6928,3576,38218,778,616,327,1721,39939
22-10-2016,6,15402,13798,7204,3608,40013,861,623,338,1822,41835
22-10-2016,7,16370,14514,7525,3697,42106,883,625,344,1852,43958
22-10-2016,8,17023,15588,7702,3738,44052,879,647,341,1867,45919
22-10-2016,9,17915,16755,7884,3918,46472,938,629,335,1902,48374
22-10-2016,10,18374,17059,7909,4238,47579,976,610,367,1953,49532
22-10-2016,11,18060,17131,7882,4472,47545,984,608,387,1979,49524
22-10-2016,12,18123,16974,7972,4383,47452,991,602,383,1976,49428
22-10-2016,13,17809,16736,7884,4373,46802,981,587,385,1953,48755
22-10-2016,14,17166,16386,7900,4245,45697,988,591,380,1959,47656
22-10-2016,15,17103,16436,7955,4192,45688,987,599,336,1922,47610
22-10-2016,16,17648,16842,8153,4140,46784,968,603,367,1938,48722
22-10-2016,17,18670,18281,8433,4143,49528,980,624,369,1973,51501
22-10-2016,18,18874,19060,8511,4127,50572,983,1013,313,2309,52881
22-10-2016,19,18625,18793,8512,3900,49831,980,594,281,1855,51686
22-10-2016,20,17955,17525,8316,3814,47612,984,583,291,1858,49470
22-10-2016,21,17362,16506,7815,3811,45495,967,568,256,1791,47286
22-10-2016,22,16564,15236,7512,3755,43069,946,554,212,1712,44781
22-10-2016,23,15777,14247,7388,3628,41039,989,554,201,1744,42783
23-10-2016,0,15225,13330,7321,3530,39409,908,559,179,1646,41055
23-10-2016,1,14362,13166,7337,3505,38370,855,567,170,1592,39962
23-10-2016,2,13800,13126,7243,3447,37616,848,575,158,1581,39197
23-10-2016,3,12841,13168,7250,3247,36506,804,582,138,1524,38030
23-10-2016,4,12938,13207,7242,3289,36675,840,593,120,1553,38228
23-10-2016,5,12885,13256,7377,3212,36730,872,595,113,1580,38310
23-10-2016,6,14003,13177,7418,3076,37674,873,604,119,1596,39270
23-10-2016,7,15649,13256,7477,3151,39533,858,615,133,1606,41139
23-10-2016,8,16455,13873,7797,3126,41252,905,622,133,1660,42912
23-10-2016,9,17935,14266,8114,2999,43315,1058,608,135,1801,45116
23-10-2016,10,18132,14538,8087,3065,43823,1067,591,126,1784,45607
23-10-2016,11,17907,14567,8056,3058,43589,1047,584,139,1770,45359
23-10-2016,12,18194,14732,8151,3094,44171,1033,576,146,1755,45926
23-10-2016,13,17898,14774,8400,3048,44122,1026,572,148,1746,45868
23-10-2016,14,17732,14400,8377,2885,43393,1020,571,158,1749,45142
23-10-2016,15,17511,14350,8108,2626,42595,1010,579,182,1771,44366
23-10-2016,16,17930,14880,8167,2805,43782,1002,579,205,1786,45568
23-10-2016,17,18967,16143,8304,3064,46478,1010,596,224,1830,48308
23-10-2016,18,19462,17549,8410,3227,48648,1013,926,252,2191,50839
23-10-2016,19,19476,17382,8489,3207,48554,990,1204,256,2450,51004
23-10-2016,20,19211,16374,8289,3079,46953,968,653,276,1897,48850
23-10-2016,21,18570,14956,8018,2732,44278,960,603,274,1837,46115
23-10-2016,22,17157,13562,7850,2551,41120,931,604,292,1827,42947
23-10-2016,23,15946,12856,7659,2329,38791,925,601,278,1804,40595
24-10-2016,0,13534,12464,7356,2306,35661,820,601,283,1704,37365
24-10-2016,1,13042,12407,7278,2088,34816,865,598,296,1759,36575
24-10-2016,2,12994,12444,7313,2096,34847,931,601,300,1832,36679
24-10-2016,3,12832,12477,7477,2167,34953,986,591,296,1873,36826
24-10-2016,4,13535,12651,7503,2394,36083,1143,609,280,2032,38115
24-10-2016,5,15428,13946,7736,2684,39794,1576,659,280,2515,42309
24-10-2016,6,19136,16940,8608,3179,47863,1676,679,328,2683,50546
24-10-2016,7,20787,19276,9192,3715,52969,1686,1233,472,3391,56360
24-10-2016,8,20975,19719,9257,3871,53822,1715,1361,475,3551,57373
24-10-2016,9,21274,19664,9217,3594,53749,1719,1450,537,3706,57455
24-10-2016,10,21336,19794,9213,3377,53720,1726,1459,572,3757,57477
24-10-2016,11,21259,19877,9196,3283,53616,1737,1455,590,3782,57398
24-10-2016,12,20826,19672,9099,3418,53016,1750,1458,596,3804,56820
24-10-2016,13,20882,19473,8993,3588,52934,1743,1465,438,3646,56580
24-10-2016,14,20540,19135,8984,3692,52350,1749,1462,418,3629,55979
24-10-2016,15,20440,19087,8814,3694,52035,1735,1467,380,3582,55617
24-10-2016,16,20494,18685,8826,3701,51707,1724,1483,365,3572,55279
24-10-2016,17,20651,19202,8875,3650,52379,1725,1823,533,4081,56460
24-10-2016,18,20765,19407,8977,3809,52957,1715,1909,588,4212,57169
24-10-2016,19,20135,19252,8913,3675,51974,1719,1460,491,3670,55644
24-10-2016,20,19475,18200,8520,3596,49792,1727,872,243,2842,52634
24-10-2016,21,19547,16222,8284,3282,47335,1731,602,224,2557,49892
24-10-2016,22,18544,14774,7942,2993,44252,1743,577,213,2533,46785
24-10-2016,23,16946,13851,7696,2740,41234,1635,577,184,2396,43630
25-10-2016,0,15866,13103,7520,2625,39113,1488,639,183,2310,41423
25-10-2016,1,15065,12779,7361,2636,37841,1351,639,179,2169,40010
25-10-2016,2,15255,12593,7338,2576,37763,1402,638,156,2196,39959
25-10-2016,3,15449,12527,7380,2690,38048,1450,648,133,2231,40279
25-10-2016,4,16012,12671,7547,2705,38936,1543,651,131,2325,41261
25-10-2016,5,17039,13805,8032,2773,41649,1713,682,120,2515,44164
25-10-2016,6,19419,16221,8735,3181,47556,1713,806,157,2676,50232
25-10-2016,7,20838,18648,9314,3642,52443,1719,1529,343,3591,56034
25-10-2016,8,20551,19490,9436,4001,53479,1786,1661,507,3954,57433
25-10-2016,9,20376,19227,9335,4013,52952,1683,1546,382,3611,56563
25-10-2016,10,20300,19348,9224,4115,52987,1665,1781,391,3837,56824
25-10-2016,11,20393,19327,9168,4028,52916,1626,1790,373,3789,56705
25-10-2016,12,20141,19275,9110,3833,52360,1614,1650,372,3636,55996
25-10-2016,13,20173,19080,9066,3690,52010,1635,1541,344,3520,55530
25-10-2016,14,20460,18972,9186,3573,52192,1638,1551,291,3480,55672
25-10-2016,15,20803,18828,9088,3578,52297,1642,1464,274,3380,55677
25-10-2016,16,20909,18709,8845,3541,52002,1636,1458,258,3352,55354
25-10-2016,17,21221,19195,8903,3534,52853,1644,1528,504,3676,56529
25-10-2016,18,21570,19294,8990,3623,53478,1640,1431,497,3568,57046
25-10-2016,19,21438,19066,8882,3541,52926,1648,1418,321,3387,56313
25-10-2016,20,21105,18422,8692,3179,51399,1668,1021,247,2936,54335
25-10-2016,21,20425,16225,8300,3013,47963,1659,636,56,2351,50314
25-10-2016,22,19550,14721,7944,2965,45181,1653,611,59,2323,47504
25-10-2016,23,18019,13290,7739,2845,41894,1584,604,72,2260,44154
26-10-2016,0,17427,12453,7695,2653,40229,1544,571,102,2217,42446
26-10-2016,1,16608,12222,7551,2597,38978,1550,563,125,2238,41216
26-10-2016,2,16357,12087,7319,2534,38297,1608,561,131,2300,40597
26-10-2016,3,16505,12113,7309,2465,38392,1618,565,136,2319,40711
26-10-2016,4,16423,12308,7510,2558,38800,1636,576,163,2375,41175
26-10-2016,5,16860,13504,8028,2836,41228,1778,606,124,2508,43736
26-10-2016,6,19476,16267,8657,3212,47613,1776,806,130,2712,50325
26-10-2016,7,21366,18795,9016,3714,52893,1756,1491,275,3522,56415
26-10-2016,8,21464,19286,8895,4015,53659,1802,1605,424,3831,57490
26-10-2016,9,21189,19210,8876,4004,53280,1788,1848,411,4047,57327
26-10-2016,10,20997,19276,8925,4145,53342,1786,1607,307,3700,57042
26-10-2016,11,20743,18799,8966,4116,52623,1790,1506,474,3770,56393
26-10-2016,12,20834,18541,8922,3973,52271,1788,1483,342,3613,55884
26-10-2016,13,20535,18608,8756,3939,51837,1793,1448,315,3556,55393
26-10-2016,14,20084,18510,8525,4093,51213,1802,1407,94,3303,54516
26-10-2016,15,19949,18560,8394,4044,50947,1807,1430,90,3327,54274
26-10-2016,16,19821,18875,8487,4128,51312,1810,1415,247,3472,54784
26-10-2016,17,20046,19748,8726,4203,52722,1805,1394,250,3449,56171
26-10-2016,18,20091,19879,8765,4486,53221,1789,1395,493,3677,56898
26-10-2016,19,19784,19664,8697,4566,52713,1779,1414,320,3513,56226
26-10-2016,20,18774,18011,8302,4541,49628,1770,821,74,2665,52293
26-10-2016,21,18001,16455,7898,4460,46813,1769,603,90,2462,49275
26-10-2016,22,17139,15244,7573,4276,44232,1782,598,121,2501,46733
26-10-2016,23,15026,14434,7242,3977,40680,1583,577,133,2293,42973
27-10-2016,0,13896,13712,7246,3472,38326,1378,556,136,2070,40396
27-10-2016,1,13224,13511,7081,3502,37317,1244,560,146,1950,39267
27-10-2016,2,12354,13464,7027,3341,36187,1213,566,161,1940,38127
27-10-2016,3,12265,13370,7009,3342,35986,1228,569,197,1994,37980
27-10-2016,4,13229,13356,7214,3045,36844,1389,573,204,2166,39010
27-10-2016,5,14881,14185,7580,2971,39619,1804,582,214,2600,42219
27-10-2016,6,18260,16535,8336,3415,46546,1828,593,210,2631,49177
27-10-2016,7,20592,19384,8878,3423,52279,1882,919,243,3044,55323
27-10-2016,8,20983,19828,9012,3600,53423,1876,1017,393,3286,56709
27-10-2016,9,20884,19715,8977,3541,53116,1893,1187,226,3306,56422
27-10-2016,10,20870,19368,8851,3447,52536,1903,1078,211,3192,55728
27-10-2016,11,20266,19196,8821,3534,51818,1920,917,215,3052,54870
27-10-2016,12,19515,17821,8652,3808,49796,1897,935,219,3051,52847
27-10-2016,13,18966,16978,8480,4068,48492,1896,924,170,2990,51482
27-10-2016,14,18597,16909,8418,4127,48051,1933,670,189,2792,50843
27-10-2016,15,18757,17042,8405,4010,48214,1904,623,226,2753,50967
27-10-2016,16,18927,17745,8521,3943,49137,1892,632,262,2786,51923
27-10-2016,17,19142,18954,8615,4155,50865,1859,836,280,2975,53840
27-10-2016,18,19187,19534,8654,4325,51700,1857,851,295,3003,54703
27-10-2016,19,18377,18988,8480,4611,50456,1805,749,304,2858,53314
27-10-2016,20,17353,17132,8089,4664,47237,1828,574,290,2692,49929
27-10-2016,21,16003,15960,7649,4819,44430,1839,556,293,2688,47118
27-10-2016,22,14003,15423,7259,4794,41477,1800,552,303,2655,44132
27-10-2016,23,11645,15091,7105,4842,38685,1431,550,302,2283,40968
28-10-2016,0,10377,14451,7148,5106,37080,1268,548,305,2121,39201
28-10-2016,1,9259,14302,6978,4911,35451,1263,485,306,2054,37505
28-10-2016,2,8992,14117,7006,4883,34998,1272,487,301,2060,37058
28-10-2016,3,9002,13971,7004,4987,34963,1271,490,333,2094,37057
28-10-2016,4,9301,14036,6951,5028,35317,1281,549,372,2202,37519
28-10-2016,5,10986,14907,7014,5233,38140,1407,555,400,2362,40502
28-10-2016,6,14569,16244,7338,5280,43431,1749,561,471,2781,46212
28-10-2016,7,17812,17916,7770,5664,49163,1709,650,484,2843,52006
28-10-2016,8,18129,18842,7840,5842,50653,1747,651,491,2889,53542
28-10-2016,9,18231,18591,7805,5589,50216,1733,630,504,2867,53083
28-10-2016,10,18186,18882,7959,5746,50774,1750,607,513,2870,53644
28-10-2016,11,17606,18563,7871,5926,49965,1763,606,516,2885,52850
28-10-2016,12,17021,18064,7706,6169,48959,1754,585,513,2852,51811
28-10-2016,13,16586,17565,7601,6240,47993,1755,568,509,2832,50825
28-10-2016,14,16202,17328,7490,6327,47346,1743,574,505,2822,50168
28-10-2016,15,16250,17361,7464,5673,46747,1731,535,505,2771,49518
28-10-2016,16,16292,17693,7444,5504,46933,1730,540,499,2769,49702
28-10-2016,17,17005,18402,7683,5407,48497,1719,626,488,2833,51330
28-10-2016,18,17375,18723,7680,5350,49127,1708,714,485,2907,52034
28-10-2016,19,17050,18431,7639,5226,48346,1700,596,498,2794,51140
28-10-2016,20,15966,17255,7156,5165,45542,1691,532,479,2702,48244
28-10-2016,21,14493,16285,6893,5354,43025,1623,518,425,2566,45591
28-10-2016,22,13490,15734,6805,5212,41240,1217,537,402,2156,43396
28-10-2016,23,11851,15395,6784,4852,38882,1086,535,390,2011,40893
29-10-2016,0,10417,15061,6749,4599,36826,988,633,387,2008,38834
29-10-2016,1,9863,14874,6661,4582,35982,976,641,394,2011,37993
29-10-2016,2,9444,14824,6692,4588,35548,989,640,390,2019,37567
29-10-2016,3,9075,14836,6700,4443,35053,980,559,371,1910,36963
29-10-2016,4,9279,14809,6775,4439,35301,974,568,347,1889,37190
29-10-2016,5,9618,14742,6884,4518,35762,993,589,340,1922,37684
29-10-2016,6,11053,15078,7091,4723,37945,986,602,333,1921,39866
29-10-2016,7,13129,15349,7218,4691,40386,1022,602,335,1959,42345
29-10-2016,8,14994,15623,7279,4945,42841,1183,591,333,2107,44948
29-10-2016,9,16283,15866,7322,4955,44427,1190,617,322,2129,46556
29-10-2016,10,16421,16009,7310,5209,44950,1225,656,363,2244,47194
29-10-2016,11,15773,15580,7287,5411,44051,1197,658,390,2245,46296
29-10-2016,12,14132,15324,7240,5473,42170,1211,852,402,2465,44635
29-10-2016,13,13309,15431,7171,5158,41069,1096,688,406,2190,43259
29-10-2016,14,12579,15876,7172,4939,40567,1029,680,403,2112,42679
29-10-2016,15,12370,15721,7185,4938,40214,1047,776,391,2214,42428
29-10-2016,16,13683,16320,7290,4905,42200,1072,686,375,2133,44333
29-10-2016,17,16707,17309,7559,4603,46179,1192,753,363,2308,48487
29-10-2016,18,17625,17541,7699,4629,47494,1213,1090,341,2644,50138
29-10-2016,19,16812,17545,7623,4401,46382,1196,869,357,2422,48804
29-10-2016,20,15366,17201,7603,4235,44404,1173,675,350,2198,46602
29-10-2016,21,14614,16202,7669,4174,42659,1166,632,321,2119,44778
29-10-2016,22,13858,15598,7533,4090,41079,1159,614,301,2074,43153
29-10-2016,23,12945,14990,7342,3902,39180,1055,613,296,1964,41144
30-10-2016,0,11550,14554,7100,3536,36740,910,623,300,1833,38573
30-10-2016,1,10817,14333,6980,3369,35500,886,624,323,1833,37333
30-10-2016,2,10168,13809,6853,2830,33660,882,626,340,1848,35508
30-10-2016,2,10108,14222,6860,2823,34013,890,624,347,1861,35874
30-10-2016,3,10671,13969,7029,2685,34355,873,624,347,1844,36199
30-10-2016,4,10783,13972,7087,2341,34184,921,634,345,1900,36084
30-10-2016,5,11572,13916,7152,2245,34886,1046,650,327,2023,36909
30-10-2016,6,12419,13995,7211,2184,35811,1139,658,275,2072,37883
30-10-2016,7,13674,14162,7396,2239,37468,1179,658,255,2092,39560
30-10-2016,8,15846,14277,7512,2381,40015,1205,659,280,2144,42159
30-10-2016,9,17504,14316,7538,2324,41681,1185,664,328,2177,43858
30-10-2016,10,17702,14317,7453,2428,41901,1171,701,331,2203,44104
30-10-2016,11,18019,14364,7568,2492,42444,1151,679,356,2186,44630
30-10-2016,12,17726,14390,7663,2416,42195,1139,652,328,2119,44314
30-10-2016,13,16303,14231,7631,2423,40589,1100,661,315,2076,42665
30-10-2016,14,15651,14213,7643,2407,39915,1092,746,276,2114,42029
30-10-2016,15,16239,14714,7794,2449,41197,1073,755,287,2115,43312
30-10-2016,16,17913,16192,7949,2538,44592,1092,826,277,2195,46787
30-10-2016,17,19666,18080,8271,2762,48778,1095,1037,223,2355,51133
30-10-2016,18,19826,17831,8241,2704,48601,1086,1109,233,2428,51029
30-10-2016,19,19574,16962,8187,2712,47435,1105,912,231,2248,49683
30-10-2016,20,18874,15555,7998,2707,45135,1108,816,216,2140,47275
30-10-2016,21,18520,14484,7907,2580,43491,1100,807,190,2097,45588
30-10-2016,22,18013,13698,7778,2348,41837,1084,638,191,1913,43750
30-10-2016,23,16977,12927,7495,2147,39546,1060,688,198,1946,41492
31-10-2016,0,15252,11952,7446,2125,36774,1040,512,186,1738,38512
31-10-2016,1,15208,11633,7398,2099,36338,1107,499,178,1784,38122
31-10-2016,2,14752,11576,7240,2077,35646,1129,509,176,1814,37460
31-10-2016,3,14235,11674,7315,2036,35262,1155,568,151,1874,37136
31-10-2016,4,15446,12163,7501,2109,37217,1246,583,163,1992,39209
31-10-2016,5,17335,14020,7927,2538,41823,1304,626,157,2087,43910
31-10-2016,6,19921,16477,8577,2632,47608,1373,681,408,2462,50070
31-10-2016,7,21329,18079,9024,2832,51263,1445,1686,421,3552,54815
31-10-2016,8,21378,17870,8924,2981,51152,1461,1694,456,3611,54763
31-10-2016,9,21093,17756,8847,3098,50794,1471,1699,284,3454,54248
31-10-2016,10,21007,17558,8798,3090,50453,1469,1527,126,3122,53575
31-10-2016,11,20833,17441,8803,3077,50155,1458,1455,134,3047,53202
31-10-2016,12,20783,17158,8794,3123,49859,1465,1320,146,2931,52790
31-10-2016,13,20639,17164,8752,2845,49400,1456,1318,155,2929,52329
31-10-2016,14,20595,16990,8731,2871,49187,1468,1414,163,3045,52232
31-10-2016,15,21047,17427,8806,2976,50256,1460,1485,177,3122,53378
31-10-2016,16,21145,18666,8933,3130,51875,1450,1752,352,3554,55429
31-10-2016,17,21128,19106,9070,3319,52623,1428,1964,598,3990,56613
31-10-2016,18,20804,19020,8914,3247,51984,1421,1839,505,3765,55749
31-10-2016,19,20648,18599,8797,3112,51158,1414,1495,265,3174,54332
31-10-2016,20,19924,17054,8542,3042,48562,1409,784,256,2449,51011
31-10-2016,21,19461,15637,8062,2959,46120,1405,539,127,2071,48191
31-10-2016,22,18196,14592,7721,2757,43265,1395,524,81,2000,45265
31-10-2016,23,16455,13714,7422,2791,40382,1390,517,70,1977,42359
01-11-2016,0,14689,12886,7171,2778,37524,1391,552,60,2003,39527
01-11-2016,1,13649,12677,7122,2976,36425,1369,549,52,1970,38395
01-11-2016,2,13133,12779,7133,3042,36086,1188,547,52,1787,37873
01-11-2016,3,13011,12988,7170,3271,36441,1158,548,54,1760,38201
01-11-2016,4,13662,13359,7179,3517,37716,1329,547,68,1944,39660
01-11-2016,5,15173,14428,7419,3694,40713,1470,590,108,2168,42881
01-11-2016,6,17919,16537,7933,4304,46693,1489,767,172,2428,49121
01-11-2016,7,19740,18135,8192,4592,50659,1510,1096,191,2797,53456
01-11-2016,8,19805,18333,8288,4705,51131,1513,1159,271,2943,54074
01-11-2016,9,19162,18090,8222,4387,49860,1495,1211,214,2920,52780
01-11-2016,10,18779,17713,8057,5071,49621,1501,1079,238,2818,52439
01-11-2016,11,18516,17758,8201,5493,49969,1506,1047,267,2820,52789
01-11-2016,12,18208,17895,8217,5848,50169,1521,1109,346,2976,53145
01-11-2016,13,18139,17892,8175,5843,50050,1513,1017,401,2931,52981
01-11-2016,14,17769,17930,8266,5723,49688,1533,1018,440,2991,52679
01-11-2016,15,17905,18241,8373,5520,50039,1547,1114,476,3137,53176
01-11-2016,16,19175,18925,8442,5093,51635,1565,1461,472,3498,55133
01-11-2016,17,19845,19619,8557,5143,53164,1577,1572,647,3796,56960
01-11-2016,18,19401,19768,8431,5343,52943,1590,1481,415,3486,56429
01-11-2016,19,18769,18580,8230,5339,50918,1550,952,381,2883,53801
01-11-2016,20,18161,17103,8014,5260,48539,1541,787,298,2626,51165
01-11-2016,21,17145,16095,7788,5440,46468,1542,575,302,2419,48887
01-11-2016,22,15711,15413,7632,5280,44035,1542,525,277,2344,46379
01-11-2016,23,13497,15102,7460,4972,41031,1381,531,288,2200,43231
02-11-2016,0,12119,14963,7407,4884,39373,1301,727,290,2318,41691
02-11-2016,1,11774,14597,7346,4643,38361,1237,657,282,2176,40537
02-11-2016,2,11573,14668,7349,4501,38090,1183,633,265,2081,40171
02-11-2016,3,11290,14811,7387,4430,37918,1186,636,249,2071,39989
02-11-2016,4,12136,15042,7478,4488,39144,1304,731,188,2223,41367
02-11-2016,5,14390,16235,7755,4304,42684,1527,784,289,2600,45284
02-11-2016,6,17957,17722,8343,4371,48394,1591,923,301,2815,51209
02-11-2016,7,20439,19312,8730,4682,53164,1569,918,400,2887,56051
02-11-2016,8,20704,19709,8784,4587,53784,1546,1007,455,3008,56792
02-11-2016,9,20459,19480,8599,4677,53215,1552,1075,607,3234,56449
02-11-2016,10,20011,18995,8460,4690,52156,1549,1031,653,3233,55389
02-11-2016,11,19645,18901,8525,4923,51995,1543,1030,637,3210,55205
02-11-2016,12,19595,19106,8651,4965,52318,1532,932,616,3080,55398
02-11-2016,13,19700,19091,8694,4721,52206,1531,1018,668,3217,55423
02-11-2016,14,19690,19040,8716,4584,52031,1526,1108,614,3248,55279
02-11-2016,15,19979,19358,9036,4524,52897,1525,1130,226,2881,55778
02-11-2016,16,20785,20105,9081,4384,54355,1492,1283,366,3141,57496
02-11-2016,17,21423,21004,9314,4629,56371,1507,1494,530,3531,59902
02-11-2016,18,21148,20996,9309,4576,56029,1519,1421,445,3385,59414
02-11-2016,19,20935,19994,8965,4186,54080,1501,1156,515,3172,57252
02-11-2016,20,20287,18275,8601,3830,50992,1497,954,521,2972,53964
02-11-2016,21,19198,16750,8393,3598,47939,1507,786,497,2790,50729
02-11-2016,22,18249,15602,7934,3267,45054,1490,777,519,2786,47840
02-11-2016,23,16728,14889,7750,2971,42338,1476,780,597,2853,45191
03-11-2016,0,15392,14620,7728,2882,40624,1311,747,595,2653,43277
03-11-2016,1,15431,14242,7705,2597,39977,1279,747,430,2456,42433
03-11-2016,2,15327,14070,7701,2636,39734,1277,750,427,2454,42188
03-11-2016,3,15914,14166,7743,2526,40350,1271,754,455,2480,42830
03-11-2016,4,17095,14372,7973,2674,42111,1256,757,448,2461,44572
03-11-2016,5,18864,15672,8547,2706,45788,1283,858,412,2553,48341
03-11-2016,6,20456,18671,8991,2917,51035,1402,1403,635,3440,54475
03-11-2016,7,22111,20059,9298,3400,54868,1417,1565,811,3793,58661
03-11-2016,8,22374,20328,9299,3616,55619,1397,1562,818,3777,59396
03-11-2016,9,22210,19758,9266,3693,54928,1396,1552,802,3750,58678
03-11-2016,10,21740,19381,9128,3685,53935,1399,1381,647,3427,57362
03-11-2016,11,21881,18963,9111,3642,53598,1367,1375,663,3405,57003
03-11-2016,12,21857,18594,9112,3568,53130,1369,1562,806,3737,56867
03-11-2016,13,22023,18573,9194,3551,53342,1366,1565,660,3591,56933
03-11-2016,14,22029,18592,9295,3477,53393,1377,1630,990,3997,57390
03-11-2016,15,22370,19078,9456,3463,54367,1378,1642,807,3827,58194
03-11-2016,16,22401,19646,9529,3618,55194,1371,1922,800,4093,59287
03-11-2016,17,22444,19824,9621,3709,55598,1364,2000,816,4180,59778
03-11-2016,18,22409,19734,9543,3878,55563,1358,1936,607,3901,59464
03-11-2016,19,22216,18925,9472,3772,54386,1343,1719,507,3569,57955
03-11-2016,20,21348,17597,9181,3411,51536,1337,1260,366,2963,54499
03-11-2016,21,20616,16387,8797,3241,49042,1329,810,366,2505,51547
03-11-2016,22,18694,15144,8309,3176,45323,1322,734,362,2418,47741
03-11-2016,23,16931,13810,7979,2931,41651,1285,730,299,2314,43965
04-11-2016,0,16110,12963,8006,3107,40186,1232,732,303,2267,42453
04-11-2016,1,15573,12825,8018,2991,39406,1232,731,294,2257,41663
04-11-2016,2,15338,12826,8032,2863,39061,1221,735,299,2255,41316
04-11-2016,3,15409,12890,8056,2906,39262,1213,738,303,2254,41516
04-11-2016,4,16231,13349,8203,2910,40694,1213,746,291,2250,42944
04-11-2016,5,17482,14642,8406,2986,43515,1376,809,303,2488,46003
04-11-2016,6,19856,17279,8916,3224,49277,1432,859,316,2607,51884
04-11-2016,7,22054,19384,9486,3452,54378,1427,1208,368,3003,57381
04-11-2016,8,22346,19823,9696,3728,55593,1438,1344,512,3294,58887
04-11-2016,9,22255,19709,9621,3768,55352,1440,1434,500,3374,58726
04-11-2016,10,21977,19523,9369,3974,54844,1448,1444,328,3220,58064
04-11-2016,11,22324,19396,9441,4063,55221,1433,1380,323,3136,58357
04-11-2016,12,21436,19455,9340,3964,54194,1441,1386,322,3149,57343
04-11-2016,13,21383,19046,9272,3942,53643,1442,1452,323,3217,56860
04-11-2016,14,21505,19012,9193,3891,53602,1457,1242,320,3019,56621
04-11-2016,15,21921,19648,9365,3792,54725,1447,1054,321,2822,57547
04-11-2016,16,22470,20075,9573,3979,56098,1448,1133,505,3086,59184
04-11-2016,17,22305,20572,9760,4139,56776,1443,1184,525,3152,59928
04-11-2016,18,22197,20041,9634,4165,56037,1433,950,533,2916,58953
04-11-2016,19,21501,19232,9386,4072,54190,1399,757,333,2489,56679
04-11-2016,20,20117,17773,8914,3950,50755,1368,745,133,2246,53001
04-11-2016,21,19609,16741,8466,3804,48620,1268,743,121,2132,50752
04-11-2016,22,18209,15782,8197,3249,45437,1219,743,124,2086,47523
04-11-2016,23,16281,14929,7984,3141,42336,1131,746,154,2031,44367
05-11-2016,0,16037,14203,8063,2752,41057,1033,750,176,1959,43016
05-11-2016,1,15910,13936,8007,2755,40608,1031,752,195,1978,42586
05-11-2016,2,15269,13942,7990,2757,39957,1026,755,217,1998,41955
05-11-2016,3,14760,13983,7998,2690,39430,1008,757,244,2009,41439
05-11-2016,4,14654,14033,8077,2691,39456,1013,758,246,2017,41473
05-11-2016,5,15156,14033,8069,2835,40094,1004,763,274,2041,42135
05-11-2016,6,15754,14344,8258,3000,41357,1010,769,276,2055,43412
05-11-2016,7,16771,14946,8535,3046,43298,1010,858,311,2179,45477
05-11-2016,8,18489,15803,8828,3257,46377,1004,903,294,2201,48578
05-11-2016,9,19389,16787,8877,3600,48653,1014,901,288,2203,50856
05-11-2016,10,19898,17503,9048,3898,50349,1010,906,399,2315,52664
05-11-2016,11,19826,17918,8840,4039,50623,1012,1018,504,2534,53157
05-11-2016,12,19639,17758,8750,4005,50152,1001,1110,502,2613,52765
05-11-2016,13,19044,17324,8820,4076,49264,999,1098,525,2622,51886
05-11-2016,14,18589,17328,8779,4083,48779,1002,1133,545,2680,51459
05-11-2016,15,18666,17173,9123,4258,49220,1008,1209,567,2784,52004
05-11-2016,16,20094,18315,9227,4334,51970,1007,1262,589,2858,54828
05-11-2016,17,20619,19218,9267,4378,53482,1015,1475,608,3098,56580
05-11-2016,18,20044,19224,9224,4268,52761,1029,1250,618,2897,55658
05-11-2016,19,18948,18234,9242,4174,50597,1077,1047,633,2757,53354
05-11-2016,20,17863,16914,9070,4181,48027,1080,980,629,2689,50716
05-11-2016,21,17420,16113,8814,4178,46526,1090,870,411,2371,48897
05-11-2016,22,16133,15524,8456,4106,44219,1105,809,350,2264,46483
05-11-2016,23,14678,14991,8084,4037,41789,1100,793,362,2255,44044
06-11-2016,0,13682,14690,7920,3802,40094,1004,796,425,2225,42319
06-11-2016,1,13231,14553,7914,3821,39520,1014,792,420,2226,41746
06-11-2016,2,13196,14587,7899,3760,39441,1034,796,434,2264,41705
06-11-2016,3,12770,14494,7955,3751,38970,1153,798,365,2316,41286
06-11-2016,4,12760,14534,8072,3838,39205,1163,798,386,2347,41552
06-11-2016,5,12920,14694,8175,3998,39786,1154,801,374,2329,42115
06-11-2016,6,13408,15114,8379,4125,41025,1161,814,341,2316,43341
06-11-2016,7,13869,15717,8567,4374,42529,1167,852,329,2348,44877
06-11-2016,8,14819,16236,8704,4517,44277,1196,876,322,2394,46671
06-11-2016,9,16940,16831,8810,4968,47549,1187,930,265,2382,49931
06-11-2016,10,17815,17481,8994,5202,49492,1097,964,291,2352,51844
06-11-2016,11,18095,17898,9039,5301,50333,1119,959,196,2274,52607
06-11-2016,12,17877,17795,9068,5402,50142,1134,954,157,2245,52387
06-11-2016,13,17830,17406,9081,5472,49789,1123,952,140,2215,52004
06-11-2016,14,17113,17548,9255,5462,49378,1112,958,131,2201,51579
06-11-2016,15,17175,17915,9385,5500,49974,1135,1068,239,2442,52416
06-11-2016,16,18242,19000,9448,5730,52420,1152,1274,320,2746,55166
06-11-2016,17,18707,19719,9795,5905,54126,1173,1517,319,3009,57135
06-11-2016,18,18626,19743,9841,6070,54281,1206,1580,314,3100,57381
06-11-2016,19,18193,19014,9541,6070,52818,1235,1304,308,2847,55665
06-11-2016,20,17880,18121,9387,5847,51235,1236,1009,310,2555,53790
06-11-2016,21,17212,17549,9299,5748,49810,1234,835,306,2375,52185
06-11-2016,22,16330,16664,9072,5401,47466,1227,780,281,2288,49754
06-11-2016,23,14914,15845,8956,5095,44810,1298,787,284,2369,47179
07-11-2016,0,13338,15253,8775,5155,42520,1452,944,282,2678,45198
07-11-2016,1,13027,15058,8783,5058,41928,1446,954,279,2679,44607
07-11-2016,2,13194,15036,8809,4917,41957,1475,933,275,2683,44640
07-11-2016,3,13482,15083,8910,4807,42282,1486,931,279,2696,44978
07-11-2016,4,14370,15666,9079,4858,43973,1575,981,279,2835,46808
07-11-2016,5,16528,16968,9362,4738,47597,1713,1017,278,3008,50605
07-11-2016,6,19523,19533,9681,4691,53427,1716,1422,469,3607,57034
07-11-2016,7,21893,22025,10147,4800,58865,1715,1447,573,3735,62600
07-11-2016,8,22386,22435,10236,4889,59946,1703,1516,646,3865,63811
07-11-2016,9,22633,22351,10087,4949,60020,1688,1517,586,3791,63811
07-11-2016,10,22391,21869,10041,4817,59119,1696,1519,338,3553,62672
07-11-2016,11,22133,21689,10005,4821,58649,1690,1518,716,3924,62573
07-11-2016,12,21868,21722,10082,4911,58583,1677,1596,551,3824,62407
07-11-2016,13,22318,21763,10043,4836,58960,1671,1608,461,3740,62700
07-11-2016,14,22500,21584,10110,4587,58780,1690,1683,369,3742,62522
07-11-2016,15,22749,21926,10275,4353,59303,1752,1688,666,4106,63409
07-11-2016,16,23299,22437,10410,4285,60431,1732,1771,771,4274,64705
07-11-2016,17,23664,22767,10585,4657,61672,1725,1876,761,4362,66034
07-11-2016,18,23395,22619,10559,4560,61133,1721,1786,757,4264,65397
07-11-2016,19,22768,21807,10369,4165,59109,1705,1604,683,3992,63101
07-11-2016,20,22171,20589,10025,3855,56640,1700,1437,549,3686,60326
07-11-2016,21,21085,19209,9773,3570,53637,1692,1184,451,3327,56964
07-11-2016,22,20287,17777,9597,3609,51271,1657,1174,267,3098,54369
07-11-2016,23,18585,16408,9398,3458,47850,1558,1181,278,3017,50867
08-11-2016,0,18033,15245,9192,3302,45772,1492,985,296,2773,48545
08-11-2016,1,17456,14977,9045,3437,44916,1466,935,273,2674,47590
08-11-2016,2,17376,14977,9022,3369,44745,1480,936,274,2690,47435
08-11-2016,3,17447,14939,9084,3387,44859,1487,934,274,2695,47554
08-11-2016,4,18303,15249,9218,3331,46101,1647,934,273,2854,48955
08-11-2016,5,19595,16670,9629,3350,49244,1664,975,333,2972,52216
08-11-2016,6,21454,19553,9946,3390,54343,1656,1492,706,3854,58197
08-11-2016,7,23120,21665,10253,3755,58794,1684,1566,803,4053,62847
08-11-2016,8,23973,22033,10352,3944,60303,1808,1545,824,4177,64480
08-11-2016,9,24104,22002,10385,3922,60413,1588,1518,831,3937,64350
08-11-2016,10,23826,21755,10214,4059,59854,1643,1460,778,3881,63735
08-11-2016,11,23701,21591,10161,4057,59511,1657,1541,754,3952,63463
08-11-2016,12,23669,21457,10192,4124,59443,1664,1709,815,4188,63631
08-11-2016,13,23340,21158,10252,4021,58771,1660,1713,790,4163,62934
08-11-2016,14,23632,21437,10390,3840,59299,1660,1801,775,4236,63535
08-11-2016,15,23617,22072,10413,3890,59992,1667,1789,791,4247,64239
08-11-2016,16,23586,22025,10469,4003,60085,1683,1957,829,4469,64554
08-11-2016,17,23727,22234,10525,4037,60523,1716,1887,832,4435,64958
08-11-2016,18,23503,21989,10440,4044,59975,1691,1851,805,4347,64322
08-11-2016,19,23244,21283,10295,4030,58854,1675,1504,786,3965,62819
08-11-2016,20,22098,19127,10103,3778,55106,1686,1404,582,3672,58778
08-11-2016,21,21311,17791,9717,3691,52510,1689,941,475,3105,55615
08-11-2016,22,20383,16669,9601,3449,50103,1670,932,294,2896,52999
08-11-2016,23,18543,15558,9381,3373,46855,1489,939,287,2715,49570
09-11-2016,0,17074,14925,9198,3409,44606,1440,928,288,2656,47262
09-11-2016,1,16544,14654,9062,3465,43724,1429,907,282,2618,46342
09-11-2016,2,15637,14589,9017,3521,42763,1431,910,278,2619,45382
09-11-2016,3,15576,14697,9051,3635,42960,1468,908,279,2655,45615
09-11-2016,4,16881,15321,9080,3766,45049,1525,917,283,2725,47774
09-11-2016,5,18774,16799,9367,3859,48799,1697,946,337,2980,51779
09-11-2016,6,21326,19204,9588,4171,54288,1679,1355,723,3757,58045
09-11-2016,7,23428,21443,9997,4135,59004,1684,1582,798,4064,63068
09-11-2016,8,23541,21702,10106,4466,59816,1677,1582,818,4077,63893
09-11-2016,9,23743,21618,10012,4356,59730,1675,1543,841,4059,63789
09-11-2016,10,23614,21334,9797,4461,59206,1684,1453,847,3984,63190
09-11-2016,11,23483,21560,9841,4291,59175,1685,1409,843,3937,63112
09-11-2016,12,23392,21619,9778,4276,59066,1680,1396,857,3933,62999
09-11-2016,13,23531,21581,9801,4340,59253,1658,1380,870,3908,63161
09-11-2016,14,23260,21578,9951,4215,59006,1662,1485,886,4033,63039
09-11-2016,15,23283,21737,10121,4076,59218,1688,1637,894,4219,63437
09-11-2016,16,23662,21853,10265,4125,59905,1704,1999,914,4617,64522
09-11-2016,17,23698,21856,10356,4200,60111,1727,1996,918,4641,64752
09-11-2016,18,23571,21713,10162,4073,59520,1730,1926,917,4573,64093
09-11-2016,19,23158,21190,9882,3875,58105,1711,1660,922,4293,62398
09-11-2016,20,22090,19430,9543,3585,54648,1700,1371,743,3814,58462
09-11-2016,21,21494,17762,9366,3342,51965,1691,1029,625,3345,55310
09-11-2016,22,20294,16535,9063,3093,48986,1553,932,451,2936,51922
09-11-2016,23,18752,15360,8815,2943,45872,1504,920,437,2861,48733
10-11-2016,0,17450,14654,8649,2518,43271,1453,936,413,2802,46073
10-11-2016,1,16972,14369,8470,2608,42420,1436,932,388,2756,45176
10-11-2016,2,16704,14332,8417,2676,42128,1430,930,359,2719,44847
10-11-2016,3,16673,14407,8452,2843,42375,1479,931,338,2748,45123
10-11-2016,4,17445,14780,8672,2948,43844,1608,935,331,2874,46718
10-11-2016,5,18882,16392,9219,3089,47582,1695,950,368,3013,50595
10-11-2016,6,21414,19047,9650,3391,53502,1693,1319,516,3528,57030
10-11-2016,7,22878,21005,9898,3786,57567,1707,1425,775,3907,61474
10-11-2016,8,23118,21470,9811,4156,58556,1733,1459,768,3960,62516
10-11-2016,9,23138,21400,9740,3990,58269,1739,1539,766,4044,62313
10-11-2016,10,23237,21363,9518,3865,57983,1758,1545,760,4063,62046
10-11-2016,11,23128,21188,9524,3868,57709,1747,1456,752,3955,61664
10-11-2016,12,23186,21052,9498,3756,57493,1730,1702,751,4183,61676
10-11-2016,13,23617,21092,9294,3667,57669,1718,1681,751,4150,61819
10-11-2016,14,23386,21147,9173,3686,57392,1728,1651,750,4129,61521
10-11-2016,15,23139,21135,9271,3708,57254,1745,1822,749,4316,61570
10-11-2016,16,23433,21364,9461,3820,58077,1720,1982,749,4451,62528
10-11-2016,17,23344,21441,9600,4437,58822,1738,1997,750,4485,63307
10-11-2016,18,23086,21259,9495,4338,58177,1705,1923,750,4378,62555
10-11-2016,19,22756,20334,9058,4285,56434,1709,1585,741,4035,60469
10-11-2016,20,22344,18868,8733,4066,54012,1705,1494,565,3764,57776
10-11-2016,21,21712,17698,8731,3790,51932,1704,1272,448,3424,55356
10-11-2016,22,20362,16486,8691,3540,49079,1707,952,273,2932,52011
10-11-2016,23,19104,15215,8461,3590,46371,1659,934,276,2869,49240
11-11-2016,0,18193,14130,8449,3469,44242,1496,935,277,2708,46950
11-11-2016,1,17101,13860,8312,3387,42661,1417,933,278,2628,45289
11-11-2016,2,16539,13875,8269,3350,42032,1398,934,278,2610,44642
11-11-2016,3,16776,13894,8319,3426,42414,1408,934,278,2620,45034
11-11-2016,4,17919,14235,8586,3654,44394,1501,943,331,2775,47169
11-11-2016,5,18930,15793,8973,3653,47349,1560,1287,357,3204,50553
11-11-2016,6,21380,18859,9275,3901,53415,1554,1643,493,3690,57105
11-11-2016,7,23679,20692,9475,4215,58060,1598,1925,665,4188,62248
11-11-2016,8,23964,21174,9628,4122,58888,1615,1984,748,4347,63235
11-11-2016,9,23882,21243,9594,4285,59005,1612,1975,743,4330,63335
11-11-2016,10,23854,21014,9490,4221,58580,1623,1670,567,3860,62440
11-11-2016,11,23601,20800,9525,4101,58026,1633,1754,577,3964,61990
11-11-2016,12,23302,20640,9512,3794,57249,1645,1751,746,4142,61391
11-11-2016,13,23346,20440,9528,3795,57111,1646,1759,752,4157,61268
11-11-2016,14,23025,20336,9544,3651,56556,1628,1542,765,3935,60491
11-11-2016,15,23213,20292,9698,3630,56835,1634,1548,766,3948,60783
11-11-2016,16,23954,20908,9909,3607,58379,1650,1756,770,4176,62555
11-11-2016,17,23982,21378,10027,3611,58998,1656,1831,780,4267,63265
11-11-2016,18,23969,21293,9981,3583,58826,1646,1782,780,4208,63034
11-11-2016,19,23807,20551,9796,3568,57722,1629,1487,587,3703,61425
11-11-2016,20,23084,18522,9459,3374,54439,1616,1365,580,3561,58000
11-11-2016,21,22131,17265,9289,3281,51966,1607,982,465,3054,55020
11-11-2016,22,21403,16204,9034,3254,49896,1552,934,287,2773,52669
11-11-2016,23,20528,15022,8805,3192,47549,1465,930,296,2691,50240
12-11-2016,0,20114,14391,8562,2913,45980,1358,863,306,2527,48507
12-11-2016,1,19228,14161,8398,3000,44786,1356,862,322,2540,47326
12-11-2016,2,18023,14005,8327,3011,43368,1357,846,333,2536,45904
12-11-2016,3,17232,13952,8229,2924,42337,1357,818,335,2510,44847
12-11-2016,4,17405,13889,8224,2965,42482,1394,818,348,2560,45042
12-11-2016,5,17780,14270,8364,3185,43599,1394,809,326,2529,46128
12-11-2016,6,18607,15335,8477,3375,45794,1374,820,294,2488,48282
12-11-2016,7,19400,16307,8534,3698,47938,1367,813,411,2591,50529
12-11-2016,8,20349,17459,8615,3952,50375,1349,791,501,2641,53016
12-11-2016,9,21313,18691,8721,4134,52857,1339,850,507,2696,55553
12-11-2016,10,21535,19152,8822,4259,53767,1340,857,502,2699,56466
12-11-2016,11,21260,18904,8759,4280,53202,1338,960,509,2807,56009
12-11-2016,12,20519,18296,8600,4282,51699,1331,808,442,2581,54280
12-11-2016,13,20017,17817,8563,4271,50669,1462,803,279,2544,53213
12-11-2016,14,19307,17828,8570,4175,49880,1476,788,296,2560,52440
12-11-2016,15,20332,18446,8731,4234,51743,1391,849,290,2530,54273
12-11-2016,16,21325,19511,8946,4258,54040,1317,1647,504,3468,57508
12-11-2016,17,21794,19895,9113,4375,55178,1304,1995,505,3804,58982
12-11-2016,18,21399,19767,8942,4484,54591,1307,1659,509,3475,58066
12-11-2016,19,20354,19041,8697,4503,52596,1321,1065,507,2893,55489
12-11-2016,20,18480,18104,8548,4217,49349,1350,765,414,2529,51878
12-11-2016,21,17493,17340,8388,3989,47209,1334,755,281,2370,49579
12-11-2016,22,16455,16047,8261,4094,44857,1349,746,281,2376,47233
12-11-2016,23,15723,15106,8073,4171,43073,1381,744,286,2411,45484
13-11-2016,0,15255,14267,7829,3911,41262,1389,805,283,2477,43739
13-11-2016,1,14391,13974,7686,3987,40038,1400,804,305,2509,42547
13-11-2016,2,14192,13875,7661,3959,39687,1365,803,296,2464,42151
13-11-2016,3,14020,13808,7657,3956,39442,1402,816,292,2510,41952
13-11-2016,4,14194,13749,7677,3998,39620,1486,818,307,2611,42231
13-11-2016,5,14670,13822,7767,4119,40379,1493,832,329,2654,43033
13-11-2016,6,15445,14384,8031,4070,41931,1467,842,325,2634,44565
13-11-2016,7,15785,14483,8112,3963,42343,1470,853,460,2783,45126
13-11-2016,8,17010,14928,8225,3890,44053,1509,843,544,2896,46949
13-11-2016,9,17674,15841,8325,4105,45946,1413,818,537,2768,48714
13-11-2016,10,17782,16363,8317,4086,46550,1397,802,530,2729,49279
13-11-2016,11,17957,16521,8380,4138,46995,1396,786,521,2703,49698
13-11-2016,12,17675,16566,8299,4057,46597,1394,780,517,2691,49288
13-11-2016,13,17805,16383,8073,3944,46204,1392,789,526,2707,48911
13-11-2016,14,17990,16457,8116,3781,46345,1393,793,527,2713,49058
13-11-2016,15,18948,17148,8243,3798,48138,1413,881,543,2837,50975
13-11-2016,16,20176,18386,8540,4017,51119,1485,1377,547,3409,54528
13-11-2016,17,20417,18872,8616,4018,51923,1482,1749,554,3785,55708
13-11-2016,18,20167,18591,8583,4134,51477,1494,1599,554,3647,55124
13-11-2016,19,19917,18152,8541,4319,50929,1493,1003,546,3042,53971
13-11-2016,20,19341,17312,8340,4154,49146,1505,828,442,2775,51921
13-11-2016,21,18442,16425,8054,3905,46826,1514,842,296,2652,49478
13-11-2016,22,17765,14838,7983,3871,44458,1508,825,300,2633,47091
13-11-2016,23,16431,14194,7762,3837,42225,1429,810,296,2535,44760
14-11-2016,0,14762,13699,7578,3678,39718,1431,814,302,2547,42265
14-11-2016,1,13018,13708,7497,3869,38092,1406,827,325,2558,40650
14-11-2016,2,12727,13751,7525,3922,37925,1347,828,349,2524,40449
14-11-2016,3,13255,13845,7552,3855,38507,1444,819,386,2649,41156
14-11-2016,4,14268,14251,7858,3780,40157,1587,821,430,2838,42995
14-11-2016,5,15686,16127,8376,3980,44170,1768,925,437,3130,47300
14-11-2016,6,18969,18976,8988,4703,51636,1756,1278,566,3600,55236
14-11-2016,7,20880,21074,9270,4782,56006,1751,1616,705,4072,60078
14-11-2016,8,21195,21318,9333,5113,56961,1766,1682,703,4151,61112
14-11-2016,9,20924,20983,9422,5054,56382,1741,1320,725,3786,60168
14-11-2016,10,20410,20337,9290,5271,55309,1735,1144,747,3626,58935
14-11-2016,11,20369,20626,9162,5301,55459,1766,1110,748,3624,59083
14-11-2016,12,19884,20608,9213,5376,55080,1761,1268,769,3798,58878
14-11-2016,13,19837,20697,9138,5295,54967,1759,1419,753,3931,58898
14-11-2016,14,19862,20777,9193,5408,55241,1757,1357,693,3807,59048
14-11-2016,15,19910,21426,9428,5518,56283,1763,1683,738,4184,60467
14-11-2016,16,20200,21772,9694,5675,57341,1774,1957,737,4468,61809
14-11-2016,17,20362,21465,9715,5751,57293,1772,1954,877,4603,61896
14-11-2016,18,19622,20509,9560,5851,55541,1777,1938,768,4483,60024
14-11-2016,19,19140,19735,9088,5741,53704,1773,1162,702,3637,57341
14-11-2016,20,18174,18474,8689,5692,51028,1775,1015,707,3497,54525
14-11-2016,21,17588,17368,8438,5383,48777,1776,1000,610,3386,52163
14-11-2016,22,16161,16167,8146,4908,45381,1767,865,487,3119,48500
14-11-2016,23,14095,15154,7892,4751,41892,1612,854,508,2974,44866
15-11-2016,0,13025,14668,7844,4303,39841,1223,692,508,2423,42264
15-11-2016,1,12493,14483,7685,4198,38859,1147,678,515,2340,41199
15-11-2016,2,12344,14355,7735,3939,38374,1161,676,490,2327,40701
15-11-2016,3,12356,14340,7780,4032,38507,1156,680,477,2313,40820
15-11-2016,4,12886,14517,7949,3896,39247,1309,682,484,2475,41722
15-11-2016,5,14694,15897,8469,4092,43151,1766,701,479,2946,46097
15-11-2016,6,17392,18086,9072,4449,48998,1782,1061,599,3442,52440
15-11-2016,7,19975,19765,9552,4907,54201,1793,1195,676,3664,57865
15-11-2016,8,20224,19946,9581,4629,54380,1812,1187,655,3654,58034
15-11-2016,9,20235,19421,9611,4753,54020,1826,1293,663,3782,57802
15-11-2016,10,20078,18917,9434,4823,53252,1834,1085,606,3525,56777
15-11-2016,11,19970,18960,9363,4732,53025,1835,1224,614,3673,56698
15-11-2016,12,19954,19061,9517,4732,53263,1844,1365,578,3787,57050
15-11-2016,13,19781,19067,9450,4841,53140,1865,1357,525,3747,56887
15-11-2016,14,19512,18961,9473,4888,52836,1869,1387,588,3844,56680
15-11-2016,15,19577,19272,9584,4783,53216,1892,1475,622,3989,57205
15-11-2016,16,20165,19605,9773,4942,54483,1907,1763,789,4459,58942
15-11-2016,17,20625,20088,9745,4969,55429,1911,1764,767,4442,59871
15-11-2016,18,20521,19991,9651,4818,54982,1895,1482,764,4141,59123
15-11-2016,19,20061,19243,9329,4658,53291,1899,914,787,3600,56891
15-11-2016,20,19497,18001,8843,4561,50902,1898,910,737,3545,54447
15-11-2016,21,19144,16614,8412,4432,48602,1923,839,612,3374,51976
15-11-2016,22,17942,15680,8093,4238,45952,1596,728,464,2788,48740
15-11-2016,23,15839,14855,7801,3633,42128,1480,723,521,2724,44852
16-11-2016,0,14733,14155,7762,3060,39710,1411,715,484,2610,42320
16-11-2016,1,14069,14076,7560,3020,38726,1365,702,531,2598,41324
16-11-2016,2,13553,13908,7399,2955,37816,1345,682,524,2551,40367
16-11-2016,3,13744,13677,7351,2726,37500,1376,677,430,2483,39983
16-11-2016,4,14919,13749,7538,2614,38820,1555,683,405,2643,41463
16-11-2016,5,17172,15501,8149,2990,43814,1784,703,440,2927,46741
16-11-2016,6,19903,17943,8637,3692,50176,1728,1311,592,3631,53807
16-11-2016,7,20959,19593,8989,4400,53941,1697,1778,876,4351,58292
16-11-2016,8,21063,19870,9014,4475,54424,1676,1789,864,4329,58753
16-11-2016,9,21093,19398,8989,4464,53944,1674,1834,841,4349,58293
16-11-2016,10,20753,19050,8929,4422,53155,1678,1452,617,3747,56902
16-11-2016,11,20322,19042,8774,4727,52866,1677,1372,553,3602,56468
16-11-2016,12,20472,19065,8768,4744,53048,1671,1658,530,3859,56907
16-11-2016,13,20312,19180,8961,4790,53243,1676,1385,536,3597,56840
16-11-2016,14,20113,19423,8815,4950,53301,1671,1429,588,3688,56989
16-11-2016,15,19981,20006,8709,4957,53653,1667,1683,818,4168,57821
16-11-2016,16,20216,20642,8823,5091,54773,1679,1635,885,4199,58972
16-11-2016,17,19950,20977,8740,5181,54848,1680,1832,845,4357,59205
16-11-2016,18,19584,20606,8497,5126,53812,1676,1492,679,3847,57659
16-11-2016,19,19166,19847,8207,4964,52185,1683,823,679,3185,55370
16-11-2016,20,18118,18271,7855,4719,48963,1699,878,712,3289,52252
16-11-2016,21,17559,17033,7501,4570,46662,1722,702,654,3078,49740
16-11-2016,22,15303,16340,7404,4293,43339,1578,700,495,2773,46112
16-11-2016,23,12855,15995,7247,4042,40140,1393,698,465,2556,42696
17-11-2016,0,12032,15835,7144,3828,38839,1154,720,436,2310,41149
17-11-2016,1,11458,15790,7145,3784,38178,1088,725,451,2264,40442
17-11-2016,2,11229,15716,7182,3702,37829,1060,730,483,2273,40102
17-11-2016,3,11519,15728,7227,3674,38147,1064,736,495,2295,40442
17-11-2016,4,12199,15772,7305,3664,38940,1157,737,501,2395,41335
17-11-2016,5,14596,16904,7625,3659,42785,1547,740,569,2856,45641
17-11-2016,6,17804,18602,8254,4084,48744,1580,905,706,3191,51935
17-11-2016,7,20197,20373,8788,4330,53689,1589,1189,761,3539,57228
17-11-2016,8,20766,20518,8954,4386,54625,1567,1315,710,3592,58217
17-11-2016,9,20422,20215,8871,4666,54175,1578,1119,731,3428,57603
17-11-2016,10,19963,19566,8665,4630,52824,1533,977,718,3228,56052
17-11-2016,11,19827,19470,8645,4735,52675,1519,953,718,3190,55865
17-11-2016,12,19973,19352,8755,4706,52786,1517,950,615,3082,55868
17-11-2016,13,19954,19306,8868,4606,52734,1521,961,667,3149,55883
17-11-2016,14,19889,19738,8951,4630,53208,1491,1070,678,3239,56447
17-11-2016,15,20016,20168,9157,4717,54058,1473,1162,690,3325,57383
17-11-2016,16,20384,20348,9214,4673,54618,1475,1687,682,3844,58462
17-11-2016,17,20360,20553,9107,4532,54552,1481,1796,797,4074,58626
17-11-2016,18,19688,20376,8975,4515,53554,1488,1454,675,3617,57171
17-11-2016,19,18622,19376,8801,4514,51314,1479,877,698,3054,54368
17-11-2016,20,17789,18168,8567,4630,49154,1479,852,738,3069,52223
17-11-2016,21,17173,16993,8150,4808,47125,1464,695,777,2936,50061
17-11-2016,22,15071,15832,7946,4942,43793,1394,685,594,2673,46466
17-11-2016,23,13570,15273,7634,5120,41596,1142,676,612,2430,44026
18-11-2016,0,12496,14975,7524,5025,40020,1034,603,574,2211,42231
18-11-2016,1,11731,14910,7463,4639,38742,1029,584,517,2130,40872
18-11-2016,2,11392,15151,7426,4422,38392,1035,572,521,2128,40520
18-11-2016,3,11650,15336,7489,4064,38539,1056,564,500,2120,40659
18-11-2016,4,12254,15630,7540,4437,39860,1087,565,501,2153,42013
18-11-2016,5,14198,16465,7996,4348,43006,1396,583,605,2584,45590
18-11-2016,6,16902,17962,8509,4601,47973,1421,869,748,3038,51011
18-11-2016,7,19427,20125,8807,5008,53368,1439,961,754,3154,56522
18-11-2016,8,19845,20343,8914,4842,53945,1463,979,768,3210,57155
18-11-2016,9,19647,20064,8728,4912,53352,1480,962,790,3232,56584
18-11-2016,10,19473,19286,8624,4985,52369,1493,935,841,3269,55638
18-11-2016,11,19498,19085,8633,5176,52391,1561,934,833,3328,55719
18-11-2016,12,19552,19295,8806,5138,52792,1588,848,865,3301,56093
18-11-2016,13,18682,18743,8661,5470,51556,1580,1264,788,3632,55188
18-11-2016,14,18566,18496,8682,5504,51248,1576,1423,654,3653,54901
18-11-2016,15,19429,18615,8643,5781,52468,1536,1488,677,3701,56169
18-11-2016,16,20037,19228,8805,5543,53613,1550,1478,678,3706,57319
18-11-2016,17,20190,19617,8806,5536,54149,1590,1297,679,3566,57715
18-11-2016,18,19745,19158,8634,5505,53040,1585,1481,728,3794,56834
18-11-2016,19,18363,18155,8286,5467,50271,1583,1101,733,3417,53688
18-11-2016,20,16678,17460,7831,5154,47123,1562,979,729,3270,50393
18-11-2016,21,15602,16852,7856,4731,45041,1470,700,710,2880,47921
18-11-2016,22,14445,16143,7854,4605,43048,1005,548,614,2167,45215
18-11-2016,23,12680,15572,7673,4583,40509,954,554,599,2107,42616
19-11-2016,0,12268,15365,7673,4439,39746,974,534,335,1843,41589
19-11-2016,1,11411,15305,7532,4359,38607,948,487,335,1770,40377
19-11-2016,2,11173,15253,7502,4326,38254,949,484,333,1766,40020
19-11-2016,3,10795,15278,7513,4252,37838,921,484,350,1755,39593
19-11-2016,4,10912,15315,7580,4159,37967,931,494,379,1804,39771
19-11-2016,5,11475,15490,7575,4233,38771,924,550,351,1825,40596
19-11-2016,6,12441,15834,7749,4389,40413,926,768,402,2096,42509
19-11-2016,7,14705,16125,7767,4560,43156,911,812,399,2122,45278
19-11-2016,8,16472,16294,7931,4880,45576,985,881,368,2234,47810
19-11-2016,9,17726,16530,8152,4993,47401,991,856,311,2158,49559
19-11-2016,10,18071,16751,8253,5014,48090,1068,809,226,2103,50193
19-11-2016,11,18116,16745,8267,4889,48017,1083,874,188,2145,50162
19-11-2016,12,18045,16710,8287,4792,47835,1092,967,155,2214,50049
19-11-2016,13,17837,16745,8278,4773,47634,1066,1190,135,2391,50025
19-11-2016,14,17946,16846,8384,4581,47757,1029,1482,167,2678,50435
19-11-2016,15,18660,17356,8563,4559,49137,1025,1480,186,2691,51828
19-11-2016,16,19171,18135,8857,4754,50917,1079,1532,201,2812,53729
19-11-2016,17,19620,18380,8852,4857,51709,1088,1490,191,2769,54478
19-11-2016,18,19573,17634,8813,4572,50592,1065,1359,181,2605,53197
19-11-2016,19,18815,17259,8686,4485,49244,984,1222,170,2376,51620
19-11-2016,20,17017,16528,8425,4044,46014,961,883,179,2023,48037
19-11-2016,21,16528,15866,8171,3920,44485,974,721,178,1873,46358
19-11-2016,22,15321,15142,8035,3934,42432,779,570,120,1469,43901
19-11-2016,23,13700,14962,7874,3923,40459,774,564,117,1455,41914
20-11-2016,0,12420,14614,7682,3933,38649,790,562,125,1477,40126
20-11-2016,1,11644,14354,7499,3806,37303,798,558,152,1508,38811
20-11-2016,2,11462,14303,7303,3709,36776,783,556,147,1486,38262
20-11-2016,3,11363,14142,7201,3520,36226,775,540,153,1468,37694
20-11-2016,4,11563,14001,7217,3602,36385,786,541,175,1502,37887
20-11-2016,5,12131,13913,7341,3668,37053,804,575,186,1565,38618
20-11-2016,6,12713,14072,7386,3929,38101,894,768,267,1929,40030
20-11-2016,7,13674,14223,7576,4182,39656,1010,871,236,2117,41773
20-11-2016,8,14334,14564,7541,4487,40925,1017,850,257,2124,43049
20-11-2016,9,15457,15018,7693,4665,42834,1023,871,243,2137,44971
20-11-2016,10,16730,15463,7761,4900,44854,1085,899,199,2183,47037
20-11-2016,11,16727,15548,7747,4974,44996,1078,1130,204,2412,47408
20-11-2016,12,17057,15424,7785,5179,45444,1048,1115,204,2367,47811
20-11-2016,13,16821,15673,7795,5114,45404,1015,1133,195,2343,47747
20-11-2016,14,16483,15979,7853,5135,45450,972,1163,213,2348,47798
20-11-2016,15,16722,16533,7847,5222,46324,929,1254,262,2445,48769
20-11-2016,16,16969,17178,7877,5213,47237,1006,1486,524,3016,50253
20-11-2016,17,17582,17519,7968,5190,48259,984,1567,454,3005,51264
20-11-2016,18,17349,17485,7901,5132,47866,969,1504,583,3056,50922
20-11-2016,19,17226,17340,7854,4818,47237,943,941,504,2388,49625
20-11-2016,20,16248,16994,7693,4536,45471,971,882,463,2316,47787
20-11-2016,21,15727,16535,7615,4376,44253,1018,758,464,2240,46493
20-11-2016,22,14781,16250,7671,4467,43170,970,619,434,2023,45193
20-11-2016,23,12854,16050,7459,4018,40381,980,601,441,2022,42403
21-11-2016,0,12373,15958,7219,4234,39785,937,458,429,1824,41609
21-11-2016,1,11779,15774,7181,4197,38930,969,453,402,1824,40754
21-11-2016,2,11573,15844,7169,3999,38585,994,454,391,1839,40424
21-11-2016,3,11100,15822,7228,3739,37889,1025,453,391,1869,39758
21-11-2016,4,11502,15987,7366,3321,38177,1142,523,394,2059,40236
21-11-2016,5,13939,16814,7545,2916,41214,1316,613,379,2308,43522
21-11-2016,6,17318,18625,8033,3246,47221,1750,787,412,2949,50170
21-11-2016,7,20575,20772,8492,3678,53517,1754,969,579,3302,56819
21-11-2016,8,21353,20809,8519,3685,54366,1766,976,570,3312,57678
21-11-2016,9,21903,20236,8461,3597,54197,1719,945,702,3366,57563
21-11-2016,10,21719,19252,8373,3785,53129,1727,1165,687,3579,56708
21-11-2016,11,21357,18941,8362,3780,52439,1755,1317,534,3606,56045
21-11-2016,12,21302,19435,8605,3822,53165,1728,1337,537,3602,56767
21-11-2016,13,21234,20010,8615,3966,53826,1746,1351,549,3646,57472
21-11-2016,14,21423,19811,8617,3619,53470,1717,1305,572,3594,57064
21-11-2016,15,21335,20115,8790,3999,54239,1745,1326,573,3644,57883
21-11-2016,16,21681,20277,8738,3889,54585,1734,1567,621,3922,58507
21-11-2016,17,21454,20337,8742,3982,54515,1747,1759,711,4217,58732
21-11-2016,18,20744,19416,8677,4259,53097,1760,1185,766,3711,56808
21-11-2016,19,19506,18131,8415,4294,50346,1762,920,767,3449,53795
21-11-2016,20,18729,16883,7760,4233,47604,1762,795,793,3350,50954
21-11-2016,21,17361,15976,7269,4262,44869,1756,682,757,3195,48064
21-11-2016,22,15376,15723,7107,4265,42469,1569,619,586,2774,45243
21-11-2016,23,13430,15230,7038,3961,39660,1365,595,588,2548,42208
22-11-2016,0,12690,14444,6998,3775,37906,1110,566,588,2264,40170
22-11-2016,1,11927,14159,6914,3620,36621,1102,565,576,2243,38864
22-11-2016,2,11133,14024,6947,3625,35729,1094,568,577,2239,37968
22-11-2016,3,11154,13897,6996,3599,35647,1077,582,582,2241,37888
22-11-2016,4,12330,14090,7036,3507,36962,1108,587,578,2273,39235
22-11-2016,5,14315,15025,7192,3492,40024,1448,1009,563,3020,43044
22-11-2016,6,17556,16859,7627,4042,46084,1554,1029,772,3355,49439
22-11-2016,7,20064,18905,8000,4548,51518,1568,1325,1061,3954,55472
22-11-2016,8,20630,19269,8144,4306,52350,1604,1320,1063,3987,56337
22-11-2016,9,20452,18818,8036,3689,50995,1601,1286,893,3780,54775
22-11-2016,10,20147,18498,7973,3886,50504,1556,1294,624,3474,53978
22-11-2016,11,20506,19055,7986,3785,51334,1602,1274,601,3477,54811
22-11-2016,12,20362,19758,8033,3280,51432,1566,1259,610,3435,54867
22-11-2016,13,20361,19740,8120,3563,51785,1636,1264,671,3571,55356
22-11-2016,14,20558,19584,8359,3816,52314,1646,1475,661,3782,56096
22-11-2016,15,20900,19856,8608,3883,53249,1643,1442,877,3962,57211
22-11-2016,16,21205,20339,8709,3961,54214,1673,1447,838,3958,58172
22-11-2016,17,21163,20613,8798,4068,54641,1720,1455,837,4012,58653
22-11-2016,18,20674,20294,8632,3938,53539,1730,1465,842,4037,57576
22-11-2016,19,19920,19189,8536,3926,51570,1748,1093,934,3775,55345
22-11-2016,20,19463,17641,8459,3873,49435,1724,1015,784,3523,52958
22-11-2016,21,18675,16240,8264,3694,46874,1728,996,637,3361,50235
22-11-2016,22,17289,15350,8167,3669,44474,1703,620,384,2707,47181
22-11-2016,23,14832,14933,7964,3518,41246,1480,635,367,2482,43728
23-11-2016,0,13647,14394,7974,3235,39250,1236,769,290,2295,41545
23-11-2016,1,12715,14076,7868,3194,37853,1194,780,277,2251,40104
23-11-2016,2,12231,13853,7800,3254,37138,1194,784,323,2301,39439
23-11-2016,3,12049,13765,7705,3154,36673,1183,787,310,2280,38953
23-11-2016,4,13090,14210,7723,3199,38222,1216,788,250,2254,40476
23-11-2016,5,14956,15096,7928,3463,41443,1591,1050,239,2880,44323
23-11-2016,6,18379,17323,8340,3598,47641,1810,1137,278,3225,50866
23-11-2016,7,19970,19666,8679,3686,52002,1824,1218,452,3494,55496
23-11-2016,8,19699,19805,8622,4180,52306,1918,1396,420,3734,56040
23-11-2016,9,19842,19475,8568,4194,52079,1895,1299,232,3426,55505
23-11-2016,10,19956,19586,8431,3988,51960,1886,1307,152,3345,55305
23-11-2016,11,19893,19852,8359,3969,52074,1894,1455,143,3492,55566
23-11-2016,12,20204,19955,8424,3816,52398,1874,1458,130,3462,55860
23-11-2016,13,20578,20160,8432,3790,52961,1847,1474,139,3460,56421
23-11-2016,14,20530,20424,8575,3707,53235,1868,1472,107,3447,56682
23-11-2016,15,20967,20697,8722,3623,54008,1876,1583,190,3649,57657
23-11-2016,16,21586,21167,8851,3621,55226,1868,1629,385,3882,59108
23-11-2016,17,21606,21180,8853,3898,55536,1879,1630,386,3895,59431
23-11-2016,18,21386,20733,8641,3801,54561,1849,1627,390,3866,58427
23-11-2016,19,20982,20078,8369,3371,52801,1834,1210,263,3307,56108
23-11-2016,20,20468,18488,8022,2964,49942,1858,1108,152,3118,53060
23-11-2016,21,19800,17401,7654,2996,47851,1857,1076,155,3088,50939
23-11-2016,22,17943,16305,7422,3141,44811,1806,731,112,2649,47460
23-11-2016,23,15045,15493,7269,3084,40891,1550,731,105,2386,43277
24-11-2016,0,13392,15103,7104,3065,38664,1461,890,109,2460,41124
24-11-2016,1,12995,15268,7003,2825,38091,1487,891,110,2488,40579
24-11-2016,2,12370,15362,6927,2736,37396,1500,887,110,2497,39893
24-11-2016,3,12251,15516,6965,2663,37394,1507,888,112,2507,39901
24-11-2016,4,12468,15821,7092,2562,37943,1519,888,157,2564,40507
24-11-2016,5,14984,16918,7497,2620,42020,1588,992,179,2759,44779
24-11-2016,6,18407,18599,8132,2809,47947,1834,1049,267,3150,51097
24-11-2016,7,21342,21513,8750,3388,54995,1914,1073,297,3284,58279
24-11-2016,8,21678,21870,8860,3424,55833,1939,1286,498,3723,59556
24-11-2016,9,21459,21529,8845,3367,55201,1976,1207,508,3691,58892
24-11-2016,10,21130,21053,8895,3496,54574,1980,1232,356,3568,58142
24-11-2016,11,21277,21120,8947,3508,54852,1981,1306,317,3604,58456
24-11-2016,12,21172,21320,9053,3475,55022,1979,1296,294,3569,58591
24-11-2016,13,21543,21365,8999,3552,55461,1991,1293,245,3529,58990
24-11-2016,14,21736,21154,9087,3260,55236,2004,1297,228,3529,58765
24-11-2016,15,21940,21547,9063,3239,55789,2020,1550,403,3973,59762
24-11-2016,16,22496,21891,9203,3402,56993,2022,1572,430,4024,61017
24-11-2016,17,22479,21979,9172,3349,56982,2020,1563,399,3982,60964
24-11-2016,18,22360,21240,9135,3267,56003,2020,1571,429,4020,60023
24-11-2016,19,22114,20617,9097,3067,54894,1986,1259,266,3511,58405
24-11-2016,20,21031,18807,8653,2748,51240,1996,1163,281,3440,54680
24-11-2016,21,20415,17369,8429,2604,48818,1955,1165,230,3350,52168
24-11-2016,22,18689,15926,8208,2493,45316,1927,971,207,3105,48421
24-11-2016,23,16461,15138,7737,2382,41718,1655,974,180,2809,44527
25-11-2016,0,16753,14477,7522,2441,41194,1648,959,183,2790,43984
25-11-2016,1,15230,14171,7385,2265,39052,1514,954,176,2644,41696
25-11-2016,2,14447,14010,7316,2298,38071,1469,953,158,2580,40651
25-11-2016,3,14139,13962,7314,2309,37726,1474,953,169,2596,40322
25-11-2016,4,15038,14178,7497,2359,39071,1544,954,197,2695,41766
25-11-2016,5,17683,15637,7907,2648,43874,1865,1142,205,3212,47086
25-11-2016,6,20140,18390,8555,3217,50302,1914,1219,251,3384,53686
25-11-2016,7,22438,21603,8796,3374,56213,1925,1558,339,3822,60035
25-11-2016,8,22807,22197,8807,3406,57218,1882,1553,358,3793,61011
25-11-2016,9,22525,22258,8596,3391,56771,1870,1528,357,3755,60526
25-11-2016,10,22045,22091,8579,3367,56083,1812,1377,331,3520,59603
25-11-2016,11,21947,22261,8644,3287,56139,1806,1324,326,3456,59595
25-11-2016,12,21751,22172,8690,3353,55968,1792,1310,341,3443,59411
25-11-2016,13,21514,21987,8693,3524,55718,1814,1316,316,3446,59164
25-11-2016,14,21331,21943,8744,3555,55572,1781,1356,351,3488,59060
25-11-2016,15,21369,22093,8878,3474,55815,1796,1420,393,3609,59424
25-11-2016,16,21453,22217,8895,3607,56171,1817,1423,422,3662,59833
25-11-2016,17,21243,21896,8938,3676,55753,1818,1225,433,3476,59229
25-11-2016,18,21243,21363,8758,3631,54995,1817,1141,462,3420,58415
25-11-2016,19,20440,20213,8647,3574,52876,1825,1157,291,3273,56149
25-11-2016,20,19156,19457,8600,3664,50876,1704,1161,333,3198,54074
25-11-2016,21,18389,18811,8530,3683,49413,1325,1066,358,2749,52162
25-11-2016,22,16977,17897,8297,3556,46727,1219,968,325,2512,49239
25-11-2016,23,14935,17195,8171,3577,43877,1102,957,351,2410,46287
26-11-2016,0,13742,16441,8057,3780,42019,1118,633,398,2149,44168
26-11-2016,1,12631,16408,7880,3638,40559,1134,627,388,2149,42708
26-11-2016,2,12269,16374,7711,3707,40061,1146,611,409,2166,42227
26-11-2016,3,12132,16378,7619,3776,39906,1130,604,423,2157,42063
26-11-2016,4,11642,16350,7526,3929,39449,1144,606,443,2193,41642
26-11-2016,5,12115,16432,7503,4028,40079,1148,608,427,2183,42262
26-11-2016,6,12952,16704,7586,4192,41434,1144,614,477,2235,43669
26-11-2016,7,14108,16894,7734,4558,43295,1092,906,493,2491,45786
26-11-2016,8,15326,17502,7722,4774,45323,1054,1093,492,2639,47962
26-11-2016,9,16216,17878,7787,4924,46805,1082,1114,498,2694,49499
26-11-2016,10,16428,18154,7807,5183,47571,1054,1188,505,2747,50318
26-11-2016,11,16251,18196,7748,5405,47600,1083,1190,504,2777,50377
26-11-2016,12,15855,18274,7849,5580,47559,1071,1186,505,2762,50321
26-11-2016,13,15583,18047,7894,5594,47118,1074,1188,503,2765,49883
26-11-2016,14,16109,18138,7995,5554,47797,1107,1192,504,2803,50600
26-11-2016,15,16617,18627,7972,5522,48738,1279,1291,506,3076,51814
26-11-2016,16,17385,19214,8009,5628,50237,1362,1357,505,3224,53461
26-11-2016,17,18721,19377,8127,5677,51901,1338,1353,500,3191,55092
26-11-2016,18,18064,18065,8014,5420,49564,1347,1346,493,3186,52750
26-11-2016,19,16992,17847,7973,5349,48162,1212,1288,463,2963,51125
26-11-2016,20,15115,17128,8007,5590,45839,1112,1109,402,2623,48462
26-11-2016,21,14851,16849,7966,5444,45110,1091,790,374,2255,47365
26-11-2016,22,13939,16568,8029,5318,43855,1086,648,267,2001,45856
26-11-2016,23,13000,16178,7849,5026,42053,1093,634,233,1960,44013
27-11-2016,0,11911,16136,7744,4404,40194,1117,614,214,1945,42139
27-11-2016,1,11496,16082,7629,4287,39494,1089,610,252,1951,41445
27-11-2016,2,11019,15934,7654,3886,38492,1078,612,267,1957,40449
27-11-2016,3,10470,15963,7700,3590,37722,1058,605,271,1934,39656
27-11-2016,4,10136,16065,7819,3555,37575,1063,616,269,1948,39523
27-11-2016,5,10111,16103,7902,3698,37814,1094,625,273,1992,39806
27-11-2016,6,11271,16271,8151,3813,39506,1067,706,267,2040,41546
27-11-2016,7,13020,16464,8262,3943,41689,1065,685,253,2003,43692
27-11-2016,8,14169,16780,8230,4248,43425,1049,686,275,2010,45435
27-11-2016,9,16011,17034,8325,4495,45865,1193,888,249,2330,48195
27-11-2016,10,17207,17310,8370,4412,47297,1284,1083,294,2661,49958
27-11-2016,11,17567,17571,8463,4441,48042,1340,1250,331,2921,50963
27-11-2016,12,17215,17974,8438,4417,48043,1317,1282,341,2940,50983
27-11-2016,13,16163,18071,8470,4435,47138,1202,1307,379,2888,50026
27-11-2016,14,16563,18122,8835,4228,47747,1261,1444,350,3055,50802
27-11-2016,15,17298,18769,9069,4208,49344,1315,1451,321,3087,52431
27-11-2016,16,18612,19548,9074,4520,51753,1381,1649,302,3332,55085
27-11-2016,17,19040,19781,9128,4653,52603,1395,1651,293,3339,55942
27-11-2016,18,18493,19569,9162,4727,51950,1396,1644,291,3331,55281
27-11-2016,19,18028,19049,9053,4965,51097,1370,1433,311,3114,54211
27-11-2016,20,17462,17790,9135,4953,49339,1380,1345,300,3025,52364
27-11-2016,21,15828,16931,8895,4683,46338,1237,1383,302,2922,49260
27-11-2016,22,14917,16408,8709,4621,44656,1162,1010,327,2499,47155
27-11-2016,23,13472,16269,8442,4320,42503,1199,739,287,2225,44728
28-11-2016,0,11964,16013,8173,4097,40247,1210,668,302,2180,42427
28-11-2016,1,11183,15971,8219,3902,39276,1258,671,325,2254,41530
28-11-2016,2,10840,15843,8241,3745,38669,1307,673,296,2276,40945
28-11-2016,3,11454,15696,8245,3614,39008,1405,679,255,2339,41347
28-11-2016,4,13168,15861,8334,3567,40931,1478,951,272,2701,43632
28-11-2016,5,16087,16935,8620,3474,45115,1697,1010,323,3030,48145
28-11-2016,6,19664,18813,9254,3890,51621,1881,1167,423,3471,55092
28-11-2016,7,23116,21399,9827,4163,58505,1858,1440,580,3878,62383
28-11-2016,8,23738,22487,9952,4169,60347,1834,1441,594,3869,64216
28-11-2016,9,23162,21809,9926,3980,58879,1851,1562,474,3887,62766
28-11-2016,10,22699,20806,9767,3805,57078,1850,1568,366,3784,60862
28-11-2016,11,22791,21453,9867,3712,57821,1836,1609,363,3808,61629
28-11-2016,12,22173,20643,9807,3538,56161,1839,1585,403,3827,59988
28-11-2016,13,22608,21198,9859,3545,57211,1842,1616,379,3837,61048
28-11-2016,14,22819,22125,9861,3500,58306,1914,1638,467,4019,62325
28-11-2016,15,22821,22650,9987,3382,58839,1890,1670,463,4023,62862
28-11-2016,16,23198,23045,9965,3586,59794,1876,1667,454,3997,63791
28-11-2016,17,22992,23537,9947,3698,60173,1874,1712,523,4109,64282
28-11-2016,18,22558,23280,9721,3753,59312,1883,1762,588,4233,63545
28-11-2016,19,22282,22000,9618,3821,57721,1882,1597,439,3918,61639
28-11-2016,20,21989,20093,9406,3952,55441,1893,1418,498,3809,59250
28-11-2016,21,21441,18329,8890,3986,52647,1892,1315,413,3620,56267
28-11-2016,22,19502,17249,8563,4045,49359,1901,1132,430,3463,52822
28-11-2016,23,17531,16289,8118,4139,46076,1727,1036,444,3207,49283
29-11-2016,0,17599,15343,7820,4139,44902,1648,1098,440,3186,48088
29-11-2016,1,17252,14890,7692,4145,43978,1589,1083,430,3102,47080
29-11-2016,2,16709,14802,7736,4184,43431,1559,1097,388,3044,46475
29-11-2016,3,16716,14671,7787,4321,43494,1507,1099,318,2924,46418
29-11-2016,4,17490,14861,8099,4383,44832,1781,1105,275,3161,47993
29-11-2016,5,18198,16816,8521,4528,48062,1866,1187,221,3274,51336
29-11-2016,6,19992,19713,9210,4596,53510,1837,1610,253,3700,57210
29-11-2016,7,22141,21742,9730,4801,58415,1839,1919,449,4207,62622
29-11-2016,8,22678,22230,9953,4818,59680,1834,1925,414,4173,63853
29-11-2016,9,22355,22149,9972,4713,59190,1818,1922,373,4113,63303
29-11-2016,10,21833,21730,9872,4762,58197,1835,1648,77,3560,61757
29-11-2016,11,21443,21440,9709,4811,57403,1832,1643,110,3585,60988
29-11-2016,12,21415,21560,9539,4791,57304,1842,1595,78,3515,60819
29-11-2016,13,21361,22180,9602,4764,57906,1839,1588,77,3504,61410
29-11-2016,14,21187,22054,9733,4786,57759,1849,1546,78,3473,61232
29-11-2016,15,21382,22413,9753,4832,58381,1872,1557,292,3721,62102
29-11-2016,16,21646,23097,9809,5065,59618,1902,1771,359,4032,63650
29-11-2016,17,21338,23250,9773,5209,59570,1933,1833,404,4170,63740
29-11-2016,18,20757,22419,9568,5305,58051,1959,1691,270,3920,61971
29-11-2016,19,19999,20781,9359,5395,55534,1964,1689,264,3917,59451
29-11-2016,20,18768,19835,9094,5524,53222,1996,1388,282,3666,56888
29-11-2016,21,17064,18813,8715,5474,50066,1945,1387,313,3645,53711
29-11-2016,22,15226,18185,8407,5521,47340,1549,1334,286,3169,50509
29-11-2016,23,12828,17485,8212,5467,43991,1525,1245,304,3074,47065
30-11-2016,0,12763,17121,8056,5306,43247,1496,939,363,2798,46045
30-11-2016,1,11913,16811,7884,5141,41750,1464,788,371,2623,44373
30-11-2016,2,11641,16746,7822,4997,41207,1502,790,389,2681,43888
30-11-2016,3,11526,16751,7914,5091,41283,1420,743,429,2592,43875
30-11-2016,4,12349,17145,8087,5081,42663,1437,1031,438,2906,45569
30-11-2016,5,13803,18125,8399,4987,45315,1510,1128,463,3101,48416
30-11-2016,6,17176,20071,8902,5343,51491,1908,1305,457,3670,55161
30-11-2016,7,19561,21739,9134,5515,55949,1930,1446,456,3832,59781
30-11-2016,8,19943,22084,9144,5597,56767,1916,1464,420,3800,60567
30-11-2016,9,20291,21906,8957,5389,56544,1923,1488,407,3818,60362
30-11-2016,10,20121,21500,8905,5234,55761,1920,1458,387,3765,59526
30-11-2016,11,20143,21382,8849,5105,55480,1912,1519,386,3817,59297
30-11-2016,12,19519,21201,8819,5045,54583,1919,1535,378,3832,58415
30-11-2016,13,19252,21037,8893,5153,54334,1904,1533,331,3768,58102
30-11-2016,14,19875,21333,9073,5174,55455,1887,1538,338,3763,59218
30-11-2016,15,20031,22014,9322,5345,56712,1886,1619,327,3832,60544
30-11-2016,16,20503,23069,9476,5325,58373,1872,1672,361,3905,62278
30-11-2016,17,20682,23034,9410,5457,58584,1880,1675,392,3947,62531
30-11-2016,18,20356,22070,9362,5357,57145,1887,1679,324,3890,61035
30-11-2016,19,19566,20624,9191,5410,54792,1888,1521,321,3730,58522
30-11-2016,20,18842,18973,8837,5467,52119,1881,1344,313,3538,55657
30-11-2016,21,17191,17793,8447,5265,48697,1869,1191,280,3340,52037
30-11-2016,22,15624,16833,8241,5054,45752,1515,1114,226,2855,48607
30-11-2016,23,13497,16249,8128,4755,42629,1442,1105,219,2766,45395
01-12-2016,0,13151,15371,8108,4427,41057,1264,753,251,2268,43325
01-12-2016,1,12603,15167,7945,4448,40163,1258,732,247,2237,42400
01-12-2016,2,12289,15111,7906,4446,39752,1265,731,242,2238,41990
01-12-2016,3,12425,15163,7902,4543,40033,1267,736,235,2238,42271
01-12-2016,4,13101,15318,7934,4707,41060,1301,742,237,2280,43340
01-12-2016,5,14355,16300,8330,4874,43860,1748,761,235,2744,46604
01-12-2016,6,17442,18583,8602,5201,49829,1769,1066,240,3075,52904
01-12-2016,7,19593,20808,8960,5495,54855,1751,1475,272,3498,58353
01-12-2016,8,19971,21392,8983,5657,56004,1734,1487,258,3479,59483
01-12-2016,9,19916,20800,8904,5694,55313,1743,1484,188,3415,58728
01-12-2016,10,19641,20655,8936,5913,55145,1749,1303,202,3254,58399
01-12-2016,11,19169,20737,8893,6167,54966,1747,1302,212,3261,58227
01-12-2016,12,19450,20937,8985,6112,55483,1760,1115,157,3032,58515
01-12-2016,13,18873,21059,8966,6083,54982,1777,1109,137,3023,58005
01-12-2016,14,18486,21226,8877,6445,55034,1798,962,128,2888,57922
01-12-2016,15,18833,21841,9043,6399,56116,1783,1047,401,3231,59347
01-12-2016,16,19539,22434,8976,6234,57184,1787,1326,386,3499,60683
01-12-2016,17,19893,22335,8970,6022,57221,1792,1464,355,3611,60832
01-12-2016,18,19665,21390,8812,6250,56116,1779,1391,238,3408,59524
01-12-2016,19,19500,20163,8792,6002,54457,1780,1215,130,3125,57582
01-12-2016,20,18309,19287,8647,5792,52035,1754,811,91,2656,54691
01-12-2016,21,16751,18386,8377,5539,49053,1720,812,88,2620,51673
01-12-2016,22,15368,17664,8110,5331,46473,1300,732,85,2117,48590
01-12-2016,23,13587,17141,7973,5181,43882,1218,729,61,2008,45890
02-12-2016,0,13465,16952,7998,4700,43115,1213,550,59,1822,44937
02-12-2016,1,12965,16759,7998,4550,42273,1202,520,60,1782,44055
02-12-2016,2,12664,16621,8019,4114,41418,1188,515,63,1766,43184
02-12-2016,3,12769,16577,8048,3726,41120,1180,517,61,1758,42878
02-12-2016,4,13500,16798,8201,3563,42062,1170,573,64,1807,43869
02-12-2016,5,15910,17717,8520,3666,45812,1416,847,94,2357,48169
02-12-2016,6,18930,19877,8905,3903,51614,1647,1026,117,2790,54404
02-12-2016,7,21586,22502,9578,4436,58101,1648,1299,163,3110,61211
02-12-2016,8,22451,23274,9733,4608,60066,1644,1302,244,3190,63256
02-12-2016,9,21949,22882,9704,4611,59148,1661,1488,217,3366,62514
02-12-2016,10,21990,22395,9695,4613,58694,1655,1314,202,3171,61865
02-12-2016,11,21641,22294,9699,4483,58116,1644,1297,240,3181,61297
02-12-2016,12,21600,21973,9731,4225,57529,1635,1265,281,3181,60710
02-12-2016,13,21743,21887,9779,3914,57322,1658,1356,279,3293,60615
02-12-2016,14,21949,21832,10080,3564,57425,1654,1412,248,3314,60739
02-12-2016,15,22061,22071,10264,3619,58016,1677,1452,248,3377,61393
02-12-2016,16,22497,22489,10372,3755,59114,1681,1643,483,3807,62921
02-12-2016,17,22687,22083,10281,3997,59047,1693,1634,484,3811,62858
02-12-2016,18,22344,21452,10101,3873,57769,1714,1483,280,3477,61246
02-12-2016,19,22156,20135,9857,3535,55683,1717,1313,260,3290,58973
02-12-2016,20,21513,18709,9534,3201,52957,1729,1282,248,3259,56216
02-12-2016,21,21443,17769,9440,2978,51629,1743,1098,233,3074,54703
02-12-2016,22,20806,16698,9100,2828,49432,1758,1014,245,3017,52449
02-12-2016,23,19717,15788,8895,2587,46990,1797,886,233,2916,49906
03-12-2016,0,17953,15169,8817,2601,44541,1368,856,207,2431,46972
03-12-2016,1,17371,14907,8667,2566,43511,1196,835,206,2237,45748
03-12-2016,2,17821,14759,8610,2563,43754,1288,835,226,2349,46103
03-12-2016,3,17616,14690,8512,2692,43510,1217,827,238,2282,45792
03-12-2016,4,17770,14751,8568,2928,44015,1224,836,231,2291,46306
03-12-2016,5,17744,14891,8654,3061,44350,1262,837,229,2328,46678
03-12-2016,6,19136,15563,8969,3247,46916,1416,839,245,2500,49416
03-12-2016,7,19936,16544,9100,3408,48987,1397,912,265,2574,51561
03-12-2016,8,21124,17724,9302,3637,51787,1416,1005,283,2704,54491
03-12-2016,9,21674,18825,9397,3657,53554,1402,1212,244,2858,56412
03-12-2016,10,21637,19117,9261,3529,53544,1407,1221,208,2836,56380
03-12-2016,11,21342,18659,9129,3560,52689,1399,1214,175,2788,55477
03-12-2016,12,20914,18165,9104,3502,51685,1393,1208,177,2778,54463
03-12-2016,13,20837,17963,9097,3486,51383,1388,1198,164,2750,54133
03-12-2016,14,21040,18943,9237,3414,52634,1372,1203,143,2718,55352
03-12-2016,15,21714,20026,9518,3647,54905,1380,1566,159,3105,58010
03-12-2016,16,22169,20848,9723,3744,56484,1393,1634,276,3303,59787
03-12-2016,17,22365,20951,9784,3884,56983,1406,1640,355,3401,60384
03-12-2016,18,22286,20742,9668,3867,56564,1403,1611,249,3263,59827
03-12-2016,19,21989,20330,9564,3710,55593,1398,1498,194,3090,58683
03-12-2016,20,21384,19186,9267,3663,53501,1394,1335,202,2931,56432
03-12-2016,21,20727,18211,9040,3337,51315,1384,1248,218,2850,54165
03-12-2016,22,20433,17318,8979,3281,50010,1378,1097,234,2709,52719
03-12-2016,23,19270,15822,8690,3294,47078,1362,829,204,2395,49473
04-12-2016,0,19002,14908,8385,3470,45766,1258,736,184,2178,47944
04-12-2016,1,18494,14552,8071,3393,44511,1264,736,170,2170,46681
04-12-2016,2,18653,14780,8025,3468,44926,1175,733,155,2063,46989
04-12-2016,3,18572,14864,8029,3496,44960,1154,735,171,2060,47020
04-12-2016,4,18008,14797,8020,3341,44167,1214,731,157,2102,46269
04-12-2016,5,17910,14860,8194,3146,44111,1257,731,120,2108,46219
04-12-2016,6,18081,14963,8368,3174,44587,1317,732,168,2217,46804
04-12-2016,7,18645,15757,8763,3002,46166,1320,735,316,2371,48537
04-12-2016,8,19581,16388,9182,3521,48673,1291,951,303,2545,51218
04-12-2016,9,20710,17000,9413,3666,50790,1280,940,302,2522,53312
04-12-2016,10,20733,17269,9444,3770,51216,1268,928,482,2678,53894
04-12-2016,11,20773,17462,9556,3738,51531,1267,924,435,2626,54157
04-12-2016,12,20260,17571,9548,3801,51180,1269,939,343,2551,53731
04-12-2016,13,19621,17559,9532,4078,50792,1292,991,235,2518,53310
04-12-2016,14,20153,17831,9618,3857,51460,1360,1057,181,2598,54058
04-12-2016,15,20822,18615,9773,3988,53199,1434,1342,224,3000,56199
04-12-2016,16,21520,19836,9799,3871,55028,1490,1478,267,3235,58263
04-12-2016,17,21523,20216,9655,4113,55507,1395,1470,258,3123,58630
04-12-2016,18,21342,19795,9434,4077,54648,1382,1492,303,3177,57825
04-12-2016,19,20710,19434,9072,4092,53308,1472,1417,302,3191,56499
04-12-2016,20,20187,18816,8711,3941,51655,1435,1209,332,2976,54631
04-12-2016,21,19775,18181,8407,3989,50352,1504,798,364,2666,53018
04-12-2016,22,18343,17416,8137,4027,47923,1362,775,362,2499,50422
04-12-2016,23,16636,16986,7907,3767,45295,1286,767,368,2421,47716
05-12-2016,0,15224,16598,7762,3522,,1251,774,388,2413,
05-12-2016,1,14231,16441,7725,3667,42065,1250,774,414,2438,44503
05-12-2016,2,13484,16517,7824,3637,41462,1261,763,435,2459,43921
05-12-2016,3,13278,16588,7885,3680,41432,1270,764,436,2470,43902
05-12-2016,4,14170,16802,8027,3717,42714,1308,768,445,2521,45235
05-12-2016,5,16010,17762,8299,3801,45872,1563,776,450,2789,48661
05-12-2016,6,18858,19209,8603,4073,50743,1905,848,480,3233,53976
05-12-2016,7,20996,20985,8957,4334,55272,1961,919,479,3359,58631
05-12-2016,8,21379,21697,9175,4484,56737,1952,921,549,3422,60159
05-12-2016,9,21177,21219,9131,4517,56046,1875,916,484,3275,59321
05-12-2016,10,20982,20871,9145,4586,55585,1875,938,480,3293,58878
05-12-2016,11,20721,20984,9105,4661,55472,1881,908,483,3272,58744
05-12-2016,12,20701,21130,9193,4783,55808,1873,913,481,3267,59075
05-12-2016,13,20885,21338,9337,4753,56314,1920,1229,492,3641,59955
05-12-2016,14,21011,21396,9462,4715,56584,1866,1376,501,3743,60327
05-12-2016,15,21364,22103,9539,4696,57702,1877,1326,489,3692,61394
05-12-2016,16,21689,22703,9578,4896,58866,1904,1390,471,3765,62631
05-12-2016,17,21553,22558,9528,5153,58792,1908,1384,431,3723,62515
05-12-2016,18,21234,22246,9373,4917,57769,1904,1381,388,3673,61442
05-12-2016,19,21170,21028,9285,4689,56174,1912,1136,315,3363,59537
05-12-2016,20,20778,19718,9018,4537,54051,1881,951,273,3105,57156
05-12-2016,21,20443,18504,8808,4428,52183,1851,767,286,2904,55087
05-12-2016,22,19326,17473,8620,4099,49518,1674,772,227,2673,52191
05-12-2016,23,17901,16629,8521,3615,46666,1484,768,206,2458,49124
06-12-2016,0,17676,15869,8447,3391,45383,1274,631,203,2108,47491
06-12-2016,1,17167,15365,8407,3166,44105,1287,630,227,2144,46249
06-12-2016,2,17606,15179,8498,2978,44260,1378,642,296,2316,46576
06-12-2016,3,17585,15028,8575,2975,44163,1473,667,290,2430,46593
06-12-2016,4,17827,15813,8793,3217,45649,1548,691,237,2476,48125
06-12-2016,5,18763,17724,9282,3274,49044,1680,748,234,2662,51706
06-12-2016,6,21191,20317,9776,3530,54814,1650,882,476,3008,57822
06-12-2016,7,23208,22096,10052,4004,59361,1661,1126,499,3286,62647
06-12-2016,8,23412,22661,10010,4069,60151,1636,1534,486,3656,63807
06-12-2016,9,23008,22295,9971,3858,59133,1623,1792,460,3875,63008
06-12-2016,10,22888,22160,9964,3784,58796,1601,1711,432,3744,62540
06-12-2016,11,22528,22073,9942,3784,58327,1603,1696,440,3739,62066
06-12-2016,12,22582,21992,10032,3782,58388,1652,1608,464,3724,62112
06-12-2016,13,22461,22022,10104,3797,58383,1698,1865,489,4052,62435
06-12-2016,14,22739,22089,10242,3760,58831,1704,1893,450,4047,62878
06-12-2016,15,22995,22280,10579,3838,59691,1724,1913,433,4070,63761
06-12-2016,16,23247,22874,10816,3914,60850,1711,1967,421,4099,64949
06-12-2016,17,22827,23151,10896,4138,61011,1702,1999,421,4122,65133
06-12-2016,18,22664,22882,10780,3997,60322,1694,1756,391,3841,64163
06-12-2016,19,22323,22384,10598,3763,59069,1692,1511,374,3577,62646
06-12-2016,20,21863,21294,10302,3642,57102,1692,1322,296,3310,60412
06-12-2016,21,21557,20107,9858,3510,55033,1689,1303,106,3098,58131
06-12-2016,22,20375,18173,9571,3538,51657,1696,1227,63,2986,54643
06-12-2016,23,19195,16962,9333,3038,48529,1601,1211,56,2868,51397
07-12-2016,0,18411,16569,9098,2874,46954,1324,888,60,2272,49226
07-12-2016,1,17375,16242,8988,2858,45463,1255,872,69,2196,47659
07-12-2016,2,16564,16266,8857,3035,44721,1234,871,85,2190,46911
07-12-2016,3,16173,16183,8791,3227,44374,1279,853,110,2242,46616
07-12-2016,4,16878,16294,8877,3361,45411,1284,853,134,2271,47682
07-12-2016,5,18163,17712,9154,3547,48576,1500,854,170,2524,51100
07-12-2016,6,20368,20235,9584,3873,54061,1741,1112,242,3095,57156
07-12-2016,7,22419,22723,9781,4340,59265,1819,1377,430,3626,62891
07-12-2016,8,22444,22959,9845,4864,60113,1760,1364,596,3720,63833
07-12-2016,9,21857,22060,9723,4734,58376,1764,1575,609,3948,62324
07-12-2016,10,21621,21665,9522,4865,57673,1829,1123,650,3602,61275
07-12-2016,11,21175,21667,9345,5038,57226,1827,1164,630,3621,60847
07-12-2016,12,21032,21774,9338,4976,57119,1816,1250,651,3717,60836
07-12-2016,13,20828,21736,9358,5080,57002,1826,1349,685,3860,60862
07-12-2016,14,21009,21983,9478,4942,57412,1798,1296,663,3757,61169
07-12-2016,15,21278,22828,9332,4921,58358,1820,1155,679,3654,62012
07-12-2016,16,21192,23021,9264,5065,58543,1819,1183,719,3721,62264
07-12-2016,17,21485,22613,9240,5014,58351,1808,1081,729,3618,61969
07-12-2016,18,20948,21315,9079,4896,56241,1806,1210,742,3758,59999
07-12-2016,19,20751,19633,8833,4850,54068,1759,893,729,3381,57449
07-12-2016,20,19568,18764,8355,4898,51585,1716,873,711,3300,54885
07-12-2016,21,18682,16946,7876,4958,48462,1347,870,607,2824,51286
07-12-2016,22,16978,16371,7677,5065,46091,1324,787,598,2709,48800
07-12-2016,23,14139,15810,7385,5006,42339,1309,679,564,2552,44891
08-12-2016,0,13430,14893,7201,4741,40265,1138,536,544,2218,42483
08-12-2016,1,13061,14682,7147,4778,39667,1115,467,515,2097,41764
08-12-2016,2,12804,14680,7124,4688,39296,1086,450,561,2097,41393
08-12-2016,3,12858,14699,7105,4797,39460,1068,464,591,2123,41583
08-12-2016,4,13017,15031,7223,4637,39909,1142,498,639,2279,42188
08-12-2016,5,13803,16323,7842,4855,42822,1395,517,655,2567,45389
08-12-2016,6,16159,17270,8635,5191,47256,1589,987,1045,3621,50877
08-12-2016,7,19072,18889,8849,5340,52150,1607,1266,1095,3968,56118
08-12-2016,8,20191,19341,8868,5111,53513,1611,1270,1064,3945,57458
08-12-2016,9,20405,19482,8710,5174,53771,1612,919,804,3335,57106
08-12-2016,10,20304,19015,8540,5342,53201,1450,893,770,3113,56314
08-12-2016,11,20151,18751,8434,5445,52780,1604,1067,775,3446,56226
08-12-2016,12,19971,18554,8632,5287,52444,1621,1228,777,3626,56070
08-12-2016,13,20183,18747,8788,5156,52875,1642,1242,762,3646,56521
08-12-2016,14,20438,19039,8780,4800,53057,1706,1222,903,3831,56888
08-12-2016,15,21004,19708,8965,4235,53914,1701,1298,946,3945,57859
08-12-2016,16,21670,20335,8965,3957,54927,1681,1361,964,4006,58933
08-12-2016,17,21665,20734,8951,3696,55047,1679,1358,939,3976,59023
08-12-2016,18,20926,20190,8837,3957,53908,1673,1302,778,3753,57661
08-12-2016,19,20909,19709,8504,3926,53048,1656,807,669,3132,56180
08-12-2016,20,20387,19048,8209,3855,51499,1424,690,668,2782,54281
08-12-2016,21,19039,17870,7971,3897,48776,1276,574,654,2504,51280
08-12-2016,22,16547,16912,7712,3829,45001,1265,538,643,2446,47447
08-12-2016,23,14369,16521,7519,3820,42230,1263,474,646,2383,44613
09-12-2016,0,13805,15959,7572,3545,40882,1226,432,428,2086,42968
09-12-2016,1,12918,16111,7589,3448,40067,1229,433,420,2082,42149
09-12-2016,2,12599,16119,7649,3263,39630,1203,431,396,2030,41660
09-12-2016,3,12508,16086,7676,3190,39461,1226,441,382,2049,41510
09-12-2016,4,12772,16225,7997,3543,40538,1379,477,378,2234,42772
09-12-2016,5,13859,17087,8613,4036,43595,1750,778,344,2872,46467
09-12-2016,6,17584,17931,9282,4380,49178,1766,1417,358,3541,52719
09-12-2016,7,20847,19377,9472,4560,54256,1751,1499,583,3833,58089
09-12-2016,8,21536,20427,9509,4705,56177,1730,1419,622,3771,59948
09-12-2016,9,21078,20245,9175,4628,55129,1747,1197,444,3388,58517
09-12-2016,10,21162,19862,9055,4582,54662,1674,1230,483,3387,58049
09-12-2016,11,21084,19348,9072,4523,54026,1711,1137,476,3324,57350
09-12-2016,12,20802,19326,9185,4364,53677,1736,1117,482,3335,57012
09-12-2016,13,20560,19429,9247,4292,53529,1748,1149,483,3380,56909
09-12-2016,14,20943,19866,9169,4375,54353,1750,1127,473,3350,57703
09-12-2016,15,21678,20296,9160,4366,55501,1769,1125,443,3337,58838
09-12-2016,16,21678,21081,9380,4426,56565,1756,1127,460,3343,59908
09-12-2016,17,21623,20909,9392,4395,56319,1754,1135,451,3340,59659
09-12-2016,18,21361,20347,9341,4248,55297,1731,870,414,3015,58312
09-12-2016,19,21129,18650,9292,3897,52969,1733,897,404,3034,56003
09-12-2016,20,20288,17575,9074,3860,50797,1264,928,392,2584,53381
09-12-2016,21,19461,16137,8884,4035,48519,1086,773,369,2228,50747
09-12-2016,22,17889,14748,8536,4151,45325,996,673,357,2026,47351
09-12-2016,23,16229,14077,8340,4202,42847,1027,341,331,1699,44546
10-12-2016,0,13919,13454,8383,4429,40186,989,334,300,1623,41809
10-12-2016,1,13104,13289,8332,4160,38886,991,330,284,1605,40491
10-12-2016,2,12653,13219,8276,4277,38426,1006,326,263,1595,40021
10-12-2016,3,12603,13228,8237,4187,38256,992,327,253,1572,39828
10-12-2016,4,12977,13197,8286,3952,38412,963,327,221,1511,39923
10-12-2016,5,13652,13203,8359,3996,39210,989,333,193,1515,40725
10-12-2016,6,14719,13554,8443,4090,40807,976,530,181,1687,42494
10-12-2016,7,15575,14117,8539,4018,42250,986,674,159,1819,44069
10-12-2016,8,17843,15160,8542,4404,45948,1032,747,128,1907,47855
10-12-2016,9,19616,15909,8735,4666,48925,1027,853,113,1993,50918
10-12-2016,10,20813,16575,8833,4556,50777,1061,857,106,2024,52801
10-12-2016,11,20533,16994,8838,4659,51022,1063,855,109,2027,53049
10-12-2016,12,20230,17024,8702,4725,50682,1055,857,122,2034,52716
10-12-2016,13,20112,17252,8690,4525,50579,1065,1028,123,2216,52795
10-12-2016,14,20372,17757,8778,4452,51359,1069,1175,127,2371,53730
10-12-2016,15,20974,18762,8974,4219,52930,1072,1330,156,2558,55488
10-12-2016,16,21601,19759,9188,3986,54536,1071,1513,169,2753,57289
10-12-2016,17,21769,19951,9225,4019,54965,1069,1518,161,2748,57713
10-12-2016,18,21647,19517,9143,3977,54284,1065,1515,164,2744,57028
10-12-2016,19,21567,18806,9034,3605,53012,1056,1273,178,2507,55519
10-12-2016,20,21018,17967,8897,3518,51400,1056,1116,190,2362,53762
10-12-2016,21,20894,17107,8689,3220,49910,1049,1091,183,2323,52233
10-12-2016,22,20371,16170,8389,3308,48239,1012,701,172,1885,50124
10-12-2016,23,19462,15107,8173,3169,45911,1023,453,150,1626,47537
11-12-2016,0,17999,14459,7879,2715,43050,976,342,136,1454,44504
11-12-2016,1,16778,14182,7694,2488,41142,953,336,132,1421,42563
11-12-2016,2,16368,14134,7651,2438,40591,942,336,123,1401,41992
11-12-2016,3,15646,13974,7659,2298,39576,918,337,124,1379,40955
11-12-2016,4,15450,14103,7649,2424,39627,926,339,129,1394,41021
11-12-2016,5,15637,13849,7673,2571,39728,902,341,124,1367,41095
11-12-2016,6,16531,14153,7856,2861,41402,887,430,104,1421,42823
11-12-2016,7,17037,14800,8070,3166,43075,939,450,180,1569,44644
11-12-2016,8,18156,15224,8239,3490,45107,996,846,176,2018,47125
11-12-2016,9,19149,15811,8475,3653,47087,1019,890,140,2049,49136
11-12-2016,10,19537,16521,8669,3989,48715,1072,898,178,2148,50863
11-12-2016,11,19672,17224,8609,4150,49656,1053,973,158,2184,51840
11-12-2016,12,19025,17499,8511,4444,49479,1033,979,160,2172,51651
11-12-2016,13,19179,17148,8543,4444,49316,1034,981,139,2154,51470
11-12-2016,14,19109,17607,8555,4449,49721,1048,1083,144,2275,51996
11-12-2016,15,19705,18611,8789,4254,51359,1044,1225,151,2420,53779
11-12-2016,16,20605,19061,8879,4139,52683,1065,1395,170,2630,55313
11-12-2016,17,21193,19113,8915,4158,53379,1063,1305,0,2368,55747
11-12-2016,18,21033,19027,8729,3859,52648,1066,1698,0,2764,55412
11-12-2016,19,20810,18724,8423,3728,51684,1067,1488,204,2759,54443
11-12-2016,20,20362,17948,8271,3697,50277,1074,998,203,2275,52552
11-12-2016,21,19514,17172,8174,3664,48524,1057,947,165,2169,50693
11-12-2016,22,18662,16566,7963,3541,46732,1068,753,183,2004,48736
11-12-2016,23,16737,16004,7920,3494,44155,1073,629,176,1878,46033
12-12-2016,0,14735,16315,8002,3696,42747,1019,845,180,2044,44791
12-12-2016,1,14809,16258,8071,3347,42486,1069,842,169,2080,44566
12-12-2016,2,14425,16167,8170,3519,42282,1110,824,181,2115,44397
12-12-2016,3,14987,16304,8210,3183,42684,1152,841,178,2171,44855
12-12-2016,4,16216,16581,8377,2818,43991,1217,869,206,2292,46283
12-12-2016,5,18573,18056,8958,2806,48393,1449,1199,234,2882,51275
12-12-2016,6,21532,21580,9873,3641,56625,1571,1343,381,3295,59920
12-12-2016,7,23494,23789,10414,4163,61860,1547,1591,655,3793,65653
12-12-2016,8,24000,24048,10353,4329,62728,1555,1501,761,3817,66545
12-12-2016,9,23471,23560,10194,4264,61490,1533,1599,753,3885,65375
12-12-2016,10,23604,23954,10041,4081,61680,1553,1534,736,3823,65503
12-12-2016,11,23515,24021,9964,4178,61678,1605,1522,499,3626,65304
12-12-2016,12,23572,23808,9911,4092,61384,1632,1521,554,3707,65091
12-12-2016,13,24015,23950,9985,3869,61819,1667,1593,723,3983,65802
12-12-2016,14,23828,24234,9947,3904,61914,1667,1611,712,3990,65904
12-12-2016,15,23707,24630,9972,4134,62441,1658,1871,709,4238,66679
12-12-2016,16,23846,24832,10046,4291,63013,1672,1907,812,4391,67404
12-12-2016,17,23790,24516,10025,4379,62710,1684,1908,811,4403,67113
12-12-2016,18,23484,23991,9882,4322,61681,1672,1898,820,4390,66071
12-12-2016,19,23722,22961,9548,4110,60343,1648,1623,539,3810,64153
12-12-2016,20,23165,21962,9302,3749,58179,1632,1341,255,3228,61407
12-12-2016,21,22819,20742,9016,3438,56016,1611,1217,179,3007,59023
12-12-2016,22,21772,19259,8596,3131,52757,1548,1068,259,2875,55632
12-12-2016,23,20727,18020,7596,3092,49436,1399,1048,297,2744,52180
13-12-2016,0,20245,17026,7666,2751,47690,1164,953,229,2346,50036
13-12-2016,1,19317,16601,7650,2794,46362,1117,701,276,2094,48456
13-12-2016,2,18813,16617,7815,2784,46030,1104,695,305,2104,48134
13-12-2016,3,18641,16643,8098,2722,46103,1083,699,305,2087,48190
13-12-2016,4,19449,16665,8331,2667,47112,1139,938,312,2389,49501
13-12-2016,5,20374,17867,8574,2845,49661,1439,1027,302,2768,52429
13-12-2016,6,22330,20843,9243,3287,55704,1524,1309,336,3169,58873
13-12-2016,7,23929,23453,9515,3747,60645,1593,1319,521,3433,64078
13-12-2016,8,24121,23965,9416,3876,61377,1585,1683,517,3785,65162
13-12-2016,9,23816,23711,9359,3854,60740,1582,1568,521,3671,64411
13-12-2016,10,23775,23451,9097,3810,60133,1595,1484,484,3563,63696
13-12-2016,11,23783,23547,9084,3856,60271,1601,1415,529,3545,63816
13-12-2016,12,23889,23323,9214,3793,60219,1602,1498,546,3646,63865
13-12-2016,13,23472,23340,9232,3857,59901,1633,1539,584,3756,63657
13-12-2016,14,23632,23344,9221,3787,59983,1725,1640,597,3962,63945
13-12-2016,15,23946,23787,9252,3739,60725,1716,1652,605,3973,64698
13-12-2016,16,24488,24031,9076,3698,61293,1722,1677,578,3977,65270
13-12-2016,17,24330,24277,8969,3609,61185,1726,1637,562,3925,65110
13-12-2016,18,24050,24059,8883,3615,60608,1749,1526,548,3823,64431
13-12-2016,19,23776,23174,8646,3543,59138,1747,1355,352,3454,62592
13-12-2016,20,23518,21863,8273,3230,56885,1758,1034,353,3145,60030
13-12-2016,21,23181,20705,8138,3095,55119,1668,1036,373,3077,58196
13-12-2016,22,21820,19769,7592,2527,51708,1365,992,338,2695,54403
13-12-2016,23,20006,18761,7389,2520,48677,1256,935,360,2551,51228
14-12-2016,0,18498,18222,7147,2238,46105,1169,918,358,2445,48550
14-12-2016,1,17994,17974,6945,2253,45167,1140,910,361,2411,47578
14-12-2016,2,17583,17929,6907,2184,44602,1127,903,288,2318,46920
14-12-2016,3,18483,17839,6975,2247,45544,1134,895,255,2284,47828
14-12-2016,4,19386,17939,7032,2431,46788,1206,904,218,2328,49116
14-12-2016,5,21488,19246,7860,2501,51095,1432,1013,247,2692,53787
14-12-2016,6,22614,22035,8662,3254,56565,1654,1015,313,2982,59547
14-12-2016,7,24268,24291,8896,4029,61485,1776,1210,410,3396,64881
14-12-2016,8,24557,24698,9012,4109,62377,1761,1248,387,3396,65773
14-12-2016,9,24127,24581,8730,4183,61622,1757,1230,386,3373,64995
14-12-2016,10,24504,24305,8419,4232,61460,1778,1136,296,3210,64670
14-12-2016,11,24221,24009,8497,4307,61034,1772,1118,394,3284,64318
14-12-2016,12,23869,23969,8655,4297,60791,1746,1333,398,3477,64268
14-12-2016,13,23979,23983,8882,4286,61130,1745,1319,412,3476,64606
14-12-2016,14,24156,24038,8890,4290,61375,1718,1444,415,3577,64952
14-12-2016,15,24541,24304,8966,4336,62147,1716,1603,400,3719,65866
14-12-2016,16,24710,24908,9110,4531,63260,1707,1681,421,3809,67069
14-12-2016,17,24657,24917,9144,4781,63499,1706,1702,428,3836,67335
14-12-2016,18,24381,24432,9086,4453,62352,1705,1689,414,3808,66160
14-12-2016,19,24419,23744,8669,4020,60852,1676,1552,404,3632,64484
14-12-2016,20,24187,22764,8456,3641,59049,1651,1050,206,2907,61956
14-12-2016,21,23974,21549,8164,3414,57102,1672,1036,180,2888,59990
14-12-2016,22,22988,19820,7760,3103,53672,1520,991,110,2621,56293
14-12-2016,23,22193,18136,7432,2953,50714,1337,960,115,2412,53126
15-12-2016,0,21281,17060,7073,2977,48391,1205,945,109,2259,50650
15-12-2016,1,20322,16749,6907,3088,47066,1204,940,107,2251,49317
15-12-2016,2,20414,16775,6814,3102,47106,1215,939,124,2278,49384
15-12-2016,3,20589,16924,6814,3188,47514,1215,938,114,2267,49781
15-12-2016,4,20983,17864,7195,3092,49134,1323,941,109,2373,51507
15-12-2016,5,21638,19824,7828,3255,52546,1580,1014,134,2728,55274
15-12-2016,6,22969,22657,8696,3663,57985,1689,1194,212,3095,61080
15-12-2016,7,24417,24911,9194,4119,62642,1724,1342,546,3612,66254
15-12-2016,8,24642,25165,9338,4498,63643,1816,1535,671,4022,67665
15-12-2016,9,24277,24331,9255,4482,62345,1716,1740,774,4230,66575
15-12-2016,10,23507,23404,9120,4534,60566,1809,1940,770,4519,65085
15-12-2016,11,23651,23501,8960,4154,60266,1719,1803,769,4291,64557
15-12-2016,12,24093,23650,8918,4204,60866,1740,1808,769,4317,65183
15-12-2016,13,24521,23671,8904,4326,61422,1774,1734,770,4278,65700
15-12-2016,14,24406,23913,8885,4256,61461,1772,1861,770,4403,65864
15-12-2016,15,24065,24091,8890,4314,61360,1785,1996,969,4750,66110
15-12-2016,16,24094,23483,9057,4453,61088,1794,1998,773,4565,65653
15-12-2016,17,24218,23475,8984,4535,61212,1823,2000,786,4609,65821
15-12-2016,18,23888,23016,8808,4285,59997,1820,1999,777,4596,64593
15-12-2016,19,23639,22522,8582,4157,58900,1811,1657,716,4184,63084
15-12-2016,20,23491,21445,8163,4058,57157,1769,1252,503,3524,60681
15-12-2016,21,23040,20446,7843,3917,55246,1720,1238,468,3426,58672
15-12-2016,22,21850,18631,7473,3855,51809,1546,1189,456,3191,55000
15-12-2016,23,20943,17014,7296,3824,49079,1351,1171,428,2950,52029
16-12-2016,0,20283,16236,7114,3549,47181,1341,842,461,2644,49825
16-12-2016,1,19272,15854,7044,3397,45568,1318,839,496,2653,48221
16-12-2016,2,19030,15656,7011,3410,45108,1310,826,467,2603,47711
16-12-2016,3,19316,15543,7063,3342,45264,1329,835,496,2660,47924
16-12-2016,4,20279,15734,7334,3370,46718,1521,836,494,2851,49569
16-12-2016,5,20878,17283,7910,3561,49634,1731,839,528,3098,52732
16-12-2016,6,22548,20380,8631,3724,55283,1739,1022,697,3458,58741
16-12-2016,7,23885,22561,9238,3931,59614,1743,1383,927,4053,63667
16-12-2016,8,24300,23086,9366,4202,60954,1736,1382,964,4082,65036
16-12-2016,9,24000,23241,9111,4093,60445,1735,1480,946,4161,64606
16-12-2016,10,24149,23002,8838,4044,60034,1740,1479,952,4171,64205
16-12-2016,11,24090,22906,8767,4072,59834,1752,1635,933,4320,64154
16-12-2016,12,23900,22841,8886,4180,59807,1757,1700,943,4400,64207
16-12-2016,13,24061,22927,8952,4116,60056,1738,1660,929,4327,64383
16-12-2016,14,23955,22924,8999,4100,59978,1732,1702,905,4339,64317
16-12-2016,15,23900,23073,9202,4213,60388,1734,1813,937,4484,64872
16-12-2016,16,23868,23028,9231,4466,60594,1726,1888,934,4548,65142
16-12-2016,17,23996,22424,9240,4373,60032,1715,1906,941,4562,64594
16-12-2016,18,23932,22252,9224,4078,59487,1708,1508,909,4125,63612
16-12-2016,19,23710,21549,8916,3833,58008,1701,1046,590,3337,61345
16-12-2016,20,23473,20297,8529,3687,55987,1699,1034,438,3171,59158
16-12-2016,21,22964,19207,8166,3297,53633,1703,1033,416,3152,56785
16-12-2016,22,22221,17337,7798,3147,50504,1696,954,397,3047,53551
16-12-2016,23,21484,16298,7272,2872,47927,1619,831,340,2790,50717
17-12-2016,0,20917,16005,7146,2484,46554,1197,717,135,2049,48603
17-12-2016,1,20347,15770,7203,2369,45689,1078,701,122,1901,47590
17-12-2016,2,20363,15362,7029,2205,44959,1055,707,100,1862,46821
17-12-2016,3,20710,15185,6771,2176,44841,1045,710,99,1854,46695
17-12-2016,4,20629,15349,6859,2260,45096,1051,718,108,1877,46973
17-12-2016,5,20810,15845,7156,2531,46343,1065,723,102,1890,48233
17-12-2016,6,21075,16593,7505,2627,47800,1048,720,138,1906,49706
17-12-2016,7,21980,17758,7618,3014,50370,1050,733,142,1925,52295
17-12-2016,8,22275,19424,7916,3320,52934,1207,807,133,2147,55081
17-12-2016,9,22119,20293,8074,3963,54449,1306,982,127,2415,56864
17-12-2016,10,22164,20785,8363,3865,55177,1305,983,120,2408,57585
17-12-2016,11,22331,20774,8653,3901,55659,1307,978,121,2406,58065
17-12-2016,12,22319,20301,8593,3695,54908,1319,1065,129,2513,57421
17-12-2016,13,22521,20060,8467,3639,54688,1321,1173,153,2647,57335
17-12-2016,14,22409,20428,8504,3725,55066,1333,1229,174,2736,57802
17-12-2016,15,22481,21202,8434,3788,55905,1354,1361,197,2912,58817
17-12-2016,16,22678,21378,8589,3886,56531,1354,1568,218,3140,59671
17-12-2016,17,22909,21067,8477,4103,56557,1358,1404,234,2996,59553
17-12-2016,18,22610,20849,8230,3941,55631,1345,1395,238,2978,58609
17-12-2016,19,22125,20106,7984,3793,54009,1305,1180,229,2714,56723
17-12-2016,20,21570,18920,7766,3906,52160,1222,860,204,2286,54446
17-12-2016,21,20692,17790,7588,3776,49846,1210,769,220,2199,52045
17-12-2016,22,20009,17207,7324,3737,48277,1192,763,172,2127,50404
17-12-2016,23,18316,16823,7199,3741,46079,1151,738,152,2041,48120
18-12-2016,0,16091,16302,7457,3878,43727,1125,530,138,1793,45520
18-12-2016,1,15092,16102,7359,3866,42420,1101,526,128,1755,44175
18-12-2016,2,14966,16073,7294,3616,41949,1094,524,117,1735,43684
18-12-2016,3,14969,16072,7159,3438,41639,1077,526,112,1715,43354
18-12-2016,4,15246,16141,7152,3256,41795,1097,523,100,1720,43515
18-12-2016,5,16090,16234,7310,3210,42845,1100,527,95,1722,44567
18-12-2016,6,17243,16646,7577,3124,44590,1081,812,102,1995,46585
18-12-2016,7,18953,16839,7690,3036,46520,1060,829,157,2046,48566
18-12-2016,8,20926,17040,7857,2991,48815,1073,913,165,2151,50966
18-12-2016,9,22210,17361,8002,2980,50554,1103,914,169,2186,52740
18-12-2016,10,22863,18093,8195,2969,52121,1227,915,163,2305,54426
18-12-2016,11,23112,18500,8291,2928,52831,1232,908,156,2296,55127
18-12-2016,12,23141,18640,8475,2881,53137,1233,926,146,2305,55442
18-12-2016,13,23067,18609,8504,2835,53014,1236,1104,141,2481,55495
18-12-2016,14,22966,18892,8554,2926,53338,1228,1267,129,2624,55962
18-12-2016,15,23013,19912,8610,2835,54369,1174,1453,127,2754,57123
18-12-2016,16,22833,20687,8623,3012,55154,1181,1642,163,2986,58140
18-12-2016,17,22950,20625,8583,3025,55183,1184,1641,324,3149,58332
18-12-2016,18,22862,20336,8568,2959,54726,1185,1637,174,2996,57722
18-12-2016,19,22485,19978,8393,2877,53731,1181,1442,158,2781,56512
18-12-2016,20,22382,18823,8259,2779,52242,1193,1276,165,2634,54876
18-12-2016,21,21515,18093,8084,2697,50391,1200,919,170,2289,52680
18-12-2016,22,20358,17464,7854,2480,48156,1121,741,138,2000,50156
18-12-2016,23,18248,16936,7575,2500,45260,1071,738,148,1957,47217
19-12-2016,0,17543,17235,7456,2486,44720,1079,735,183,1997,46717
19-12-2016,1,16941,17087,7289,2421,43739,1112,709,211,2032,45771
19-12-2016,2,16539,17150,7145,2439,43274,1141,710,188,2039,45313
19-12-2016,3,16700,17109,7175,2456,43439,1169,728,212,2109,45548
19-12-2016,4,17937,17412,7301,2547,45197,1204,731,228,2163,47360
19-12-2016,5,19960,18335,7515,2630,48441,1327,800,263,2390,50831
19-12-2016,6,21386,20523,7983,3002,52893,1576,1182,364,3122,56015
19-12-2016,7,23249,22331,8733,3280,57594,1570,1202,542,3314,60908
19-12-2016,8,23627,23181,8902,3639,59349,1566,1280,684,3530,62879
19-12-2016,9,23384,22688,8574,3731,58376,1560,1273,712,3545,61921
19-12-2016,10,23110,22426,8190,3730,57456,1565,1267,703,3535,60991
19-12-2016,11,23307,22209,8120,3777,57415,1562,1261,661,3484,60899
19-12-2016,12,23505,21930,8523,3657,57615,1560,1347,764,3671,61286
19-12-2016,13,23799,22190,8554,3622,58164,1551,1312,785,3648,61812
19-12-2016,14,23757,22743,8671,3714,58885,1528,1313,828,3669,62554
19-12-2016,15,23808,23203,8731,3698,59440,1569,1312,860,3741,63181
19-12-2016,16,23627,23277,8697,3795,59397,1606,1408,976,3990,63387
19-12-2016,17,23725,22649,8581,3875,58830,1617,1419,982,4018,62848
19-12-2016,18,23556,22303,8390,3693,57943,1603,1367,883,3853,61796
19-12-2016,19,23161,21481,8180,3629,56451,1403,1274,566,3243,59694
19-12-2016,20,22878,19830,7962,3288,53958,1332,1205,464,3001,56959
19-12-2016,21,22236,18802,7816,3095,51950,1356,1105,474,2935,54885
19-12-2016,22,20238,17819,7545,3008,48611,1356,1001,412,2769,51380
19-12-2016,23,17883,17465,7543,3053,45944,1329,984,411,2724,48668
20-12-2016,0,16860,16908,7573,2849,44190,1168,521,392,2081,46271
20-12-2016,1,15904,16884,7620,2695,43103,1124,506,381,2011,45114
20-12-2016,2,15247,16880,7646,2641,42414,1124,505,365,1994,44408
20-12-2016,3,15393,16873,7677,2592,42536,1134,501,340,1975,44511
20-12-2016,4,16345,16880,7757,2587,43568,1153,508,318,1979,45547
20-12-2016,5,17757,18045,8017,2735,46555,1358,689,296,2343,48898
20-12-2016,6,20966,19416,8555,3003,51942,1245,1074,312,2631,54573
20-12-2016,7,23213,20971,8825,3434,56443,1537,1278,683,3498,59941
20-12-2016,8,23761,21863,8838,3592,58054,1582,1279,787,3648,61702
20-12-2016,9,23487,21538,8722,3284,57031,1297,1279,808,3384,60415
20-12-2016,10,23348,21466,8717,3284,56816,1309,1283,800,3392,60208
20-12-2016,11,23304,21366,8717,3307,56695,1372,1318,736,3426,60121
20-12-2016,12,23070,21494,8662,3515,56740,1385,1387,698,3470,60210
20-12-2016,13,23168,21585,8584,3617,56954,1499,1386,788,3673,60627
20-12-2016,14,23297,21985,8487,3636,57406,1519,1389,791,3699,61105
20-12-2016,15,23268,22398,8450,3758,57873,1573,1466,803,3842,61715
20-12-2016,16,23038,22351,8409,3935,57733,1601,1401,808,3810,61543
20-12-2016,17,23066,22355,8222,3867,57511,1576,1398,809,3783,61294
20-12-2016,18,22851,21916,8288,3839,56894,1569,1398,830,3797,60691
20-12-2016,19,22738,21448,8003,3786,55976,1242,1202,652,3096,59072
20-12-2016,20,22123,20038,8101,3866,54128,1222,1092,342,2656,56784
20-12-2016,21,21272,18937,8014,3985,52207,1212,1002,325,2539,54746
20-12-2016,22,19123,18346,7860,4085,49414,1217,763,335,2315,51729
20-12-2016,23,16754,17526,7636,4067,45982,1209,578,185,1972,47954
21-12-2016,0,16024,17246,7721,3999,44991,938,277,121,1336,46327
21-12-2016,1,15632,17194,7622,3842,44289,909,276,112,1297,45586
21-12-2016,2,15192,17215,7598,3793,43799,919,280,105,1304,45103
21-12-2016,3,15319,17178,7621,3861,43981,888,281,116,1285,45266
21-12-2016,4,16013,17430,7715,3802,44959,901,278,120,1299,46258
21-12-2016,5,17544,18648,7961,3994,48148,926,427,132,1485,49633
21-12-2016,6,19652,20280,8404,4280,52618,935,957,178,2070,54688
21-12-2016,7,21541,21833,8856,4867,57098,1050,1072,194,2316,59414
21-12-2016,8,22238,22245,8923,5412,58819,963,1132,196,2291,61110
21-12-2016,9,21462,22265,8722,5122,57572,944,1132,268,2344,59916
21-12-2016,10,20858,22254,8572,5606,57289,940,1122,283,2345,59634
21-12-2016,11,20796,22073,8416,5721,57006,942,1128,299,2369,59375
21-12-2016,12,20962,21923,8507,5246,56638,940,1129,298,2367,59005
21-12-2016,13,21194,22152,8806,5316,57467,989,1197,303,2489,59956
21-12-2016,14,21034,22302,8947,5631,57915,1006,1211,316,2533,60448
21-12-2016,15,21298,22676,9047,5541,58563,1032,1299,336,2667,61230
21-12-2016,16,21370,22387,8879,5755,58391,1001,1297,344,2642,61033
21-12-2016,17,20999,22617,8595,5584,57795,986,1302,284,2572,60367
21-12-2016,18,20637,22405,8631,5407,57080,1007,1193,290,2490,59570
21-12-2016,19,20131,21797,8308,4892,55129,1011,1047,263,2321,57450
21-12-2016,20,18781,21197,8229,4785,52992,1025,715,223,1963,54955
21-12-2016,21,17780,20223,8058,4817,50877,985,608,217,1810,52687
21-12-2016,22,16570,19407,7896,4599,48472,1013,541,181,1735,50207
21-12-2016,23,15041,18762,7590,4425,45816,1017,453,181,1651,47467
22-12-2016,0,13868,18138,7469,3902,43378,1009,323,158,1490,44868
22-12-2016,1,13364,17914,7430,3595,42302,995,302,156,1453,43755
22-12-2016,2,13463,17617,7354,3293,41727,964,305,163,1432,43159
22-12-2016,3,14038,17497,7443,3109,42088,966,306,179,1451,43539
22-12-2016,4,15231,17601,7536,3157,43526,980,307,161,1448,44974
22-12-2016,5,17013,18436,7839,3250,46538,971,347,140,1458,47996
22-12-2016,6,19889,19847,8412,3213,51362,1009,731,211,1951,53313
22-12-2016,7,22169,21269,8736,3618,55792,1011,930,421,2362,58154
22-12-2016,8,23272,21831,8794,3888,57785,1021,1210,434,2665,60450
22-12-2016,9,22806,21870,8431,4109,57216,1000,1217,411,2628,59844
22-12-2016,10,22245,21814,8332,4179,56570,992,1194,416,2602,59172
22-12-2016,11,22155,21815,8358,4344,56672,993,1137,407,2537,59209
22-12-2016,12,22355,21739,8365,4294,56752,1001,1132,413,2546,59298
22-12-2016,13,22022,21800,8434,5410,57666,1000,1131,432,2563,60229
22-12-2016,14,21608,21802,8747,4391,56547,990,1164,433,2587,59134
22-12-2016,15,21903,21752,8876,4392,56924,1023,1191,466,2680,59604
22-12-2016,16,22051,22209,8772,4563,57594,1070,1018,466,2554,60148
22-12-2016,17,21486,22378,8726,4760,57350,1049,988,451,2488,59838
22-12-2016,18,21361,21801,8741,4751,56655,1038,939,432,2409,59064
22-12-2016,19,21089,20551,8514,4675,54827,963,801,271,2035,56862
22-12-2016,20,20253,19833,8174,4505,52766,928,674,236,1838,54604
22-12-2016,21,19290,19204,8013,4440,50949,893,421,250,1564,52513
22-12-2016,22,17504,18750,7785,4526,48567,860,362,214,1436,50003
22-12-2016,23,15326,18250,7608,4488,45671,865,360,207,1432,47103
23-12-2016,0,12471,17814,7530,4676,42491,864,299,178,1341,43832
23-12-2016,1,11639,17601,7393,4495,41129,864,306,169,1339,42468
23-12-2016,2,11479,17500,7323,4423,40724,876,310,176,1362,42086
23-12-2016,3,11481,17417,7273,4457,40629,874,309,193,1376,42005
23-12-2016,4,12516,17587,7268,4380,41752,867,307,218,1392,43144
23-12-2016,5,14190,18180,7593,4257,44220,883,321,212,1416,45636
23-12-2016,6,16747,19496,8007,4092,48342,937,460,317,1714,50056
23-12-2016,7,19984,20898,8152,3966,53000,960,582,344,1886,54886
23-12-2016,8,21665,21457,8274,3847,55243,967,949,403,2319,57562
23-12-2016,9,21286,21951,8252,3814,55303,967,890,434,2291,57594
23-12-2016,10,20946,21919,8195,3952,55012,940,856,450,2246,57258
23-12-2016,11,20280,22072,8201,4112,54665,918,755,472,2145,56810
23-12-2016,12,20087,21973,7958,4172,54191,928,777,492,2197,56388
23-12-2016,13,19714,21699,8070,4391,53874,869,813,464,2146,56020
23-12-2016,14,19576,21581,8281,4464,53902,872,812,446,2130,56032
23-12-2016,15,19903,21803,8219,4946,54871,866,1051,462,2379,57250
23-12-2016,16,19941,21989,8194,5332,55456,879,1145,499,2523,57979
23-12-2016,17,19731,21866,8178,5344,55120,875,1081,457,2413,57533
23-12-2016,18,18947,21636,8056,5572,54210,858,998,342,2198,56408
23-12-2016,19,17870,20996,7785,5598,52248,836,763,300,1899,54147
23-12-2016,20,16387,19915,7702,5430,49434,822,721,306,1849,51283
23-12-2016,21,15627,19107,7597,5180,47511,806,512,337,1655,49166
23-12-2016,22,14948,18507,7434,4894,45783,799,349,338,1486,47269
23-12-2016,23,12304,17792,7152,4832,42082,834,349,340,1523,43605
24-12-2016,0,12000,17361,6962,4342,40666,799,226,359,1384,42050
24-12-2016,1,11418,17417,6822,4170,39829,815,229,312,1356,41185
24-12-2016,2,10928,17531,6894,4003,39356,853,235,367,1455,40811
24-12-2016,3,10713,17587,6965,3970,39234,860,232,390,1482,40716
24-12-2016,4,10857,17573,6998,3886,39314,867,233,383,1483,40797
24-12-2016,5,10903,17529,7089,4176,39696,893,247,406,1546,41242
24-12-2016,6,10859,17415,7174,4463,39912,906,487,415,1808,41720
24-12-2016,7,11892,17520,7342,4402,41155,893,730,495,2118,43273
24-12-2016,8,13958,18095,7508,4724,44287,899,767,520,2186,46473
24-12-2016,9,15149,19013,7815,5008,46985,926,832,526,2284,49269
24-12-2016,10,15854,19274,8042,5388,48559,911,847,520,2278,50837
24-12-2016,11,15532,19418,8082,5509,48542,914,846,510,2270,50812
24-12-2016,12,14766,19423,8023,5514,47727,919,846,492,2257,49984
24-12-2016,13,14204,19207,7858,5425,46693,916,861,498,2275,48968
24-12-2016,14,14059,19222,7866,5342,46489,906,853,472,2231,48720
24-12-2016,15,14899,19047,7791,5381,47118,910,841,453,2204,49322
24-12-2016,16,15726,19439,7701,5444,48310,897,794,465,2156,50466
24-12-2016,17,14284,19875,7801,5382,47342,906,698,435,2039,49381
24-12-2016,18,12871,18324,7589,5111,43896,867,690,441,1998,45894
24-12-2016,19,13093,18120,7565,4598,43376,865,723,403,1991,45367
24-12-2016,20,12778,17933,7397,4354,42464,842,716,410,1968,44432
24-12-2016,21,12589,17752,7394,4108,41843,837,689,429,1955,43798
24-12-2016,22,12743,17534,7352,3971,41600,858,576,397,1831,43431
24-12-2016,23,12642,17464,7150,3497,40754,844,311,370,1525,42279
25-12-2016,0,12814,17359,6997,2943,40113,836,235,360,1431,41544
25-12-2016,1,12559,17278,6926,2877,39641,820,229,362,1411,41052
25-12-2016,2,11752,17061,6907,2866,38586,834,213,392,1439,40025
25-12-2016,3,11331,16877,6943,2738,37891,818,205,400,1423,39314
25-12-2016,4,10930,16822,6947,2666,37365,786,198,325,1309,38674
25-12-2016,5,10670,16792,6931,3029,37419,822,195,291,1308,38727
25-12-2016,6,10821,16607,6958,2629,37013,822,389,255,1466,38479
25-12-2016,7,11071,16686,7015,2946,37717,803,446,204,1453,39170
25-12-2016,8,11921,17174,7042,3426,39563,808,439,280,1527,41090
25-12-2016,9,12790,17156,7045,4070,41064,851,542,267,1660,42724
25-12-2016,10,13154,17653,7250,4524,42581,861,576,286,1723,44304
25-12-2016,11,14198,17690,7137,4929,43954,854,555,317,1726,45680
25-12-2016,12,14055,17835,7047,4923,43859,857,684,324,1865,45724
25-12-2016,13,13763,17481,7070,5013,43327,859,845,330,2034,45361
25-12-2016,14,14369,17029,6904,4399,42702,855,795,306,1956,44658
25-12-2016,15,15032,17328,6885,4729,43975,847,944,319,2110,46085
25-12-2016,16,15690,17670,7045,4882,45287,844,1005,320,2169,47456
25-12-2016,17,15519,17554,7024,5097,45195,844,956,354,2154,47349
25-12-2016,18,15100,17429,6881,5119,44528,841,893,354,2088,46616
25-12-2016,19,14673,17071,6731,4946,43421,830,917,334,2081,45502
25-12-2016,20,14110,16818,6681,4935,42544,831,884,336,2051,44595
25-12-2016,21,14084,16932,6630,4880,42525,859,789,334,1982,44507
25-12-2016,22,13490,16933,6475,4654,41552,871,651,340,1862,43414
25-12-2016,23,12510,16947,6387,4136,39979,895,241,332,1468,41447
26-12-2016,0,10703,16530,6306,4253,37793,890,251,351,1492,39285
26-12-2016,1,9747,16394,6299,3834,36274,878,241,354,1473,37747
26-12-2016,2,9509,16373,6331,3256,35470,879,237,377,1493,36963
26-12-2016,3,9399,16541,6379,2973,35293,900,242,431,1573,36866
26-12-2016,4,9980,16674,6460,2837,35952,914,224,449,1587,37539
26-12-2016,5,10414,16759,6476,2446,36095,894,228,431,1553,37648
26-12-2016,6,11217,16977,6581,2509,37285,916,358,410,1684,38969
26-12-2016,7,12317,17453,6637,2878,39285,905,395,412,1712,40997
26-12-2016,8,13127,17748,6790,3260,40927,934,421,439,1794,42721
26-12-2016,9,13670,18054,6897,4284,42905,954,473,446,1873,44778
26-12-2016,10,13867,18208,6990,4705,43771,947,576,482,2005,45776
26-12-2016,11,14214,18284,7084,4882,44464,951,639,499,2089,46553
26-12-2016,12,14240,18700,7258,4962,45160,935,699,496,2130,47290
26-12-2016,13,14318,18995,7415,4447,45175,930,705,465,2100,47275
26-12-2016,14,14763,19135,7451,3979,45328,925,769,431,2125,47453
26-12-2016,15,16053,19412,7580,4119,47165,931,879,435,2245,49410
26-12-2016,16,16702,19684,7609,4554,48550,942,891,432,2265,50815
26-12-2016,17,16636,19737,7674,4671,48718,925,893,451,2269,50987
26-12-2016,18,16414,19521,7540,4462,47937,895,915,487,2297,50234
26-12-2016,19,15665,18912,7486,4243,46307,850,929,492,2271,48578
26-12-2016,20,15075,18601,7225,3698,44598,854,868,487,2209,46807
26-12-2016,21,14855,18064,7066,3233,43218,865,806,487,2158,45376
26-12-2016,22,14185,17400,6872,3131,41587,866,711,508,2085,43672
26-12-2016,23,13327,16935,6713,2703,39679,881,368,472,1721,41400
27-12-2016,0,12468,17039,6601,2481,38590,863,246,470,1579,40169
27-12-2016,1,12285,17203,6544,2450,38481,833,241,467,1541,40022
27-12-2016,2,12401,17441,6489,2540,38871,812,240,466,1518,40389
27-12-2016,3,12440,17658,6406,2674,39177,791,232,458,1481,40658
27-12-2016,4,12403,17947,6466,2842,39658,780,227,470,1477,41135
27-12-2016,5,12981,18496,6745,3062,41283,748,379,459,1586,42869
27-12-2016,6,14275,19317,7282,3761,44635,743,727,488,1958,46593
27-12-2016,7,15491,20134,7608,4840,48073,774,1127,483,2384,50457
27-12-2016,8,15946,20798,7881,5297,49922,785,1092,494,2371,52293
27-12-2016,9,16171,20837,7834,5439,50282,763,910,498,2171,52453
27-12-2016,10,16557,20889,7967,5411,50824,790,947,498,2235,53059
27-12-2016,11,16897,20842,8243,5353,51336,853,907,526,2286,53622
27-12-2016,12,17070,20885,8283,5269,51508,866,786,510,2162,53670
27-12-2016,13,17342,21032,8411,5106,51892,863,800,514,2177,54069
27-12-2016,14,17745,21204,8623,4735,52306,888,1249,514,2651,54957
27-12-2016,15,18598,21744,8952,4710,54004,909,1311,515,2735,56739
27-12-2016,16,19640,22342,9065,4694,55742,919,1312,517,2748,58490
27-12-2016,17,20170,22269,8993,4711,56143,926,1302,504,2732,58875
27-12-2016,18,19739,21564,9004,4922,55230,922,1314,493,2729,57959
27-12-2016,19,19143,21229,8758,4687,53817,931,949,514,2394,56211
27-12-2016,20,18143,20668,8369,4558,51739,938,919,519,2376,54115
27-12-2016,21,16762,20020,8275,3974,49031,944,763,530,2237,51268
27-12-2016,22,15379,19074,8104,3712,46269,936,837,526,2299,48568
27-12-2016,23,13522,18068,7897,3670,43158,921,509,527,1957,45115
28-12-2016,0,12920,17215,7838,3254,41228,916,381,427,1724,42952
28-12-2016,1,12626,16876,7768,3171,40440,911,372,410,1693,42133
28-12-2016,2,12519,16600,7745,3070,39934,922,366,401,1689,41623
28-12-2016,3,12834,16358,7788,2926,39906,915,367,377,1659,41565
28-12-2016,4,13936,16198,7873,3020,41027,975,380,371,1726,42753
28-12-2016,5,16309,16668,8041,3184,44202,986,549,361,1896,46098
28-12-2016,6,19372,18084,8231,3441,49129,981,695,418,2094,51223
28-12-2016,7,20969,19794,8565,3521,52849,947,1121,660,2728,55577
28-12-2016,8,21863,20974,8626,3624,55087,974,1165,732,2871,57958
28-12-2016,9,22844,21086,8477,3442,55848,908,1143,835,2886,58734
28-12-2016,10,23292,21039,8458,3334,56121,880,1295,932,3107,59228
28-12-2016,11,23448,21289,8283,3318,56338,879,1303,1032,3214,59552
28-12-2016,12,23021,21788,8307,3325,56439,875,1298,1077,3250,59689
28-12-2016,13,22750,21752,8410,3427,56339,887,1471,1015,3373,59712
28-12-2016,14,23031,21857,8392,3271,56552,910,1305,977,3192,59744
28-12-2016,15,23014,22571,8556,3244,57385,979,1315,967,3261,60646
28-12-2016,16,22960,22935,8925,3275,58096,992,1601,948,3541,61637
28-12-2016,17,22871,22949,9323,3157,58301,967,1567,933,3467,61768
28-12-2016,18,22625,22624,9229,3126,57604,917,1458,919,3294,60898
28-12-2016,19,22394,21636,9014,3021,56066,807,1305,795,2907,58973
28-12-2016,20,21755,20895,8598,2831,54080,764,1145,728,2637,56717
28-12-2016,21,21230,19674,8364,2689,51957,760,1049,691,2500,54457
28-12-2016,22,20645,18930,8187,2631,50393,750,568,459,1777,52170
28-12-2016,23,18519,18122,7911,2625,47175,754,565,374,1693,48868
29-12-2016,0,16646,17424,7877,2821,44767,721,515,313,1549,46316
29-12-2016,1,15366,17163,7837,2996,43363,737,514,279,1530,44893
29-12-2016,2,14450,17050,7820,3005,42327,744,518,263,1525,43852
29-12-2016,3,14565,17077,7826,2932,42401,768,518,277,1563,43964
29-12-2016,4,15662,17137,7857,2955,43611,817,522,270,1609,45220
29-12-2016,5,17523,17466,8142,3160,46292,882,530,272,1684,47976
29-12-2016,6,19139,18600,8343,3474,49555,891,957,459,2307,51862
29-12-2016,7,20151,20296,8755,3684,52886,916,1030,606,2552,55438
29-12-2016,8,20747,20873,8826,4163,54609,896,1052,617,2565,57174
29-12-2016,9,20894,20861,8463,4321,54538,889,1072,609,2570,57108
29-12-2016,10,20987,21113,8207,4396,54704,908,1074,661,2643,57347
29-12-2016,11,20910,21099,8180,4406,54597,895,1114,668,2677,57274
29-12-2016,12,20895,21157,8263,4387,54702,881,1160,717,2758,57460
29-12-2016,13,20938,21273,8384,4272,54868,886,1159,733,2778,57646
29-12-2016,14,20881,21367,8550,4310,55108,888,1196,751,2835,57943
29-12-2016,15,20851,21774,8654,4262,55541,821,1417,771,3009,58550
29-12-2016,16,21080,22176,8638,4312,56206,841,1212,885,2938,59144
29-12-2016,17,21092,21989,8623,4376,56081,884,1259,790,2933,59014
29-12-2016,18,20666,21529,8513,4558,55266,869,1165,803,2837,58103
29-12-2016,19,20254,21163,8060,4380,53857,898,948,799,2645,56502
29-12-2016,20,19855,20440,7691,4134,52120,874,583,812,2269,54389
29-12-2016,21,19176,19767,7455,4071,50468,869,580,720,2169,52637
29-12-2016,22,18181,18769,7387,3933,48270,874,556,598,2028,50298
29-12-2016,23,16688,18333,7250,3819,46092,843,539,589,1971,48063
30-12-2016,0,15107,17350,7026,3736,43218,837,534,424,1795,45013
30-12-2016,1,13877,17277,6947,3623,41725,817,533,418,1768,43493
30-12-2016,2,13100,17241,6950,3549,40841,815,522,359,1696,42537
30-12-2016,3,13271,17401,6885,3486,41044,812,528,339,1679,42723
30-12-2016,4,14099,17603,6988,3494,42184,836,523,349,1708,43892
30-12-2016,5,15156,18409,7453,3473,44491,825,541,340,1706,46197
30-12-2016,6,17028,19524,7973,3593,48117,822,863,323,2008,50125
30-12-2016,7,18690,20277,8382,3862,51211,825,805,325,1955,53166
30-12-2016,8,19312,20641,8600,4371,52923,836,1304,341,2481,55404
30-12-2016,9,19626,20716,8434,4170,52947,837,1224,512,2573,55520
30-12-2016,10,19758,21079,8396,4157,53391,838,1192,359,2389,55780
30-12-2016,11,19825,21125,8457,4281,53687,861,1005,323,2189,55876
30-12-2016,12,19507,21299,8511,4436,53753,874,1189,294,2357,56110
30-12-2016,13,19309,21254,8709,4387,53660,889,1197,298,2384,56044
30-12-2016,14,19194,21232,8703,4386,53515,914,1259,421,2594,56109
30-12-2016,15,19387,21220,8784,4436,53828,897,1573,521,2991,56819
30-12-2016,16,19832,21136,8664,4507,54139,901,1586,548,3035,57174
30-12-2016,17,19702,21282,8601,4691,54277,926,1500,538,2964,57241
30-12-2016,18,19241,20900,8541,4453,53135,921,1434,442,2797,55932
30-12-2016,19,18789,20167,8207,4298,51463,928,889,391,2208,53671
30-12-2016,20,17088,19416,7905,4528,48936,931,668,383,1982,50918
30-12-2016,21,15629,19009,7746,4580,46963,943,611,382,1936,48899
30-12-2016,22,13989,18530,7506,4501,44527,931,576,415,1922,46449
30-12-2016,23,12252,18113,7275,4571,42209,915,540,417,1872,44081
31-12-2016,0,10797,17735,7289,4280,40101,901,236,333,1470,41571
31-12-2016,1,10484,17617,7207,4019,39327,902,230,322,1454,40781
31-12-2016,2,10097,17601,7160,3889,38747,907,232,331,1470,40217
31-12-2016,3,9973,17580,7161,3877,38591,905,221,339,1465,40056
31-12-2016,4,9765,17610,7159,3970,38504,923,217,337,1477,39981
31-12-2016,5,9816,17603,7201,4182,38801,917,236,355,1508,40309
31-12-2016,6,9854,17538,7312,4338,39042,912,356,364,1632,40674
31-12-2016,7,10596,17733,7484,4639,40453,894,365,388,1647,42100
31-12-2016,8,12211,18266,7557,4497,42531,911,484,384,1779,44310
31-12-2016,9,13244,18407,7575,4574,43800,895,681,383,1959,45759
31-12-2016,10,14141,18670,7695,4710,45218,959,903,408,2270,47488
31-12-2016,11,15103,18848,7679,4735,46365,999,948,436,2383,48748
31-12-2016,12,15340,18945,7628,4702,46615,1001,953,457,2411,49026
31-12-2016,13,14767,19001,7673,4894,46337,985,1100,439,2524,48861
31-12-2016,14,15133,19125,7621,4876,46757,984,1193,424,2601,49358
31-12-2016,15,16041,19367,7745,4933,48087,972,1195,425,2592,50679
31-12-2016,16,17023,19630,7807,5112,49573,978,1197,439,2614,52187
31-12-2016,17,17336,19719,7820,5055,49929,1045,1188,422,2655,52584
31-12-2016,18,16172,19251,7822,5113,48360,1017,1177,439,2633,50993
31-12-2016,19,14648,18585,7848,4976,46058,985,999,451,2435,48493
31-12-2016,20,13487,17842,7537,4874,43740,927,888,444,2259,45999
31-12-2016,21,12947,17368,7424,4904,42643,915,690,450,2055,44698
31-12-2016,22,12736,17015,7305,4775,41832,918,605,399,1922,43754
31-12-2016,23,12399,16460,7080,4618,40557,865,240,396,1501,42058
01-01-2017,0,12316,16898,7079,4425,40717,841,240,396,1477,42194
01-01-2017,1,12189,16674,6954,4258,40075,815,240,400,1455,41530
01-01-2017,2,11992,16615,6903,4139,39649,809,240,403,1452,41101
01-01-2017,3,11646,16449,6882,4092,39069,800,240,391,1431,40500
01-01-2017,4,11760,16274,6880,3836,38751,793,239,388,1420,40171
01-01-2017,5,12143,16184,6815,3457,38599,777,239,395,1411,40010
01-01-2017,6,12847,16192,6871,3321,39230,767,240,426,1433,40663
01-01-2017,7,12967,16293,6939,3211,39410,760,376,424,1560,40970
01-01-2017,8,13174,16208,6959,3266,39606,771,435,410,1616,41222
01-01-2017,9,13921,16540,7074,3288,40823,755,486,415,1656,42479
01-01-2017,10,15434,16683,7129,3164,42412,753,537,467,1757,44169
01-01-2017,11,16173,17004,7247,3165,43590,761,737,459,1957,45547
01-01-2017,12,16621,17242,7391,3148,44402,786,890,471,2147,46549
01-01-2017,13,17067,17498,7497,3078,45141,823,1025,487,2335,47476
01-01-2017,14,17992,17861,7730,3082,46665,845,750,480,2075,48740
01-01-2017,15,19886,18044,7658,2984,48573,847,911,468,2226,50799
01-01-2017,16,20823,18683,7760,3123,50390,880,1109,452,2441,52831
01-01-2017,17,21304,18901,7848,2983,51037,888,1118,441,2447,53484
01-01-2017,18,20884,19116,7878,2935,50812,912,1089,421,2422,53234
01-01-2017,19,20352,19050,7936,2893,50231,930,939,385,2254,52485
01-01-2017,20,19586,18539,7749,2970,48846,937,940,371,2248,51094
01-01-2017,21,19043,18119,7648,2954,47764,933,801,334,2068,49832
01-01-2017,22,18039,17456,7542,3008,46045,970,554,257,1781,47826
01-01-2017,23,17244,16816,7488,2948,44496,980,361,227,1568,46064
02-01-2017,0,16198,16805,7374,2948,43325,994,547,162,1703,45028
02-01-2017,1,15377,16601,7389,2826,42190,1012,560,137,1709,43899
02-01-2017,2,14977,16590,7390,2946,41903,1029,549,130,1708,43611
02-01-2017,3,14890,16665,7361,3002,41919,1012,541,138,1691,43610
02-01-2017,4,16088,16698,7401,2801,42987,1050,650,140,1840,44827
02-01-2017,5,18770,17428,7563,2839,46600,1001,803,142,1946,48546
02-01-2017,6,21176,19907,8001,2688,51773,976,900,193,2069,53842
02-01-2017,7,23081,22332,8284,2914,56611,1042,927,351,2320,58931
02-01-2017,8,23612,23324,8472,3203,58611,1162,1023,356,2541,61152
02-01-2017,9,23821,23404,8625,3582,59433,1096,1458,369,2923,62356
02-01-2017,10,24075,23736,8599,3635,60045,1203,1417,198,2818,62863
02-01-2017,11,23756,23826,8596,3695,59874,1236,1464,199,2899,62773
02-01-2017,12,23702,23707,8566,3725,59699,1228,1409,247,2884,62583
02-01-2017,13,23858,23614,8590,3523,59585,1192,1335,278,2805,62390
02-01-2017,14,24105,23817,8809,3381,60112,1195,1326,259,2780,62892
02-01-2017,15,24475,24152,8937,3496,61061,1203,1594,261,3058,64119
02-01-2017,16,24748,24487,9040,3554,61829,1372,1394,444,3210,65039
02-01-2017,17,24655,24518,9030,3787,61991,1377,1312,435,3124,65115
02-01-2017,18,24119,24301,8998,3655,61073,1373,1302,442,3117,64190
02-01-2017,19,23785,23747,8804,3403,59740,1286,1512,250,3048,62788
02-01-2017,20,23236,23037,8554,3327,58155,1109,1548,240,2897,61052
02-01-2017,21,23482,21370,8399,3418,56669,1079,1377,272,2728,59397
02-01-2017,22,22813,19757,8226,3178,53975,1088,1097,296,2481,56456
02-01-2017,23,22116,17754,7955,2900,50725,1095,941,167,2203,52928
03-01-2017,0,20908,16712,7746,2960,48327,983,887,170,2040,50367
03-01-2017,1,20051,16333,7582,3234,47199,961,675,179,1815,49014
03-01-2017,2,19517,16132,7582,3154,46383,968,685,155,1808,48191
03-01-2017,3,19560,15919,7670,3271,46419,980,672,167,1819,48238
03-01-2017,4,20139,16282,7790,3160,47372,982,694,199,1875,49247
03-01-2017,5,20765,17833,7978,3311,49889,986,1012,233,2231,52120
03-01-2017,6,22287,19968,8437,3503,54195,965,1186,313,2464,56659
03-01-2017,7,24085,22651,8936,3749,59419,959,1520,267,2746,62165
03-01-2017,8,24369,23837,9047,3994,61247,1108,1539,256,2903,64150
03-01-2017,9,23673,23995,9079,4346,61093,1020,1526,222,2768,63861
03-01-2017,10,23260,24066,9139,4724,61188,1028,1611,190,2829,64017
03-01-2017,11,22799,23897,9064,5188,60946,1056,1592,196,2844,63790
03-01-2017,12,22242,23442,8964,5749,60398,1044,1588,186,2818,63216
03-01-2017,13,21967,23196,9020,5982,60165,1038,1580,174,2792,62957
03-01-2017,14,21938,23453,9046,5758,60194,1034,1442,154,2630,62824
03-01-2017,15,21680,24167,9213,5892,60951,1031,1447,182,2660,63611
03-01-2017,16,21638,24473,9327,6049,61487,1043,1411,219,2673,64160
03-01-2017,17,21758,24412,9263,6114,61548,1042,1356,251,2649,64197
03-01-2017,18,21296,23556,9223,5924,59997,1055,1362,319,2736,62733
03-01-2017,19,20560,22402,9115,5828,57905,1068,1277,374,2719,60624
03-01-2017,20,19905,21257,8922,5665,55749,1088,1181,416,2685,58434
03-01-2017,21,19103,19989,8715,5306,53113,1133,903,469,2505,55618
03-01-2017,22,17807,19385,8506,5122,50819,1111,806,426,2343,53162
03-01-2017,23,16371,18801,8337,4934,48443,1092,757,442,2291,50734
04-01-2017,0,14887,18935,8338,4838,46998,1034,634,436,2104,49102
04-01-2017,1,14200,18865,8300,4507,45872,1056,625,411,2092,47964
04-01-2017,2,13516,18772,8338,4298,44925,1089,685,412,2186,47111
04-01-2017,3,13505,18701,8417,4229,44851,1150,605,395,2150,47001
04-01-2017,4,13640,18873,8481,4608,45603,1218,611,326,2155,47758
04-01-2017,5,15362,19363,8638,5045,48408,1387,639,272,2298,50706
04-01-2017,6,18448,20557,9031,5309,53346,1602,831,286,2719,56065
04-01-2017,7,21222,21892,9304,5773,58191,1881,1223,297,3401,61592
04-01-2017,8,22378,22380,9255,5487,59500,1854,1280,296,3430,62930
04-01-2017,9,22850,23149,9381,5492,60874,1858,1381,265,3504,64378
04-01-2017,10,22850,23432,9357,5693,61335,1857,1465,283,3605,64940
04-01-2017,11,22975,23767,9167,5717,61627,1824,1485,259,3568,65195
04-01-2017,12,22803,24105,9143,5738,61790,1882,1491,235,3608,65398
04-01-2017,13,22676,24199,9187,5960,62024,1884,1578,268,3730,65754
04-01-2017,14,22681,24401,9450,5786,62317,1873,1593,290,3756,66073
04-01-2017,15,22962,25314,9664,5687,63628,1871,1595,296,3762,67390
04-01-2017,16,23240,25749,9855,5634,64477,1842,1674,411,3927,68404
04-01-2017,17,23754,25957,9897,5407,65015,1776,1645,496,3917,68932
04-01-2017,18,23452,25491,9820,5523,64288,1789,1672,537,3998,68286
04-01-2017,19,23584,24837,9628,5275,63325,1806,1679,538,4023,67348
04-01-2017,20,23384,23478,9627,4954,61442,1802,1596,538,3936,65378
04-01-2017,21,22953,22110,9351,4837,59251,1808,1430,537,3775,63026
04-01-2017,22,22512,20813,9245,4473,57042,1822,1261,536,3619,60661
04-01-2017,23,21384,20141,8899,4242,54665,1806,810,526,3142,57807
05-01-2017,0,20840,18962,8631,4253,52686,1575,752,459,2786,55472
05-01-2017,1,20471,18726,8566,4133,51896,1557,755,444,2756,54652
05-01-2017,2,20467,18995,8551,4162,52175,1400,760,440,2600,54775
05-01-2017,3,20634,19022,8475,4396,52527,1341,740,415,2496,55023
05-01-2017,4,21408,19408,8558,4658,54033,1589,812,430,2831,56864
05-01-2017,5,22532,20662,8701,4538,56434,1849,1087,411,3347,59781
05-01-2017,6,23781,23210,9222,4631,60844,1891,1134,584,3609,64453
05-01-2017,7,25428,25240,9564,5176,65409,1902,1332,618,3852,69261
05-01-2017,8,25918,26334,9790,5383,67426,1670,1699,569,3938,71364
05-01-2017,9,25826,26253,9676,5307,67061,1669,1790,608,4067,71128
05-01-2017,10,26067,26461,9739,5180,67449,1674,1976,438,4088,71537
05-01-2017,11,25713,26255,9806,5184,66957,1776,1996,420,4192,71149
05-01-2017,12,25418,26167,9709,4997,66290,1767,1996,400,4163,70453
05-01-2017,13,25452,25361,9649,4859,65322,1743,2000,371,4114,69436
05-01-2017,14,25869,24888,9771,4705,65232,1834,1993,750,4577,69809
05-01-2017,15,25954,25303,10020,4728,66005,1889,1992,762,4643,70648
05-01-2017,16,26289,25461,9963,4626,66339,1875,1996,738,4609,70948
05-01-2017,17,26326,25924,10053,4549,66852,1860,1997,720,4577,71429
05-01-2017,18,26353,25985,10037,4495,66871,1850,1997,724,4571,71442
05-01-2017,19,26159,25829,9853,4365,66205,1852,1997,752,4601,70806
05-01-2017,20,25922,25469,9491,4158,65041,1843,1977,578,4398,69439
05-01-2017,21,25332,24573,9160,3970,63035,1818,1856,382,4056,67091
05-01-2017,22,24733,23459,8934,3622,60747,1812,1724,324,3860,64607
05-01-2017,23,23705,22072,8700,3349,57826,1811,1543,302,3656,61482
06-01-2017,0,23890,22189,8639,3286,58004,1695,1287,187,3169,61173
06-01-2017,1,23658,21702,8504,3220,57085,1661,1280,185,3126,60211
06-01-2017,2,23119,20858,8454,3135,55568,1651,1275,201,3127,58695
06-01-2017,3,22780,20612,8622,3246,55260,1639,1272,185,3096,58356
06-01-2017,4,22735,20690,8710,3405,55540,1643,1268,163,3074,58614
06-01-2017,5,22834,21538,8643,3727,56742,1741,1320,129,3190,59932
06-01-2017,6,24315,22993,9073,3974,60357,1832,1638,237,3707,64064
06-01-2017,7,25457,24370,9474,4074,63375,1841,1844,265,3950,67325
06-01-2017,8,25632,25071,9562,4344,64610,1808,1918,302,4028,68638
06-01-2017,9,25268,25279,9643,4432,64623,1797,1923,348,4068,68691
06-01-2017,10,25039,25682,9735,4550,65007,1808,1994,391,4193,69200
06-01-2017,11,24327,25832,9728,4844,64732,1810,1996,424,4230,68962
06-01-2017,12,23782,25798,9700,4963,64243,1804,1944,361,4109,68352
06-01-2017,13,23438,25597,9646,4943,63624,1799,1938,60,3797,67421
06-01-2017,14,23477,25498,9681,4941,63597,1796,1889,57,3742,67339
06-01-2017,15,23625,25889,9850,5034,64398,1805,1870,90,3765,68163
06-01-2017,16,23903,26080,9828,5310,65121,1814,1888,215,3917,69038
06-01-2017,17,24045,26149,9790,5377,65361,1827,1815,252,3894,69255
06-01-2017,18,23419,25820,9679,5305,64223,1831,1829,225,3885,68108
06-01-2017,19,22841,25186,9564,5290,62881,1856,1648,196,3700,66581
06-01-2017,20,21627,24078,9454,5267,60428,1869,1558,194,3621,64049
06-01-2017,21,20677,22927,9141,5436,58182,1883,1485,210,3578,61760
06-01-2017,22,19795,21701,8950,5446,55891,1851,1118,244,3213,59104
06-01-2017,23,18069,20764,8872,5260,52966,1584,1002,194,2780,55746
07-01-2017,0,17597,20169,8777,5372,51916,1484,630,64,2178,54094
07-01-2017,1,16940,19724,8766,5387,50818,1447,633,74,2154,52972
07-01-2017,2,16392,19775,8691,5227,50083,1389,633,105,2127,52210
07-01-2017,3,16018,19754,8660,5250,49683,1337,633,131,2101,51784
07-01-2017,4,15922,19838,8604,5269,49634,1371,635,143,2149,51783
07-01-2017,5,16324,19621,8650,5187,49782,1477,636,153,2266,52048
07-01-2017,6,16918,19865,8675,4948,50407,1553,637,149,2339,52746
07-01-2017,7,17888,20658,8706,4819,52072,1664,640,209,2513,54585
07-01-2017,8,19721,21226,8680,4808,54436,1660,676,230,2566,57002
07-01-2017,9,21353,21953,8650,4691,56647,1662,720,243,2625,59272
07-01-2017,10,21994,22433,8707,4480,57615,1664,716,262,2642,60257
07-01-2017,11,21923,22706,8695,4483,57809,1661,665,299,2625,60434
07-01-2017,12,21975,22731,8677,4394,57777,1671,652,273,2596,60373
07-01-2017,13,21727,22546,8624,4443,57342,1683,653,200,2536,59878
07-01-2017,14,21667,22471,8761,4321,57219,1667,650,234,2551,59770
07-01-2017,15,22281,22823,8837,4145,58087,1641,650,220,2511,60598
07-01-2017,16,22863,23720,9087,4080,59752,1618,655,249,2522,62274
07-01-2017,17,23223,23830,9119,4047,60219,1606,647,220,2473,62692
07-01-2017,18,23013,23556,9082,3885,59536,1575,632,230,2437,61973
07-01-2017,19,22813,23089,8981,3611,58494,1544,637,219,2400,60894
07-01-2017,20,22622,22315,8740,3328,57006,1542,673,217,2432,59438
07-01-2017,21,22417,21527,8632,3213,55790,1527,651,214,2392,58182
07-01-2017,22,22066,20491,8335,3028,53921,1501,581,168,2250,56171
07-01-2017,23,21248,19449,8119,2857,51674,1413,613,124,2150,53824
08-01-2017,0,20837,17945,8102,2514,49398,1379,890,103,2372,51770
08-01-2017,1,20651,17452,8041,2639,48783,1318,890,90,2298,51081
08-01-2017,2,20209,17273,7915,2505,47903,1302,889,91,2282,50185
08-01-2017,3,20157,17168,7843,2431,47600,1292,889,92,2273,49873
08-01-2017,4,20270,17356,7885,2479,47990,1292,888,83,2263,50253
08-01-2017,5,20345,17811,8074,2489,48720,1327,886,81,2294,51014
08-01-2017,6,20256,18035,8242,2508,49042,1392,892,76,2360,51402
08-01-2017,7,19890,19476,8440,2611,50418,1465,961,89,2515,52933
08-01-2017,8,20733,20313,8561,2753,52360,1436,995,95,2526,54886
08-01-2017,9,22024,21087,8681,2806,54597,1420,1010,93,2523,57120
08-01-2017,10,22880,21875,8886,2815,56456,1381,1198,88,2667,59123
08-01-2017,11,22609,22031,8971,2670,56282,1331,1194,85,2610,58892
08-01-2017,12,22459,21941,8850,2841,56092,1315,1198,83,2596,58688
08-01-2017,13,22133,21938,8819,2866,55756,1315,1197,78,2590,58346
08-01-2017,14,22086,22098,8823,2980,55986,1384,1255,80,2719,58705
08-01-2017,15,22653,22327,8941,3243,57165,1474,1260,96,2830,59995
08-01-2017,16,23173,22743,9079,3298,58293,1487,1314,98,2899,61192
08-01-2017,17,22949,22941,9176,3506,58573,1500,1313,108,2921,61494
08-01-2017,18,22696,22753,8979,3649,58078,1523,1269,121,2913,60991
08-01-2017,19,22401,22232,8825,3504,56963,1531,1212,146,2889,59852
08-01-2017,20,21674,21649,8656,3516,55496,1548,1086,151,2785,58281
08-01-2017,21,21857,20722,8642,3588,54809,1528,1019,167,2714,57523
08-01-2017,22,20358,19720,8393,3477,51948,1489,897,179,2565,54513
08-01-2017,23,18604,18828,8312,3347,49092,1441,632,182,2255,51347
09-01-2017,0,17847,18521,8299,3277,,1438,469,168,2075,
09-01-2017,1,17079,18164,8241,3231,46716,1459,454,161,2074,48790
09-01-2017,2,16665,18084,8203,3102,46055,1490,461,162,2113,48168
09-01-2017,3,17041,18230,8117,3134,46520,1481,460,186,2127,48647
09-01-2017,4,18048,18499,8186,3199,47931,1501,476,183,2160,50091
09-01-2017,5,19319,20093,8586,3332,51329,1648,732,159,2539,53868
09-01-2017,6,21271,21995,9058,3661,55985,1811,749,149,2709,58694
09-01-2017,7,23264,23864,9585,3780,60494,1808,840,313,2961,63455
09-01-2017,8,23469,24257,9609,3954,61287,1846,843,354,3043,64330
09-01-2017,9,22881,24062,9400,3959,60303,1864,932,363,3159,63462
09-01-2017,10,23033,23953,9358,4194,60537,1926,940,298,3164,63701
09-01-2017,11,22936,23959,9185,4321,60401,1931,1075,307,3313,63714
09-01-2017,12,22728,23650,9203,4466,60047,1906,1078,305,3289,63336
09-01-2017,13,22507,23718,9186,4567,59977,1913,1126,287,3326,63303
09-01-2017,14,22453,23929,9225,4559,60167,1926,880,202,3008,63175
09-01-2017,15,22657,24323,9442,4482,60905,1968,892,196,3056,63961
09-01-2017,16,22426,24813,9453,4651,61343,1995,1052,307,3354,64697
09-01-2017,17,22102,24641,9176,4930,60848,1968,1009,303,3280,64128
09-01-2017,18,21673,24099,9096,4904,59773,1931,761,307,2999,62772
09-01-2017,19,21161,22854,8583,4990,57589,1918,745,125,2788,60377
09-01-2017,20,20014,21780,8114,5195,55103,1918,745,125,2788,57891
09-01-2017,21,19304,21046,7865,5271,53485,1871,623,131,2625,56110
09-01-2017,22,17582,20283,7754,5205,50824,1849,464,142,2455,53279
09-01-2017,23,15864,19336,7663,5175,48038,1800,456,116,2372,50410
10-01-2017,0,14546,18962,7442,5193,46144,1477,455,121,2053,48197
10-01-2017,1,13836,18635,7310,5157,44937,1460,451,115,2026,46963
10-01-2017,2,13740,18658,7282,5067,44748,1457,447,104,2008,46756
10-01-2017,3,13834,18618,7341,5036,44830,1438,445,131,2014,46844
10-01-2017,4,15207,19013,7413,4726,46361,1523,449,148,2120,48481
10-01-2017,5,16744,20131,7979,4776,49629,1876,549,148,2573,52202
10-01-2017,6,19531,21795,8732,4867,54923,2000,834,205,3039,57962
10-01-2017,7,21727,23895,9045,4996,59662,2028,931,208,3167,62829
10-01-2017,8,22875,24408,9069,4943,61296,2038,933,194,3165,64461
10-01-2017,9,22460,24521,8901,4987,60869,2041,928,172,3141,64010
10-01-2017,10,22455,24530,8894,5342,61221,2072,1017,131,3220,64441
10-01-2017,11,22440,24518,8945,5165,61068,2042,1036,106,3184,64252
10-01-2017,12,22269,24504,8996,5000,60768,2012,1025,106,3143,63911
10-01-2017,13,22351,24686,8967,4998,61002,1979,1071,110,3160,64162
10-01-2017,14,22328,24791,9084,4886,61089,1969,1093,120,3182,64271
10-01-2017,15,22601,25140,9238,4852,61831,2019,1176,233,3428,65259
10-01-2017,16,22941,24978,9284,5025,62228,2060,1258,269,3587,65815
10-01-2017,17,22980,24988,9224,5090,62281,2022,1269,186,3477,65758
10-01-2017,18,22142,24976,9117,5096,61333,1999,1060,272,3331,64664
10-01-2017,19,21279,24041,9005,5231,59557,1990,942,246,3178,62735
10-01-2017,20,19910,23070,9027,5161,57168,2011,829,248,3088,60256
10-01-2017,21,19025,22272,8892,5157,55348,1981,636,270,2887,58235
10-01-2017,22,17188,21317,8649,4932,52088,1988,522,265,2775,54863
10-01-2017,23,15162,20492,8399,4759,48811,1688,471,289,2448,51259
11-01-2017,0,13125,19733,8170,5048,46076,1503,463,276,2242,48318
11-01-2017,1,11882,19393,8090,5182,44546,1482,464,274,2220,46766
11-01-2017,2,11413,19412,8005,5158,43988,1487,470,262,2219,46207
11-01-2017,3,11643,19556,8049,5326,44573,1493,472,262,2227,46800
11-01-2017,4,12416,19772,8169,5361,45718,1496,474,285,2255,47973
11-01-2017,5,14016,20685,8504,5745,48949,1516,538,293,2347,51296
11-01-2017,6,16479,21932,8972,6125,53507,1744,606,334,2684,56191
11-01-2017,7,18855,23613,9313,6396,58177,2040,816,370,3226,61403
11-01-2017,8,19367,24136,9278,6490,59271,2045,1187,388,3620,62891
11-01-2017,9,19413,24172,9124,6510,59219,2029,1253,358,3640,62859
11-01-2017,10,19756,24407,9180,6434,59777,2003,1253,329,3585,63362
11-01-2017,11,19349,24502,9247,6500,59599,1995,1107,335,3437,63036
11-01-2017,12,19305,24522,9240,6376,59443,1963,1126,340,3429,62872
11-01-2017,13,19554,24596,9251,6325,59726,1892,1111,331,3334,63060
11-01-2017,14,19416,24620,9363,6305,59705,1872,898,405,3175,62880
11-01-2017,15,19669,24681,9337,6195,59882,1837,941,454,3232,63114
11-01-2017,16,20314,24731,9453,6229,60727,1844,1327,463,3634,64361
11-01-2017,17,20634,24686,9474,6340,61135,1885,1328,458,3671,64806
11-01-2017,18,20169,24335,9360,6177,60042,1894,1109,453,3456,63498
11-01-2017,19,19453,23626,9047,6117,58243,1878,717,465,3060,61303
11-01-2017,20,17776,22482,8854,5990,55103,1719,681,471,2871,57974
11-01-2017,21,16763,21547,8684,5706,52701,1561,680,469,2710,55411
11-01-2017,22,15221,20516,8527,5524,49786,1549,670,451,2670,52456
11-01-2017,23,13584,19535,8300,5244,46662,1566,510,469,2545,49207
12-01-2017,0,12407,19214,8227,5068,44916,1438,493,462,2393,47309
12-01-2017,1,12267,18885,8144,4936,44232,1382,488,451,2321,46553
12-01-2017,2,12163,18725,8182,4775,43843,1362,488,444,2294,46137
12-01-2017,3,12338,18645,8198,4811,43993,1363,489,434,2286,46279
12-01-2017,4,12803,18869,8342,4977,44990,1378,495,414,2287,47277
12-01-2017,5,14154,20101,8759,5184,48197,1459,533,371,2363,50560
12-01-2017,6,16885,22462,9210,5865,54422,1749,575,344,2668,57090
12-01-2017,7,19480,24107,9514,6117,59217,1768,1003,319,3090,62307
12-01-2017,8,20088,24612,9559,6260,60519,1763,1222,299,3284,63803
12-01-2017,9,19570,24676,9565,6407,60219,1780,1203,375,3358,63577
12-01-2017,10,19715,24610,9600,6546,60471,1789,1232,284,3305,63776
12-01-2017,11,19518,24496,9551,6536,60101,1785,1184,249,3218,63319
12-01-2017,12,19340,24307,9521,6444,59611,1761,1191,249,3201,62812
12-01-2017,13,19397,24168,9470,6430,59464,1751,1203,252,3206,62670
12-01-2017,14,19636,24137,9412,6303,59488,1740,1354,311,3405,62893
12-01-2017,15,19885,24098,9688,6371,60042,1742,1440,392,3574,63616
12-01-2017,16,21191,24317,9731,6171,61410,1734,1444,554,3732,65142
12-01-2017,17,21683,24657,9694,6158,62191,1716,1427,510,3653,65844
12-01-2017,18,21399,24560,9662,5623,61244,1723,1371,543,3637,64881
12-01-2017,19,21015,24448,9300,5101,59865,1699,928,403,3030,62895
12-01-2017,20,20726,24195,9103,4643,58666,1666,705,422,2793,61459
12-01-2017,21,20212,23454,8964,4361,56991,1601,645,420,2666,59657
12-01-2017,22,19113,22377,8809,3948,54247,1526,619,397,2542,56789
12-01-2017,23,18066,20909,8688,3637,51301,1395,488,396,2279,53580
13-01-2017,0,17329,19151,8549,3273,48304,1343,478,391,2212,50516
13-01-2017,1,17013,18736,8431,2948,47128,1348,474,412,2234,49362
13-01-2017,2,16597,18490,8351,2615,46054,1340,471,389,2200,48254
13-01-2017,3,16485,18242,8148,2623,45498,1315,466,387,2168,47666
13-01-2017,4,17262,18473,8072,2574,46381,1397,484,339,2220,48601
13-01-2017,5,20348,19756,8273,2564,50942,1641,882,337,2860,53802
13-01-2017,6,22992,22633,8924,3035,57584,1706,933,287,2926,60510
13-01-2017,7,24792,24395,9069,3364,61621,1716,1266,620,3602,65223
13-01-2017,8,25039,25012,8904,3993,62948,1704,1252,662,3618,66566
13-01-2017,9,24864,24819,8855,3783,62321,1700,1375,671,3746,66067
13-01-2017,10,24686,24744,8743,3925,62098,1684,1382,655,3721,65819
13-01-2017,11,24812,24445,8696,3990,61943,1665,1472,609,3746,65689
13-01-2017,12,24350,23798,8641,4060,60850,1660,1487,598,3745,64595
13-01-2017,13,23794,23220,8596,4016,59625,1644,1463,552,3659,63284
13-01-2017,14,23830,22814,8581,3769,58993,1650,1490,433,3573,62566
13-01-2017,15,23917,23400,8682,3576,59575,1636,1402,613,3651,63226
13-01-2017,16,24076,24405,8750,3711,60941,1633,1352,635,3620,64561
13-01-2017,17,23725,24649,8712,3832,60918,1641,1464,606,3711,64629
13-01-2017,18,23596,24445,8909,3710,60662,1708,1292,577,3577,64239
13-01-2017,19,23207,23643,8662,3384,58895,1607,1103,376,3086,61981
13-01-2017,20,22401,22294,7951,3490,56137,1590,1045,322,2957,59094
13-01-2017,21,22037,20838,7623,3659,54157,1584,1035,147,2766,56923
13-01-2017,22,20769,19672,7476,3543,51460,1578,1023,120,2721,54181
13-01-2017,23,19802,18386,7120,3387,48695,1545,573,94,2212,50907
14-01-2017,0,18084,17558,6909,3067,45619,1213,534,83,1830,47449
14-01-2017,1,16049,17341,6775,3189,43356,1086,507,82,1675,45031
14-01-2017,2,15129,17235,6783,3553,42699,978,507,83,1568,44267
14-01-2017,3,14767,17253,6770,3775,42567,942,506,95,1543,44110
14-01-2017,4,14863,17211,6816,3953,42842,918,506,95,1519,44361
14-01-2017,5,15433,17413,6985,3996,43827,904,520,94,1518,45345
14-01-2017,6,17302,17985,7041,4216,46544,1028,539,79,1646,48190
14-01-2017,7,18792,18799,7199,4100,48890,1012,621,56,1689,50579
14-01-2017,8,20196,20637,7271,4030,52134,1133,936,57,2126,54260
14-01-2017,9,21668,21057,7544,4585,54855,1216,946,60,2222,57077
14-01-2017,10,22361,21307,7646,4603,55915,1218,928,69,2215,58130
14-01-2017,11,22193,21620,7689,4668,56171,1206,928,61,2195,58366
14-01-2017,12,21721,21564,7656,4779,55721,1212,925,59,2196,57917
14-01-2017,13,21433,21478,7571,4737,55219,1208,1031,60,2299,57518
14-01-2017,14,21132,21603,7542,4747,55026,1197,1123,53,2373,57399
14-01-2017,15,21724,21870,7669,4702,55966,1217,1217,52,2486,58452
14-01-2017,16,22573,22932,7952,4804,58261,1242,1321,58,2621,60882
14-01-2017,17,23000,23408,7970,4842,59220,1254,1322,64,2640,61860
14-01-2017,18,22679,23254,7915,4790,58639,1226,1316,72,2614,61253
14-01-2017,19,22196,22382,7721,4648,56949,1202,1253,83,2538,59487
14-01-2017,20,21097,21320,7437,4585,54439,1181,1177,69,2427,56866
14-01-2017,21,19985,20387,7200,4389,51961,1169,895,66,2130,54091
14-01-2017,22,19179,19407,7049,4329,49965,1166,774,81,2021,51986
14-01-2017,23,17096,18990,6960,4149,47194,1214,525,90,1829,49023
15-01-2017,0,15973,18422,6975,3921,45292,988,467,90,1545,46837
15-01-2017,1,15193,18198,6952,3788,44130,890,464,96,1450,45580
15-01-2017,2,14995,18134,6892,3830,43851,887,464,88,1439,45290
15-01-2017,3,14871,18250,6901,3781,43804,892,463,91,1446,45250
15-01-2017,4,15417,18499,6804,3575,44295,897,484,110,1491,45786
15-01-2017,5,16141,19031,6497,3239,44909,908,514,120,1542,46451
15-01-2017,6,16913,19918,6576,2999,46408,1025,567,147,1739,48147
15-01-2017,7,18100,20642,6708,2950,48399,1033,550,148,1731,50130
15-01-2017,8,20403,21524,6729,3209,51864,1201,849,134,2184,54048
15-01-2017,9,22742,22540,6970,3124,55378,1217,974,153,2344,57722
15-01-2017,10,23371,23486,7097,3191,57145,1248,1077,154,2479,59624
15-01-2017,11,23499,23761,7241,3164,57664,1296,1195,137,2628,60292
15-01-2017,12,23037,23777,7305,3281,57400,1283,1197,118,2598,59998
15-01-2017,13,22965,23392,7571,3110,57038,1302,1197,108,2607,59645
15-01-2017,14,23025,23442,7577,3118,57161,1287,1191,106,2584,59745
15-01-2017,15,23496,23725,7780,3295,58296,1379,1291,112,2782,61078
15-01-2017,16,24087,24616,8122,3394,60218,1355,1361,118,2834,63052
15-01-2017,17,24261,25280,8331,3443,61315,1394,1373,99,2866,64181
15-01-2017,18,23979,25343,8290,3385,60997,1394,1366,93,2853,63850
15-01-2017,19,23848,24740,8148,3393,60131,1385,1345,87,2817,62948
15-01-2017,20,23746,24106,8037,3270,59158,1383,1226,81,2690,61848
15-01-2017,21,23885,23127,7920,3079,58010,1393,991,75,2459,60469
15-01-2017,22,23178,22204,7713,2743,55840,1380,727,68,2175,58015
15-01-2017,23,21891,21240,7648,2636,53415,1364,698,65,2127,55542
16-01-2017,0,20875,20473,7500,2682,51531,1344,697,64,2105,53636
16-01-2017,1,20661,19876,7566,2568,50671,1378,720,66,2164,52835
16-01-2017,2,20489,19715,7609,2562,50376,1427,751,66,2244,52620
16-01-2017,3,20725,19583,7783,2584,50676,1486,752,65,2303,52979
16-01-2017,4,21616,19900,8111,2749,52377,1584,753,65,2402,54779
16-01-2017,5,22501,21641,8856,2973,55971,1790,880,96,2766,58737
16-01-2017,6,24323,25121,9588,3382,62415,1789,1028,147,2964,65379
16-01-2017,7,25188,26733,9994,4488,66403,1710,1203,502,3415,69818
16-01-2017,8,25379,26395,10009,4472,66255,1724,1727,851,4302,70557
16-01-2017,9,25421,25963,10008,4547,65939,1721,1739,956,4416,70355
16-01-2017,10,24921,25869,10048,4531,65369,1721,1824,886,4431,69800
16-01-2017,11,25209,25496,9969,4654,65328,1708,1828,520,4056,69384
16-01-2017,12,25189,25355,9814,4616,64973,1707,1825,491,4023,68996
16-01-2017,13,24848,25191,9767,4589,64395,1705,1829,593,4127,68522
16-01-2017,14,24993,25015,9701,4487,64197,1709,1836,289,3834,68031
16-01-2017,15,25388,25090,9727,4582,64788,1728,1838,289,3855,68643
16-01-2017,16,25178,25542,9815,4628,65163,1730,1860,524,4114,69277
16-01-2017,17,25305,25571,9668,4665,65208,1731,1972,998,4701,69909
16-01-2017,18,24965,25595,9633,4254,64448,1740,1861,856,4457,68905
16-01-2017,19,24776,25331,9612,3955,63674,1703,1569,926,4198,67872
16-01-2017,20,24698,24638,9173,3417,61926,1705,1413,495,3613,65539
16-01-2017,21,24929,23978,8847,3235,60989,1686,1341,115,3142,64131
16-01-2017,22,24089,22670,8557,2997,58314,1653,1287,60,3000,61314
16-01-2017,23,22307,21603,8367,2933,55210,1622,1180,56,2858,58068
17-01-2017,0,21589,19765,8357,2950,52663,1606,721,55,2382,55045
17-01-2017,1,21161,19354,8247,3037,51799,1614,720,55,2389,54188
17-01-2017,2,20958,19344,8222,2893,51416,1590,718,55,2363,53779
17-01-2017,3,20864,19348,8251,2957,51422,1591,717,56,2364,53786
17-01-2017,4,21515,19637,8499,2997,52648,1593,720,54,2367,55015
17-01-2017,5,22543,21241,9051,3111,55946,1645,753,294,2692,58638
17-01-2017,6,23570,24014,9906,3354,60844,1871,1010,249,3130,63974
17-01-2017,7,24928,25783,10183,4193,65086,1631,1509,454,3594,68680
17-01-2017,8,25143,25966,10437,4279,65824,1482,1642,453,3577,69401
17-01-2017,9,25053,25587,10384,4212,65237,1546,1495,459,3500,68737
17-01-2017,10,24923,25415,10278,4218,64834,1627,1441,470,3538,68372
17-01-2017,11,25053,25407,9976,4143,64578,1619,1442,473,3534,68112
17-01-2017,12,24740,25139,9797,4227,63903,1613,1545,307,3465,67368
17-01-2017,13,24933,25159,9720,4178,63990,1612,1557,306,3475,67465
17-01-2017,14,24893,25052,9753,4197,63894,1639,1550,305,3494,67388
17-01-2017,15,24653,25172,9951,4233,64009,1648,1554,315,3517,67526
17-01-2017,16,24987,25436,10054,4286,64764,1635,1464,478,3577,68341
17-01-2017,17,24959,25763,10012,4636,65368,1634,1479,489,3602,68970
17-01-2017,18,24305,25352,9891,4454,64002,1640,1388,495,3523,67525
17-01-2017,19,23229,24824,9511,4359,61923,1642,1256,333,3231,65154
17-01-2017,20,22040,24231,9063,4199,59534,1651,1198,290,3139,62673
17-01-2017,21,21197,23392,8747,4161,57498,1687,902,489,3078,60576
17-01-2017,22,20044,22207,8449,4027,54727,1697,714,452,2863,57590
17-01-2017,23,18776,20821,8328,4004,51928,1672,528,293,2493,54421
18-01-2017,0,17643,19237,8216,4024,49120,1664,471,141,2276,51396
18-01-2017,1,17131,18722,8112,3944,47909,1656,550,157,2363,50272
18-01-2017,2,16983,18568,8188,3875,47615,1601,522,172,2295,49910
18-01-2017,3,17144,18479,8155,3982,47760,1646,623,185,2454,50214
18-01-2017,4,18018,18878,8356,4066,49319,1645,683,193,2521,51840
18-01-2017,5,19505,19971,8751,4214,52443,1742,724,193,2659,55102
18-01-2017,6,21219,22430,9296,4363,57307,1766,1091,235,3092,60399
18-01-2017,7,22937,24288,9649,4616,61490,1748,1279,370,3397,64887
18-01-2017,8,23301,24994,9721,4777,62794,1757,1280,383,3420,66214
18-01-2017,9,22994,24958,9668,4611,62231,1754,1266,395,3415,65646
18-01-2017,10,22771,24908,9574,4562,61816,1729,1258,420,3407,65223
18-01-2017,11,22197,25051,9522,4613,61383,1741,1201,427,3369,64752
18-01-2017,12,21728,25094,9460,4747,61030,1748,1238,423,3409,64439
18-01-2017,13,21481,25318,9224,4834,60859,1751,1261,378,3390,64249
18-01-2017,14,21330,25450,9182,4868,60829,1728,1255,375,3358,64187
18-01-2017,15,21386,25474,9364,4881,61106,1749,1298,380,3427,64533
18-01-2017,16,21820,25815,9442,4762,61839,1753,1308,643,3704,65543
18-01-2017,17,22030,26090,9400,4780,62300,1765,1297,642,3704,66004
18-01-2017,18,21157,25918,9300,4751,61127,1770,1151,602,3523,64650
18-01-2017,19,20314,25121,8899,4819,59153,1767,1142,456,3365,62518
18-01-2017,20,19241,24172,8624,4777,56815,1757,996,293,3046,59861
18-01-2017,21,18964,22634,8388,4696,54683,1747,886,306,2939,57622
18-01-2017,22,17720,21789,8102,4511,52123,1766,683,292,2741,54864
18-01-2017,23,17009,20253,7958,4274,49496,1508,673,296,2477,51973
19-01-2017,0,15875,19404,8011,3806,47096,1321,738,281,2340,49436
19-01-2017,1,15377,19064,8093,3619,46153,1308,720,285,2313,48466
19-01-2017,2,15195,19007,8200,3547,45949,1309,677,294,2280,48229
19-01-2017,3,15314,18886,8163,3567,45930,1304,658,299,2261,48191
19-01-2017,4,16380,18984,8053,3574,46991,1397,711,264,2372,49363
19-01-2017,5,17822,19780,8334,3713,49649,1692,706,319,2717,52366
19-01-2017,6,19849,21867,9072,3845,54634,1701,852,348,2901,57535
19-01-2017,7,21987,23981,9487,3802,59256,1681,1088,368,3137,62393
19-01-2017,8,22756,24531,9476,3797,60560,1662,1241,419,3322,63882
19-01-2017,9,22865,24250,9288,3622,60026,1664,1260,412,3336,63362
19-01-2017,10,22602,24450,9247,3728,60027,1649,1229,399,3277,63304
19-01-2017,11,22086,24611,9159,3967,59823,1633,1208,354,3195,63018
19-01-2017,12,21508,24547,9172,3993,59219,1652,1226,350,3228,62447
19-01-2017,13,21130,24735,9284,3954,59103,1643,1199,353,3195,62298
19-01-2017,14,20943,24737,9317,3849,58846,1659,1195,375,3229,62075
19-01-2017,15,21404,24876,9492,3745,59518,1687,1235,333,3255,62773
19-01-2017,16,22178,25068,9603,3689,60538,1705,1250,399,3354,63892
19-01-2017,17,23055,25284,9522,3804,61666,1739,1228,370,3337,65003
19-01-2017,18,22610,24985,9374,3633,60601,1724,1179,359,3262,63863
19-01-2017,19,21388,24611,9323,3580,58902,1701,926,357,2984,61886
19-01-2017,20,20080,23798,9191,3505,56574,1683,923,370,2976,59550
19-01-2017,21,19762,22778,8976,3464,54979,1608,831,328,2767,57746
19-01-2017,22,18976,21547,8785,3481,52788,1498,681,255,2434,55222
19-01-2017,23,17905,20151,8575,3473,50104,1390,626,246,2262,52366
20-01-2017,0,16354,18897,8451,3512,47212,1297,439,211,1947,49159
20-01-2017,1,15864,18285,8417,3466,46032,1286,429,190,1905,47937
20-01-2017,2,15729,18165,8369,3478,45741,1279,428,175,1882,47623
20-01-2017,3,15824,18200,8427,3504,45956,1263,442,165,1870,47826
20-01-2017,4,16434,18910,8512,3537,47393,1336,457,171,1964,49357
20-01-2017,5,16999,20597,8955,3512,50062,1535,865,163,2563,52625
20-01-2017,6,18618,22831,9523,3689,54661,1666,966,206,2838,57499
20-01-2017,7,21310,24121,9930,3813,59174,1649,1161,344,3154,62328
20-01-2017,8,22236,24275,9791,3863,60164,1642,1227,399,3268,63432
20-01-2017,9,22039,24253,9680,3930,59901,1619,1289,429,3337,63238
20-01-2017,10,21816,24140,9639,3929,59525,1621,1227,370,3218,62743
20-01-2017,11,21140,23935,9498,3988,58560,1612,1195,373,3180,61740
20-01-2017,12,20152,23673,9490,4097,57414,1666,1200,378,3244,60658
20-01-2017,13,20310,23437,9443,3707,56898,1682,1190,362,3234,60132
20-01-2017,14,19699,23715,9463,3628,56505,1639,1103,297,3039,59544
20-01-2017,15,19686,23566,9588,3654,56495,1621,1234,282,3137,59632
20-01-2017,16,20590,24001,9839,3660,58090,1656,1231,400,3287,61377
20-01-2017,17,21339,24386,9726,3697,59148,1666,1225,395,3286,62434
20-01-2017,18,20821,24007,9525,3718,58073,1681,1169,431,3281,61354
20-01-2017,19,19765,23571,9089,3494,55919,1636,1069,260,2965,58884
20-01-2017,20,18465,22897,8817,3414,53595,1303,1055,253,2611,56206
20-01-2017,21,18011,21994,8646,3418,52070,1217,898,234,2349,54419
20-01-2017,22,17407,21131,8541,3400,50479,1164,583,218,1965,52444
20-01-2017,23,16538,20080,8468,3286,48373,1135,497,211,1843,50216
21-01-2017,0,16079,18742,8409,3036,46265,1021,482,174,1677,47942
21-01-2017,1,15404,18190,8345,2906,44846,1034,469,154,1657,46503
21-01-2017,2,15090,17836,8341,2813,44081,1054,471,138,1663,45744
21-01-2017,3,15132,17895,8419,2675,44120,1033,477,146,1656,45776
21-01-2017,4,15682,17982,8492,2643,44799,1014,477,156,1647,46446
21-01-2017,5,16336,18320,8562,2542,45762,1007,493,136,1636,47398
21-01-2017,6,16594,19488,8638,2520,47240,1016,608,143,1767,49007
21-01-2017,7,17751,20485,8715,2519,49470,1115,926,126,2167,51637
21-01-2017,8,19209,21187,8786,2547,51730,1126,1061,166,2353,54083
21-01-2017,9,20435,21467,8968,2491,53362,1124,1094,149,2367,55729
21-01-2017,10,21048,21842,9034,2530,54454,1124,1093,133,2350,56804
21-01-2017,11,20839,21862,8941,2550,54191,1140,1088,121,2349,56540
21-01-2017,12,20455,21827,8813,2453,53549,1135,1092,119,2346,55895
21-01-2017,13,19994,21904,8630,2379,52906,1123,1073,122,2318,55224
21-01-2017,14,20036,21916,8354,2307,52615,1098,1077,100,2275,54890
21-01-2017,15,20781,22324,8448,2335,53889,1074,1090,104,2268,56157
21-01-2017,16,22018,22700,8642,2568,55928,1070,1193,324,2587,58515
21-01-2017,17,23137,22814,8790,2622,57362,1056,1237,331,2624,59986
21-01-2017,18,22766,22891,8771,2561,56990,1055,1235,323,2613,59603
21-01-2017,19,21648,22957,8710,2368,55685,1048,1107,320,2475,58160
21-01-2017,20,20204,22562,8654,2256,53677,1049,1058,105,2212,55889
21-01-2017,21,19448,22237,8656,2237,52580,1071,992,110,2173,54753
21-01-2017,22,18543,22145,8371,2174,51234,1097,822,102,2021,53255
21-01-2017,23,17673,21235,8182,2103,49193,1045,691,112,1848,51041
22-01-2017,0,17737,19903,8020,1986,47646,1004,466,123,1593,49239
22-01-2017,1,17102,19842,7847,1972,46764,1027,465,129,1621,48385
22-01-2017,2,16639,19939,7777,1953,46307,1061,469,139,1669,47976
22-01-2017,3,16568,19741,7754,1971,46034,1045,464,166,1675,47709
22-01-2017,4,16664,19717,7751,2059,46192,1062,476,160,1698,47890
22-01-2017,5,16948,19672,7820,2071,46509,1063,482,165,1710,48219
22-01-2017,6,17216,20280,7873,2174,47543,1046,483,179,1708,49251
22-01-2017,7,17904,21037,7939,2240,49120,1088,525,189,1802,50922
22-01-2017,8,18862,21733,7966,2251,50812,1134,798,166,2098,52910
22-01-2017,9,20034,22129,8099,2226,52488,1178,1032,153,2363,54851
22-01-2017,10,21043,22503,8154,2375,54075,1185,1072,209,2466,56541
22-01-2017,11,21195,23074,8254,2481,55004,1159,1053,205,2417,57421
22-01-2017,12,20906,23226,8228,2556,54915,1186,1056,163,2405,57320
22-01-2017,13,20963,23117,8217,2425,54723,1209,1055,161,2425,57148
22-01-2017,14,20770,23372,8249,2315,54705,1225,1056,160,2441,57146
22-01-2017,15,21195,23562,8251,2424,55432,1250,1099,150,2499,57931
22-01-2017,16,22222,23788,8346,2458,56814,1285,1222,158,2665,59479
22-01-2017,17,22711,23908,8363,2815,57797,1336,1232,170,2738,60535
22-01-2017,18,22564,23942,8385,2814,57706,1341,1157,171,2669,60375
22-01-2017,19,21894,23638,8403,2531,56465,1330,1160,151,2641,59106
22-01-2017,20,20748,23358,8289,2477,54872,1328,1068,210,2606,57478
22-01-2017,21,20077,22797,8257,2445,53578,1331,961,190,2482,56060
22-01-2017,22,19306,22222,8062,2271,51861,1285,696,143,2124,53985
22-01-2017,23,17775,21700,8040,2290,49804,1249,505,137,1891,51695
23-01-2017,0,16899,20031,7982,2382,47295,1173,498,137,1808,49103
23-01-2017,1,16568,19453,7883,2387,46292,1159,492,144,1795,48087
23-01-2017,2,16277,19417,7855,2302,45851,1219,494,134,1847,47698
23-01-2017,3,16400,19689,7893,2322,46302,1268,507,132,1907,48209
23-01-2017,4,17090,20278,7962,2336,47667,1360,597,139,2096,49763
23-01-2017,5,17954,22274,8390,2468,51087,1604,1030,129,2763,53850
23-01-2017,6,20176,24113,9008,2571,55869,1708,1249,184,3141,59010
23-01-2017,7,22851,25216,9313,2840,60221,1720,1402,401,3523,63744
23-01-2017,8,23717,25911,9291,2934,61853,1710,1365,383,3458,65311
23-01-2017,9,23265,25974,9267,3054,61561,1728,1363,408,3499,65060
23-01-2017,10,23365,25897,9100,2947,61311,1750,1347,615,3712,65023
23-01-2017,11,22854,25888,9115,2963,60820,1769,1291,643,3703,64523
23-01-2017,12,22669,25634,9094,2921,60318,1756,1298,626,3680,63998
23-01-2017,13,22562,25470,9109,2968,60107,1781,1258,632,3671,63778
23-01-2017,14,22289,25385,9145,2957,59777,1819,1237,376,3432,63209
23-01-2017,15,22927,24819,9250,2937,59935,1826,1261,391,3478,63413
23-01-2017,16,23858,24808,9556,2964,61187,1829,1252,454,3535,64722
23-01-2017,17,24222,25596,9432,3255,62504,1816,1245,475,3536,66040
23-01-2017,18,23500,25580,9210,3267,61557,1813,1242,318,3373,64930
23-01-2017,19,22977,25063,8834,2944,59820,1809,1104,254,3167,62987
23-01-2017,20,21680,24521,8537,2762,57500,1811,1049,221,3081,60581
23-01-2017,21,21168,23964,8362,2836,56332,1706,915,212,2833,59165
23-01-2017,22,19906,23049,8319,2824,54098,1583,683,191,2457,56555
23-01-2017,23,18920,21697,8183,2792,51592,1541,629,184,2354,53946
24-01-2017,0,19062,19971,8220,2667,49918,1454,336,212,2002,51920
24-01-2017,1,19148,19055,8121,2664,48988,1439,358,226,2023,51011
24-01-2017,2,19095,18817,8101,2659,48672,1437,353,223,2013,50685
24-01-2017,3,19229,18775,8247,2662,48914,1463,383,211,2057,50971
24-01-2017,4,19499,19291,8323,2754,49867,1794,406,209,2409,52276
24-01-2017,5,20038,21389,8868,2779,53073,1755,824,258,2837,55910
24-01-2017,6,22709,23021,9438,2980,58147,1776,1088,247,3111,61258
24-01-2017,7,24463,24720,9664,3812,62662,1786,1438,338,3562,66224
24-01-2017,8,24921,24931,9669,4014,63536,1773,1423,347,3543,67079
24-01-2017,9,24726,24944,9588,4155,63414,1762,1418,388,3568,66982
24-01-2017,10,24741,24778,9498,4154,63171,1755,1353,417,3525,66696
24-01-2017,11,24375,24670,9416,4224,62684,1761,1301,504,3566,66250
24-01-2017,12,24432,24450,9191,4038,62112,1765,1295,428,3488,65600
24-01-2017,13,24449,24437,9263,3798,61947,1747,1301,363,3411,65358
24-01-2017,14,24295,24340,9454,3667,61755,1733,1330,362,3425,65180
24-01-2017,15,24293,24462,9417,3635,61807,1794,1498,446,3738,65545
24-01-2017,16,24767,24799,9588,3910,63064,1822,1511,521,3854,66918
24-01-2017,17,24670,25259,9637,4451,64016,1825,1524,528,3877,67893
24-01-2017,18,24011,24852,9588,4425,62876,1804,1537,529,3870,66746
24-01-2017,19,24050,24455,9215,3713,61434,1788,1301,334,3423,64857
24-01-2017,20,22881,23960,8841,3419,59101,1783,1140,372,3295,62396
24-01-2017,21,21694,23556,8729,3347,57327,1714,1011,194,2919,60246
24-01-2017,22,20486,22728,8526,3387,55126,1454,747,193,2394,57520
24-01-2017,23,19570,21088,8426,3239,52324,1327,639,175,2141,54465
25-01-2017,0,19136,19888,8324,3244,50593,1428,521,135,2084,52677
25-01-2017,1,18250,19629,8224,3287,49391,1410,483,117,2010,51401
25-01-2017,2,17561,19550,8328,3239,48679,1357,481,94,1932,50611
25-01-2017,3,17724,19318,8441,3293,48776,1349,482,79,1910,50686
25-01-2017,4,18649,19577,8696,3326,50247,1468,577,65,2110,52357
25-01-2017,5,18634,21320,9373,3361,52688,1762,872,65,2699,55387
25-01-2017,6,20796,23301,10058,3406,57561,1771,1089,117,2977,60538
25-01-2017,7,23437,25042,10257,3640,62377,1811,1204,298,3313,65690
25-01-2017,8,24079,24964,10181,3841,63064,1817,1237,381,3435,66499
25-01-2017,9,23791,24630,10152,3770,62343,1797,1226,287,3310,65653
25-01-2017,10,23777,24893,10121,3597,62389,1807,1228,254,3289,65678
25-01-2017,11,23280,24913,10044,3515,61753,1785,1188,326,3299,65052
25-01-2017,12,22778,24945,9891,3370,60983,1782,1206,284,3272,64255
25-01-2017,13,22591,24962,9751,3381,60685,1816,1209,211,3236,63921
25-01-2017,14,22473,25031,9709,3336,60551,1800,1198,194,3192,63743
25-01-2017,15,22501,25380,9892,3229,61003,1835,1203,189,3227,64230
25-01-2017,16,23059,25550,10105,3418,62133,1860,1240,483,3583,65716
25-01-2017,17,23596,25657,10001,3687,62941,1902,1233,355,3490,66431
25-01-2017,18,23034,25583,9923,3435,61975,1927,1183,376,3486,65461
25-01-2017,19,21925,25205,9523,3208,59860,1906,1144,239,3289,63149
25-01-2017,20,20557,24250,9328,3045,57181,1851,1060,172,3083,60264
25-01-2017,21,19778,23680,9165,2898,55522,1658,877,168,2703,58225
25-01-2017,22,18302,22900,8827,2880,52909,1533,707,181,2421,55330
25-01-2017,23,17193,21405,8590,2809,49997,1467,617,182,2266,52263
26-01-2017,0,16482,20382,8297,2793,47953,1481,472,185,2138,50091
26-01-2017,1,15866,19903,8336,2798,46904,1471,455,207,2133,49037
26-01-2017,2,15343,19646,8365,2891,46246,1466,450,226,2142,48388
26-01-2017,3,15312,19784,8394,2862,46353,1481,484,224,2189,48542
26-01-2017,4,16162,20287,8462,2775,47686,1491,556,220,2267,49953
26-01-2017,5,17193,22303,8711,2801,51009,1621,616,211,2448,53457
26-01-2017,6,19282,24053,9205,2928,55468,1895,849,238,2982,58450
26-01-2017,7,21751,25265,9536,3335,59889,1917,974,283,3174,63063
26-01-2017,8,22370,25421,9541,3192,60525,1907,1147,564,3618,64143
26-01-2017,9,22278,25082,9482,3296,60137,1894,1072,597,3563,63700
26-01-2017,10,22515,25155,9322,3529,60521,1902,1179,518,3599,64120
26-01-2017,11,22246,24930,9288,3439,59904,1929,1206,517,3652,63556
26-01-2017,12,22067,24564,9121,3361,59112,1931,1185,377,3493,62605
26-01-2017,13,21813,24434,9112,3196,58555,1924,1176,394,3494,62049
26-01-2017,14,21919,24527,9123,3156,58726,1930,933,371,3234,61960
26-01-2017,15,22077,24450,9292,3324,59141,1906,1056,377,3339,62480
26-01-2017,16,22395,24666,9425,3426,59911,1889,1258,744,3891,63802
26-01-2017,17,23102,24762,9398,3619,60880,1911,1309,826,4046,64926
26-01-2017,18,22771,24612,9360,3771,60514,1908,990,568,3466,63980
26-01-2017,19,22035,24284,9062,3546,58926,1820,777,383,2980,61906
26-01-2017,20,21041,23888,8881,3387,57198,1787,778,328,2893,60091
26-01-2017,21,20325,23644,8738,3373,56080,1768,639,269,2676,58756
26-01-2017,22,18903,22775,8631,3378,53686,1814,451,212,2477,56163
26-01-2017,23,18150,21416,8291,3159,51017,1615,456,215,2286,53303
27-01-2017,0,17098,19564,8150,3021,47831,1503,616,190,2309,50140
27-01-2017,1,16685,19114,8084,2974,46858,1391,628,175,2194,49052
27-01-2017,2,16405,18953,8158,2940,46457,1322,626,144,2092,48549
27-01-2017,3,16525,18977,8278,3008,46788,1404,624,115,2143,48931
27-01-2017,4,16908,19469,8383,3241,48000,1661,624,94,2379,50379
27-01-2017,5,18440,20576,8612,3517,51144,1771,628,85,2484,53628
27-01-2017,6,21132,22204,9154,3934,56425,1765,1029,105,2899,59324
27-01-2017,7,23157,23564,9523,4522,60767,1768,1098,338,3204,63971
27-01-2017,8,23632,24059,9536,4733,61961,1771,1095,517,3383,65344
27-01-2017,9,23506,23721,9388,4731,61347,1774,1084,308,3166,64513
27-01-2017,10,23229,23770,9341,4673,61013,1759,1063,242,3064,64077
27-01-2017,11,22633,23630,9247,4643,60155,1765,1044,281,3090,63245
27-01-2017,12,22193,23380,9195,4528,59295,1751,1114,271,3136,62431
27-01-2017,13,21677,23088,9138,4601,58504,1734,1121,276,3131,61635
27-01-2017,14,21786,22870,9257,4281,58194,1710,1138,275,3123,61317
27-01-2017,15,22095,23043,9454,3974,58567,1744,1155,278,3177,61744
27-01-2017,16,22535,23710,9588,4108,59943,1760,1199,282,3241,63184
27-01-2017,17,23271,24067,9669,4064,61071,1732,1289,496,3517,64588
27-01-2017,18,23015,24203,9695,3851,60765,1739,1184,282,3205,63970
27-01-2017,19,22126,23771,9440,3640,58979,1731,1034,277,3042,62021
27-01-2017,20,20873,22699,9177,3417,56167,1744,1002,58,2804,58971
27-01-2017,21,20274,21986,8915,3171,54347,1747,742,59,2548,56895
27-01-2017,22,18931,21255,8661,2881,51729,1764,617,58,2439,54168
27-01-2017,23,18221,20217,8448,2761,49648,1755,649,56,2460,52108
28-01-2017,0,17749,18937,8349,2619,47654,1248,518,57,1823,49477
28-01-2017,1,17202,18612,8245,2593,46651,1139,516,57,1712,48363
28-01-2017,2,16876,18508,8142,2582,46108,1097,516,61,1674,47782
28-01-2017,3,16736,18490,8125,2652,46003,1091,516,73,1680,47683
28-01-2017,4,16847,18512,8215,2670,46244,1096,516,79,1691,47935
28-01-2017,5,17127,19053,8236,2789,47205,1105,516,74,1695,48900
28-01-2017,6,17598,19888,8434,2966,48888,1111,519,76,1706,50594
28-01-2017,7,18566,20908,8594,3110,51177,1131,572,79,1782,52959
28-01-2017,8,19429,21473,8730,3400,53033,1373,628,102,2103,55136
28-01-2017,9,20517,21800,8926,3476,54718,1371,900,102,2373,57091
28-01-2017,10,21121,21836,8867,3690,55514,1388,1000,95,2483,57997
28-01-2017,11,21195,21797,8872,3705,55569,1388,994,98,2480,58049
28-01-2017,12,21125,21820,8858,3502,55306,1389,879,95,2363,57669
28-01-2017,13,20941,21610,8799,3379,54730,1387,772,95,2254,56984
28-01-2017,14,20674,21469,8942,3301,54385,1386,768,96,2250,56635
28-01-2017,15,21059,21667,9016,3465,55207,1390,814,102,2306,57513
28-01-2017,16,22015,22205,9000,3769,56989,1392,976,113,2481,59470
28-01-2017,17,22624,22624,8959,4101,58308,1403,913,124,2440,60748
28-01-2017,18,22132,22562,8855,4144,57693,1372,906,131,2409,60102
28-01-2017,19,21202,22201,8794,3830,56028,1375,919,141,2435,58463
28-01-2017,20,20544,21429,8638,3754,54366,1380,682,144,2206,56572
28-01-2017,21,19781,20925,8467,3656,52829,1379,615,146,2140,54969
28-01-2017,22,18706,19876,8236,3425,50243,1337,579,104,2020,52263
28-01-2017,23,17718,19097,8043,3284,48142,1213,526,89,1828,49970
29-01-2017,0,17298,18240,7911,3043,46493,1384,527,117,2028,48521
29-01-2017,1,16384,18140,7737,2979,45239,1291,527,83,1901,47140
29-01-2017,2,15864,18055,7747,2977,44642,1203,527,91,1821,46463
29-01-2017,3,15732,17936,7761,2959,44388,1216,529,110,1855,46243
29-01-2017,4,15701,17967,7723,3086,44478,1218,528,114,1860,46338
29-01-2017,5,15847,18050,7748,3357,45001,1221,532,111,1864,46865
29-01-2017,6,16224,18568,7908,3500,46198,1213,534,124,1871,48069
29-01-2017,7,16651,19195,8039,3485,47369,1205,535,137,1877,49246
29-01-2017,8,17578,19714,8216,3835,49341,1233,538,148,1919,51260
29-01-2017,9,18585,20405,8451,4070,51511,1406,545,246,2197,53708
29-01-2017,10,19290,20792,8727,4300,53110,1429,599,238,2266,55376
29-01-2017,11,19094,21220,8904,4238,53456,1436,600,233,2269,55725
29-01-2017,12,19073,21320,8706,4323,53423,1430,605,204,2239,55662
29-01-2017,13,19250,21748,8910,4148,54057,1425,608,199,2232,56289
29-01-2017,14,19183,21881,8925,4068,54057,1417,655,173,2245,56302
29-01-2017,15,19253,22437,9036,4184,54912,1396,711,158,2265,57177
29-01-2017,16,19999,22935,9253,4254,56442,1396,787,181,2364,58806
29-01-2017,17,20678,23497,9319,4193,57688,1372,802,215,2389,60077
29-01-2017,18,20396,23535,9315,4158,57403,1405,798,251,2454,59857
29-01-2017,19,19662,23199,9355,4094,56312,1406,750,229,2385,58697
29-01-2017,20,19120,22382,9338,3801,54641,1400,661,214,2275,56916
29-01-2017,21,18697,21929,9069,3554,53250,1399,556,220,2175,55425
29-01-2017,22,17763,21236,8906,3539,51444,1335,547,224,2106,53550
29-01-2017,23,16944,19987,8744,3553,49228,1223,566,230,2019,51247
30-01-2017,0,16077,19088,8469,3128,,1195,401,253,1849,
30-01-2017,1,15458,18868,8406,3000,45731,1192,389,249,1830,47561
30-01-2017,2,15531,18783,8433,2755,45503,1239,389,233,1861,47364
30-01-2017,3,16239,18675,8466,2743,46122,1308,387,226,1921,48043
30-01-2017,4,17005,19282,8568,2625,47481,1577,449,196,2222,49703
30-01-2017,5,18842,20342,8870,2679,50734,1692,515,184,2391,53125
30-01-2017,6,21922,21942,9306,2709,55879,1777,971,171,2919,58798
30-01-2017,7,23650,24720,9563,3027,60960,1801,1140,326,3267,64227
30-01-2017,8,23986,24882,9452,3093,61415,1805,1312,367,3484,64899
30-01-2017,9,23869,24787,9408,3085,61150,1814,1400,363,3577,64727
30-01-2017,10,23396,24664,9640,3271,60972,1830,1387,350,3567,64539
30-01-2017,11,23063,24654,9561,3484,60763,1840,1354,329,3523,64286
30-01-2017,12,22753,24439,9525,3756,60474,1827,1347,329,3503,63977
30-01-2017,13,22821,24176,9367,3453,59817,1841,1296,333,3470,63287
30-01-2017,14,22961,23936,9263,3359,59520,1831,1188,328,3347,62867
30-01-2017,15,23166,23724,9383,3605,59878,1803,1166,323,3292,63170
30-01-2017,16,23364,23670,9592,3773,60400,1794,1183,327,3304,63704
30-01-2017,17,23407,23824,9522,4253,61005,1829,1316,553,3698,64703
30-01-2017,18,23204,23660,9374,4231,60469,1823,1126,354,3303,63772
30-01-2017,19,23259,22903,9055,3806,59025,1795,1142,207,3144,62169
30-01-2017,20,22558,22031,8911,3419,56919,1782,1132,123,3037,59956
30-01-2017,21,21879,21166,8728,3377,55149,1796,957,133,2886,58035
30-01-2017,22,20641,19703,8648,3212,52204,1782,791,145,2718,54922
30-01-2017,23,19292,18567,8475,3413,49748,1757,536,147,2440,52188
31-01-2017,0,17491,17489,8405,3432,46819,1698,563,154,2415,49234
31-01-2017,1,17134,17114,8252,3483,45985,1537,545,149,2231,48216
31-01-2017,2,17337,16892,8117,3490,45836,1555,543,147,2245,48081
31-01-2017,3,17623,16859,8088,3471,46040,1621,546,158,2325,48365
31-01-2017,4,18749,17360,8159,3773,48042,1699,588,159,2446,50488
31-01-2017,5,20353,18458,8295,3775,50881,1756,831,196,2783,53664
31-01-2017,6,22302,21232,8806,3777,56116,1749,931,184,2864,58980
31-01-2017,7,23909,23222,9248,4712,61090,1745,1194,173,3112,64202
31-01-2017,8,24278,23947,9283,4814,62321,1736,1268,417,3421,65742
31-01-2017,9,24212,23904,9391,4759,62267,1736,1224,449,3409,65676
31-01-2017,10,24531,24022,9405,4598,62557,1741,1336,355,3432,65989
31-01-2017,11,24378,24343,9311,4276,62308,1729,1329,321,3379,65687
31-01-2017,12,24052,24147,9311,4125,61636,1715,1396,189,3300,64936
31-01-2017,13,23980,24042,9350,4212,61583,1733,1386,183,3302,64885
31-01-2017,14,23823,24081,9463,4093,61460,1733,1442,129,3304,64764
31-01-2017,15,23838,23827,9587,3922,61173,1744,1496,166,3406,64579
31-01-2017,16,24751,23700,9688,3823,61962,1721,1481,475,3677,65639
31-01-2017,17,25078,24362,9892,4076,63408,1724,1567,469,3760,67168
31-01-2017,18,24777,24592,9899,3805,63073,1704,1360,384,3448,66521
31-01-2017,19,24466,23446,9658,3527,61097,1675,1134,161,2970,64067
31-01-2017,20,24004,22061,9397,3058,58520,1689,1135,123,2947,61467
31-01-2017,21,23519,20804,9121,2956,56401,1681,1142,130,2953,59354
31-01-2017,22,22206,19708,8909,2867,53691,1687,1077,127,2891,56582
31-01-2017,23,20938,18556,8673,2765,50932,1712,993,68,2773,53705
01-02-2017,0,19493,17701,8260,2592,48047,1695,597,65,2357,50404
01-02-2017,1,19152,17467,8133,2594,47347,1460,596,61,2117,49464
01-02-2017,2,19068,17296,8034,2611,47008,1437,596,55,2088,49096
01-02-2017,3,19271,17315,8062,2604,47253,1456,606,55,2117,49370
01-02-2017,4,19922,17996,8333,2654,48905,1669,606,53,2328,51233
01-02-2017,5,21229,19402,8741,2862,52233,1700,817,100,2617,54850
01-02-2017,6,22863,21924,9290,3335,57412,1702,837,212,2751,60163
01-02-2017,7,24243,23621,9629,3921,61413,1700,1138,460,3298,64711
01-02-2017,8,24519,23886,9603,4187,62196,1700,1461,545,3706,65902
01-02-2017,9,24489,23618,9529,4156,61793,1683,1576,577,3836,65629
01-02-2017,10,24676,23727,9497,4115,62016,1707,1570,536,3813,65829
01-02-2017,11,24411,23775,9240,3924,61351,1693,1294,425,3412,64763
01-02-2017,12,24263,23865,9095,3954,61179,1704,1238,436,3378,64557
01-02-2017,13,23983,24027,9248,3979,61237,1699,1238,443,3380,64617
01-02-2017,14,23834,24260,9384,4091,61570,1677,1236,467,3380,64950
01-02-2017,15,23819,24318,9698,4109,61944,1699,1150,454,3303,65247
01-02-2017,16,23822,24211,9711,4375,62119,1697,1223,477,3397,65516
01-02-2017,17,24133,24191,9911,4604,62841,1702,1299,540,3541,66382
01-02-2017,18,23718,23986,9954,4633,62292,1703,1010,469,3182,65474
01-02-2017,19,23248,23389,9455,4591,60683,1701,1004,191,2896,63579
01-02-2017,20,22636,21942,8972,4500,58049,1671,988,126,2785,60834
01-02-2017,21,21867,20730,8583,4521,55700,1670,923,123,2716,58416
01-02-2017,22,20743,19678,8467,4478,53367,1681,678,80,2439,55806
01-02-2017,23,19216,18719,8367,4404,50706,1466,667,80,2213,52919
02-02-2017,0,17408,17912,8318,4414,48051,1314,616,84,2014,50065
02-02-2017,1,16834,17736,8200,4418,47189,1273,616,92,1981,49170
02-02-2017,2,16787,17713,8045,4219,46765,1272,616,97,1985,48750
02-02-2017,3,16724,17693,8028,4357,46803,1277,612,94,1983,48786
02-02-2017,4,17594,18033,8230,4453,48310,1460,611,99,2170,50480
02-02-2017,5,19171,19434,8550,4754,51912,1598,627,106,2331,54243
02-02-2017,6,21447,21604,9421,4763,57234,1692,820,158,2670,59904
02-02-2017,7,23566,23665,9845,4974,62049,1717,838,367,2922,64971
02-02-2017,8,24105,24100,9841,4974,63021,1725,1243,359,3327,66348
02-02-2017,9,23709,23894,9863,4960,62427,1733,1267,407,3407,65834
02-02-2017,10,24192,23851,9880,4948,62873,1734,1258,415,3407,66280
02-02-2017,11,24050,23978,9328,4875,62233,1732,1027,182,2941,65174
02-02-2017,12,24208,23776,9008,4739,61730,1736,1029,129,2894,64624
02-02-2017,13,24340,23717,9283,4728,62068,1745,1080,120,2945,65013
02-02-2017,14,24202,23820,9759,4605,62385,1730,1120,339,3189,65574
02-02-2017,15,24272,23729,9775,4575,62350,1722,1393,320,3435,65785
02-02-2017,16,24332,24167,9586,4580,62665,1715,1447,565,3727,66392
02-02-2017,17,24465,24353,9805,4585,63209,1715,1459,553,3727,66936
02-02-2017,18,23785,23993,9732,4649,62158,1715,1293,446,3454,65612
02-02-2017,19,23433,23314,9308,4526,60580,1705,955,421,3081,63661
02-02-2017,20,22718,22658,8718,4084,58178,1712,836,133,2681,60859
02-02-2017,21,22377,21218,8552,4038,56186,1693,804,134,2631,58817
02-02-2017,22,21320,20114,8245,3706,53384,1663,792,134,2589,55973
02-02-2017,23,19655,19019,8025,3802,50501,1664,698,114,2476,52977
03-02-2017,0,17447,18614,7957,3657,47675,1686,446,87,2219,49894
03-02-2017,1,16741,18127,7887,3993,46748,1682,442,91,2215,48963
03-02-2017,2,16494,17975,7888,3992,46348,1672,441,82,2195,48543
03-02-2017,3,16724,17927,7880,3922,46453,1671,444,83,2198,48651
03-02-2017,4,17965,18157,8010,3972,48103,1678,497,77,2252,50355
03-02-2017,5,19542,19432,8514,4201,51689,1696,701,71,2468,54157
03-02-2017,6,21541,21772,9192,4519,57024,1675,1030,145,2850,59874
03-02-2017,7,23272,23948,9460,4821,61502,1673,1190,328,3191,64693
03-02-2017,8,23520,24483,9569,4874,62446,1669,1326,529,3524,65970
03-02-2017,9,23708,24273,9626,4815,62421,1664,1436,541,3641,66062
03-02-2017,10,23948,24117,9609,4857,62532,1670,1408,545,3623,66155
03-02-2017,11,23885,24015,9303,4839,62041,1673,1108,219,3000,65041
03-02-2017,12,23876,23718,9052,4395,61041,1676,1107,137,2920,63961
03-02-2017,13,23614,23866,9231,4235,60946,1673,1092,137,2902,63848
03-02-2017,14,23351,23898,9401,4305,60955,1660,1105,318,3083,64038
03-02-2017,15,23560,23605,9341,4285,60790,1644,1379,372,3395,64185
03-02-2017,16,23834,23411,9541,4341,61126,1641,1498,473,3612,64738
03-02-2017,17,24006,23933,9509,4544,61993,1642,1501,537,3680,65673
03-02-2017,18,23510,23838,9318,4351,61017,1636,1391,531,3558,64575
03-02-2017,19,23113,23000,8745,4238,59097,1634,1082,126,2842,61939
03-02-2017,20,21623,22235,8298,3918,56073,1563,914,110,2587,58660
03-02-2017,21,20605,21468,8124,3714,53911,1555,806,75,2436,56347
03-02-2017,22,19830,20338,7809,3653,51631,1557,775,79,2411,54042
03-02-2017,23,18814,19109,7682,3690,49295,1594,616,92,2302,51597
04-02-2017,0,17701,17868,7752,3569,46890,1173,501,81,1755,48645
04-02-2017,1,16835,17598,7750,3659,45842,1087,485,84,1656,47498
04-02-2017,2,16252,17633,7673,3777,45336,1075,482,81,1638,46974
04-02-2017,3,16026,17455,7631,3807,44919,1076,482,83,1641,46560
04-02-2017,4,16118,17547,7552,3781,44997,1095,482,84,1661,46658
04-02-2017,5,16576,17880,7649,3891,45996,1097,482,99,1678,47674
04-02-2017,6,17561,18751,7745,3808,47866,1097,490,112,1699,49565
04-02-2017,7,18807,19673,7830,3770,50079,1091,609,117,1817,51896
04-02-2017,8,20238,20661,8028,3691,52617,1096,652,125,1873,54490
04-02-2017,9,21345,21433,8252,3738,54769,1113,701,108,1922,56691
04-02-2017,10,21728,21939,8501,3788,55956,1113,708,95,1916,57872
04-02-2017,11,21710,22031,8518,3814,56072,1111,794,91,1996,58068
04-02-2017,12,21381,22139,8515,3586,55621,1112,883,87,2082,57703
04-02-2017,13,21301,22011,8439,3267,55018,1113,884,88,2085,57103
04-02-2017,14,21430,22061,8468,2983,54942,1101,886,99,2086,57028
04-02-2017,15,21692,22206,8554,2909,55361,1110,1001,127,2238,57599
04-02-2017,16,22797,22686,8692,2945,57119,1112,1073,177,2362,59481
04-02-2017,17,23502,22843,8676,2983,58004,1040,1248,252,2540,60544
04-02-2017,18,23514,22681,8660,3022,57878,983,1131,252,2366,60244
04-02-2017,19,22523,22279,8386,3085,56273,1014,1052,228,2294,58567
04-02-2017,20,21716,21887,8188,2851,54643,1065,804,180,2049,56692
04-02-2017,21,21075,21521,8105,2721,53423,1093,627,158,1878,55301
04-02-2017,22,20077,20711,7881,2561,51231,1099,615,186,1900,53131
04-02-2017,23,18676,19933,7830,2546,48985,1097,498,199,1794,50779
05-02-2017,0,17715,18821,7830,2435,46802,1063,696,218,1977,48779
05-02-2017,1,17525,18252,7814,2465,46056,1090,489,220,1799,47855
05-02-2017,2,17215,17873,7847,2500,45436,1101,487,201,1789,47225
05-02-2017,3,16875,17738,7886,2472,44971,1096,486,187,1769,46740
05-02-2017,4,16898,17699,7918,2671,45186,1095,484,165,1744,46930
05-02-2017,5,17133,18010,8000,2815,45957,1089,485,132,1706,47663
05-02-2017,6,17531,18223,8181,2978,46914,1091,498,121,1710,48624
05-02-2017,7,17927,18547,8302,3210,47987,1097,715,114,1926,49913
05-02-2017,8,18691,19568,8415,3426,50099,1094,719,94,1907,52006
05-02-2017,9,19925,20467,8624,3705,52720,1080,706,95,1881,54601
05-02-2017,10,20600,21305,8602,3963,54470,1099,722,105,1926,56396
05-02-2017,11,20698,21976,8480,3993,55148,1110,800,100,2010,57158
05-02-2017,12,20312,22187,8631,4033,55162,1123,798,96,2017,57179
05-02-2017,13,20252,21913,8719,4070,54955,1152,801,99,2052,57007
05-02-2017,14,20233,21746,8729,4002,54711,1186,818,110,2114,56825
05-02-2017,15,20107,21912,8703,4066,54789,1176,1047,116,2339,57128
05-02-2017,16,21471,22426,8867,4066,56830,1210,1103,132,2445,59275
05-02-2017,17,22551,23044,9058,4119,58771,1224,1152,144,2520,61291
05-02-2017,18,22152,23124,9049,4199,58523,1211,1148,142,2501,61024
05-02-2017,19,21081,22825,8872,4495,57274,1216,1147,136,2499,59773
05-02-2017,20,20140,22255,8793,4348,55537,1194,971,138,2303,57840
05-02-2017,21,19699,21695,8614,4247,54257,1192,734,152,2078,56335
05-02-2017,22,18546,20979,8479,4143,52146,1211,734,157,2102,54248
05-02-2017,23,17633,19997,8380,3922,49932,1220,540,170,1930,51862
06-02-2017,0,16762,18667,8281,3946,47656,1343,543,170,2056,49712
06-02-2017,1,16162,18214,8186,4030,46592,1368,542,177,2087,48679
06-02-2017,2,15864,18055,8198,4063,46180,1389,547,195,2131,48311
06-02-2017,3,16103,18074,8242,4070,46489,1424,593,238,2255,48744
06-02-2017,4,17024,18550,8499,4199,48272,1568,607,262,2437,50709
06-02-2017,5,18627,19952,8876,4023,51480,1703,954,343,3000,54480
06-02-2017,6,21230,22129,9477,4033,56870,1768,1121,400,3289,60159
06-02-2017,7,23603,24331,9849,4107,61889,1783,1305,514,3602,65491
06-02-2017,8,23826,24976,9831,4156,62791,1781,1324,520,3625,66416
06-02-2017,9,24166,24360,9948,4034,62510,1782,1415,511,3708,66218
06-02-2017,10,24138,24596,9932,4095,62762,1771,1388,515,3674,66436
06-02-2017,11,23712,24716,9600,4186,62214,1765,1382,332,3479,65693
06-02-2017,12,23378,24360,9449,4120,61307,1683,1358,330,3371,64678
06-02-2017,13,23368,24258,9624,4192,61443,1636,1453,342,3431,64874
06-02-2017,14,23414,24279,9766,4106,61566,1632,1469,344,3445,65011
06-02-2017,15,23289,24391,9797,4311,61787,1642,1479,501,3622,65409
06-02-2017,16,23599,24637,10055,4432,62723,1691,1589,497,3777,66500
06-02-2017,17,24120,24745,10164,4595,63625,1702,1714,743,4159,67784
06-02-2017,18,23671,24881,10118,4738,63409,1706,1503,781,3990,67399
06-02-2017,19,23231,24347,9922,4789,62288,1691,1353,487,3531,65819
06-02-2017,20,22264,23383,9581,4744,59971,1663,1209,392,3264,63235
06-02-2017,21,21651,22481,9290,4678,58099,1662,1115,381,3158,61257
06-02-2017,22,20623,21426,9020,4526,55598,1655,1026,351,3032,58630
06-02-2017,23,19501,20683,8836,4207,53227,1643,814,350,2807,56034
07-02-2017,0,18379,19338,8626,4066,50407,1499,947,339,2785,53192
07-02-2017,1,17912,18677,8424,4433,49445,1460,865,333,2658,52103
07-02-2017,2,17687,18611,8400,4479,49177,1480,768,351,2599,51776
07-02-2017,3,17743,18623,8557,4546,49469,1515,833,349,2697,52166
07-02-2017,4,18839,18830,8928,4689,51285,1514,1121,351,2986,54271
07-02-2017,5,20124,20273,9725,4688,54810,1602,1212,364,3178,57988
07-02-2017,6,21737,22856,10331,4840,59764,1651,1540,433,3624,63388
07-02-2017,7,23327,24865,10738,5368,64297,1662,1595,616,3873,68170
07-02-2017,8,23744,25194,10710,5358,65007,1655,1642,712,4009,69016
07-02-2017,9,23739,25441,10737,5180,65097,1659,1641,758,4058,69155
07-02-2017,10,23268,25552,10672,5250,64742,1649,1644,615,3908,68650
07-02-2017,11,22757,25534,10325,5662,64279,1637,1541,459,3637,67916
07-02-2017,12,22540,25503,10079,5567,63688,1618,1494,379,3491,67179
07-02-2017,13,22561,25384,10218,5523,63685,1632,1408,426,3466,67151
07-02-2017,14,22530,25281,10258,5598,63667,1634,1454,403,3491,67158
07-02-2017,15,22325,25441,10273,5618,63656,1682,1396,560,3638,67294
07-02-2017,16,22475,25557,10555,5757,64345,1694,1508,783,3985,68330
07-02-2017,17,22799,26138,10825,6037,65797,1727,1528,834,4089,69886
07-02-2017,18,22668,25966,10693,6022,65350,1711,1530,856,4097,69447
07-02-2017,19,22615,25268,10403,5870,64155,1676,1398,646,3720,67875
07-02-2017,20,22392,24245,10087,5584,62310,1668,1303,432,3403,65713
07-02-2017,21,22193,23151,9728,5455,60528,1698,1249,427,3374,63902
07-02-2017,22,21140,21920,9478,5394,57932,1692,1163,417,3272,61204
07-02-2017,23,20202,20491,9174,5258,55127,1699,1167,407,3273,58400
08-02-2017,0,18531,19726,8792,5354,52403,1608,937,404,2949,55352
08-02-2017,1,17738,19394,8782,5338,51253,1609,928,403,2940,54193
08-02-2017,2,17719,19330,8702,5313,51064,1603,922,403,2928,53992
08-02-2017,3,17986,19268,8741,5305,51298,1599,923,412,2934,54232
08-02-2017,4,19044,19432,9041,5160,52678,1627,928,390,2945,55623
08-02-2017,5,20576,20810,9793,5047,56226,1650,1000,433,3083,59309
08-02-2017,6,22773,23579,10469,4975,61795,1675,1250,623,3548,65343
08-02-2017,7,24088,25728,10823,5093,65732,1686,1611,805,4102,69834
08-02-2017,8,23957,26148,10973,5246,66325,1680,1662,840,4182,70507
08-02-2017,9,24048,25907,10903,5225,66083,1621,1793,837,4251,70334
08-02-2017,10,24211,25519,10651,5316,65696,1658,1785,351,3794,69490
08-02-2017,11,23657,25406,10335,5484,64882,1626,1567,333,3526,68408
08-02-2017,12,23682,25465,10241,5346,64734,1603,1343,321,3267,68001
08-02-2017,13,23578,25623,10391,5230,64822,1622,1347,305,3274,68096
08-02-2017,14,23335,25612,10495,5431,64873,1632,1303,432,3367,68240
08-02-2017,15,23431,25722,10458,5322,64933,1626,1295,380,3301,68234
08-02-2017,16,23667,25997,10675,5240,65579,1636,1637,598,3871,69450
08-02-2017,17,24271,26070,10811,5084,66236,1707,1795,838,4340,70576
08-02-2017,18,24215,25846,10793,5081,65935,1697,1768,832,4297,70232
08-02-2017,19,24344,25332,10631,5079,65387,1687,1347,793,3827,69214
08-02-2017,20,24157,24995,10039,4870,64061,1642,1093,373,3108,67169
08-02-2017,21,23543,24050,9622,4532,61746,1581,1063,350,2994,64740
08-02-2017,22,22870,22245,9225,4358,58698,1593,985,243,2821,61519
08-02-2017,23,21811,20902,8978,4048,55739,1604,978,188,2770,58509
09-02-2017,0,20713,19818,8771,4200,53502,1608,986,167,2761,56263
09-02-2017,1,20246,19684,8739,4143,52814,1627,986,149,2762,55576
09-02-2017,2,19872,19771,8711,4229,52582,1635,982,137,2754,55336
09-02-2017,3,20255,19799,8817,4239,53110,1622,982,131,2735,55845
09-02-2017,4,21336,20143,9272,4237,54988,1630,980,134,2744,57732
09-02-2017,5,22452,22256,10071,4165,58945,1621,991,209,2821,61766
09-02-2017,6,24315,24215,10661,4414,63605,1622,1281,523,3426,67031
09-02-2017,7,25970,25784,10916,4771,67441,1626,1886,544,4056,71497
09-02-2017,8,26084,25960,11042,4771,67856,1616,1909,565,4090,71946
09-02-2017,9,26076,25377,11012,5193,67659,1625,1941,629,4195,71854
09-02-2017,10,26261,25229,10899,5065,67457,1619,1938,616,4173,71630
09-02-2017,11,26014,25266,10690,5034,67003,1616,1758,553,3927,70930
09-02-2017,12,25188,25152,10533,4912,65784,1617,1982,545,4144,69928
09-02-2017,13,24992,24745,10498,4796,65031,1611,1951,560,4122,69153
09-02-2017,14,25242,24927,10484,4643,65296,1590,1657,598,3845,69141
09-02-2017,15,24952,25082,10495,4300,64830,1593,1416,565,3574,68404
09-02-2017,16,25069,24966,10745,4341,65121,1597,1732,625,3954,69075
09-02-2017,17,25452,24960,10905,4484,65801,1617,1768,636,4021,69822
09-02-2017,18,25384,25234,10868,4306,65791,1608,1752,516,3876,69667
09-02-2017,19,25330,25099,10611,4090,65130,1600,1301,395,3296,68426
09-02-2017,20,24086,24337,10029,4090,62542,1574,1113,171,2858,65400
09-02-2017,21,24093,23263,9504,3732,60592,1553,1000,153,2706,63298
09-02-2017,22,22815,21888,8931,3663,57298,1561,999,138,2698,59996
09-02-2017,23,21805,20375,8776,3572,54528,1379,989,138,2506,57034
10-02-2017,0,21224,19262,8636,3257,52379,1520,940,145,2605,54984
10-02-2017,1,20628,18839,8618,3276,51361,1535,743,153,2431,53792
10-02-2017,2,20204,18832,8688,3333,51057,1559,733,147,2439,53496
10-02-2017,3,20116,18859,8748,3591,51315,1545,731,138,2414,53729
10-02-2017,4,20416,19220,8976,3829,52440,1582,734,144,2460,54900
10-02-2017,5,21692,20427,9703,3908,55731,1575,1162,534,3271,59002
10-02-2017,6,23358,22454,10574,4066,60453,1687,1282,504,3473,63926
10-02-2017,7,24933,24547,10685,4324,64490,1843,1502,647,3992,68482
10-02-2017,8,25136,25053,10766,4427,65381,1657,1692,638,3987,69368
10-02-2017,9,24930,25321,10747,4492,65491,1695,1654,522,3871,69362
10-02-2017,10,24431,25358,10659,4799,65249,1832,1500,332,3664,68913
10-02-2017,11,24121,25420,10435,5038,65014,1807,1271,134,3212,68226
10-02-2017,12,23506,24977,10242,5140,63865,1575,1023,235,2833,66698
10-02-2017,13,23043,24172,10233,5436,62886,1620,1104,306,3030,65916
10-02-2017,14,22631,23876,10360,5642,62509,1797,1095,378,3270,65779
10-02-2017,15,22110,23679,10322,5727,61837,1649,1134,551,3334,65171
10-02-2017,16,22186,23658,10532,5647,62023,1812,1122,582,3516,65539
10-02-2017,17,22733,24377,10682,5683,63475,1846,1079,625,3550,67025
10-02-2017,18,22982,24591,10585,5521,63678,1617,1027,509,3153,66831
10-02-2017,19,22393,24156,9790,5275,61613,1513,1028,244,2785,64398
10-02-2017,20,21681,23289,9196,4958,59124,1464,986,256,2706,61830
10-02-2017,21,21440,22130,8898,4643,57112,1485,961,260,2706,59818
10-02-2017,22,20805,20981,8544,4575,54905,1484,755,271,2510,57415
10-02-2017,23,19388,19951,8462,4659,52460,1444,736,266,2446,54906
11-02-2017,0,18462,18892,8406,4482,50242,1069,699,236,2004,52246
11-02-2017,1,17840,18424,8375,4381,49020,995,689,212,1896,50916
11-02-2017,2,17229,18345,8332,4456,48362,977,641,203,1821,50183
11-02-2017,3,16960,18405,8339,4404,48109,967,644,206,1817,49926
11-02-2017,4,17235,18500,8315,4479,48529,972,648,222,1842,50371
11-02-2017,5,17741,18566,8317,4617,49241,1009,705,229,1943,51184
11-02-2017,6,18303,19022,8398,4934,50657,1012,707,225,1944,52601
11-02-2017,7,19144,19802,8558,5308,52813,1020,712,209,1941,54754
11-02-2017,8,19967,21101,8703,5424,55196,1003,717,190,1910,57106
11-02-2017,9,20916,21701,8906,5423,56947,1020,882,169,2071,59018
11-02-2017,10,21179,21892,8870,5737,57679,1007,964,208,2179,59858
11-02-2017,11,20572,21756,8797,6080,57205,1007,856,194,2057,59262
11-02-2017,12,20234,21452,8635,6035,56355,1002,747,180,1929,58284
11-02-2017,13,19645,21193,8665,5941,55445,973,704,178,1855,57300
11-02-2017,14,19362,21023,8585,6031,55000,1066,702,163,1931,56931
11-02-2017,15,19390,20854,8842,6002,55088,1082,702,222,2006,57094
11-02-2017,16,20383,21203,9316,5828,56728,1085,723,191,1999,58727
11-02-2017,17,21930,22084,9579,5641,59234,1089,723,182,1994,61228
11-02-2017,18,21993,22647,9393,5595,59628,1105,724,179,2008,61636
11-02-2017,19,21289,22373,9063,5572,58297,1112,747,173,2032,60329
11-02-2017,20,20253,21484,8738,5863,56338,1103,750,152,2005,58343
11-02-2017,21,20246,20770,8602,5581,55199,1107,694,133,1934,57133
11-02-2017,22,19563,19694,8358,5332,52948,1075,689,118,1882,54830
11-02-2017,23,18378,18758,8296,5154,50584,1046,684,105,1835,52419
12-02-2017,0,16879,18285,8218,5068,48451,1042,495,98,1635,50086
12-02-2017,1,16304,17926,8190,4978,47398,1023,483,88,1594,48992
12-02-2017,2,15606,17719,8133,4935,46392,1008,482,84,1574,47966
12-02-2017,3,15565,17716,8155,4941,46377,1018,482,87,1587,47964
12-02-2017,4,15290,17587,8231,5102,46211,1034,481,82,1597,47808
12-02-2017,5,15667,17939,8323,5093,47022,1035,481,76,1592,48614
12-02-2017,6,16174,18314,8377,5230,48095,1052,480,70,1602,49697
12-02-2017,7,17057,19198,8474,5371,50099,1057,481,68,1606,51705
12-02-2017,8,18238,20350,8573,5041,52202,1050,540,69,1659,53861
12-02-2017,9,19360,21296,8655,5119,54432,1051,545,74,1670,56102
12-02-2017,10,19840,21439,8702,5291,55273,1078,544,92,1714,56987
12-02-2017,11,19684,21622,8765,5142,55212,1057,544,62,1663,56875
12-02-2017,12,18523,21793,8913,5289,54519,1072,543,56,1671,56190
12-02-2017,13,17596,21581,9091,5120,53390,1075,495,56,1626,55016
12-02-2017,14,17811,21517,9125,4900,53353,1086,507,58,1651,55004
12-02-2017,15,18234,21724,9110,4438,53507,1130,545,65,1740,55247
12-02-2017,16,19799,22287,9300,4323,55710,1140,563,74,1777,57487
12-02-2017,17,21765,22782,9457,4330,58335,1162,862,78,2102,60437
12-02-2017,18,21947,22998,9527,4202,58675,1151,1130,80,2361,61036
12-02-2017,19,21447,22890,9338,4155,57830,1140,867,75,2082,59912
12-02-2017,20,20641,22349,9387,4181,56558,1142,590,76,1808,58366
12-02-2017,21,20275,21316,9201,3894,54687,1173,529,68,1770,56457
12-02-2017,22,19753,20223,8974,3630,52581,1212,524,64,1800,54381
12-02-2017,23,17682,19812,8888,3486,49867,1268,477,61,1806,51673
13-02-2017,0,16132,19350,8625,3324,47431,1372,478,58,1908,49339
13-02-2017,1,15527,19197,8589,3411,46724,1428,478,54,1960,48684
13-02-2017,2,15725,19231,8492,3409,46856,1459,478,72,2009,48865
13-02-2017,3,15890,19318,8504,3174,46887,1488,476,78,2042,48929
13-02-2017,4,16695,19760,8580,3110,48145,1579,496,80,2155,50300
13-02-2017,5,18956,21297,8839,3129,52222,1771,575,161,2507,54729
13-02-2017,6,21986,23900,9459,3122,58467,1944,867,194,3005,61472
13-02-2017,7,24346,25102,9682,3342,62472,2024,1067,308,3399,65871
13-02-2017,8,24502,25080,9750,3829,63163,2037,1408,480,3925,67088
13-02-2017,9,24689,24643,9648,3764,62745,1951,1379,493,3823,66568
13-02-2017,10,24260,24522,9487,3762,62030,1945,1361,438,3744,65774
13-02-2017,11,23488,24219,9279,3635,60620,1894,1090,121,3105,63725
13-02-2017,12,22754,23769,9154,3496,59171,1897,1047,134,3078,62249
13-02-2017,13,22971,23703,9195,3557,59427,1834,1082,148,3064,62491
13-02-2017,14,22750,23663,9250,3430,59093,1907,1073,166,3146,62239
13-02-2017,15,22013,23921,9294,3651,58879,1906,1073,170,3149,62028
13-02-2017,16,22703,24047,9397,3308,59454,1905,1188,391,3484,62938
13-02-2017,17,23676,24431,9518,3452,61076,1908,1213,575,3696,64772
13-02-2017,18,23778,24635,9475,3347,61235,1933,1225,582,3740,64975
13-02-2017,19,22836,24449,9360,3238,59884,1911,1140,272,3323,63207
13-02-2017,20,21509,23873,9183,3059,57625,1926,952,222,3100,60725
13-02-2017,21,20775,23146,8971,3245,56138,1912,732,287,2931,59069
13-02-2017,22,19227,21762,8900,3087,52977,1917,568,258,2743,55720
13-02-2017,23,17995,20861,8743,2996,50595,1932,537,231,2700,53295
14-02-2017,0,16549,20151,8553,2952,48205,1870,467,236,2573,50778
14-02-2017,1,16142,19692,8469,2896,47199,1829,465,236,2530,49729
14-02-2017,2,16065,19492,8426,2700,46683,1764,463,234,2461,49144
14-02-2017,3,16292,19461,8512,2738,47005,1784,466,229,2479,49484
14-02-2017,4,16788,19888,8724,3094,48494,1869,474,239,2582,51076
14-02-2017,5,18515,20757,8878,3245,51394,1862,496,596,2954,54348
14-02-2017,6,21774,22363,9270,3373,56781,1852,736,621,3209,59990
14-02-2017,7,23714,24321,9454,3572,61061,1915,886,452,3253,64314
14-02-2017,8,24166,24492,9306,3781,61746,1861,853,602,3316,65062
14-02-2017,9,24014,24370,9066,3777,61228,1873,874,545,3292,64520
14-02-2017,10,23435,24032,8757,3776,60000,1821,840,526,3187,63187
14-02-2017,11,23020,23032,8432,3856,58341,1753,805,348,2906,61247
14-02-2017,12,22762,22123,8232,3849,56966,1708,801,346,2855,59821
14-02-2017,13,23106,21800,8156,3848,56911,1738,807,284,2829,59740
14-02-2017,14,22967,21599,8329,3727,56622,1779,821,482,3082,59704
14-02-2017,15,22964,21555,8469,3690,56678,1773,820,441,3034,59712
14-02-2017,16,23007,22002,8877,3542,57429,1778,1028,296,3102,60531
14-02-2017,17,23755,22719,9206,3901,59582,1790,1349,481,3620,63202
14-02-2017,18,24024,23458,9113,4009,60603,1789,1414,468,3671,64274
14-02-2017,19,24313,22756,8750,3734,59553,1735,1198,235,3168,62721
14-02-2017,20,23845,21795,8391,3511,57543,1689,784,224,2697,60240
14-02-2017,21,23704,20660,8245,3426,56036,1766,736,165,2667,58703
14-02-2017,22,23035,19588,8163,3457,54244,1736,635,120,2491,56735
14-02-2017,23,21467,18808,8116,3314,51706,1688,482,96,2266,53972
15-02-2017,0,20356,17747,7880,3264,49248,1673,467,80,2220,51468
15-02-2017,1,20567,17417,7741,3213,48939,1661,466,61,2188,51127
15-02-2017,2,20696,17431,7697,3185,49011,1690,464,51,2205,51216
15-02-2017,3,20977,17548,7881,3180,49586,1684,474,52,2210,51796
15-02-2017,4,21296,18285,8468,3191,51239,1674,635,54,2363,53602
15-02-2017,5,21551,19756,9186,3553,54046,1664,663,103,2430,56476
15-02-2017,6,23011,22407,9699,3914,59030,1663,1266,270,3199,62229
15-02-2017,7,24032,23454,9873,4577,61934,1690,1428,340,3458,65392
15-02-2017,8,24418,23551,9930,4726,62625,1700,1635,339,3674,66299
15-02-2017,9,24409,23766,9737,4668,62580,1711,1550,254,3515,66095
15-02-2017,10,24616,23810,9542,4657,62625,1711,1273,252,3236,65861
15-02-2017,11,24907,23190,9300,4413,61810,1673,1061,266,3000,64810
15-02-2017,12,24729,22982,9060,4052,60825,1667,1062,260,2989,63814
15-02-2017,13,24388,22942,9112,3977,60420,1654,1061,260,2975,63395
15-02-2017,14,23881,23108,9107,4175,60271,1655,1096,260,3011,63282
15-02-2017,15,23496,23081,9152,4062,59792,1705,1071,265,3041,62833
15-02-2017,16,23589,23341,9411,4140,60482,1720,1107,266,3093,63575
15-02-2017,17,24666,23979,9807,4260,62712,1761,1237,250,3248,65960
15-02-2017,18,24317,24253,9646,4336,62553,1784,1195,93,3072,65625
15-02-2017,19,23752,23920,9404,3940,61016,1794,985,98,2877,63893
15-02-2017,20,23427,22643,8767,3656,58494,1793,893,74,2760,61254
15-02-2017,21,22919,21779,8470,3599,56766,1763,838,68,2669,59435
15-02-2017,22,21538,20356,8092,3369,53355,1762,654,87,2503,55858
15-02-2017,23,19607,19408,7960,3157,50133,1749,656,83,2488,52621
16-02-2017,0,18221,18626,7893,2946,47685,1669,649,86,2404,50089
16-02-2017,1,17800,18183,7828,2837,46647,1673,645,87,2405,49052
16-02-2017,2,17549,18153,7750,3210,46662,1683,641,90,2414,49076
16-02-2017,3,17978,18312,7734,3181,47207,1679,641,91,2411,49618
16-02-2017,4,18230,18659,7956,3376,48220,1693,655,89,2437,50657
16-02-2017,5,19669,19817,8489,3805,51780,1701,728,150,2579,54359
16-02-2017,6,21320,21949,9152,4294,56715,1750,973,172,2895,59610
16-02-2017,7,23048,23387,9399,4314,60148,1725,1128,173,3026,63174
16-02-2017,8,23100,23633,9366,4491,60590,1714,1241,180,3135,63725
16-02-2017,9,22772,23559,9331,4801,60462,1718,1254,164,3136,63598
16-02-2017,10,22525,23342,9348,5124,60337,1727,1114,124,2965,63302
16-02-2017,11,22028,23149,8885,5206,59269,1737,1009,122,2868,62137
16-02-2017,12,21819,22699,8621,5379,58517,1750,1008,125,2883,61400
16-02-2017,13,22075,22731,8880,5162,58847,1748,1007,132,2887,61734
16-02-2017,14,22049,23053,9121,5229,59453,1755,996,155,2906,62359
16-02-2017,15,21649,23423,9180,5185,59438,1774,1044,184,3002,62440
16-02-2017,16,21938,23451,9289,5082,59759,1740,1366,226,3332,63091
16-02-2017,17,22968,23846,9508,5096,61416,1726,1382,253,3361,64777
16-02-2017,18,22640,23994,9469,4951,61054,1704,1274,258,3236,64290
16-02-2017,19,21721,23630,8903,4772,59028,1682,1054,264,3000,62028
16-02-2017,20,20962,22725,8369,4662,56719,1664,891,282,2837,59556
16-02-2017,21,20545,21751,8072,4386,54755,1657,786,319,2762,57517
16-02-2017,22,19229,20834,8012,4059,52136,1655,706,338,2699,54835
16-02-2017,23,17249,20013,7832,3854,48949,1663,647,323,2633,51582
17-02-2017,0,15994,19202,7785,3371,46354,1689,511,317,2517,48871
17-02-2017,1,15884,18909,7647,3022,45462,1455,514,301,2270,47732
17-02-2017,2,15699,18900,7634,2780,45013,1356,512,272,2140,47153
17-02-2017,3,15634,18987,7602,2567,44790,1388,507,247,2142,46932
17-02-2017,4,16296,19442,7772,2570,46080,1712,524,254,2490,48570
17-02-2017,5,17929,20725,8267,2750,49671,1738,598,278,2614,52285
17-02-2017,6,20356,22970,8818,2762,54905,1779,1205,260,3244,58149
17-02-2017,7,22300,24619,9195,3184,59297,1780,1307,217,3304,62601
17-02-2017,8,23028,24832,9368,3294,60522,1792,1257,203,3252,63774
17-02-2017,9,23090,24737,9408,3487,60721,1788,1256,324,3368,64089
17-02-2017,10,22987,24594,9261,3576,60418,1788,1251,506,3545,63963
17-02-2017,11,22156,24088,8971,3583,58798,1762,1234,264,3260,62058
17-02-2017,12,21971,23273,8707,3535,57489,1775,1233,319,3327,60816
17-02-2017,13,21636,23475,8664,3434,57212,1789,1217,274,3280,60492
17-02-2017,14,21031,23034,9055,3377,56496,1776,1156,329,3261,59757
17-02-2017,15,20551,23320,9025,3362,56259,1749,1148,257,3154,59413
17-02-2017,16,20967,23375,9154,3392,56889,1660,1249,350,3259,60148
17-02-2017,17,22375,23602,9576,3418,58971,1649,1257,587,3493,62464
17-02-2017,18,22927,23751,9486,3357,59520,1655,1200,380,3235,62755
17-02-2017,19,21556,23471,9030,3328,57384,1644,1168,125,2937,60321
17-02-2017,20,19969,23029,8594,3027,54619,1594,1108,124,2826,57445
17-02-2017,21,19203,22263,8357,2982,52805,1623,973,109,2705,55510
17-02-2017,22,18520,21541,8285,2834,51181,1617,824,119,2560,53741
17-02-2017,23,17666,20695,8145,2765,49271,1688,530,110,2328,51599
18-02-2017,0,16419,19097,8269,2770,46554,1267,503,81,1851,48405
18-02-2017,1,16036,18543,8247,2748,45574,1259,501,81,1841,47415
18-02-2017,2,15509,18601,8151,2750,45011,1264,501,76,1841,46852
18-02-2017,3,15662,18649,8182,2738,45233,1272,500,69,1841,47074
18-02-2017,4,15831,18808,8146,2785,45570,1285,497,64,1846,47416
18-02-2017,5,16244,19321,8169,2840,46574,1294,497,74,1865,48439
18-02-2017,6,16246,20083,8218,2995,47543,1366,518,57,1941,49484
18-02-2017,7,17346,20813,8307,3141,49607,1361,707,46,2114,51721
18-02-2017,8,18802,21310,8406,3269,51787,1367,726,43,2136,53923
18-02-2017,9,20063,21766,8459,3531,53820,1380,1012,44,2436,56256
18-02-2017,10,20485,22040,8393,3812,54730,1385,1057,61,2503,57233
18-02-2017,11,20018,21971,8218,4130,54338,1393,1057,74,2524,56862
18-02-2017,12,19375,21698,8100,4272,53445,1401,1013,91,2505,55950
18-02-2017,13,19085,21806,8026,4152,53069,1447,836,98,2381,55450
18-02-2017,14,18569,21870,8086,4052,52577,1439,848,106,2393,54970
18-02-2017,15,17944,21999,7900,4320,52163,1434,734,94,2262,54425
18-02-2017,16,18561,22227,7836,4696,53320,1431,735,105,2271,55591
18-02-2017,17,20033,22734,7956,4906,55628,1373,764,231,2368,57996
18-02-2017,18,19851,23310,7917,5129,56205,1418,769,185,2372,58577
18-02-2017,19,18572,22895,7723,5177,54366,1399,733,159,2291,56657
18-02-2017,20,17377,22182,7581,5143,52284,1392,726,181,2299,54583
18-02-2017,21,16699,21502,7408,5156,50765,1399,712,231,2342,53107
18-02-2017,22,15768,20611,7380,5198,48959,1376,576,288,2240,51199
18-02-2017,23,14900,19648,7210,4977,46734,1222,590,303,2115,48849
19-02-2017,0,14142,18193,7026,4685,44046,1165,476,307,1948,45994
19-02-2017,1,13131,17887,6960,4633,42611,1163,452,322,1937,44548
19-02-2017,2,13089,17918,6987,4527,42522,1170,452,327,1949,44471
19-02-2017,3,12660,17981,7010,4433,42084,1152,448,345,1945,44029
19-02-2017,4,12417,17956,7137,4377,41885,1184,451,334,1969,43854
19-02-2017,5,12348,17830,7190,4265,41634,1201,453,369,2023,43657
19-02-2017,6,12845,17904,7232,4182,42164,1199,454,385,2038,44202
19-02-2017,7,12931,17931,7295,4071,42228,1197,454,387,2038,44266
19-02-2017,8,14661,18052,7413,4167,44294,1207,453,374,2034,46328
19-02-2017,9,16468,18769,7435,4206,46878,1314,490,365,2169,49047
19-02-2017,10,16552,19313,7487,4132,47484,1274,489,361,2124,49608
19-02-2017,11,17726,19584,7449,4337,49097,1282,488,363,2133,51230
19-02-2017,12,16958,19858,7381,4290,48488,1273,487,366,2126,50614
19-02-2017,13,17243,19998,7441,4174,48857,1312,487,363,2162,51019
19-02-2017,14,17206,20227,7539,4245,49217,1335,485,397,2217,51434
19-02-2017,15,16845,20335,7624,4484,49289,1325,481,398,2204,51493
19-02-2017,16,17814,20895,7798,4654,51160,1352,511,404,2267,53427
19-02-2017,17,19281,21520,7970,4699,53471,1340,724,362,2426,55897
19-02-2017,18,19801,21755,7945,4671,54172,1332,724,361,2417,56589
19-02-2017,19,18771,21905,7870,4638,53184,1332,704,423,2459,55643
19-02-2017,20,18123,21191,7856,4336,51505,1333,521,370,2224,53729
19-02-2017,21,17264,20498,7706,4432,49900,1314,480,336,2130,52030
19-02-2017,22,16308,19410,7726,4551,47995,1281,479,342,2102,50097
19-02-2017,23,15094,18223,7656,4604,45578,1219,475,358,2052,47630
20-02-2017,0,13226,17570,7457,4313,42565,1225,321,379,1925,44490
20-02-2017,1,12460,17360,7313,4312,41444,1237,307,396,1940,43384
20-02-2017,2,12583,17300,7182,4264,41329,1220,302,384,1906,43235
20-02-2017,3,13088,17344,7112,4276,41822,1191,329,406,1926,43748
20-02-2017,4,13715,17556,7348,4528,43147,1197,372,403,1972,45119
20-02-2017,5,15014,18509,8016,4954,46492,1365,810,451,2626,49118
20-02-2017,6,16869,20793,8841,5506,52009,1586,1032,610,3228,55237
20-02-2017,7,18940,22209,8996,6090,56237,1593,1164,647,3404,59641
20-02-2017,8,19270,22304,9173,6334,57081,1552,1235,626,3413,60494
20-02-2017,9,19241,22605,9088,6239,57173,1557,1098,589,3244,60417
20-02-2017,10,19297,22723,9155,6248,57423,1532,1039,612,3183,60606
20-02-2017,11,19123,22591,8875,6124,56715,1511,975,488,2974,59689
20-02-2017,12,18923,22352,8517,5963,55756,1477,976,476,2929,58685
20-02-2017,13,18422,22074,8628,5831,54956,1464,977,475,2916,57872
20-02-2017,14,18695,22192,8886,5900,55671,1473,797,651,2921,58592
20-02-2017,15,18627,22070,8848,5952,55499,1459,831,628,2918,58417
20-02-2017,16,18735,22253,8966,6000,55956,1439,867,669,2975,58931
20-02-2017,17,19618,22086,9052,6265,57022,1366,1206,869,3441,60463
20-02-2017,18,19758,22020,9046,6267,57091,1285,1211,856,3352,60443
20-02-2017,19,18985,22125,8834,5878,55822,1270,833,633,2736,58558
20-02-2017,20,17635,21643,8450,5707,53434,1273,502,547,2322,55756
20-02-2017,21,16818,20200,7966,5478,50462,1273,456,458,2187,52649
20-02-2017,22,15999,19493,7568,4985,48045,1279,439,437,2155,50200
20-02-2017,23,14844,18612,7484,4798,45738,1163,435,420,2018,47756
21-02-2017,0,14154,17822,7604,5040,44618,1049,462,414,1925,46543
21-02-2017,1,13431,17508,7738,5138,43813,1091,456,419,1966,45779
21-02-2017,2,12982,17344,7850,5096,43273,1094,453,421,1968,45241
21-02-2017,3,12415,17279,7953,5225,42871,1083,451,427,1961,44832
21-02-2017,4,12990,17605,8180,5368,44143,1144,460,415,2019,46162
21-02-2017,5,14644,18523,8760,5436,47364,1313,624,401,2338,49702
21-02-2017,6,17317,20465,9440,5942,53165,1335,1013,393,2741,55906
21-02-2017,7,19523,22502,9732,6339,58096,1341,1028,412,2781,60877
21-02-2017,8,19828,22691,9781,6540,58839,1352,1054,506,2912,61751
21-02-2017,9,19606,22701,9348,6482,58140,1342,1151,586,3079,61219
21-02-2017,10,19630,22261,9102,6664,57657,1321,1296,441,3058,60715
21-02-2017,11,18967,22021,8799,6874,56662,1299,1215,449,2963,59625
21-02-2017,12,18486,21616,8713,6784,55598,1332,1013,452,2797,58395
21-02-2017,13,18408,21353,8852,6723,55336,1330,1208,444,2982,58318
21-02-2017,14,18440,21050,8927,6677,55095,1323,1020,440,2783,57878
21-02-2017,15,18823,20891,8887,6476,55077,1359,978,415,2752,57829
21-02-2017,16,19862,21203,9100,6071,56236,1364,1128,390,2882,59118
21-02-2017,17,21620,22129,9507,5761,59018,1347,1334,359,3040,62058
21-02-2017,18,22359,22707,9550,5398,60015,1356,1308,323,2987,63002
21-02-2017,19,21873,22610,9258,5142,58883,1356,1100,343,2799,61682
21-02-2017,20,21274,22267,8772,5049,57362,1336,1001,321,2658,60020
21-02-2017,21,20329,21740,8508,4831,55409,1317,776,270,2363,57772
21-02-2017,22,18919,20575,8228,4482,52205,1302,554,214,2070,54275
21-02-2017,23,16357,18650,8006,4724,47737,1263,480,179,1922,49659
22-02-2017,0,14666,17802,8089,4561,45118,1124,477,127,1728,46846
22-02-2017,1,13162,17488,8149,4700,43499,1091,477,95,1663,45162
22-02-2017,2,13070,17510,8208,4897,43686,1091,476,76,1643,45329
22-02-2017,3,13163,17770,8295,4950,44179,1124,478,62,1664,45843
22-02-2017,4,13774,18308,8602,5028,45711,1162,505,64,1731,47442
22-02-2017,5,14281,19516,9213,5061,48070,1443,1151,88,2682,50752
22-02-2017,6,15802,21118,9820,5411,52151,1558,1380,322,3260,55411
22-02-2017,7,17624,22983,9953,5795,56355,1503,1441,388,3332,59687
22-02-2017,8,18362,23553,9806,6037,57757,1555,1452,385,3392,61149
22-02-2017,9,18002,23626,9705,6370,57702,1462,1271,360,3093,60795
22-02-2017,10,17804,23787,9483,6481,57557,1494,1264,390,3148,60705
22-02-2017,11,17234,23659,9271,6674,56839,1590,765,411,2766,59605
22-02-2017,12,16868,23238,9263,6539,55908,1671,681,415,2767,58675
22-02-2017,13,16655,23314,9384,6566,55919,1723,688,445,2856,58775
22-02-2017,14,16811,23233,9538,6487,56069,1733,699,447,2879,58948
22-02-2017,15,16755,23201,9510,6405,55871,1736,665,453,2854,58725
22-02-2017,16,16999,23416,9782,6313,56510,1528,675,642,2845,59355
22-02-2017,17,17624,23472,10110,6414,57621,1527,1236,472,3235,60856
22-02-2017,18,17956,23412,9974,6988,58331,1510,1323,462,3295,61626
22-02-2017,19,17679,23154,9543,6799,57175,1458,905,471,2834,60009
22-02-2017,20,16597,21763,9067,6568,53996,1335,577,477,2389,56385
22-02-2017,21,16785,20581,8930,6244,52540,1330,574,468,2372,54912
22-02-2017,22,15833,19517,8574,6115,50040,1332,548,484,2364,52404
22-02-2017,23,14918,18432,8153,5943,47444,1313,516,494,2323,49767
23-02-2017,0,14445,17736,8022,5206,45410,1311,513,502,2326,47736
23-02-2017,1,13746,17545,7868,5094,44253,1297,513,501,2311,46564
23-02-2017,2,13223,17588,7799,5283,43895,1286,513,498,2297,46192
23-02-2017,3,13325,17818,7760,5553,44455,1282,528,503,2313,46768
23-02-2017,4,14021,18664,7861,5340,45888,1268,532,504,2304,48192
23-02-2017,5,14973,20235,8188,4941,48338,1268,623,502,2393,50731
23-02-2017,6,17460,23073,8764,4594,53892,1457,758,495,2710,56602
23-02-2017,7,19499,25090,9020,4374,57984,1462,940,494,2896,60880
23-02-2017,8,20406,25409,8938,4348,59102,1482,1118,479,3079,62181
23-02-2017,9,21008,25480,8943,4047,59478,1486,1193,578,3257,62735
23-02-2017,10,20901,25273,8969,3840,58983,1494,1218,511,3223,62206
23-02-2017,11,20198,24898,8725,3532,57353,1493,1219,580,3292,60645
23-02-2017,12,19934,24285,8544,3472,56237,1609,1206,576,3391,59628
23-02-2017,13,19740,23908,8466,3450,55565,1684,1034,394,3112,58677
23-02-2017,14,19769,23213,8529,3314,54825,1701,1033,277,3011,57836
23-02-2017,15,19829,22810,8775,3398,54813,1678,941,235,2854,57667
23-02-2017,16,19348,22810,8681,3912,54751,1685,932,206,2823,57574
23-02-2017,17,20618,22937,8737,4120,56413,1692,933,233,2858,59271
23-02-2017,18,21138,23422,8828,4278,57666,1672,1118,216,3006,60672
23-02-2017,19,19572,23569,8561,4160,55861,1658,851,197,2706,58567
23-02-2017,20,17921,22790,8431,3941,53083,1622,656,165,2443,55526
23-02-2017,21,17025,22187,8382,3893,51488,1585,565,153,2303,53791
23-02-2017,22,15666,20680,8148,3973,48467,1505,503,153,2161,50628
23-02-2017,23,14705,19214,7728,4074,45721,1221,472,105,1798,47519
24-02-2017,0,14895,18409,7638,4013,44956,1085,295,172,1552,46508
24-02-2017,1,14384,18321,7543,3658,43906,1082,283,165,1530,45436
24-02-2017,2,14205,18366,7566,3564,43701,1127,286,181,1594,45295
24-02-2017,3,14267,18358,7585,3912,44122,1128,286,184,1598,45720
24-02-2017,4,14923,18660,7659,3841,45083,1167,285,191,1643,46726
24-02-2017,5,16295,20112,7999,3660,48065,1399,306,266,1971,50036
24-02-2017,6,18528,23690,8569,3671,54458,1471,428,281,2180,56638
24-02-2017,7,21525,25504,8936,3808,59773,1516,629,255,2400,62173
24-02-2017,8,23041,25476,8975,3910,61401,1519,1161,320,3000,64401
24-02-2017,9,22434,25392,8854,4195,60875,1526,1156,298,2980,63855
24-02-2017,10,21806,25220,8970,4574,60569,1528,1051,266,2845,63414
24-02-2017,11,20969,25006,8914,4867,59757,1537,698,280,2515,62272
24-02-2017,12,20285,24722,8665,5132,58805,1517,548,300,2365,61170
24-02-2017,13,19462,24469,8615,5300,57847,1556,555,325,2436,60283
24-02-2017,14,18526,24463,8497,5321,56808,1536,544,375,2455,59263
24-02-2017,15,18210,24158,8447,5265,56081,1495,499,374,2368,58449
24-02-2017,16,18867,24267,8547,5293,56974,1585,491,363,2439,59413
24-02-2017,17,20686,24843,8774,4897,59201,1570,580,372,2522,61723
24-02-2017,18,21695,25526,8805,4734,60762,1588,531,399,2518,63280
24-02-2017,19,20859,25354,8733,4630,59574,1552,550,399,2501,62075
24-02-2017,20,19605,24902,8305,4670,57482,1486,547,441,2474,59956
24-02-2017,21,19003,24112,8187,4211,55514,1489,542,466,2497,58011
24-02-2017,22,17939,23400,8099,3839,53278,1498,502,367,2367,55645
24-02-2017,23,16979,21795,7907,3738,50419,1541,509,365,2415,52834
25-02-2017,0,15932,20537,8053,3711,48233,1128,316,348,1792,50025
25-02-2017,1,15903,20177,8120,3297,47497,1046,313,322,1681,49178
25-02-2017,2,15659,20005,8100,3112,46876,994,314,315,1623,48499
25-02-2017,3,15834,19909,7999,3130,46874,1060,317,320,1697,48571
25-02-2017,4,16195,20053,8154,3156,47557,1032,321,343,1696,49253
25-02-2017,5,16216,20346,8451,3121,48134,1023,411,427,1861,49995
25-02-2017,6,16986,22131,8642,3306,51066,1046,659,415,2120,53186
25-02-2017,7,17724,23382,8823,3224,53154,1078,743,425,2246,55400
25-02-2017,8,18885,23936,8846,3556,55223,1110,909,416,2435,57658
25-02-2017,9,19646,24128,8682,3955,56411,1098,1071,410,2579,58990
25-02-2017,10,19228,23819,8504,4228,55780,1083,1021,465,2569,58349
25-02-2017,11,17908,23036,8458,4764,54166,1065,939,440,2444,56610
25-02-2017,12,16291,21888,8271,5043,51493,1053,763,428,2244,53737
25-02-2017,13,15501,21098,8318,5384,50302,1085,677,425,2187,52489
25-02-2017,14,15481,20699,8291,5624,50095,1135,674,411,2220,52315
25-02-2017,15,15958,20774,8276,5850,50859,1128,668,399,2195,53054
25-02-2017,16,16104,21378,8536,6214,52230,1151,665,330,2146,54376
25-02-2017,17,17463,21907,8851,6511,54732,1118,802,384,2304,57036
25-02-2017,18,18002,22311,8937,6649,55898,1101,757,342,2200,58098
25-02-2017,19,16995,22333,8822,6546,54698,1106,747,272,2125,56823
25-02-2017,20,15677,21697,8597,5954,51925,1087,659,280,2026,53951
25-02-2017,21,15352,20534,8428,5529,49845,1080,653,303,2036,51881
25-02-2017,22,15457,19528,8305,5197,48487,907,510,216,1633,50120
25-02-2017,23,14580,18513,8052,4870,46015,854,498,241,1593,47608
26-02-2017,0,14787,17566,7958,4666,44977,840,343,313,1496,46473
26-02-2017,1,14030,17156,7848,4347,43381,869,331,304,1504,44885
26-02-2017,2,13203,16922,7754,4091,41972,857,316,346,1519,43491
26-02-2017,3,13190,16799,7760,3769,41517,858,323,389,1570,43087
26-02-2017,4,13287,16689,7815,3655,41446,853,324,420,1597,43043
26-02-2017,5,13643,16872,7858,3631,42005,872,337,418,1627,43632
26-02-2017,6,13873,17278,7929,3535,42617,894,432,408,1734,44351
26-02-2017,7,14299,17843,8062,3543,43745,871,556,453,1880,45625
26-02-2017,8,15120,18449,8220,3643,45430,909,557,504,1970,47400
26-02-2017,9,15514,19218,8159,3693,46584,905,720,508,2133,48717
26-02-2017,10,15861,19552,8092,4046,47550,899,899,494,2292,49842
26-02-2017,11,15748,19437,8154,4118,47458,872,889,476,2237,49695
26-02-2017,12,15537,19575,8052,4132,47295,863,883,471,2217,49512
26-02-2017,13,15290,19301,7976,4007,46573,866,989,469,2324,48897
26-02-2017,14,15393,19169,7926,3720,46208,856,970,455,2281,48489
26-02-2017,15,15318,19134,7996,3696,46145,872,958,460,2290,48435
26-02-2017,16,15807,19505,8248,4067,47625,880,960,456,2296,49921
26-02-2017,17,17636,20219,8563,4474,50891,881,989,453,2323,53214
26-02-2017,18,19160,21337,8683,4467,53648,901,1017,463,2381,56029
26-02-2017,19,18412,21024,8715,4439,52590,926,962,454,2342,54932
26-02-2017,20,17101,20777,8686,4253,50816,890,949,416,2255,53071
26-02-2017,21,16273,20293,8402,4421,49390,869,934,340,2143,51533
26-02-2017,22,16424,19044,8099,4419,47987,895,663,306,1864,49851
26-02-2017,23,15241,17926,7765,4446,45379,900,475,257,1632,47011
27-02-2017,0,15011,16955,7835,4546,44345,916,285,230,1431,45776
27-02-2017,1,14495,16821,7771,4655,43742,934,282,197,1413,45155
27-02-2017,2,13839,16960,7733,4722,43254,968,301,163,1432,44686
27-02-2017,3,13785,17271,7777,4861,43695,965,325,153,1443,45138
27-02-2017,4,13913,17976,7939,4897,44726,1080,374,145,1599,46325
27-02-2017,5,15388,19598,8574,5024,48584,1267,1072,148,2487,51071
27-02-2017,6,18394,22248,9108,5138,54889,1372,1351,202,2925,57814
27-02-2017,7,20220,24338,9332,5480,59371,1487,1371,404,3262,62633
27-02-2017,8,20809,24525,9296,5441,60071,1581,1337,622,3540,63611
27-02-2017,9,20502,24155,9264,5451,59373,1545,1322,509,3376,62749
27-02-2017,10,20699,24559,9185,5374,59818,1523,1280,362,3165,62983
27-02-2017,11,20075,24483,8984,5239,58782,1464,1256,270,2990,61772
27-02-2017,12,19023,23912,8781,4834,56551,1500,1141,255,2896,59447
27-02-2017,13,18166,23657,8880,4697,55399,1533,1221,232,2986,58385
27-02-2017,14,17959,23740,9024,4633,55354,1545,1246,218,3009,58363
27-02-2017,15,18164,23355,8987,4601,55106,1602,1323,207,3132,58238
27-02-2017,16,19371,23294,9280,4774,56721,1625,1239,229,3093,59814
27-02-2017,17,20729,23984,9535,4992,59241,1654,1246,261,3161,62402
27-02-2017,18,21004,24263,9595,5220,60083,1651,1136,302,3089,63172
27-02-2017,19,20040,23957,9283,5154,58435,1606,716,340,2662,61097
27-02-2017,20,18410,23121,8816,5047,55393,1621,499,375,2495,57888
27-02-2017,21,16518,21163,8439,4898,51019,1489,491,410,2390,53409
27-02-2017,22,15778,19165,8074,4946,47964,1332,509,378,2219,50183
27-02-2017,23,14900,17653,7644,4971,45168,1282,506,406,2194,47362
28-02-2017,0,14155,17298,7611,4928,43992,1222,487,423,2132,46124
28-02-2017,1,13415,17369,7537,4990,43310,1222,478,421,2121,45431
28-02-2017,2,13150,17393,7451,4866,42859,1204,486,434,2124,44983
28-02-2017,3,12681,17552,7427,4802,42463,1212,488,427,2127,44590
28-02-2017,4,12925,17687,7649,4813,43074,1231,498,407,2136,45210
28-02-2017,5,14124,18915,8102,4846,45989,1380,527,447,2354,48343
28-02-2017,6,15870,21534,8527,5291,51222,1682,536,445,2663,53885
28-02-2017,7,18581,23690,8755,5855,56882,1646,649,452,2747,59629
28-02-2017,8,19181,24082,8782,6120,58165,1647,875,417,2939,61104
28-02-2017,9,19202,24034,8837,6370,58444,1641,985,375,3001,61445
28-02-2017,10,18732,23955,8638,6370,57695,1692,1177,352,3221,60916
28-02-2017,11,18193,23936,8372,6283,56783,1684,893,327,2904,59687
28-02-2017,12,17842,23415,8348,5754,55359,1746,722,273,2741,58100
28-02-2017,13,18328,23471,8444,6248,56492,1775,740,247,2762,59254
28-02-2017,14,18608,23692,8717,6129,57148,1765,1056,240,3061,60209
28-02-2017,15,18876,24027,8844,6248,57995,1732,967,229,2928,60923
28-02-2017,16,18896,24022,8895,6159,57972,1720,1101,276,3097,61069
28-02-2017,17,20435,24310,9078,5790,59614,1769,1157,313,3239,62853
28-02-2017,18,20863,24795,9017,6105,60782,1732,1240,343,3315,64097
28-02-2017,19,19904,24591,8633,6211,59342,1762,891,268,2921,62263
28-02-2017,20,18894,23523,8365,6105,56886,1741,800,274,2815,59701
28-02-2017,21,18094,22489,8009,6178,54771,1742,522,268,2532,57303
28-02-2017,22,16573,21026,7931,6071,51601,1715,490,264,2469,54070
28-02-2017,23,15256,19116,7709,6124,48206,1557,501,236,2294,50500
01-03-2017,0,15349,18048,7584,5563,46544,1264,308,163,1735,48279
01-03-2017,1,14950,17639,7474,5459,45521,1241,287,142,1670,47191
01-03-2017,2,13654,17595,7317,5338,43905,1240,291,100,1631,45536
01-03-2017,3,13795,17629,7398,5439,44261,1221,295,139,1655,45916
01-03-2017,4,13879,18303,7570,5369,45122,1240,287,321,1848,46970
01-03-2017,5,15368,20167,8111,5340,48986,1573,311,323,2207,51193
01-03-2017,6,18247,22067,8700,5419,54432,1685,885,336,2906,57338
01-03-2017,7,19959,23971,8998,5893,58820,1684,988,400,3072,61892
01-03-2017,8,20474,24110,9128,6109,59820,1635,1074,431,3140,62960
01-03-2017,9,20236,23991,9161,6108,59495,1616,1041,406,3063,62558
01-03-2017,10,20011,24098,9060,6254,59423,1599,1036,425,3060,62483
01-03-2017,11,19476,23942,8919,6193,58529,1600,1013,440,3053,61582
01-03-2017,12,18958,23716,8916,5989,57579,1582,1142,441,3165,60744
01-03-2017,13,18682,23747,8889,5787,57105,1570,1013,471,3054,60159
01-03-2017,14,18619,23838,8822,5785,57065,1572,1021,411,3004,60069
01-03-2017,15,18780,24201,8809,5480,57270,1588,1044,320,2952,60222
01-03-2017,16,19352,24142,8861,5291,57646,1543,1037,341,2921,60567
01-03-2017,17,20691,24334,9040,5148,59212,1577,1094,542,3213,62425
01-03-2017,18,22076,24487,9032,4856,60453,1611,1092,523,3226,63679
01-03-2017,19,21863,24621,8855,4326,59665,1617,874,243,2734,62399
01-03-2017,20,21110,24257,8462,3966,57797,1631,553,277,2461,60258
01-03-2017,21,20446,23611,8254,3823,56134,1660,485,313,2458,58592
01-03-2017,22,19060,21812,8054,3637,52562,1639,493,314,2446,55008
01-03-2017,23,16837,19813,7981,3552,48183,1567,483,342,2392,50575
02-03-2017,0,15540,18868,7612,3177,45197,1579,317,344,2240,47437
02-03-2017,1,14693,18406,7347,3157,43603,1555,309,306,2170,45773
02-03-2017,2,13470,17642,7138,2900,41151,1282,308,277,1867,43018
02-03-2017,3,13471,17505,7129,2795,40899,1209,310,236,1755,42654
02-03-2017,4,14080,17872,7320,2813,42084,1267,317,219,1803,43887
02-03-2017,5,15821,19350,7720,2913,45804,1548,511,227,2286,48090
02-03-2017,6,19060,21852,8170,3278,52360,1577,959,235,2771,55131
02-03-2017,7,22426,23770,8596,3453,58245,1558,1150,214,2922,61167
02-03-2017,8,22320,24062,8714,3665,58761,1582,1166,187,2935,61696
02-03-2017,9,21035,23785,8692,3418,56931,1581,1098,174,2853,59784
02-03-2017,10,20693,23598,8510,3483,56284,1595,1062,160,2817,59101
02-03-2017,11,19976,23255,8381,3950,55562,1573,1044,156,2773,58335
02-03-2017,12,19194,22734,8292,4256,54475,1559,972,166,2697,57172
02-03-2017,13,18644,22081,8240,4691,53655,1554,913,173,2640,56295
02-03-2017,14,18097,21943,8279,4606,52926,1556,725,289,2570,55496
02-03-2017,15,17924,21974,8307,4672,52877,1490,710,213,2413,55290
02-03-2017,16,18136,22110,8432,4666,53343,1472,779,211,2462,55805
02-03-2017,17,20227,22964,8744,4917,56852,1476,1093,303,2872,59724
02-03-2017,18,21495,23562,8842,5046,58946,1463,1060,396,2919,61865
02-03-2017,19,21174,23418,8414,5210,58217,1416,724,252,2392,60609
02-03-2017,20,20063,22987,8397,5041,56488,1328,558,195,2081,58569
02-03-2017,21,18043,21877,8060,4931,52911,1307,692,233,2232,55143
02-03-2017,22,16314,19882,7528,4785,48509,1285,550,268,2103,50612
02-03-2017,23,15046,18310,7506,4846,45709,1074,483,263,1820,47529
03-03-2017,0,15140,17314,7484,4805,44743,983,382,276,1641,46384
03-03-2017,1,15034,17193,7477,4879,44584,981,380,253,1614,46198
03-03-2017,2,15031,17247,7618,4769,44665,974,382,254,1610,46275
03-03-2017,3,14925,17650,7863,4661,45100,973,383,257,1613,46713
03-03-2017,4,15560,18488,8178,4614,46842,1128,424,271,1823,48665
03-03-2017,5,17502,19713,8283,4610,50107,1224,706,302,2232,52339
03-03-2017,6,19912,22109,8649,4727,55396,1264,952,344,2560,57956
03-03-2017,7,21447,23879,9015,4943,59283,1273,1099,489,2861,62144
03-03-2017,8,21949,24358,9028,5139,60475,1283,1437,558,3278,63753
03-03-2017,9,21489,24521,8921,5361,60291,1286,1424,594,3304,63595
03-03-2017,10,21274,24249,8697,5466,59687,1317,1406,618,3341,63028
03-03-2017,11,21172,24167,8717,5490,59548,1326,1356,596,3278,62826
03-03-2017,12,20449,23852,8838,5274,58413,1343,1309,479,3131,61544
03-03-2017,13,20352,23606,8697,5076,57732,1316,1331,499,3146,60878
03-03-2017,14,20577,23568,8669,4647,57461,1273,1305,506,3084,60545
03-03-2017,15,20839,23552,8673,4327,57391,1257,1237,480,2974,60365
03-03-2017,16,21220,23598,8820,3922,57559,1251,1327,415,2993,60552
03-03-2017,17,22734,23912,9170,4009,59826,1267,1398,536,3201,63027
03-03-2017,18,23471,24375,9343,4051,61240,1279,1454,399,3132,64372
03-03-2017,19,22339,23929,8878,3762,58908,1263,1424,328,3015,61923
03-03-2017,20,20793,23287,8554,3196,55831,1213,1263,371,2847,58678
03-03-2017,21,20493,22187,8407,2942,54027,1192,1225,398,2815,56842
03-03-2017,22,19715,21143,8385,2821,52067,1176,1038,341,2555,54622
03-03-2017,23,18664,20048,8176,2612,49498,1162,792,304,2258,51756
04-03-2017,0,18318,17871,7922,2447,46558,1007,493,339,1839,48397
04-03-2017,1,16203,17131,7918,2403,43656,950,473,330,1753,45409
04-03-2017,2,15347,17010,7871,2433,42660,948,465,296,1709,44369
04-03-2017,3,14382,16920,7812,2566,41679,885,466,270,1621,43300
04-03-2017,4,13983,16835,7872,2833,41524,884,463,262,1609,43133
04-03-2017,5,15355,17332,8065,3092,43846,938,464,278,1680,45526
04-03-2017,6,15387,18096,8178,3336,44996,906,603,237,1746,46742
04-03-2017,7,16672,19814,8492,3653,48630,928,779,237,1944,50574
04-03-2017,8,18959,20831,8624,3935,52349,912,919,209,2040,54389
04-03-2017,9,20024,21582,8556,4122,54282,911,1030,176,2117,56399
04-03-2017,10,20230,21792,8563,4259,54844,908,1118,155,2181,57025
04-03-2017,11,19720,21760,8540,4406,54425,913,1115,144,2172,56597
04-03-2017,12,19016,21737,8497,4593,53842,906,1086,148,2140,55982
04-03-2017,13,18391,21723,8483,4603,53200,895,1070,150,2115,55315
04-03-2017,14,17832,21723,8515,4496,52567,903,1019,143,2065,54632
04-03-2017,15,17898,21626,8451,4500,52476,946,1021,147,2114,54590
04-03-2017,16,18148,22136,8487,4486,53257,981,1010,162,2153,55410
04-03-2017,17,19229,22648,8781,4694,55352,977,998,172,2147,57499
04-03-2017,18,20131,22831,8843,4784,56589,991,1005,162,2158,58747
04-03-2017,19,19172,22816,8947,4585,55519,1003,935,171,2109,57628
04-03-2017,20,18399,22218,8803,4458,53878,1014,794,176,1984,55862
04-03-2017,21,18164,21450,8609,4288,52511,1019,564,178,1761,54272
04-03-2017,22,17699,20011,8510,4065,50287,1020,459,176,1655,51942
04-03-2017,23,16791,18617,8016,3958,47381,930,470,189,1589,48970
05-03-2017,0,16209,17673,7766,4116,45766,844,393,209,1446,47212
05-03-2017,1,15662,17472,7787,3853,44775,839,398,253,1490,46265
05-03-2017,2,15312,17408,7654,3862,44236,834,401,300,1535,45771
05-03-2017,3,14774,17315,7612,3949,43650,861,396,335,1592,45242
05-03-2017,4,14413,17527,7644,4006,43590,862,412,346,1620,45210
05-03-2017,5,14827,17665,7671,4202,44365,858,411,369,1638,46003
05-03-2017,6,14991,17945,7863,4312,45111,853,610,400,1863,46974
05-03-2017,7,15366,18374,7946,4174,45861,858,701,414,1973,47834
05-03-2017,8,16308,19236,8079,4304,47928,862,795,450,2107,50035
05-03-2017,9,17122,20204,8180,4362,49868,892,826,455,2173,52041
05-03-2017,10,17271,20741,8055,4524,50591,870,918,438,2226,52817
05-03-2017,11,17314,20937,7930,4206,50388,966,932,434,2332,52720
05-03-2017,12,17651,20782,7931,4056,50421,978,977,425,2380,52801
05-03-2017,13,16833,20620,8032,4092,49577,938,940,411,2289,51866
05-03-2017,14,16203,20473,7974,3975,48624,918,923,358,2199,50823
05-03-2017,15,15700,20337,7866,3896,47800,948,922,339,2209,50009
05-03-2017,16,16375,20854,8186,3904,49321,949,967,300,2216,51537
05-03-2017,17,18986,22333,8696,4039,54054,969,1053,269,2291,56345
05-03-2017,18,21621,23642,8744,4024,58030,1006,1250,262,2518,60548
05-03-2017,19,22102,23881,8682,3849,58513,1028,1248,239,2515,61028
05-03-2017,20,21034,23332,8609,3840,56814,1058,1136,230,2424,59238
05-03-2017,21,20284,22678,8553,3891,55406,1079,763,235,2077,57483
05-03-2017,22,19144,21609,8448,3825,53028,1087,602,246,1935,54963
05-03-2017,23,17783,20559,8268,3977,50588,1099,504,256,1859,52447
06-03-2017,0,16484,19262,8185,4251,48182,1109,834,262,2205,50387
06-03-2017,1,15675,18580,7980,4413,46649,1033,877,266,2176,48825
06-03-2017,2,14372,18377,7899,4426,45074,995,881,247,2123,47197
06-03-2017,3,14063,18210,7812,4544,44630,1010,896,282,2188,46818
06-03-2017,4,15178,18747,8096,4762,46783,1135,916,313,2364,49147
06-03-2017,5,17431,20242,8590,5112,51375,1382,991,327,2700,54075
06-03-2017,6,21574,22319,9003,5763,58660,1405,1246,498,3149,61809
06-03-2017,7,23958,24560,9365,6106,63989,1409,1422,545,3376,67365
06-03-2017,8,24145,25241,9294,6447,65128,1453,1774,576,3803,68931
06-03-2017,9,23661,25330,9118,6490,64597,1479,1798,602,3879,68476
06-03-2017,10,23197,24932,9071,6080,63281,1491,1796,564,3851,67132
06-03-2017,11,22887,24336,8966,6090,62279,1493,1797,462,3752,66031
06-03-2017,12,22548,24288,8799,6054,61691,1524,1785,468,3777,65468
06-03-2017,13,22283,24011,8729,6115,61139,1510,1780,475,3765,64904
06-03-2017,14,22075,23764,8623,5950,60413,1507,1773,481,3761,64174
06-03-2017,15,22029,23524,8535,5851,59940,1520,1788,478,3786,63726
06-03-2017,16,21922,23584,8669,5770,59945,1484,1789,487,3760,63705
06-03-2017,17,22754,24333,9033,5668,61790,1495,1791,623,3909,65699
06-03-2017,18,23057,25199,9179,5642,63077,1510,1798,668,3976,67053
06-03-2017,19,22806,24492,8943,5422,61662,1512,1783,487,3782,65444
06-03-2017,20,21652,23950,8644,5382,59627,1497,1687,476,3660,63287
06-03-2017,21,21047,23393,8371,5352,58164,1418,1556,458,3432,61596
06-03-2017,22,19862,22422,8290,5054,55629,1373,1462,406,3241,58870
06-03-2017,23,18420,21214,8210,4858,52701,1359,1387,348,3094,55795
07-03-2017,0,17224,19788,8325,4772,50108,1430,1350,314,3094,53202
07-03-2017,1,15845,19273,8187,4498,47803,1449,1343,276,3068,50871
07-03-2017,2,15424,19189,8271,4086,46971,1468,1309,246,3023,49994
07-03-2017,3,15921,18966,8297,3967,47153,1468,1306,218,2992,50145
07-03-2017,4,17048,19384,8415,4045,48892,1481,1313,207,3001,51893
07-03-2017,5,20334,20877,8845,4038,54094,1623,1465,221,3309,57403
07-03-2017,6,22879,22747,9482,4308,59416,1671,1639,215,3525,62941
07-03-2017,7,24068,25010,10088,4903,64069,1777,1647,216,3640,67709
07-03-2017,8,23701,25724,10221,5111,64757,1756,1659,387,3802,68559
07-03-2017,9,23540,25921,10242,5197,64900,1751,1677,381,3809,68709
07-03-2017,10,23462,25932,10016,5015,64424,1727,1684,368,3779,68203
07-03-2017,11,23104,25196,9934,4725,62958,1721,1610,174,3505,66463
07-03-2017,12,23633,25180,10018,4398,63229,1710,1593,169,3472,66701
07-03-2017,13,23371,25220,9871,4333,62795,1676,1580,166,3422,66217
07-03-2017,14,23290,25094,9768,4139,62290,1679,1567,174,3420,65710
07-03-2017,15,23310,25129,9913,4130,62482,1654,1588,186,3428,65910
07-03-2017,16,23118,24849,10146,4101,62213,1640,1576,196,3412,65625
07-03-2017,17,23355,24344,10461,4350,62511,1638,1580,422,3640,66151
07-03-2017,18,23528,25155,10702,4423,63807,1612,1666,476,3754,67561
07-03-2017,19,23487,24731,10562,4215,62995,1593,1590,407,3590,66585
07-03-2017,20,23351,23655,10326,3717,61049,1604,1516,296,3416,64465
07-03-2017,21,23288,22712,9882,3554,59436,1615,1431,327,3373,62809
07-03-2017,22,22623,21124,9474,3213,56434,1623,1429,347,3399,59833
07-03-2017,23,21204,19701,9202,3150,53258,1626,1426,341,3393,56651
08-03-2017,0,19851,18927,9114,2974,50867,1619,1367,342,3328,54195
08-03-2017,1,18415,18570,8934,2883,48801,1632,1434,316,3382,52183
08-03-2017,2,17705,18424,8854,2888,47872,1604,1402,319,3325,51197
08-03-2017,3,17206,18434,8859,2871,47371,1557,1374,306,3237,50608
08-03-2017,4,17037,18455,8756,2964,47212,1583,1374,304,3261,50473
08-03-2017,5,18814,19089,8881,3120,49904,1661,1387,302,3350,53254
08-03-2017,6,22696,21128,9439,3682,56946,1616,1679,320,3615,60561
08-03-2017,7,23651,23508,9870,4589,61619,1729,1719,319,3767,65386
08-03-2017,8,23614,23559,10034,4771,61980,1740,1730,287,3757,65737
08-03-2017,9,23511,23212,9899,5001,61623,1793,1684,300,3777,65400
08-03-2017,10,23130,23311,9624,4918,60981,1746,1658,277,3681,64662
08-03-2017,11,22301,22806,9335,5162,59604,1854,1582,269,3705,63309
08-03-2017,12,21441,22534,9146,5213,58334,1838,1550,276,3664,61998
08-03-2017,13,21126,22587,9033,5285,58031,1838,1528,287,3653,61684
08-03-2017,14,21062,22528,8992,5347,57928,1832,1526,251,3609,61537
08-03-2017,15,20756,22670,9050,5386,57862,1789,1415,241,3445,61307
08-03-2017,16,20693,22961,9241,5462,58357,1783,1415,249,3447,61804
08-03-2017,17,21740,23198,9454,5717,60108,1763,1556,266,3585,63693
08-03-2017,18,22295,23790,9590,5622,61296,1746,1570,555,3871,65167
08-03-2017,19,21744,23616,9494,5419,60272,1738,1595,654,3987,64259
08-03-2017,20,21064,23199,9139,5093,58495,1747,1467,251,3465,61960
08-03-2017,21,19354,22123,9152,4889,55518,1733,1340,271,3344,58862
08-03-2017,22,17772,20938,8978,4501,52192,1724,1295,297,3316,55508
08-03-2017,23,16101,19591,8711,4135,48540,1499,1342,310,3151,51691
09-03-2017,0,15277,19198,8734,3896,47105,1295,1293,301,2889,49994
09-03-2017,1,14675,18965,8637,3951,46228,1244,1302,294,2840,49068
09-03-2017,2,14585,18463,8527,3907,45483,1250,1297,295,2842,48325
09-03-2017,3,14042,19041,8567,3752,45403,1396,1295,278,2969,48372
09-03-2017,4,14366,18905,8598,3705,45574,1632,1244,282,3158,48732
09-03-2017,5,17155,19895,9087,4069,50207,1687,1237,290,3214,53421
09-03-2017,6,20545,22222,9470,4129,56366,1753,1485,293,3531,59897
09-03-2017,7,22348,24667,9577,4287,60877,1740,1474,285,3499,64376
09-03-2017,8,22883,24931,9762,4399,61976,1721,1551,239,3511,65487
09-03-2017,9,22567,24860,9718,4730,61875,1751,1394,200,3345,65220
09-03-2017,10,22288,24642,9782,4891,61603,1748,1332,182,3262,64865
09-03-2017,11,21884,24390,9687,4792,60755,1771,1311,175,3257,64012
09-03-2017,12,21329,24228,9615,4672,59844,1757,1288,151,3196,63040
09-03-2017,13,20969,24075,9528,4443,59017,1755,1292,143,3190,62207
09-03-2017,14,20573,23984,9496,4279,58334,1672,1297,132,3101,61435
09-03-2017,15,20306,23886,9539,4145,57877,1703,1292,131,3126,61003
09-03-2017,16,20674,23521,9290,3894,57381,1713,1307,132,3152,60533
09-03-2017,17,21275,23657,9311,3956,58198,1719,1323,145,3187,61385
09-03-2017,18,21855,23948,9440,4155,59399,1709,1362,275,3346,62745
09-03-2017,19,20793,23387,9332,4084,57598,1699,1400,139,3238,60836
09-03-2017,20,19363,22161,9071,4148,54743,1687,1177,143,3007,57750
09-03-2017,21,18995,20163,8521,4289,51969,1682,1143,139,2964,54933
09-03-2017,22,16584,18966,8088,4194,47833,1672,1131,138,2941,50774
09-03-2017,23,15042,17844,7946,4212,45045,1589,1107,140,2836,47881
10-03-2017,0,13820,17214,7763,4060,42857,1311,1037,132,2480,45337
10-03-2017,1,13472,16979,7661,4157,42269,1126,1033,134,2293,44562
10-03-2017,2,13680,16994,7591,4170,42435,1092,1033,132,2257,44692
10-03-2017,3,13752,17166,7545,4350,42813,1098,1035,135,2268,45081
10-03-2017,4,13879,17768,7639,4595,43882,1506,1034,130,2670,46552
10-03-2017,5,15637,18870,7903,4897,47305,1641,1050,133,2824,50129
10-03-2017,6,18840,20987,8406,5228,53462,1639,1295,133,3067,56529
10-03-2017,7,20806,23399,8797,5338,58341,1655,1497,134,3286,61627
10-03-2017,8,21507,23603,8826,5372,59308,1667,1608,135,3410,62718
10-03-2017,9,20557,23342,8719,5463,58081,1659,1634,134,3427,61508
10-03-2017,10,20721,22669,8742,5474,57606,1650,1522,137,3309,60915
10-03-2017,11,20035,22747,8652,5310,56743,1682,1521,138,3341,60084
10-03-2017,12,19040,22605,8609,4974,55229,1693,1445,141,3279,58508
10-03-2017,13,18384,22567,8486,4612,54049,1688,1434,138,3260,57309
10-03-2017,14,18011,22536,8416,4247,53211,1685,1420,144,3249,56460
10-03-2017,15,18708,22595,8409,4049,53762,1681,1394,145,3220,56982
10-03-2017,16,19870,22890,8581,3821,55162,1697,1396,139,3232,58394
10-03-2017,17,21423,23495,8893,3598,57409,1702,1488,150,3340,60749
10-03-2017,18,22132,23839,9076,3911,58958,1737,1562,260,3559,62517
10-03-2017,19,21581,23771,8871,3439,57662,1590,1426,160,3176,60838
10-03-2017,20,20434,23227,8494,3159,55315,1466,1264,163,2893,58208
10-03-2017,21,19843,22292,8134,3089,53358,1428,1285,159,2872,56230
10-03-2017,22,19274,20733,8011,3003,51020,1435,1360,155,2950,53970
10-03-2017,23,18493,19639,7899,2844,48875,1428,1283,161,2872,51747
11-03-2017,0,17594,18630,7944,2590,46758,1371,1426,148,2945,49703
11-03-2017,1,16146,18295,8052,2411,44905,1363,1423,150,2936,47841
11-03-2017,2,15366,18198,7967,2278,43810,1360,1421,152,2933,46743
11-03-2017,3,14449,18029,8005,2298,42781,1354,1421,145,2920,45701
11-03-2017,4,13773,17933,7974,2255,41936,1364,1418,135,2917,44853
11-03-2017,5,15209,17970,8168,2211,43558,1376,1415,136,2927,46485
11-03-2017,6,16901,18856,8393,2556,46706,1394,1411,136,2941,49647
11-03-2017,7,18486,20249,8584,2552,49873,1385,1408,137,2930,52803
11-03-2017,8,19993,20858,8395,2863,52109,1393,1406,138,2937,55046
11-03-2017,9,20745,20998,8200,3029,52971,1391,1407,140,2938,55909
11-03-2017,10,20235,20575,7994,3211,52014,1373,1419,142,2934,54948
11-03-2017,11,18949,19987,7857,3159,49952,1379,1419,140,2938,52890
11-03-2017,12,17739,19253,7849,2903,47744,1362,1418,138,2918,50662
11-03-2017,13,15759,18954,7757,2756,45226,1342,1419,140,2901,48127
11-03-2017,14,15489,18758,7679,2665,44591,1376,1420,155,2951,47542
11-03-2017,15,15939,19097,7959,2612,45608,1370,1439,157,2966,48574
11-03-2017,16,17617,19210,8181,2836,47843,1374,1441,169,2984,50827
11-03-2017,17,20719,20337,8427,2900,52384,1367,1442,184,2993,55377
11-03-2017,18,21519,21338,8621,3108,54587,1367,1435,172,2974,57561
11-03-2017,19,20730,21107,8649,3196,53683,1367,1423,163,2953,56636
11-03-2017,20,18663,20219,8655,3289,50824,1368,1413,155,2936,53760
11-03-2017,21,17273,19652,8316,3268,48511,1365,1414,157,2936,51447
11-03-2017,22,16413,18646,8050,3130,46239,1358,1412,156,2926,49165
11-03-2017,23,13702,17751,7818,2881,42152,1351,1373,162,2886,45038
12-03-2017,0,13439,17053,7922,2970,41384,1020,1363,166,2549,43933
12-03-2017,1,12114,16853,7916,2812,39695,968,1362,165,2495,42190
12-03-2017,2,11555,16645,7880,2819,38898,948,1365,162,2475,41373
12-03-2017,3,10921,16588,7866,2793,38170,954,1367,161,2482,40652
12-03-2017,4,11214,16561,7881,2961,38617,967,1368,153,2488,41105
12-03-2017,5,12088,16524,8008,2926,39545,975,1370,152,2497,42042
12-03-2017,6,12486,16823,8064,2963,40336,972,1368,149,2489,42825
12-03-2017,7,13177,17411,8222,3222,42033,1023,1367,143,2533,44566
12-03-2017,8,13991,18026,8328,3576,43922,1241,1360,136,2737,46659
12-03-2017,9,14607,18632,8219,3724,45181,1271,1360,134,2765,47946
12-03-2017,10,14800,18800,8080,3951,45632,1270,1362,134,2766,48398
12-03-2017,11,14282,18883,8029,3944,45137,1255,1436,133,2824,47961
12-03-2017,12,14242,18835,8038,3957,45072,1312,1435,132,2879,47951
12-03-2017,13,13362,18574,7989,3958,43884,1344,1439,132,2915,46799
12-03-2017,14,13308,18477,7967,3870,43622,1346,1417,133,2896,46518
12-03-2017,15,13341,18575,8016,3829,43762,1372,1406,135,2913,46675
12-03-2017,16,13808,18794,7977,3819,44399,1434,1407,136,2977,47376
12-03-2017,17,14740,19318,8141,4047,46245,1502,1409,139,3050,49295
12-03-2017,18,17351,20274,8240,4403,50267,1527,1415,203,3145,53412
12-03-2017,19,18160,20559,8292,4406,51417,1571,1420,180,3171,54588
12-03-2017,20,16806,20087,8273,4397,49563,1574,1422,161,3157,52720
12-03-2017,21,16399,19772,8049,4326,48547,1577,1385,171,3133,51680
12-03-2017,22,15773,18963,7891,4210,46838,1566,1375,170,3111,49949
12-03-2017,23,14065,17871,7583,3668,43188,1601,1375,173,3149,46337
13-03-2017,0,12864,17362,7316,3319,40862,1244,1375,175,2794,43656
13-03-2017,1,12281,17150,7309,3131,39872,1221,1376,160,2757,42629
13-03-2017,2,12432,17056,7308,2956,39752,1228,1425,148,2801,42553
13-03-2017,3,12920,17156,7311,2926,40314,1298,1443,141,2882,43196
13-03-2017,4,13552,17479,7473,2956,41459,1670,1446,138,3254,44713
13-03-2017,5,16327,18751,7926,3056,46061,1580,1448,137,3165,49226
13-03-2017,6,20194,22018,8436,3490,54137,1589,1490,129,3208,57345
13-03-2017,7,22314,23855,8785,4062,59016,1575,1540,131,3246,62262
13-03-2017,8,22487,24051,8914,4240,59692,1620,1560,299,3479,63171
13-03-2017,9,22467,23846,8783,3983,59081,1651,1561,282,3494,62575
13-03-2017,10,22388,23792,8676,3714,58571,1662,1558,277,3497,62068
13-03-2017,11,21442,23645,8569,3721,57377,1674,1556,254,3484,60861
13-03-2017,12,20766,23266,8458,3558,56048,1676,1530,273,3479,59527
13-03-2017,13,21055,23329,8363,3403,56149,1671,1557,262,3490,59639
13-03-2017,14,20762,23185,8424,3470,55841,1681,1555,136,3372,59213
13-03-2017,15,21191,23190,8498,3645,56523,1683,1554,149,3386,59909
13-03-2017,16,21251,23435,8675,3702,57063,1660,1555,159,3374,60437
13-03-2017,17,21613,23517,8888,3752,57769,1625,1555,312,3492,61261
13-03-2017,18,22185,23475,9061,3892,58613,1626,1554,345,3525,62138
13-03-2017,19,21329,23413,9088,3903,57733,1631,1553,341,3525,61258
13-03-2017,20,20038,23242,9116,3862,56256,1623,1554,142,3319,59575
13-03-2017,21,19269,22650,8962,3488,54370,1623,1556,141,3320,57690
13-03-2017,22,17548,21342,8847,3396,51133,1622,1556,141,3319,54452
13-03-2017,23,16297,19796,8731,3033,47856,1615,1471,141,3227,51083
14-03-2017,0,14920,18227,8506,2949,44602,1427,1476,109,3012,47614
14-03-2017,1,13969,18066,8268,2876,43179,1187,1469,107,2763,45942
14-03-2017,2,12872,17782,8103,2858,41615,1122,1476,107,2705,44320
14-03-2017,3,12951,17871,8072,2981,41875,1118,1479,109,2706,44581
14-03-2017,4,13228,18097,8198,2958,42481,1304,1480,114,2898,45379
14-03-2017,5,14708,19181,8535,3131,45555,1525,1567,155,3247,48802
14-03-2017,6,18974,21330,8958,3732,52994,1619,1566,172,3357,56351
14-03-2017,7,21305,23062,9090,4233,57693,1657,1551,281,3489,61182
14-03-2017,8,21128,23543,9136,4628,58436,1744,1562,394,3700,62136
14-03-2017,9,20243,23669,8960,4946,57817,1664,1546,350,3560,61377
14-03-2017,10,19288,23691,8843,5264,57085,1668,1552,322,3542,60627
14-03-2017,11,18027,23590,8912,5544,56074,1618,1534,212,3364,59438
14-03-2017,12,16259,23424,8725,5587,53996,1637,1542,228,3407,57403
14-03-2017,13,15562,23204,8739,5627,53133,1622,1529,221,3372,56505
14-03-2017,14,14799,23351,8649,5674,52473,1590,1527,281,3398,55871
14-03-2017,15,15062,23569,8825,5930,53387,1563,1542,395,3500,56887
14-03-2017,16,15573,23854,8823,5954,54203,1577,1545,399,3521,57724
14-03-2017,17,16472,24095,8998,6145,55711,1568,1550,267,3385,59096
14-03-2017,18,17689,23838,9054,5877,56459,1609,1598,416,3623,60082
14-03-2017,19,16865,23705,8860,5450,54881,1624,1600,543,3767,58648
14-03-2017,20,16012,22731,8748,5438,52931,1451,1604,441,3496,56427
14-03-2017,21,15118,21695,8273,5506,50593,1417,1606,419,3442,54035
14-03-2017,22,14032,20747,7838,5370,47988,1400,1604,353,3357,51345
14-03-2017,23,12625,19374,7518,5177,44696,1398,1596,393,3387,48083
15-03-2017,0,12415,18724,7173,4961,43273,1250,1450,400,3100,46373
15-03-2017,1,12093,18681,7115,4662,42553,1215,1212,414,2841,45394
15-03-2017,2,11899,18694,7049,4673,42315,1225,1073,428,2726,45041
15-03-2017,3,12103,18742,7049,5020,42916,1223,1080,421,2724,45640
15-03-2017,4,12411,19017,7216,5157,43803,1195,1506,416,3117,46920
15-03-2017,5,13208,20256,7621,5165,46249,1216,1517,423,3156,49405
15-03-2017,6,15471,22340,8272,5325,51409,1525,1586,428,3539,54948
15-03-2017,7,17126,24310,8693,5675,55804,1584,1591,470,3645,59449
15-03-2017,8,17109,24638,8752,5923,56422,1658,1590,465,3713,60135
15-03-2017,9,16362,24243,8762,6212,55578,1550,1587,488,3625,59203
15-03-2017,10,15703,24316,8654,6286,54959,1567,1592,722,3881,58840
15-03-2017,11,15198,23739,8552,6313,53802,1553,1586,734,3873,57675
15-03-2017,12,15065,23451,8505,6335,53356,1578,1583,499,3660,57016
15-03-2017,13,14725,23324,8403,6241,52693,1429,1573,688,3690,56383
15-03-2017,14,14826,23255,8275,6119,52476,1322,1569,481,3372,55848
15-03-2017,15,14961,22991,8390,6185,52527,1342,1567,505,3414,55941
15-03-2017,16,15153,23386,8558,6048,53145,1591,1562,482,3635,56780
15-03-2017,17,15987,24148,8811,5782,54728,1573,1556,577,3706,58434
15-03-2017,18,16858,24732,8928,5361,55879,1571,1554,640,3765,59644
15-03-2017,19,16663,24646,9022,5130,55460,1563,1554,571,3688,59148
15-03-2017,20,16071,23780,8858,4920,53628,1475,1553,602,3630,57258
15-03-2017,21,15997,22309,8517,4919,51743,1462,1557,548,3567,55310
15-03-2017,22,15295,21189,8111,4644,49239,1302,1554,367,3223,52462
15-03-2017,23,14126,20342,7780,4546,46794,1150,1501,341,2992,49786
16-03-2017,0,12980,19695,7812,4435,44922,1216,1491,426,3133,48055
16-03-2017,1,12695,19379,7782,4219,44076,1149,1489,435,3073,47149
16-03-2017,2,12842,19263,7832,4058,43997,1167,1490,379,3036,47033
16-03-2017,3,12739,19158,7886,3951,43735,1172,1492,364,3028,46763
16-03-2017,4,13310,19145,7968,3803,44224,1208,1489,335,3032,47256
16-03-2017,5,14731,20341,8174,3745,46992,1451,1495,369,3315,50307
16-03-2017,6,17350,22540,8565,3936,52393,1448,1499,569,3516,55909
16-03-2017,7,20331,23878,9043,4360,57613,1441,1499,532,3472,61085
16-03-2017,8,21478,23523,8992,4340,58333,1436,1576,499,3511,61844
16-03-2017,9,21382,22377,8885,4034,56678,1447,1577,469,3493,60171
16-03-2017,10,21167,21946,8634,3748,55494,1381,1574,471,3426,58920
16-03-2017,11,19715,21709,8458,3746,53628,1369,1567,423,3359,56987
16-03-2017,12,17851,21116,8375,3907,51250,1323,1564,446,3333,54583
16-03-2017,13,16493,21064,8207,4501,50264,1338,1560,430,3328,53592
16-03-2017,14,16120,20940,8226,4943,50229,1317,1565,445,3327,53556
16-03-2017,15,16634,21241,8252,5192,51318,1339,1561,439,3339,54657
16-03-2017,16,17300,22315,8380,5416,53411,1373,1480,414,3267,56678
16-03-2017,17,17997,23274,8527,5280,55079,1325,1483,407,3215,58294
16-03-2017,18,17722,23648,8880,5381,55629,1373,1557,408,3338,58967
16-03-2017,19,17008,23691,8885,5311,54895,1427,1573,397,3397,58292
16-03-2017,20,16088,22640,8769,5294,52791,1459,1579,316,3354,56145
16-03-2017,21,15755,21163,8389,5357,50662,1450,1580,189,3219,53881
16-03-2017,22,14375,20582,8070,5313,48341,1237,1588,205,3030,51371
16-03-2017,23,12948,19648,7831,5135,45562,1212,1521,220,2953,48515
17-03-2017,0,12553,18482,7813,5028,43876,1182,1519,254,2955,46831
17-03-2017,1,12167,18086,7820,4429,42503,1162,1521,302,2985,45488
17-03-2017,2,12414,17818,7860,3911,42005,1178,1523,363,3064,45069
17-03-2017,3,12658,17723,7965,3957,42304,1191,1528,404,3123,45427
17-03-2017,4,12533,18063,8018,4177,42792,1212,1530,422,3164,45956
17-03-2017,5,14149,19282,8391,4378,46199,1253,1534,429,3216,49415
17-03-2017,6,15796,21850,8796,4832,51274,1388,1536,468,3392,54666
17-03-2017,7,17778,23748,9092,5045,55663,1391,1595,511,3497,59160
17-03-2017,8,17558,23931,8965,5595,56050,1393,1593,509,3495,59545
17-03-2017,9,17272,23831,8921,6123,56149,1385,1600,501,3486,59635
17-03-2017,10,16643,23784,8713,6097,55238,1360,1609,509,3478,58716
17-03-2017,11,15670,23369,8612,6078,53730,1280,1609,513,3402,57132
17-03-2017,12,15039,22064,8524,5992,51621,1244,1604,507,3355,54976
17-03-2017,13,15198,21582,8271,5916,50966,1226,1591,494,3311,54277
17-03-2017,14,15024,21696,8359,5921,50999,1197,1577,428,3202,54201
17-03-2017,15,14949,21608,8280,5676,50512,1176,1574,403,3153,53665
17-03-2017,16,15024,21850,8282,5440,50596,1198,1579,346,3123,53719
17-03-2017,17,15955,23193,8636,5171,52953,1299,1579,328,3206,56159
17-03-2017,18,17154,24016,8840,4853,54863,1321,1580,321,3222,58085
17-03-2017,19,16713,24073,8913,4330,54029,1341,1572,359,3272,57301
17-03-2017,20,16164,23097,8469,3910,51641,1321,1574,372,3267,54908
17-03-2017,21,15834,21615,8163,3750,49361,1153,1572,356,3081,52442
17-03-2017,22,14977,19941,8107,3519,46546,1098,1564,352,3014,49560
17-03-2017,23,13006,18834,7872,3362,43076,1067,1476,339,2882,45958
18-03-2017,0,12278,17627,7634,3194,40734,1086,1191,340,2617,43351
18-03-2017,1,11813,17095,7572,2984,39463,1101,1192,336,2629,42092
18-03-2017,2,11330,16902,7481,2971,38684,1098,1191,314,2603,41287
18-03-2017,3,11379,16661,7408,3090,38539,1077,1196,297,2570,41109
18-03-2017,4,11451,16652,7414,3082,38599,1081,1195,244,2520,41119
18-03-2017,5,11363,16872,7425,3240,38901,1060,1193,237,2490,41391
18-03-2017,6,11636,16958,7550,3373,39517,1030,1397,288,2715,42232
18-03-2017,7,12890,17538,7831,3475,41735,1033,1422,270,2725,44460
18-03-2017,8,14620,18751,7900,3961,45233,1037,1426,316,2779,48012
18-03-2017,9,15000,19196,7865,4455,46517,1117,1423,274,2814,49331
18-03-2017,10,15237,19324,7922,4755,47237,1088,1420,176,2684,49921
18-03-2017,11,15371,19075,7898,5042,47386,1041,1416,204,2661,50047
18-03-2017,12,14801,18753,7935,5394,46883,1007,1409,211,2627,49510
18-03-2017,13,14135,18395,7736,5256,45519,1001,1403,207,2611,48130
18-03-2017,14,14008,18257,7757,5360,45382,1004,1400,207,2611,47993
18-03-2017,15,13601,18376,7689,5281,44946,994,1402,201,2597,47543
18-03-2017,16,14109,18414,7858,5208,45590,989,1343,222,2554,48144
18-03-2017,17,15110,19483,8231,4978,47803,1083,1346,219,2648,50451
18-03-2017,18,17383,21054,8461,4818,51716,1067,1352,215,2634,54350
18-03-2017,19,18518,21599,8494,4231,52842,1077,1357,213,2647,55489
18-03-2017,20,17088,21461,8538,4072,51158,1077,1354,217,2648,53806
18-03-2017,21,16348,20883,8273,3804,49309,1076,1352,203,2631,51940
18-03-2017,22,16029,19870,8211,3617,47727,1080,1352,180,2612,50339
18-03-2017,23,15150,18482,7994,3247,44872,1072,1336,167,2575,47447
19-03-2017,0,14599,16730,7815,2954,42097,914,955,133,2002,44099
19-03-2017,1,13907,15934,7651,2710,40203,914,950,136,2000,42203
19-03-2017,2,13424,15820,7663,2469,39377,935,950,141,2026,41403
19-03-2017,3,13395,15785,7759,2225,39165,936,949,148,2033,41198
19-03-2017,4,13440,16010,7857,2283,39590,945,948,162,2055,41645
19-03-2017,5,13385,16250,7921,2350,39906,968,1034,183,2185,42091
19-03-2017,6,13196,16957,7936,2690,40780,1048,1031,213,2292,43072
19-03-2017,7,13227,17150,7981,3113,41471,1030,1255,209,2494,43965
19-03-2017,8,13535,18568,7782,3330,43216,1031,1275,199,2505,45721
19-03-2017,9,14336,19233,7787,3437,44792,1030,1272,186,2488,47280
19-03-2017,10,14663,19485,7782,3574,45505,1052,1271,176,2499,48004
19-03-2017,11,14702,19690,7760,3907,46058,1043,1269,164,2476,48534
19-03-2017,12,14519,19328,7697,4043,45588,1069,1347,150,2566,48154
19-03-2017,13,14682,18997,7669,3949,45296,1071,1358,146,2575,47871
19-03-2017,14,14655,19023,7623,3819,45121,984,1340,140,2464,47585
19-03-2017,15,14283,19233,7604,3935,45055,979,1343,133,2455,47510
19-03-2017,16,14433,19583,7628,3980,45625,1068,1344,130,2542,48167
19-03-2017,17,15281,20813,7974,3764,47833,1109,1350,133,2592,50425
19-03-2017,18,16865,22029,8221,3601,50716,1073,1356,130,2559,53275
19-03-2017,19,16914,22729,8415,3449,51506,1083,1350,129,2562,54068
19-03-2017,20,16510,21477,8279,3494,49759,1081,1244,128,2453,52212
19-03-2017,21,15921,20470,8183,3552,48126,1085,993,102,2180,50306
19-03-2017,22,14774,19228,7954,3568,45524,1007,991,104,2102,47626
19-03-2017,23,13024,18502,7842,3405,42772,969,990,103,2062,44834
20-03-2017,0,11611,17855,7876,3207,40550,974,1183,110,2267,42817
20-03-2017,1,11731,17328,7877,3080,40016,1006,1182,112,2300,42316
20-03-2017,2,11828,17185,7880,2923,39817,1028,1191,115,2334,42151
20-03-2017,3,11604,17408,7939,2962,39882,1084,1191,127,2402,42284
20-03-2017,4,12208,17669,8200,2906,40985,1164,1192,135,2491,43476
20-03-2017,5,14395,19417,8650,2844,45306,1373,1289,144,2806,48112
20-03-2017,6,18879,22108,9150,3078,53216,1457,1370,137,2964,56180
20-03-2017,7,21793,23496,9533,3550,58372,1563,1366,344,3273,61645
20-03-2017,8,22357,24140,9432,3871,59800,1536,1364,366,3266,63066
20-03-2017,9,21920,23819,9197,3958,58894,1572,1361,372,3305,62199
20-03-2017,10,21621,23433,9024,3949,58027,1574,1361,357,3292,61319
20-03-2017,11,21279,23107,8845,4143,57373,1535,1357,260,3152,60525
20-03-2017,12,20811,22620,8788,4408,56626,1516,1355,209,3080,59706
20-03-2017,13,20269,22391,8675,4245,55579,1517,1353,225,3095,58674
20-03-2017,14,19394,22018,8692,4071,54174,1522,1359,392,3273,57447
20-03-2017,15,18683,21918,8656,4123,53379,1526,1359,287,3172,56551
20-03-2017,16,18126,22060,8739,4430,53356,1573,1356,391,3320,56676
20-03-2017,17,19277,22517,8962,5020,55778,1583,1357,336,3276,59054
20-03-2017,18,19576,22977,9197,5441,57191,1561,1363,179,3103,60294
20-03-2017,19,18147,23105,9282,5163,55698,1551,1363,170,3084,58782
20-03-2017,20,16788,22336,9162,4802,53089,1540,1365,175,3080,56169
20-03-2017,21,15245,20589,8872,4896,49602,1451,1367,131,2949,52551
20-03-2017,22,14223,19255,8373,4836,46686,1350,1368,129,2847,49533
20-03-2017,23,12540,18673,7964,4786,43961,1346,1348,167,2861,46822
21-03-2017,0,11911,17616,7831,4733,42092,1202,1190,188,2580,44672
21-03-2017,1,11637,17394,7743,4624,41399,1190,1191,243,2624,44023
21-03-2017,2,11314,17454,7694,4583,41045,1200,1197,296,2693,43738
21-03-2017,3,11202,17605,7688,4501,40995,1200,1200,325,2725,43720
21-03-2017,4,11438,17866,7883,4446,41634,1217,1215,315,2747,44381
21-03-2017,5,12809,19125,8389,4628,44952,1328,1388,343,3059,48011
21-03-2017,6,14954,21856,8738,4845,50393,1596,1391,445,3432,53825
21-03-2017,7,17437,23232,9018,5160,54848,1591,1403,501,3495,58343
21-03-2017,8,17754,23300,9037,5485,55577,1655,1394,485,3534,59111
21-03-2017,9,16553,23202,9108,5824,54687,1683,1452,457,3592,58279
21-03-2017,10,15561,22749,9122,6123,53555,1711,1463,654,3828,57383
21-03-2017,11,15336,22663,9079,6414,53491,1701,1461,565,3727,57218
21-03-2017,12,15034,22840,9036,6337,53246,1696,1459,460,3615,56861
21-03-2017,13,14898,22485,9052,6353,52789,1675,1458,442,3575,56364
21-03-2017,14,14639,22508,9018,6343,52509,1709,1454,422,3585,56094
21-03-2017,15,14447,22646,8936,6291,52321,1677,1452,402,3531,55852
21-03-2017,16,14429,22611,8925,6316,52280,1662,1442,347,3451,55731
21-03-2017,17,15884,22748,9116,6110,53859,1620,1396,275,3291,57150
21-03-2017,18,16944,22949,9347,6002,55243,1598,1390,245,3233,58476
21-03-2017,19,16990,22984,9257,5960,55193,1649,1395,252,3296,58489
21-03-2017,20,16203,22252,8945,5701,53102,1646,1395,241,3282,56384
21-03-2017,21,15948,20840,8738,5510,51035,1398,1399,220,3017,54052
21-03-2017,22,15381,19695,8416,5394,48886,1329,1390,197,2916,51802
21-03-2017,23,14180,18786,7985,5274,46225,1345,1288,232,2865,49090
22-03-2017,0,13360,17902,7763,5148,44175,1359,1131,211,2701,46876
22-03-2017,1,12662,17758,7716,5049,43185,1350,1129,220,2699,45884
22-03-2017,2,12459,17778,7668,4928,42834,1362,1123,188,2673,45507
22-03-2017,3,12637,17950,7708,4812,43107,1362,1121,204,2687,45794
22-03-2017,4,13461,18726,8007,4675,44869,1403,1129,221,2753,47622
22-03-2017,5,14431,20428,8293,4652,47802,1703,1220,232,3155,50957
22-03-2017,6,16939,22732,8618,4628,52917,1680,1309,295,3284,56201
22-03-2017,7,19918,23874,8905,4730,57426,1708,1394,319,3421,60847
22-03-2017,8,20510,24230,8879,4838,58458,1709,1407,339,3455,61913
22-03-2017,9,19730,24097,8884,4754,57464,1701,1403,377,3481,60945
22-03-2017,10,18802,23850,8862,4776,56289,1709,1401,534,3644,59933
22-03-2017,11,18123,23720,8715,4820,55378,1655,1399,522,3576,58954
22-03-2017,12,17648,23213,8710,4854,54426,1647,1398,479,3524,57950
22-03-2017,13,17415,23159,8922,4823,54319,1652,1396,410,3458,57777
22-03-2017,14,17312,23315,8956,4443,54026,1615,1454,398,3467,57493
22-03-2017,15,17250,23324,8921,4118,53613,1609,1454,369,3432,57045
22-03-2017,16,17681,23293,8982,3907,53863,1621,1453,325,3399,57262
22-03-2017,17,18603,23565,9231,3626,55025,1637,1444,299,3380,58405
22-03-2017,18,20087,23809,9297,3431,56625,1649,1388,278,3315,59940
22-03-2017,19,20388,23993,9272,3051,56704,1641,1387,283,3311,60015
22-03-2017,20,18835,23712,9167,2741,54455,1633,1386,281,3300,57755
22-03-2017,21,18017,22888,8970,2708,52583,1633,1295,296,3224,55807
22-03-2017,22,16951,21601,8691,2503,49746,1623,1278,290,3191,52937
22-03-2017,23,15448,20371,8470,2493,46782,1383,1115,291,2789,49571
23-03-2017,0,14872,18719,8284,2439,44316,1290,1116,287,2693,47009
23-03-2017,1,14176,18257,8271,2419,43123,1284,1122,301,2707,45830
23-03-2017,2,13796,18462,8363,2377,42998,1326,1121,269,2716,45714
23-03-2017,3,13899,18608,8544,2370,43421,1439,1117,222,2778,46199
23-03-2017,4,14537,19058,8694,2509,44798,1475,1115,180,2770,47568
23-03-2017,5,16330,20411,9028,2679,48449,1645,1112,197,2954,51403
23-03-2017,6,19586,22118,9154,3252,54111,1631,1356,377,3364,57475
23-03-2017,7,22078,23441,9499,3671,58688,1582,1374,343,3299,61987
23-03-2017,8,21981,23492,9612,3836,58920,1560,1368,319,3247,62167
23-03-2017,9,21442,22836,9386,3362,57027,1554,1418,334,3306,60333
23-03-2017,10,20885,22545,9314,3578,56321,1496,1421,330,3247,59568
23-03-2017,11,20081,22104,9242,3486,54913,1492,1422,278,3192,58105
23-03-2017,12,19282,21881,9068,3353,53584,1489,1399,149,3037,56621
23-03-2017,13,19217,21778,9009,3385,53388,1476,1364,146,2986,56374
23-03-2017,14,18721,21747,9004,3374,52847,1456,1352,145,2953,55800
23-03-2017,15,18965,21598,9121,3492,53176,1489,1351,126,2966,56142
23-03-2017,16,19259,21786,9089,3454,53588,1509,1346,138,2993,56581
23-03-2017,17,20020,22068,9207,3499,54795,1493,1345,331,3169,57964
23-03-2017,18,21172,22257,9429,3578,56435,1498,1345,333,3176,59611
23-03-2017,19,21451,22371,9461,3397,56681,1503,1347,331,3181,59862
23-03-2017,20,20260,21952,9380,3102,54694,1524,1256,344,3124,57818
23-03-2017,21,19530,21441,9348,2914,53234,1538,1252,351,3141,56375
23-03-2017,22,18201,20877,9420,2570,51067,1546,1173,131,2850,53917
23-03-2017,23,15950,20137,9194,2523,47805,1461,1089,113,2663,50468
24-03-2017,0,14504,18061,8937,2383,43885,1403,1092,65,2560,46445
24-03-2017,1,14365,17546,8699,2396,43006,1430,1092,47,2569,45575
24-03-2017,2,14599,17484,8621,2379,43084,1448,1093,45,2586,45670
24-03-2017,3,14112,17529,8711,2282,42635,1432,1085,44,2561,45196
24-03-2017,4,14687,17997,8838,2344,43866,1431,1090,75,2596,46462
24-03-2017,5,16975,19182,9014,2597,47766,1444,1282,136,2862,50628
24-03-2017,6,20709,21474,9150,3225,54560,1423,1397,332,3152,57712
24-03-2017,7,22435,22729,9316,3864,58345,1399,1407,366,3172,61517
24-03-2017,8,22430,22004,9401,4015,57850,1430,1401,335,3166,61016
24-03-2017,9,21990,21388,9276,4063,56716,1410,1337,346,3093,59809
24-03-2017,10,22152,21373,9105,4086,56715,1426,1343,396,3165,59880
24-03-2017,11,21585,21236,8949,4071,55842,1395,1338,265,2998,58840
24-03-2017,12,20851,21002,8768,3954,54574,1384,1328,273,2985,57559
24-03-2017,13,19646,20906,8785,3710,53047,1409,1332,264,3005,56052
24-03-2017,14,17765,20894,8824,3619,51102,1393,1324,305,3022,54124
24-03-2017,15,18247,21108,8760,3595,51710,1376,1374,272,3022,54732
24-03-2017,16,19116,21580,8951,3494,53140,1381,1377,230,2988,56128
24-03-2017,17,19812,22055,9008,3652,54527,1405,1377,205,2987,57514
24-03-2017,18,20636,22384,9260,3594,55874,1426,1375,217,3018,58892
24-03-2017,19,19596,22706,9298,3472,55072,1441,1329,219,2989,58061
24-03-2017,20,17658,22259,9055,3368,52341,1440,1251,207,2898,55239
24-03-2017,21,16847,21317,8823,3452,50441,1438,1160,189,2787,53228
24-03-2017,22,15834,20190,8577,3520,48123,1437,1091,156,2684,50807
24-03-2017,23,14747,19489,8304,3613,46154,1432,1082,134,2648,48802
25-03-2017,0,14360,18416,7733,3454,43962,1119,1034,131,2284,46246
25-03-2017,1,13468,18104,7578,3587,42736,1044,1027,145,2216,44952
25-03-2017,2,12716,18006,7469,3759,41950,1040,1030,131,2201,44151
25-03-2017,3,12349,18006,7423,3842,41619,1035,1025,135,2195,43814
25-03-2017,4,12259,17775,7378,3891,41302,1018,1022,175,2215,43517
25-03-2017,5,12678,17627,7442,3903,41650,1035,1024,195,2254,43904
25-03-2017,6,13303,18025,7580,3942,42851,1078,1123,222,2423,45274
25-03-2017,7,14967,18775,7713,4017,45471,1071,1170,358,2599,48070
25-03-2017,8,15588,19776,7726,4262,47353,1068,1166,335,2569,49922
25-03-2017,9,15086,19541,7659,4555,46841,1068,1170,338,2576,49417
25-03-2017,10,14067,18951,7629,4446,45094,1011,1171,344,2526,47620
25-03-2017,11,13691,18248,7421,4341,43702,977,1175,364,2516,46218
25-03-2017,12,13122,17973,7333,4167,42594,969,1181,352,2502,45096
25-03-2017,13,12405,17770,7291,4070,41536,975,1144,353,2472,44008
25-03-2017,14,11978,17386,7256,3884,40506,982,1147,356,2485,42991
25-03-2017,15,12286,17332,7330,3691,40641,977,1145,381,2503,43144
25-03-2017,16,13009,17760,7459,3507,41737,988,1141,406,2535,44272
25-03-2017,17,15187,18818,7768,3488,45263,1043,1133,374,2550,47813
25-03-2017,18,18295,19721,8241,3864,50122,1043,1131,369,2543,52665
25-03-2017,19,18752,20082,8487,3736,51057,1065,1177,334,2576,53633
25-03-2017,20,17596,19814,8545,3295,49251,1078,1170,304,2552,51803
25-03-2017,21,16637,19540,8543,3231,47951,1052,1040,284,2376,50327
25-03-2017,22,15723,19042,8394,3079,46239,1047,1034,262,2343,48582
25-03-2017,23,13967,17824,8192,2825,42808,986,1035,218,2239,45047
26-03-2017,0,13110,16072,8212,2379,39774,1020,1002,0,2022,41796
26-03-2017,1,11634,15670,7919,2258,37481,972,998,167,2137,39618
26-03-2017,2,,,,,,1040,,,,
26-03-2017,3,11226,15646,8012,2209,37093,968,996,154,2118,39211
26-03-2017,4,10964,15623,8119,2154,36861,988,997,133,2118,38979
26-03-2017,5,10723,15633,8056,2025,36435,993,997,117,2107,38542
26-03-2017,6,11498,15985,8077,2095,37656,1012,1002,110,2124,39780
26-03-2017,7,11974,16490,8184,2048,38696,1019,1092,109,2220,40916
26-03-2017,8,12987,16972,8406,2085,40450,1057,1111,108,2276,42726
26-03-2017,9,13974,17876,8460,2173,42484,1170,1129,107,2406,44890
26-03-2017,10,13523,18208,8535,2239,42504,1161,1138,116,2415,44919
26-03-2017,11,13308,17939,8246,2369,41863,1170,1146,104,2420,44283
26-03-2017,12,12698,17439,8156,2387,40681,1180,1158,124,2462,43143
26-03-2017,13,12310,17002,7921,2458,39691,1201,1164,167,2532,42223
26-03-2017,14,12047,17001,7746,2471,39266,1192,1162,229,2583,41849
26-03-2017,15,11408,17017,7730,2425,38580,1201,1164,233,2598,41178
26-03-2017,16,11407,16863,7788,2396,38455,1185,1162,277,2624,41079
26-03-2017,17,12693,17166,7844,2343,40045,1186,1155,398,2739,42784
26-03-2017,18,14414,18806,8078,2545,43844,1260,1139,431,2830,46674
26-03-2017,19,16020,19393,8289,3283,46986,1252,1141,456,2849,49835
26-03-2017,20,16848,19667,8438,2826,47779,1235,1127,456,2818,50597
26-03-2017,21,16654,19158,8293,2502,46608,1245,1141,400,2786,49394
26-03-2017,22,16061,18459,7992,2543,45054,1175,1048,407,2630,47684
26-03-2017,23,14713,17131,7756,2473,42073,1141,1041,404,2586,44659
27-03-2017,0,13143,16176,7646,2628,39593,1126,1044,315,2485,42078
27-03-2017,1,11700,15862,7545,2572,37679,1138,1039,279,2456,40135
27-03-2017,2,11641,15610,7580,2500,37331,1152,1039,249,2440,39771
27-03-2017,3,11590,15553,7591,2208,36943,1209,1037,236,2482,39425
27-03-2017,4,12804,15984,7749,2282,38820,1245,1034,211,2490,41310
27-03-2017,5,15168,17564,8139,2585,43456,1395,1209,228,2832,46288
27-03-2017,6,18409,19811,8433,2834,49487,1417,1274,230,2921,52408
27-03-2017,7,20722,21212,8672,3369,53976,1426,1297,416,3139,57115
27-03-2017,8,20827,21714,8723,3746,55010,1450,1297,364,3111,58121
27-03-2017,9,20644,21671,8651,3891,54858,1478,1289,339,3106,57964
27-03-2017,10,19982,21923,8487,4008,54401,1453,1265,346,3064,57465
27-03-2017,11,19454,21876,8157,4006,53491,1437,1267,226,2930,56421
27-03-2017,12,18658,21471,7981,3649,51759,1452,1272,283,3007,54766
27-03-2017,13,17583,20872,8039,3598,50090,1427,1280,303,3010,53100
27-03-2017,14,16027,20947,8051,3656,48682,1435,1232,289,2956,51638
27-03-2017,15,15798,21034,8244,3849,48925,1514,1229,309,3052,51977
27-03-2017,16,16078,21067,8120,3675,48939,1541,1246,305,3092,52031
27-03-2017,17,17501,21308,8091,3647,50546,1512,1278,325,3115,53661
27-03-2017,18,18081,21439,7944,3449,50912,1529,1257,301,3087,53999
27-03-2017,19,18743,21309,8055,3405,51513,1525,1248,353,3126,54639
27-03-2017,20,18452,21359,8115,3273,51196,1554,1268,368,3190,54386
27-03-2017,21,17893,20299,8067,3109,49368,1547,1156,369,3072,52440
27-03-2017,22,16902,19165,8080,2887,47033,1540,1026,323,2889,49922
27-03-2017,23,15179,17886,8016,2728,43810,1512,1046,278,2836,46646
28-03-2017,0,13994,16368,7731,2574,40669,1369,1067,255,2691,43360
28-03-2017,1,13081,16123,7586,2383,39173,1280,1069,180,2529,41702
28-03-2017,2,13010,15982,7539,2296,38829,1353,1078,153,2584,41413
28-03-2017,3,12849,15798,7655,2219,38521,1384,1069,146,2599,41120
28-03-2017,4,13336,15764,7930,2302,39333,1405,1070,163,2638,41971
28-03-2017,5,14963,17226,8322,2428,42939,1447,1102,252,2801,45740
28-03-2017,6,18808,19807,8812,2898,50326,1500,1236,234,2970,53296
28-03-2017,7,19698,21643,9140,3812,54291,1583,1384,413,3380,57671
28-03-2017,8,19783,21468,9166,3988,54404,1599,1632,377,3608,58012
28-03-2017,9,19412,20948,8993,3677,53029,1707,1619,355,3681,56710
28-03-2017,10,19202,20487,8916,3579,52184,1626,1621,349,3596,55780
28-03-2017,11,19200,20128,8744,3557,51628,1656,1604,378,3638,55266
28-03-2017,12,18688,19673,8554,2994,49910,1620,1616,211,3447,53357
28-03-2017,13,18018,18970,8481,2866,48336,1615,1625,221,3461,51797
28-03-2017,14,17421,18513,8436,2832,47203,1574,1594,237,3405,50608
28-03-2017,15,17424,18413,8389,2735,46963,1501,1605,206,3312,50275
28-03-2017,16,17338,18430,8468,2595,46832,1543,1535,215,3293,50125
28-03-2017,17,18507,18997,8574,2696,48774,1531,1519,199,3249,52023
28-03-2017,18,19049,19377,8824,3146,50395,1653,1528,314,3495,53890
28-03-2017,19,19072,19871,9145,3129,51217,1648,1664,376,3688,54905
28-03-2017,20,19144,20077,9128,3394,51741,1621,1671,203,3495,55236
28-03-2017,21,19094,18825,8909,3132,49960,1546,1402,186,3134,53094
28-03-2017,22,18445,17729,8506,2568,47247,1531,1419,185,3135,50382
28-03-2017,23,15097,16518,8139,2432,42187,1375,1543,164,3082,45269
29-03-2017,0,13707,15101,7886,2407,39102,1215,1162,116,2493,41595
29-03-2017,1,13056,14849,7802,2260,37966,1177,1153,118,2448,40414
29-03-2017,2,12358,14808,7669,2281,37116,1109,1151,117,2377,39493
29-03-2017,3,12003,14809,7579,2361,36752,1074,1152,132,2358,39110
29-03-2017,4,12682,14946,7582,2383,37593,1193,1153,150,2496,40089
29-03-2017,5,15543,15838,7884,2583,41849,1347,1158,178,2683,44532
29-03-2017,6,18826,18293,8437,3366,48922,1342,1295,195,2832,51754
29-03-2017,7,20093,20226,8709,3980,53006,1400,1302,402,3104,56110
29-03-2017,8,20567,20784,8730,4195,54278,1420,1298,351,3069,57347
29-03-2017,9,20500,20679,8726,3810,53714,1425,1349,350,3124,56838
29-03-2017,10,20446,20573,8505,4053,53576,1433,1354,345,3132,56708
29-03-2017,11,19772,20490,8373,4113,52750,1441,1345,156,2942,55692
29-03-2017,12,19282,19927,8066,3970,51246,1451,1342,150,2943,54189
29-03-2017,13,19045,19511,8170,4022,50749,1450,1343,147,2940,53689
29-03-2017,14,18990,19222,8195,3847,50256,1444,1329,160,2933,53189
29-03-2017,15,18900,19252,8196,3825,50173,1448,1328,157,2933,53106
29-03-2017,16,19200,19304,8125,3632,50260,1428,1288,171,2887,53147
29-03-2017,17,19458,19459,8283,3748,50948,1420,1288,192,2900,53848
29-03-2017,18,19671,19990,8605,3920,52187,1422,1290,205,2917,55104
29-03-2017,19,19771,20526,8768,3879,52944,1435,1293,370,3098,56042
29-03-2017,20,20123,20235,8904,3837,53098,1446,1288,355,3089,56187
29-03-2017,21,19714,19058,8816,3382,50969,1447,1288,224,2959,53928
29-03-2017,22,19326,17739,8718,2994,48778,1443,1278,125,2846,51624
29-03-2017,23,18594,16444,8139,2221,45397,1462,1166,73,2701,48098
30-03-2017,0,17822,15317,7870,2026,43034,1385,1292,76,2753,45787
30-03-2017,1,15788,15297,7697,1974,40758,1311,1298,123,2732,43490
30-03-2017,2,14978,15042,7631,1947,39597,1281,1310,117,2708,42305
30-03-2017,3,14785,15023,7647,1956,39411,1284,1289,143,2716,42127
30-03-2017,4,15100,15136,7709,2138,40082,1325,1329,157,2811,42893
30-03-2017,5,17114,16268,7935,2500,43817,1559,1446,137,3142,46959
30-03-2017,6,19556,19522,8591,3464,51132,1624,1426,217,3267,54399
30-03-2017,7,20526,20294,8902,4042,53764,1625,1435,318,3378,57142
30-03-2017,8,20687,20490,8945,4530,54652,1637,1434,311,3382,58034
30-03-2017,9,20511,20585,8841,4694,54632,1618,1432,311,3361,57993
30-03-2017,10,20369,20570,8722,4743,54403,1616,1430,271,3317,57720
30-03-2017,11,20163,20414,8511,4642,53731,1542,1420,35,2997,56728
30-03-2017,12,20256,20017,8487,4640,53401,1400,1416,42,2858,56259
30-03-2017,13,19672,19721,8283,4736,52413,1430,1419,82,2931,55344
30-03-2017,14,19058,19387,8308,4539,51293,1397,1419,87,2903,54196
30-03-2017,15,18401,19248,8271,4579,50498,1437,1420,123,2980,53478
30-03-2017,16,18457,19449,8157,4669,50733,1494,1418,143,3055,53788
30-03-2017,17,19635,20164,8275,4439,52513,1502,1400,126,3028,55541
30-03-2017,18,19667,20760,8581,4358,53367,1591,1402,161,3154,56521
30-03-2017,19,19639,20969,8774,4197,53579,1660,1431,377,3468,57047
30-03-2017,20,19819,20529,8747,4106,53200,1629,1422,188,3239,56439
30-03-2017,21,19557,19467,8479,3958,51461,1625,1422,206,3253,54714
30-03-2017,22,18338,18489,8117,3808,48752,1624,1418,272,3314,52066
30-03-2017,23,16214,17517,7841,3443,45014,1409,1286,312,3007,48021
31-03-2017,0,14409,16002,7526,3237,41175,1273,1069,295,2637,43812
31-03-2017,1,13655,15513,7369,2911,39448,1282,1076,314,2672,42120
31-03-2017,2,12840,15614,7263,2732,38449,1307,1069,300,2676,41125
31-03-2017,3,12749,15521,7255,2733,38258,1295,1072,317,2684,40942
31-03-2017,4,12979,15354,7346,2773,38452,1292,1075,350,2717,41169
31-03-2017,5,15280,16462,7467,2854,42064,1473,1075,409,2957,45021
31-03-2017,6,18740,19558,8012,3413,49724,1617,1143,485,3245,52969
31-03-2017,7,20643,20780,8571,3804,53796,1592,1229,504,3325,57121
31-03-2017,8,20865,21013,8851,4310,55039,1604,1288,515,3407,58446
31-03-2017,9,20877,20733,8718,4302,54630,1605,1287,486,3378,58008
31-03-2017,10,20858,20669,8573,3982,54082,1620,1275,258,3153,57235
31-03-2017,11,20408,20316,8325,3970,53018,1640,1276,266,3182,56200
31-03-2017,12,19815,19877,8068,3574,51333,1649,1272,340,3261,54594
31-03-2017,13,19252,19356,7953,3515,50076,1641,1269,190,3100,53176
31-03-2017,14,18621,18850,7929,3610,49010,1639,1183,163,2985,51995
31-03-2017,15,17796,18650,7823,3815,48085,1637,1183,137,2957,51042
31-03-2017,16,17851,18759,7732,3966,48308,1641,1183,122,2946,51254
31-03-2017,17,19124,19128,8089,3965,50307,1644,1185,114,2943,53250
31-03-2017,18,19560,20227,8345,4162,52294,1660,1188,109,2957,55251
31-03-2017,19,19709,20548,8501,4139,52897,1605,1191,108,2904,55801
31-03-2017,20,19410,20267,8033,3943,51655,1619,1178,106,2903,54558
31-03-2017,21,18730,19424,7859,3410,49423,1621,1098,96,2815,52238
31-03-2017,22,18064,18782,7592,3029,47467,1616,1058,57,2731,50198
31-03-2017,23,16892,18043,7404,2673,45011,1377,1051,69,2497,47508
01-04-2017,0,15694,17012,7423,2358,42488,1073,933,109,2115,44603
01-04-2017,1,14649,16887,7425,2472,41432,1045,976,136,2157,43589
01-04-2017,2,13943,16691,7345,2374,40355,1029,976,175,2180,42535
01-04-2017,3,13560,16548,7302,2186,39596,1026,977,189,2192,41788
01-04-2017,4,13717,16433,7445,2138,39733,1056,971,196,2223,41956
01-04-2017,5,14329,16646,7544,2071,40591,1111,971,214,2296,42887
01-04-2017,6,14725,17329,7435,2367,41858,1107,962,244,2313,44171
01-04-2017,7,14688,18337,7568,2695,43287,1122,986,234,2342,45629
01-04-2017,8,16425,18941,7670,2888,45924,1287,954,199,2440,48364
01-04-2017,9,17838,19181,7739,2958,47718,1298,948,164,2410,50128
01-04-2017,10,17193,19479,7692,2723,47086,1335,932,149,2416,49502
01-04-2017,11,16373,19324,7544,2760,46003,1359,934,154,2447,48450
01-04-2017,12,14984,18915,7472,2861,44232,1340,881,172,2393,46625
01-04-2017,13,14793,18574,7394,2933,43695,1379,843,211,2433,46128
01-04-2017,14,14299,18164,7239,2821,42523,1332,840,210,2382,44905
01-04-2017,15,13922,17991,7232,2736,41880,1326,842,150,2318,44198
01-04-2017,16,14487,18466,7321,2575,42849,1311,995,211,2517,45366
01-04-2017,17,16000,19021,7384,2490,44895,1264,1007,183,2454,47349
01-04-2017,18,17235,19110,7297,2787,46429,1325,1089,154,2568,48997
01-04-2017,19,17635,19068,7345,2929,46977,1319,1068,144,2531,49508
01-04-2017,20,17473,19057,7297,2893,46720,1360,1065,138,2563,49283
01-04-2017,21,17200,18890,7338,2739,46165,1364,1075,136,2575,48740
01-04-2017,22,16433,18675,7195,2460,44763,1291,1015,100,2406,47169
01-04-2017,23,15626,17869,6955,2305,42755,1235,1001,89,2325,45080
02-04-2017,0,15255,16688,6971,2018,40932,1133,755,63,1951,42883
02-04-2017,1,14456,16227,6877,1737,39297,1106,752,61,1919,41216
02-04-2017,2,13716,15965,6821,1702,38205,1100,750,60,1910,40115
02-04-2017,3,13189,15888,6770,1651,37498,1087,749,57,1893,39391
02-04-2017,4,12973,15848,6768,1627,37215,1075,749,52,1876,39091
02-04-2017,5,12640,15843,6915,1695,37092,1075,747,52,1874,38966
02-04-2017,6,12852,16135,6875,1700,37562,1057,831,52,1940,39502
02-04-2017,7,13580,16458,6869,1757,38664,1040,835,95,1970,40634
02-04-2017,8,15801,17144,6978,1950,41873,1194,819,95,2108,43981
02-04-2017,9,17350,17466,7146,2173,44136,1225,891,66,2182,46318
02-04-2017,10,17404,17638,7168,2376,44586,1227,894,96,2217,46803
02-04-2017,11,16071,17526,7212,2452,43261,1209,892,96,2197,45458
02-04-2017,12,14408,16690,7077,2490,40666,1071,890,95,2056,42722
02-04-2017,13,13686,16306,6966,2422,39380,1055,889,96,2040,41420
02-04-2017,14,13396,16334,6883,2485,39100,1054,919,97,2070,41170
02-04-2017,15,13120,16591,6866,2539,39116,1051,925,60,2036,41152
02-04-2017,16,12992,16611,6891,2476,38971,1057,927,75,2059,41030
02-04-2017,17,14720,17317,7011,2658,41707,1096,945,83,2124,43831
02-04-2017,18,16894,18158,7286,2730,45068,1213,1001,189,2403,47471
02-04-2017,19,17963,18506,7423,2851,46742,1245,1091,239,2575,49317
02-04-2017,20,18923,18443,7505,2801,47672,1214,1040,258,2512,50184
02-04-2017,21,18287,18339,7440,2837,46905,1226,975,265,2466,49371
02-04-2017,22,17068,17814,7238,2816,44936,1219,938,164,2321,47257
02-04-2017,23,15505,16987,7084,2750,42327,1113,881,116,2110,44437
03-04-2017,0,15539,15381,6984,2430,40333,1160,925,137,2222,42555
03-04-2017,1,15205,15085,6938,2388,39616,1176,922,148,2246,41862
03-04-2017,2,15065,15072,6944,2410,39491,1217,920,156,2293,41784
03-04-2017,3,15103,15079,6998,2383,39562,1190,964,144,2298,41860
03-04-2017,4,15406,15337,7085,2358,40187,1297,965,110,2372,42559
03-04-2017,5,17579,16868,7328,2448,44223,1454,1002,97,2553,46776
03-04-2017,6,19453,19613,7882,2953,49901,1514,1084,150,2748,52649
03-04-2017,7,20392,21249,8275,3315,53231,1533,1257,319,3109,56340
03-04-2017,8,20815,21353,8291,4015,54474,1515,1253,322,3090,57564
03-04-2017,9,20953,21461,8323,3969,54706,1511,1293,323,3127,57833
03-04-2017,10,20461,21455,8296,4114,54327,1543,1388,321,3252,57579
03-04-2017,11,20026,21076,8312,4083,53498,1542,1346,321,3209,56707
03-04-2017,12,19788,20848,8202,3808,52646,1551,1276,322,3149,55795
03-04-2017,13,19791,20546,8044,3523,51905,1552,1281,128,2961,54866
03-04-2017,14,19425,20339,7879,3059,50702,1546,1286,131,2963,53665
03-04-2017,15,19229,20243,7918,2815,50206,1556,1283,146,2985,53191
03-04-2017,16,18954,20408,7946,2667,49975,1526,1283,159,2968,52943
03-04-2017,17,18894,20368,8045,2984,50289,1516,1367,149,3032,53321
03-04-2017,18,18975,20528,8138,2972,50613,1523,1364,144,3031,53644
03-04-2017,19,19431,20721,8322,3042,51516,1520,1363,248,3131,54647
03-04-2017,20,19352,20616,8403,2971,51341,1544,1360,169,3073,54414
03-04-2017,21,18646,19958,8234,2866,49705,1535,1165,140,2840,52545
03-04-2017,22,17662,18946,8028,2603,47238,1536,1105,127,2768,50006
03-04-2017,23,16230,18332,7873,2062,44496,1469,1071,149,2689,47185
04-04-2017,0,15285,17391,7732,1830,42237,1225,915,142,2282,44519
04-04-2017,1,14902,16945,7500,1767,41113,1164,904,124,2192,43305
04-04-2017,2,14958,16932,7463,1869,41221,1173,894,110,2177,43398
04-04-2017,3,14924,16956,7482,1895,41258,1175,891,110,2176,43434
04-04-2017,4,15301,17218,7596,2069,42184,1215,900,112,2227,44411
04-04-2017,5,16644,18290,7846,2277,45058,1361,999,92,2452,47510
04-04-2017,6,18552,20097,8140,2824,49612,1563,1177,113,2853,52465
04-04-2017,7,19750,21860,8377,2833,52820,1556,1330,310,3196,56016
04-04-2017,8,20077,22000,8372,3015,53466,1528,1500,305,3333,56799
04-04-2017,9,19938,21942,8338,2820,53038,1542,1496,312,3350,56388
04-04-2017,10,19865,21670,8223,2823,52579,1545,1488,307,3340,55919
04-04-2017,11,19204,21575,8101,3062,51942,1580,1257,306,3143,55085
04-04-2017,12,18571,21657,8106,3209,51543,1599,1302,227,3128,54671
04-04-2017,13,18184,21568,8077,3305,51134,1602,1198,105,2905,54039
04-04-2017,14,17263,21494,8010,3279,50047,1446,1187,95,2728,52775
04-04-2017,15,17008,21302,7901,3354,49566,1352,1188,96,2636,52202
04-04-2017,16,17033,21432,7922,3179,49567,1411,1178,96,2685,52252
04-04-2017,17,17490,21219,7912,3638,50260,1609,1205,95,2909,53169
04-04-2017,18,18011,21257,7865,3330,50463,1630,1165,95,2890,53353
04-04-2017,19,18543,21215,7953,3160,50870,1650,1182,127,2959,53829
04-04-2017,20,18619,21236,7940,3119,50915,1676,1174,115,2965,53880
04-04-2017,21,17985,20888,7797,2902,49573,1701,1019,133,2853,52426
04-04-2017,22,16975,20210,7695,2636,47518,1525,995,94,2614,50132
04-04-2017,23,15993,19192,7297,2418,44899,1394,887,97,2378,47277
05-04-2017,0,15573,17702,7100,2310,42687,1228,763,75,2066,44753
05-04-2017,1,14936,17441,7047,2280,41704,1202,762,73,2037,43741
05-04-2017,2,14502,17510,7049,2292,41354,1178,765,73,2016,43370
05-04-2017,3,14218,17532,7119,2452,41322,1190,767,66,2023,43345
05-04-2017,4,14095,17900,7231,2788,42015,1201,781,62,2044,44059
05-04-2017,5,14900,19348,7320,2981,44550,1267,852,85,2204,46754
05-04-2017,6,17335,21262,7579,3680,49855,1356,919,120,2395,52250
05-04-2017,7,18764,22345,8020,3878,53009,1342,1247,325,2914,55923
05-04-2017,8,19359,22589,8202,4271,54421,1362,1247,333,2942,57363
05-04-2017,9,18679,22482,8067,4407,53634,1393,1255,352,3000,56634
05-04-2017,10,17876,22151,8019,5001,53046,1399,1163,348,2910,55956
05-04-2017,11,17264,21522,8035,5417,52237,1388,1144,180,2712,54949
05-04-2017,12,16716,21297,7810,5443,51268,1394,1044,390,2828,54096
05-04-2017,13,16334,21109,7683,5488,50615,1391,1039,260,2690,53305
05-04-2017,14,15693,21020,7258,5734,49706,1393,968,196,2557,52263
05-04-2017,15,15665,20632,7091,5653,49041,1380,976,202,2558,51599
05-04-2017,16,15666,20973,7376,5464,49479,1356,971,191,2518,51997
05-04-2017,17,15841,20880,7329,5353,49402,1312,1023,347,2682,52084
05-04-2017,18,16055,20732,7508,5154,49448,1293,1019,357,2669,52117
05-04-2017,19,16171,20808,7550,5117,49646,1288,954,412,2654,52300
05-04-2017,20,16333,21050,7174,4959,49515,1293,961,232,2486,52001
05-04-2017,21,15797,20851,6865,4725,48239,1290,873,192,2355,50594
05-04-2017,22,14113,20034,6724,4413,45283,1275,817,164,2256,47539
05-04-2017,23,13022,18864,6642,3944,42474,1133,760,162,2055,44529
06-04-2017,0,12779,17894,6719,3961,41352,1094,845,152,2091,43443
06-04-2017,1,12556,17523,6682,3788,40550,1066,852,126,2044,42594
06-04-2017,2,12661,17366,6680,3587,40293,1065,853,103,2021,42314
06-04-2017,3,12991,17348,6691,3361,40391,1059,855,78,1992,42383
06-04-2017,4,13507,17925,6846,3123,41402,1098,858,66,2022,43424
06-04-2017,5,14480,19738,7210,3006,44432,1230,948,59,2237,46669
06-04-2017,6,17976,21573,7612,3031,50192,1257,1062,58,2377,52569
06-04-2017,7,20007,22493,7934,3431,53865,1238,1240,322,2800,56665
06-04-2017,8,20627,22430,7925,3785,54767,1228,1322,332,2882,57649
06-04-2017,9,20284,22071,7857,3787,53998,1242,1324,354,2920,56918
06-04-2017,10,19766,21725,7832,3882,53206,1253,1319,360,2932,56138
06-04-2017,11,18736,21079,7567,4271,51652,1247,1177,368,2792,54444
06-04-2017,12,18445,20517,7685,4471,51118,1252,1070,391,2713,53831
06-04-2017,13,18117,20501,7589,4724,50931,1250,1059,425,2734,53665
06-04-2017,14,17865,20749,7311,4798,50724,1253,975,222,2450,53174
06-04-2017,15,17346,20573,7482,5008,50407,1275,969,254,2498,52905
06-04-2017,16,16774,20356,7523,5252,49906,1295,986,251,2532,52438
06-04-2017,17,17250,20283,7491,5035,50060,1376,978,269,2623,52683
06-04-2017,18,16918,20472,7643,4931,49965,1447,966,222,2635,52600
06-04-2017,19,17189,20271,7694,4956,50110,1469,950,418,2837,52947
06-04-2017,20,17280,20149,7375,5041,49846,1464,957,230,2651,52497
06-04-2017,21,16734,19292,7126,4938,48089,1396,974,199,2569,50658
06-04-2017,22,15800,18158,6937,4781,45676,1209,984,94,2287,47963
06-04-2017,23,14453,17584,6663,4616,43316,1117,875,70,2062,45378
07-04-2017,0,13179,16289,6481,4582,40531,1116,862,58,2036,42567
07-04-2017,1,12645,15876,6409,4507,39439,1124,859,63,2046,41485
07-04-2017,2,12332,15727,6402,4445,38908,1116,847,43,2006,40914
07-04-2017,3,12571,15564,6386,4334,38855,1092,846,40,1978,40833
07-04-2017,4,12888,15774,6518,4406,39585,1102,853,79,2034,41619
07-04-2017,5,14425,17428,6890,4529,43273,1283,950,109,2342,45615
07-04-2017,6,16638,19346,7503,4661,48148,1444,1035,46,2525,50673
07-04-2017,7,18651,20888,7933,4865,52338,1443,1129,325,2897,55235
07-04-2017,8,19229,21233,7989,4790,53240,1443,1308,317,3068,56308
07-04-2017,9,19080,20863,7975,4801,52720,1441,1317,322,3080,55800
07-04-2017,10,18530,20652,7910,4988,52080,1453,1315,332,3100,55180
07-04-2017,11,17738,20176,7844,5196,50954,1458,1220,324,3002,53956
07-04-2017,12,17124,19685,7948,5236,49992,1464,1058,353,2875,52867
07-04-2017,13,16777,19385,7797,5158,49117,1473,1046,339,2858,51975
07-04-2017,14,16029,19058,7426,5009,47522,1451,959,148,2558,50080
07-04-2017,15,16073,18639,7441,5000,47154,1408,960,143,2511,49665
07-04-2017,16,16091,18830,7656,4803,47380,1438,951,215,2604,49984
07-04-2017,17,16336,18825,7816,4630,47607,1439,952,143,2534,50141
07-04-2017,18,16677,19077,7825,4342,47920,1442,957,145,2544,50464
07-04-2017,19,16998,19114,7836,4248,48198,1447,965,185,2597,50795
07-04-2017,20,17515,18952,7421,4120,48008,1352,971,151,2474,50482
07-04-2017,21,16998,18413,7280,3980,46672,1097,957,156,2210,48882
07-04-2017,22,16010,17846,7089,3855,44802,1044,950,159,2153,46955
07-04-2017,23,14949,17452,6959,3634,42994,950,889,172,2011,45005
08-04-2017,0,15086,15644,6995,3237,40962,952,769,154,1875,42837
08-04-2017,1,14688,15114,7015,2942,39759,974,735,192,1901,41660
08-04-2017,2,14831,14988,6934,2805,39558,965,738,155,1858,41416
08-04-2017,3,14972,15039,7027,2723,39761,971,735,204,1910,41671
08-04-2017,4,15365,15022,7087,2671,40144,945,734,212,1891,42035
08-04-2017,5,15787,15175,7158,2805,40924,909,734,233,1876,42800
08-04-2017,6,16324,15552,7134,2805,41815,891,908,229,2028,43843
08-04-2017,7,17627,16476,6956,2798,43857,966,930,234,2130,45987
08-04-2017,8,18141,18073,7034,2842,46090,963,1102,178,2243,48333
08-04-2017,9,18873,18466,7181,3002,47522,963,1188,150,2301,49823
08-04-2017,10,19004,18301,7155,3237,47698,951,1187,170,2308,50006
08-04-2017,11,18559,18299,7043,3376,47276,947,1148,144,2239,49515
08-04-2017,12,17969,18164,6889,3445,46467,969,1013,124,2106,48573
08-04-2017,13,17202,18483,6883,3411,45980,965,923,129,2017,47997
08-04-2017,14,16208,18598,6734,3396,44936,949,825,136,1910,46846
08-04-2017,15,15336,18198,6637,3373,43545,975,822,137,1934,45479
08-04-2017,16,16174,18507,6756,3248,44685,968,828,134,1930,46615
08-04-2017,17,17033,19054,6898,3133,46118,1028,875,131,2034,48152
08-04-2017,18,17183,19805,7065,2989,47043,982,873,129,1984,49027
08-04-2017,19,17333,19658,7122,2773,46885,992,889,129,2010,48895
08-04-2017,20,17692,19617,7163,2595,47067,910,908,133,1951,49018
08-04-2017,21,17672,19262,7009,2442,46386,899,842,134,1875,48261
08-04-2017,22,17050,18687,6971,2159,44867,905,855,143,1903,46770
08-04-2017,23,16222,17925,6810,2085,43045,879,868,162,1909,44954
09-04-2017,0,14811,17224,6564,2184,40783,880,686,169,1735,42518
09-04-2017,1,14220,16927,6494,2294,39936,878,672,169,1719,41655
09-04-2017,2,14059,16860,6550,2295,39763,863,679,176,1718,41481
09-04-2017,3,13681,16841,6599,2362,39483,845,676,149,1670,41153
09-04-2017,4,13725,16786,6634,2389,39535,856,673,195,1724,41259
09-04-2017,5,13354,16915,6704,2508,39481,869,672,211,1752,41233
09-04-2017,6,13247,17561,6656,2507,39972,863,673,256,1792,41764
09-04-2017,7,14259,17928,6663,2506,41357,882,758,275,1915,43272
09-04-2017,8,15371,18617,6857,2519,43363,893,769,333,1995,45358
09-04-2017,9,15546,19498,6944,2418,44405,893,757,391,2041,46446
09-04-2017,10,14425,19187,6720,2576,42909,904,784,338,2026,44935
09-04-2017,11,13043,18537,6585,2870,41035,913,834,300,2047,43082
09-04-2017,12,12897,18060,6463,3102,40522,820,852,275,1947,42469
09-04-2017,13,11575,17782,6310,3202,38869,820,856,314,1990,40859
09-04-2017,14,10762,17650,6341,3379,38131,880,851,325,2056,40187
09-04-2017,15,10333,17693,6426,3379,37831,924,856,313,2093,39924
09-04-2017,16,10499,17858,6460,3423,38240,916,925,265,2106,40346
09-04-2017,17,12368,18036,6756,3428,40590,896,948,298,2142,42732
09-04-2017,18,14459,19221,6934,3747,44361,887,1203,294,2384,46745
09-04-2017,19,15258,19826,7212,3337,45632,908,1201,235,2344,47976
09-04-2017,20,15315,20231,7293,3285,46124,932,1184,190,2306,48430
09-04-2017,21,14736,20036,7427,3403,45603,923,1129,212,2264,47867
09-04-2017,22,13745,19463,7206,3357,43770,943,891,197,2031,45801
09-04-2017,23,12729,18210,6790,3479,41210,914,890,211,2015,43225
10-04-2017,0,11528,17179,6464,3596,38767,913,731,215,1859,40626
10-04-2017,1,10795,16784,6322,3742,37642,920,725,197,1842,39484
10-04-2017,2,10149,16568,6377,3699,36793,924,727,181,1832,38625
10-04-2017,3,10072,16626,6443,3664,36805,934,737,172,1843,38648
10-04-2017,4,10174,16984,6421,3920,37500,973,890,181,2044,39544
10-04-2017,5,11867,18750,6655,4347,41619,1009,1031,193,2233,43852
10-04-2017,6,14176,20303,7270,4700,46448,1055,1149,222,2426,48874
10-04-2017,7,16189,21387,7642,4748,49967,1081,1222,418,2721,52688
10-04-2017,8,16866,21781,7816,5009,51473,1090,1229,416,2735,54208
10-04-2017,9,16372,21925,7848,5206,51351,1103,1189,445,2737,54088
10-04-2017,10,16146,21621,7818,5357,50942,1147,1201,506,2854,53796
10-04-2017,11,15730,21307,7555,5674,50266,1144,1181,475,2800,53066
10-04-2017,12,14546,20843,7397,5541,48328,1130,1227,398,2755,51083
10-04-2017,13,13952,20818,7362,5296,47429,1087,1161,449,2697,50126
10-04-2017,14,13455,20741,6803,5220,46218,1029,1144,463,2636,48854
10-04-2017,15,13210,20814,6779,5101,45904,1009,1142,582,2733,48637
10-04-2017,16,13051,20796,6882,5325,46055,1006,1142,648,2796,48851
10-04-2017,17,13914,21079,6922,5778,47694,1028,1144,563,2735,50429
10-04-2017,18,14439,21236,7054,5608,48337,1032,1139,533,2704,51041
10-04-2017,19,14687,21208,7207,5358,48461,1061,1130,629,2820,51281
10-04-2017,20,14691,21132,7027,5180,48030,999,1128,594,2721,50751
10-04-2017,21,13943,21027,6870,5169,47008,935,1124,574,2633,49641
10-04-2017,22,12643,20626,6800,5064,45132,868,939,344,2151,47283
10-04-2017,23,12135,19456,6735,4975,43300,866,797,291,1954,45254
11-04-2017,0,11880,18211,6775,4874,41740,850,879,283,2012,43752
11-04-2017,1,11782,18450,6819,4856,41906,857,869,290,2016,43922
11-04-2017,2,11491,18573,6887,4794,41746,873,923,279,2075,43821
11-04-2017,3,11376,18609,6979,4735,41698,873,916,302,2091,43789
11-04-2017,4,11400,19264,6975,4796,42435,898,916,329,2143,44578
11-04-2017,5,12053,20530,7204,4812,44599,898,912,360,2170,46769
11-04-2017,6,13784,21977,7595,4736,48092,952,1015,422,2389,50481
11-04-2017,7,15796,23147,7982,4712,51638,929,1069,422,2420,54058
11-04-2017,8,15888,23625,7932,4906,52352,953,1088,0,2041,54393
11-04-2017,9,15238,23158,7967,5220,51584,963,1099,0,2062,53646
11-04-2017,10,15376,22954,7910,5337,51577,947,1110,523,2580,54157
11-04-2017,11,15342,22774,7786,5167,51068,962,1119,456,2537,53605
11-04-2017,12,15462,22446,7787,4793,50488,984,1108,432,2524,53012
11-04-2017,13,15282,22299,7776,4682,50036,901,1142,553,2596,52632
11-04-2017,14,14927,22010,7654,4774,49364,933,1150,431,2514,51878
11-04-2017,15,14722,22011,7715,4885,49332,926,1177,437,2540,51872
11-04-2017,16,15095,22008,7755,4770,49629,925,1176,441,2542,52171
11-04-2017,17,15941,22335,7684,4618,50577,925,1150,425,2500,53077
11-04-2017,18,16795,22664,7613,4339,51410,933,1127,370,2430,53840
11-04-2017,19,17617,22843,7814,4001,52275,898,1127,342,2367,54642
11-04-2017,20,17369,22359,7888,3957,51574,920,1135,322,2377,53951
11-04-2017,21,16627,21520,7653,4163,49963,925,1137,293,2355,52318
11-04-2017,22,15567,20260,7362,4091,47279,938,1043,321,2302,49581
11-04-2017,23,14349,19221,7109,4160,44840,966,1034,349,2349,47189
12-04-2017,0,12861,17661,6992,4112,41625,952,1029,281,2262,43887
12-04-2017,1,12564,16758,6827,3955,40105,964,1030,248,2242,42347
12-04-2017,2,12687,16586,6777,3930,39980,1004,1028,228,2260,42240
12-04-2017,3,12419,16565,6764,3883,39632,1002,1027,191,2220,41852
12-04-2017,4,12314,16769,6778,4003,39863,1011,1028,175,2214,42077
12-04-2017,5,12869,18086,7058,4129,42141,983,1061,179,2223,44364
12-04-2017,6,15690,20469,7623,4373,48156,977,1219,461,2657,50813
12-04-2017,7,17601,21427,7998,4676,51703,980,1217,462,2659,54362
12-04-2017,8,17999,21609,8041,4646,52295,983,1220,482,2685,54980
12-04-2017,9,18154,21556,7996,4550,52257,984,1265,489,2738,54995
12-04-2017,10,17476,21531,7682,4562,51251,974,1264,519,2757,54008
12-04-2017,11,16252,21306,7602,4602,49761,974,1145,593,2712,52473
12-04-2017,12,15550,21042,7485,4606,48683,948,1179,608,2735,51418
12-04-2017,13,15349,20715,7459,4736,48260,966,1177,427,2570,50830
12-04-2017,14,15123,19695,7219,4852,46888,949,1175,392,2516,49404
12-04-2017,15,14865,19832,7274,4982,46954,954,1180,392,2526,49480
12-04-2017,16,14429,19676,7471,5086,46662,957,1183,408,2548,49210
12-04-2017,17,14958,19751,7416,4998,47123,953,1168,419,2540,49663
12-04-2017,18,16257,20302,7496,5055,49112,964,1161,510,2635,51747
12-04-2017,19,16697,20600,7676,4819,49793,963,1102,566,2631,52424
12-04-2017,20,16794,20719,7496,4745,49755,961,1118,443,2522,52277
12-04-2017,21,16013,20379,7390,4703,48487,906,1098,430,2434,50921
12-04-2017,22,14348,18610,7174,4685,44819,920,1105,369,2394,47213
12-04-2017,23,12349,17490,6918,4510,41269,919,1030,285,2234,43503
13-04-2017,0,11706,16247,6795,4479,39226,920,1057,281,2258,41484
13-04-2017,1,10910,15870,6781,4423,37985,909,1049,248,2206,40191
13-04-2017,2,10810,15783,6834,4355,37783,901,1052,238,2191,39974
13-04-2017,3,10679,15826,6857,4279,37643,919,1049,215,2183,39826
13-04-2017,4,11221,16200,6980,4235,38637,961,1051,223,2235,40872
13-04-2017,5,12446,17569,7336,4257,41608,981,1043,296,2320,43928
13-04-2017,6,15147,19381,7899,4210,46637,1000,1135,460,2595,49232
13-04-2017,7,16869,20547,8370,4307,50094,1034,1217,408,2659,52753
13-04-2017,8,17766,20997,8459,4493,51715,1095,1225,407,2727,54442
13-04-2017,9,18021,21176,8337,4668,52202,1006,1253,409,2668,54870
13-04-2017,10,17978,21010,8271,4733,51992,1007,1257,435,2699,54691
13-04-2017,11,17393,20807,8120,4739,51058,990,1262,465,2717,53775
13-04-2017,12,16169,20116,8140,4519,48945,995,1224,450,2669,51614
13-04-2017,13,16076,19644,8003,4378,48101,965,1209,429,2603,50704
13-04-2017,14,15376,19379,7800,4285,46839,951,1246,217,2414,49253
13-04-2017,15,15012,19198,7865,4262,46337,945,1240,219,2404,48741
13-04-2017,16,15869,19709,7900,4465,47943,915,1229,219,2363,50306
13-04-2017,17,16701,20359,7960,4591,49612,913,1150,214,2277,51889
13-04-2017,18,16613,20409,8117,4602,49742,907,1105,391,2403,52145
13-04-2017,19,16536,20163,8131,4570,49401,909,1091,385,2385,51786
13-04-2017,20,16708,20147,7767,4553,49175,895,1137,192,2224,51399
13-04-2017,21,16199,19866,7455,4751,48271,896,1155,158,2209,50480
13-04-2017,22,15066,19160,7315,4885,46427,885,1143,148,2176,48603
13-04-2017,23,14408,17855,7194,4877,44334,902,1061,127,2090,46424
14-04-2017,0,13660,16686,6989,4715,42051,881,724,86,1691,43742
14-04-2017,1,12828,15821,7000,4753,40403,855,721,70,1646,42049
14-04-2017,2,12775,15703,6959,4671,40107,859,721,64,1644,41751
14-04-2017,3,13065,15908,6987,4571,40531,854,723,56,1633,42164
14-04-2017,4,13025,16163,7070,4205,40462,851,779,56,1686,42148
14-04-2017,5,13496,17059,7121,3873,41549,858,782,57,1697,43246
14-04-2017,6,14539,17946,7207,3778,43471,857,865,100,1822,45293
14-04-2017,7,15788,18985,7523,3669,45966,858,870,109,1837,47803
14-04-2017,8,17111,19652,7729,3543,48036,867,771,320,1958,49994
14-04-2017,9,16541,19703,7815,3825,47885,856,847,118,1821,49706
14-04-2017,10,15986,19563,7913,3951,47414,857,817,114,1788,49202
14-04-2017,11,15633,19578,7803,3677,46691,868,929,108,1905,48596
14-04-2017,12,14717,19265,7841,3684,45507,868,955,109,1932,47439
14-04-2017,13,14788,19156,7606,3576,45126,874,950,83,1907,47033
14-04-2017,14,15033,19007,7341,3518,44898,854,928,83,1865,46763
14-04-2017,15,15811,19151,7344,3298,45605,885,946,88,1919,47524
14-04-2017,16,16910,19315,7444,2960,46628,887,947,97,1931,48559
14-04-2017,17,18471,19617,7648,2638,48374,872,866,132,1870,50244
14-04-2017,18,19527,20201,7773,2431,49932,869,863,137,1869,51801
14-04-2017,19,19856,20527,7859,2209,50453,863,955,314,2132,52585
14-04-2017,20,20030,20456,7715,2158,50360,849,938,90,1877,52237
14-04-2017,21,20047,20044,7514,2127,49733,869,941,85,1895,51628
14-04-2017,22,19290,19587,7435,2170,48484,873,840,82,1795,50279
14-04-2017,23,18517,18970,7103,1986,46575,874,676,84,1634,48209
15-04-2017,0,17353,17902,7040,1823,44117,848,757,64,1669,45786
15-04-2017,1,16315,16871,6984,1702,41871,843,759,65,1667,43538
15-04-2017,2,15100,16173,6840,1676,39791,842,762,72,1676,41467
15-04-2017,3,13524,15616,6834,1623,37596,829,764,75,1668,39264
15-04-2017,4,14021,15787,6844,1777,38429,860,769,70,1699,40128
15-04-2017,5,13567,16039,6805,2124,38535,850,823,78,1751,40286
15-04-2017,6,14258,16457,6823,2309,39848,851,847,77,1775,41623
15-04-2017,7,14692,17608,6962,2499,41762,853,965,84,1902,43664
15-04-2017,8,15681,18190,7053,2858,43783,849,1007,80,1936,45719
15-04-2017,9,16569,18663,6923,3170,45328,863,1016,80,1959,47287
15-04-2017,10,16431,19101,6941,3481,45955,865,1011,81,1957,47912
15-04-2017,11,15663,19117,6967,3748,45496,845,961,80,1886,47382
15-04-2017,12,14940,18865,7178,4083,45066,867,957,86,1910,46976
15-04-2017,13,14430,18810,7051,4191,44483,882,959,94,1935,46418
15-04-2017,14,13565,18689,7034,4360,43647,889,867,90,1846,45493
15-04-2017,15,13191,18558,6995,4366,43109,863,737,85,1685,44794
15-04-2017,16,13006,18591,6928,4337,42861,863,732,82,1677,44538
15-04-2017,17,13608,18673,6796,4361,43439,865,795,113,1773,45212
15-04-2017,18,13978,18730,6695,4279,43684,854,853,123,1830,45514
15-04-2017,19,14570,18636,6746,3878,43831,845,841,154,1840,45671
15-04-2017,20,15520,18577,6861,3551,44509,849,899,195,1943,46452
15-04-2017,21,15363,18561,6959,3212,44094,844,919,265,2028,46122
15-04-2017,22,14513,18144,6942,3042,42642,851,721,347,1919,44561
15-04-2017,23,13750,17247,6994,3079,41072,864,706,392,1962,43034
16-04-2017,0,14282,16220,6856,2731,40089,855,673,282,1810,41899
16-04-2017,1,14108,15809,6790,2473,39181,852,669,289,1810,40991
16-04-2017,2,13929,15703,6760,2361,38752,846,670,293,1809,40561
16-04-2017,3,13928,15741,6787,2200,38656,855,687,271,1813,40469
16-04-2017,4,14112,15758,6806,2027,38702,847,693,229,1769,40471
16-04-2017,5,14444,15957,6855,1894,39150,852,691,196,1739,40889
16-04-2017,6,14521,16224,6865,1825,39436,857,794,176,1827,41263
16-04-2017,7,14874,17182,6717,1856,40628,855,843,176,1874,42502
16-04-2017,8,15580,17440,6610,1978,41608,849,975,168,1992,43600
16-04-2017,9,15881,17955,6788,2182,42805,877,937,187,2001,44806
16-04-2017,10,16223,18361,6842,2260,43685,893,920,191,2004,45689
16-04-2017,11,15839,18225,6828,2320,43211,878,822,186,1886,45097
16-04-2017,12,15031,17726,6774,2269,41801,867,816,236,1919,43720
16-04-2017,13,14644,17485,6742,2316,41187,882,831,296,2009,43196
16-04-2017,14,13750,17245,6764,2360,40121,874,805,341,2020,42141
16-04-2017,15,12994,17045,6736,2365,39140,898,822,382,2102,41242
16-04-2017,16,12909,17042,6719,2493,39163,888,817,396,2101,41264
16-04-2017,17,14037,17336,6691,2450,40515,876,831,381,2088,42603
16-04-2017,18,16229,17937,6917,2650,43733,859,818,305,1982,45715
16-04-2017,19,17727,18560,7128,2821,46237,859,903,278,2040,48277
16-04-2017,20,19278,18884,7377,2985,48524,855,910,220,1985,50509
16-04-2017,21,19199,19010,7378,2985,48571,855,824,223,1902,50473
16-04-2017,22,18852,18678,7151,2964,47647,856,671,156,1683,49330
16-04-2017,23,17341,17950,7040,2656,44988,879,681,106,1666,46654
17-04-2017,0,15513,16303,6879,2373,41068,886,664,128,1678,42746
17-04-2017,1,14534,15413,6792,2226,38965,882,644,115,1641,40606
17-04-2017,2,14062,15201,6794,2088,38145,877,648,93,1618,39763
17-04-2017,3,13658,15222,6818,2145,37843,868,653,89,1610,39453
17-04-2017,4,13497,15604,6966,2228,38295,874,667,81,1622,39917
17-04-2017,5,13698,15836,6917,2328,38779,869,714,68,1651,40430
17-04-2017,6,14293,16823,6826,2335,40277,870,738,88,1696,41973
17-04-2017,7,14863,17718,6832,2464,41878,914,914,85,1913,43791
17-04-2017,8,16706,18246,6973,2623,44549,1000,995,98,2093,46642
17-04-2017,9,17461,18304,7325,2775,45865,873,959,98,1930,47795
17-04-2017,10,16616,18399,7404,2963,45381,902,963,102,1967,47348
17-04-2017,11,16332,18257,7275,2959,44822,923,913,99,1935,46757
17-04-2017,12,15615,18036,7313,2982,43946,936,928,83,1947,45893
17-04-2017,13,15156,18026,7241,2997,43421,897,833,82,1812,45233
17-04-2017,14,14453,17897,6911,2990,42252,898,816,88,1802,44054
17-04-2017,15,14215,17760,6890,3028,41894,891,798,90,1779,43673
17-04-2017,16,14227,17609,6917,3045,41800,900,853,92,1845,43645
17-04-2017,17,14534,17784,6979,3201,42498,896,870,93,1859,44357
17-04-2017,18,15114,18130,7027,3347,43619,891,878,82,1851,45470
17-04-2017,19,17734,18769,7353,3610,47467,888,1068,102,2058,49525
17-04-2017,20,19208,19215,7324,3475,49222,887,1018,54,1959,51181
17-04-2017,21,19258,19372,7339,3592,49560,905,874,66,1845,51405
17-04-2017,22,18037,18923,7215,3564,47739,911,769,60,1740,49479
17-04-2017,23,17034,18004,6936,3411,45385,973,684,55,1712,47097
18-04-2017,0,15707,16870,7044,3243,42863,1012,1031,54,2097,44960
18-04-2017,1,14808,16358,6962,3286,41415,1056,1067,61,2184,43599
18-04-2017,2,13785,16187,6925,3217,40114,1148,1067,68,2283,42397
18-04-2017,3,13324,16120,6826,3117,39386,1122,1066,78,2266,41652
18-04-2017,4,14135,16388,6914,3132,40568,1231,1093,89,2413,42981
18-04-2017,5,17365,17691,7208,3367,45632,1339,1203,119,2661,48293
18-04-2017,6,19974,19834,7774,3726,51306,1389,1338,165,2892,54198
18-04-2017,7,21278,21621,7892,4276,55067,1390,1573,359,3322,58389
18-04-2017,8,20554,21343,7861,4578,54338,1420,1672,533,3625,57963
18-04-2017,9,20275,20503,7878,4551,53207,1400,1676,312,3388,56595
18-04-2017,10,20335,20250,7651,4450,52687,1417,1595,300,3312,55999
18-04-2017,11,20316,20111,7621,4549,52598,1421,1455,156,3032,55630
18-04-2017,12,20199,20317,7755,4485,52757,1424,1367,124,2915,55672
18-04-2017,13,19928,20230,7788,4354,52300,1421,1328,130,2879,55179
18-04-2017,14,19409,19765,7476,3936,50588,1417,1230,168,2815,53403
18-04-2017,15,18874,19354,7354,3887,49469,1416,1216,177,2809,52278
18-04-2017,16,18442,19281,7323,3726,48771,1422,1245,148,2815,51586
18-04-2017,17,18605,19330,7473,3599,49007,1417,1250,145,2812,51819
18-04-2017,18,19215,19710,7737,3720,50383,1412,1272,156,2840,53223
18-04-2017,19,19542,20032,7880,3564,51018,1392,1418,193,3003,54021
18-04-2017,20,19719,20049,8024,3392,51184,1390,1453,241,3084,54268
18-04-2017,21,20201,19615,7897,3136,50848,1380,1303,227,2910,53758
18-04-2017,22,19687,18895,7887,2865,49335,1307,1192,180,2679,52014
18-04-2017,23,18382,17999,7646,2548,46575,1284,1030,184,2498,49073
19-04-2017,0,16800,16856,7467,2252,43376,1267,704,182,2153,45529
19-04-2017,1,17063,16816,7415,2096,43390,1215,679,173,2067,45457
19-04-2017,2,16883,16618,7444,2085,43029,1197,683,167,2047,45076
19-04-2017,3,16885,16645,7502,2064,43095,1189,685,163,2037,45132
19-04-2017,4,17390,16990,7678,2092,44151,1197,680,166,2043,46194
19-04-2017,5,18809,18655,7785,2372,47620,1192,1029,156,2377,49997
19-04-2017,6,20404,20566,8075,3132,52178,1196,1241,175,2612,54790
19-04-2017,7,20949,20987,8020,4038,53994,1181,1495,417,3093,57087
19-04-2017,8,20728,20765,7803,4087,53384,1200,1490,535,3225,56609
19-04-2017,9,20591,20365,7737,3782,52475,1187,1438,553,3178,55653
19-04-2017,10,20897,20120,7769,3666,52453,1178,1327,353,2858,55311
19-04-2017,11,20408,20289,7693,3520,51910,1216,1229,200,2645,54555
19-04-2017,12,19888,20283,7773,3674,51618,1223,1177,140,2540,54158
19-04-2017,13,19945,20500,7846,3766,52057,1232,1065,142,2439,54496
19-04-2017,14,19974,20696,7626,3274,51570,1218,1039,148,2405,53975
19-04-2017,15,19700,20532,7633,3184,51048,1210,1079,146,2435,53483
19-04-2017,16,19602,20687,7589,3170,51048,1211,1087,158,2456,53504
19-04-2017,17,19706,20695,7622,3197,51220,1210,1090,158,2458,53678
19-04-2017,18,19785,21003,7649,3340,51777,1201,1124,140,2465,54242
19-04-2017,19,20057,21014,7776,3047,51894,1199,1211,141,2551,54445
19-04-2017,20,19911,21159,7925,2977,51972,1202,1283,142,2627,54599
19-04-2017,21,19246,20788,7805,3050,50891,1194,1307,138,2639,53530
19-04-2017,22,18293,20182,7701,2612,48788,1199,1204,121,2524,51312
19-04-2017,23,16623,19525,7625,2308,46081,1196,938,71,2205,48286
20-04-2017,0,15893,18061,7403,2134,43491,1098,667,37,1802,45293
20-04-2017,1,15355,18039,7308,2010,42711,1089,667,35,1791,44502
20-04-2017,2,15498,18039,7323,2149,43009,1089,668,32,1789,44798
20-04-2017,3,15431,18120,7351,2246,43148,1102,668,32,1802,44950
20-04-2017,4,15470,18371,7429,2474,43745,1109,670,32,1811,45556
20-04-2017,5,16521,19710,7555,2713,46500,1136,822,31,1989,48489
20-04-2017,6,18309,21379,7807,3175,50668,1174,1215,75,2464,53132
20-04-2017,7,19857,22494,8461,3701,54514,1192,1371,110,2673,57187
20-04-2017,8,20079,22984,8613,3868,55545,1198,1374,438,3010,58555
20-04-2017,9,19433,23063,8632,4200,55328,1193,1327,241,2761,58089
20-04-2017,10,19106,23072,8435,4392,55004,1193,1270,205,2668,57672
20-04-2017,11,18682,22895,8415,4417,54410,1202,1218,282,2702,57112
20-04-2017,12,18178,22589,8433,4516,53717,1221,1175,131,2527,56244
20-04-2017,13,17989,22619,8273,4566,53446,1219,1138,151,2508,55954
20-04-2017,14,17584,22801,8033,4599,53016,1213,1029,181,2423,55439
20-04-2017,15,16863,22656,7996,5074,52588,1214,1021,199,2434,55022
20-04-2017,16,17033,22688,7978,4963,52663,1193,1008,230,2431,55094
20-04-2017,17,17138,22621,7957,5132,52848,1221,1002,224,2447,55295
20-04-2017,18,16850,22697,7973,4952,52472,1243,1008,213,2464,54936
20-04-2017,19,16600,22743,7977,4736,52056,1276,1098,178,2552,54608
20-04-2017,20,16295,22580,7887,4511,51273,1287,1127,138,2552,53825
20-04-2017,21,16464,22062,7616,4252,50394,1295,1142,200,2637,53031
20-04-2017,22,15035,21626,7375,4186,48222,1268,1017,260,2545,50767
20-04-2017,23,14086,20033,7174,4179,45473,1187,935,310,2432,47905
21-04-2017,0,13146,19251,6868,4045,43310,1143,785,351,2279,45589
21-04-2017,1,12680,18985,6777,4097,42538,1140,784,373,2297,44835
21-04-2017,2,12501,18867,6764,4128,42261,1134,788,369,2291,44552
21-04-2017,3,12462,18934,6720,4138,42255,1111,788,382,2281,44536
21-04-2017,4,12606,19516,6742,4269,43135,1090,788,389,2267,45402
21-04-2017,5,13137,20738,7049,4230,45153,1098,865,404,2367,47520
21-04-2017,6,14616,22386,7726,4144,48873,1191,1010,571,2772,51645
21-04-2017,7,16215,23956,8161,4330,52662,1221,1130,683,3034,55696
21-04-2017,8,16265,24048,8174,4428,52916,1227,1191,759,3177,56093
21-04-2017,9,16009,23574,8216,4610,52409,1222,1192,672,3086,55495
21-04-2017,10,15784,23235,8111,4572,51703,1216,1188,591,2995,54698
21-04-2017,11,14693,22567,8072,4821,50153,1220,1198,748,3166,53319
21-04-2017,12,14091,21993,7923,4990,48997,1229,1200,743,3172,52169
21-04-2017,13,13675,20648,7900,4904,47126,1209,1160,490,2859,49985
21-04-2017,14,13457,20248,7611,4983,46298,1180,1081,526,2787,49085
21-04-2017,15,13838,19875,7376,5170,46260,1198,1080,540,2818,49078
21-04-2017,16,14094,19875,7275,5298,46543,1189,1079,473,2741,49284
21-04-2017,17,14201,19957,7105,5324,46586,1201,1078,477,2756,49342
21-04-2017,18,14409,20359,7073,5375,47217,1167,1081,496,2744,49961
21-04-2017,19,14219,20469,7281,4839,46807,1148,1080,506,2734,49541
21-04-2017,20,14445,20292,7326,4635,46699,1099,1072,502,2673,49372
21-04-2017,21,14578,19844,7119,4598,46139,1105,1081,487,2673,48812
21-04-2017,22,14479,19009,6800,4499,44788,1107,1004,452,2563,47351
21-04-2017,23,13721,18441,6399,4299,42860,1040,799,415,2254,45114
22-04-2017,0,13692,17418,6163,4117,41390,976,595,415,1986,43376
22-04-2017,1,13450,17218,6134,3974,40777,956,581,425,1962,42739
22-04-2017,2,12784,17288,6079,4081,40235,981,630,423,2034,42269
22-04-2017,3,13047,17286,6116,4009,40459,989,638,416,2043,42502
22-04-2017,4,12711,17312,6057,4069,40150,986,645,403,2034,42184
22-04-2017,5,12598,17340,6083,4467,40488,984,740,419,2143,42631
22-04-2017,6,12135,17572,6242,4638,40587,1019,833,417,2269,42856
22-04-2017,7,12342,17938,6622,4777,41680,1107,842,429,2378,44058
22-04-2017,8,13230,18268,6817,5013,43327,1145,974,446,2565,45892
22-04-2017,9,13543,18589,6750,4911,43794,1186,960,478,2624,46418
22-04-2017,10,13804,18584,6617,4407,43411,1209,880,483,2572,45983
22-04-2017,11,14046,18484,6549,4673,43752,1228,981,485,2694,46446
22-04-2017,12,13673,18594,6697,4607,43572,1232,998,483,2713,46285
22-04-2017,13,12987,18409,6621,4308,42326,1196,998,476,2670,44996
22-04-2017,14,12476,18087,6543,4219,41325,1173,1003,471,2647,43972
22-04-2017,15,12632,17901,6530,4285,41347,1130,1001,462,2593,43940
22-04-2017,16,12561,17832,6484,4170,41048,1122,1001,434,2557,43605
22-04-2017,17,13239,18210,6501,4488,42438,1210,1047,378,2635,45073
22-04-2017,18,13386,19038,6734,4513,43672,1209,1057,335,2601,46273
22-04-2017,19,13674,19461,6914,4481,44531,1203,1151,271,2625,47156
22-04-2017,20,13995,19675,7022,4132,44824,1222,1143,190,2555,47379
22-04-2017,21,13953,19750,6814,3962,44479,1226,1054,210,2490,46969
22-04-2017,22,13422,19366,6806,4096,43689,1220,765,131,2116,45805
22-04-2017,23,13068,17912,6515,3937,41431,1095,754,141,1990,43421
23-04-2017,0,13206,16344,6238,3786,39573,1105,646,133,1884,41457
23-04-2017,1,13112,15987,6161,3712,38972,1114,642,107,1863,40835
23-04-2017,2,12869,15814,6137,3787,38608,1077,636,129,1842,40450
23-04-2017,3,12682,15871,6153,3842,38549,1084,634,139,1857,40406
23-04-2017,4,12321,16055,6175,3922,38474,1060,641,156,1857,40331
23-04-2017,5,12327,16311,6168,3808,38615,1056,740,147,1943,40558
23-04-2017,6,11650,16300,6185,3731,37865,1038,846,141,2025,39890
23-04-2017,7,12350,16673,6175,3879,39077,1049,847,160,2056,41133
23-04-2017,8,13061,17389,6202,4375,41026,1074,1072,205,2351,43377
23-04-2017,9,13667,17865,6285,4580,42397,1155,1066,207,2428,44825
23-04-2017,10,13799,18021,6343,4391,42554,1148,1014,252,2414,44968
23-04-2017,11,13862,18003,6406,4636,42906,1163,928,290,2381,45287
23-04-2017,12,13469,17928,6433,4782,42612,1162,932,339,2433,45045
23-04-2017,13,13275,17762,6368,4595,42000,1141,896,325,2362,44362
23-04-2017,14,13182,17641,6290,4338,41451,1135,889,283,2307,43758
23-04-2017,15,12993,17661,5974,4086,40714,1147,873,279,2299,43013
23-04-2017,16,12925,17772,5590,4247,40536,1146,892,278,2316,42852
23-04-2017,17,13215,18088,5657,4706,41666,1128,989,238,2355,44021
23-04-2017,18,13461,18890,5843,4858,43053,1122,1033,211,2366,45419
23-04-2017,19,15276,19224,6219,4664,45382,1151,1124,203,2478,47860
23-04-2017,20,16845,19855,6360,4286,47345,1155,1121,189,2465,49810
23-04-2017,21,17232,20404,6494,3884,48012,1191,907,165,2263,50275
23-04-2017,22,16381,19844,6417,3781,46422,1205,775,154,2134,48556
23-04-2017,23,15458,18697,5886,3810,43852,1194,786,155,2135,45987
24-04-2017,0,14480,16954,5713,3624,40772,1306,841,187,2334,43106
24-04-2017,1,13607,16312,5583,3552,39054,1249,846,213,2308,41362
24-04-2017,2,13406,16076,5575,3670,38727,1241,847,160,2248,40975
24-04-2017,3,12952,15819,5586,3994,38352,1199,907,102,2208,40560
24-04-2017,4,12496,15816,5754,4288,38354,1316,914,86,2316,40670
24-04-2017,5,15028,16828,6191,4598,42646,1536,1087,66,2689,45335
24-04-2017,6,17280,18866,6731,4867,47744,1598,1184,355,3137,50881
24-04-2017,7,18645,20109,7084,4871,50709,1619,1308,556,3483,54192
24-04-2017,8,18785,20856,7024,5029,51695,1632,1401,565,3598,55293
24-04-2017,9,17750,20524,6893,5276,50445,1650,1422,576,3648,54093
24-04-2017,10,17137,20375,6697,5142,49350,1651,1370,584,3605,52955
24-04-2017,11,16827,20174,6659,4883,48544,1680,1377,394,3451,51995
24-04-2017,12,16574,20309,6590,4620,48093,1673,1380,413,3466,51559
24-04-2017,13,16289,20434,6457,4660,47840,1662,1208,631,3501,51341
24-04-2017,14,16058,20335,6159,4732,47284,1665,1177,235,3077,50361
24-04-2017,15,16088,20519,6160,5464,48232,1622,1196,216,3034,51266
24-04-2017,16,15887,20516,6249,5341,47993,1620,1270,190,3080,51073
24-04-2017,17,16470,20899,6258,5470,49098,1618,1251,201,3070,52168
24-04-2017,18,17433,21418,6290,5416,50557,1607,1262,239,3108,53665
24-04-2017,19,17780,21310,6517,5147,50756,1621,1269,269,3159,53915
24-04-2017,20,18277,21322,6272,4649,50520,1640,1268,344,3252,53772
24-04-2017,21,18794,21229,6193,4218,50435,1642,1162,369,3173,53608
24-04-2017,22,17903,20770,6090,3784,48548,1699,1031,380,3110,51658
24-04-2017,23,16291,19873,6010,3560,45736,1735,1011,367,3113,48849
25-04-2017,0,15657,17998,5976,3394,43026,1764,1026,377,3167,46193
25-04-2017,1,15466,17748,5880,3304,42397,1778,1030,370,3178,45575
25-04-2017,2,15299,17682,5888,3262,42130,1761,981,334,3076,45206
25-04-2017,3,14850,17686,5795,3168,41500,1770,988,277,3035,44535
25-04-2017,4,15062,17627,5764,3080,41532,1737,950,196,2883,44415
25-04-2017,5,16204,18262,6080,3013,43559,1734,1119,132,2985,46544
25-04-2017,6,18784,19846,6452,3575,48657,1750,1223,212,3185,51842
25-04-2017,7,19699,22089,6728,3871,52387,1754,1380,594,3728,56115
25-04-2017,8,19807,22563,7032,4207,53611,1745,1544,633,3922,57533
25-04-2017,9,19578,22366,6992,4404,53341,1757,1435,621,3813,57154
25-04-2017,10,19437,22168,6992,4524,53121,1751,1311,508,3570,56691
25-04-2017,11,18850,21907,6954,4195,51906,1692,1282,504,3478,55384
25-04-2017,12,18294,21014,6697,4090,50094,1678,1273,539,3490,53584
25-04-2017,13,18320,20395,6773,4019,49506,1658,1214,394,3266,52772
25-04-2017,14,17973,20325,6657,3727,48682,1666,1210,202,3078,51760
25-04-2017,15,17816,20345,6704,3721,48586,1640,1247,123,3010,51596
25-04-2017,16,18234,20807,6854,4114,50010,1616,1265,133,3014,53024
25-04-2017,17,18770,21204,6983,4279,51236,1621,1308,157,3086,54322
25-04-2017,18,19175,21357,6824,4298,51654,1617,1315,118,3050,54704
25-04-2017,19,19101,21364,6734,4035,51232,1623,1333,188,3144,54376
25-04-2017,20,19138,21230,6736,3752,50856,1633,1286,384,3303,54159
25-04-2017,21,19133,20845,6522,3612,50114,1586,1302,169,3057,53171
25-04-2017,22,18326,19718,6348,2997,47388,1591,1206,146,2943,50331
25-04-2017,23,17627,18833,6031,2488,44979,1614,1186,157,2957,47936
26-04-2017,0,15985,17589,5800,2052,41427,1635,1048,205,2888,44315
26-04-2017,1,16062,17152,5713,2007,40936,1625,1038,236,2899,43835
26-04-2017,2,16045,17072,5702,1932,40750,1665,1042,255,2962,43712
26-04-2017,3,15859,17078,5803,1869,40607,1653,1042,276,2971,43578
26-04-2017,4,16264,17374,5970,1883,41491,1656,1068,283,3007,44498
26-04-2017,5,17183,18308,6465,2082,44037,1683,1263,302,3248,47285
26-04-2017,6,19428,19985,6885,2846,49145,1720,1263,543,3526,52671
26-04-2017,7,19978,22058,7173,3355,52563,1701,1536,902,4139,56702
26-04-2017,8,20057,21962,7506,3513,53037,1727,1497,1048,4272,57309
26-04-2017,9,19571,21837,7490,3349,52249,1744,1537,1172,4453,56702
26-04-2017,10,19627,21805,7491,3415,52339,1759,1532,1270,4561,56900
26-04-2017,11,19591,21489,7380,3487,51947,1775,1439,1007,4221,56168
26-04-2017,12,19082,21443,7319,3623,51467,1790,1426,974,4190,55657
26-04-2017,13,18917,20807,7243,3549,50516,1808,1157,946,3911,54427
26-04-2017,14,18689,20141,7123,3387,49339,1811,1143,731,3685,53024
26-04-2017,15,18754,20009,7063,3396,49221,1797,1148,698,3643,52864
26-04-2017,16,18491,20147,7335,3404,49378,1791,1136,682,3609,52987
26-04-2017,17,19039,20361,7291,3462,50152,1773,1224,656,3653,53805
26-04-2017,18,19058,20338,7215,3358,49969,1748,1253,603,3604,53573
26-04-2017,19,19297,20300,7258,3275,50131,1710,1300,570,3580,53711
26-04-2017,20,18883,20114,7308,3130,49434,1698,1331,507,3536,52970
26-04-2017,21,18959,19915,7317,3200,49390,1659,1281,494,3434,52824
26-04-2017,22,18278,18847,7131,3030,47286,1671,1162,389,3222,50508
26-04-2017,23,16863,17787,6656,2746,44051,1724,1121,263,3108,47159
27-04-2017,0,16671,16462,6283,2661,42077,1737,971,69,2777,44854
27-04-2017,1,16485,16382,6174,2732,41773,1740,977,69,2786,44559
27-04-2017,2,16200,16287,6151,2793,41432,1730,981,62,2773,44205
27-04-2017,3,16276,16277,6148,2883,41586,1722,1039,47,2808,44394
27-04-2017,4,16538,16600,6186,2792,42116,1716,1048,54,2818,44934
27-04-2017,5,17256,17450,6441,3021,44168,1715,1202,94,3011,47179
27-04-2017,6,19531,19485,6947,3555,49520,1714,1213,120,3047,52567
27-04-2017,7,20544,21054,7209,3774,52580,1731,1262,317,3310,55890
27-04-2017,8,20424,21062,7148,4307,52941,1743,1331,543,3617,56558
27-04-2017,9,20143,20298,7089,4282,51812,1735,1313,553,3601,55413
27-04-2017,10,20060,19948,7060,4166,51235,1740,1389,561,3690,54925
27-04-2017,11,19691,19303,7054,4270,50318,1741,1406,575,3722,54040
27-04-2017,12,19360,18761,6967,4236,49324,1709,1373,525,3607,52931
27-04-2017,13,19064,18562,6858,4244,48729,1673,1374,351,3398,52127
27-04-2017,14,18328,18470,6612,3639,47048,1701,1192,173,3066,50114
27-04-2017,15,18324,18271,6612,3340,46548,1714,1172,171,3057,49605
27-04-2017,16,18477,18517,6700,3000,46695,1698,1171,152,3021,49716
27-04-2017,17,19272,19498,6735,3351,48855,1678,1197,144,3019,51874
27-04-2017,18,19048,19787,6794,3603,49233,1682,1275,130,3087,52320
27-04-2017,19,19400,19463,6728,4049,49641,1679,1325,127,3131,52772
27-04-2017,20,19795,19148,6629,3874,49446,1669,1300,121,3090,52536
27-04-2017,21,19869,19551,6485,4033,49938,1675,1272,117,3064,53002
27-04-2017,22,18622,18227,6269,3238,46356,1677,1123,87,2887,49243
27-04-2017,23,17633,17266,6165,2540,43604,1686,1066,33,2785,46389
28-04-2017,0,16722,16198,5937,2353,41209,1593,853,32,2478,43687
28-04-2017,1,16524,16006,5860,2446,40836,1586,740,34,2360,43196
28-04-2017,2,15982,15820,5896,2549,40248,1591,752,32,2375,42623
28-04-2017,3,15892,15963,5905,2714,40476,1581,854,33,2468,42944
28-04-2017,4,16113,16313,6092,2764,41282,1574,861,39,2474,43756
28-04-2017,5,17119,17439,6481,2982,44020,1601,975,57,2633,46653
28-04-2017,6,19281,19424,6831,3314,48850,1688,1249,390,3327,52177
28-04-2017,7,20547,21037,6824,4193,52600,1645,1367,827,3839,56439
28-04-2017,8,20681,21368,6860,4406,53316,1632,1372,921,3925,57241
28-04-2017,9,20667,21505,6946,4426,53545,1696,1318,908,3922,57467
28-04-2017,10,20417,21443,6847,4426,53134,1668,1346,913,3927,57061
28-04-2017,11,20268,21089,6818,4647,52824,1677,1375,752,3804,56628
28-04-2017,12,20015,20629,6816,4397,51856,1711,1351,635,3697,55553
28-04-2017,13,19583,20163,7011,3821,50579,1734,1326,746,3806,54385
28-04-2017,14,18876,19942,6890,3835,49542,1752,1338,528,3618,53160
28-04-2017,15,18612,19772,6818,3592,48795,1763,1364,525,3652,52447
28-04-2017,16,18601,19818,6991,3475,48885,1745,1338,464,3547,52432
28-04-2017,17,19260,19837,7011,3577,49685,1759,1352,438,3549,53234
28-04-2017,18,19496,19805,6975,3456,49734,1787,1367,440,3594,53328
28-04-2017,19,19206,19627,6935,3316,49086,1784,1405,483,3672,52758
28-04-2017,20,19094,19172,6513,3190,47970,1781,1185,662,3628,51598
28-04-2017,21,19396,18961,6414,3086,47859,1813,1092,579,3484,51343
28-04-2017,22,18145,18792,6297,2634,45869,1833,984,497,3314,49183
28-04-2017,23,16316,18067,5977,2394,42754,1828,947,386,3161,45915
29-04-2017,0,16517,16925,5755,2589,41786,1609,696,231,2536,44322
29-04-2017,1,14612,16229,5653,2442,38934,1596,687,223,2506,41440
29-04-2017,2,14686,16216,5611,2416,38929,1604,692,220,2516,41445
29-04-2017,3,14818,16230,5731,2413,39191,1593,692,179,2464,41655
29-04-2017,4,15147,16250,5800,2274,39472,1613,699,184,2496,41968
29-04-2017,5,15560,16070,5837,2218,39684,1610,722,171,2503,42187
29-04-2017,6,16347,16332,5876,2650,41205,1606,852,148,2606,43811
29-04-2017,7,17368,17125,6038,3001,43532,1626,1033,105,2764,46296
29-04-2017,8,17397,17976,6077,3505,44957,1639,1087,169,2895,47852
29-04-2017,9,17228,17807,6248,3443,44727,1567,1092,221,2880,47607
29-04-2017,10,16402,17070,6170,3195,42837,1584,1115,243,2942,45779
29-04-2017,11,15913,17257,6225,3055,42452,1586,1102,166,2854,45306
29-04-2017,12,15578,17222,6143,2854,41798,1574,1062,212,2848,44646
29-04-2017,13,14907,17130,6316,2648,41001,1573,1048,196,2817,43818
29-04-2017,14,14140,16948,6310,2583,39982,1566,968,264,2798,42780
29-04-2017,15,13879,16787,6310,2507,39481,1567,937,284,2788,42269
29-04-2017,16,14006,16754,6364,2460,39583,1565,884,300,2749,42332
29-04-2017,17,15724,16987,6484,2264,41461,1549,877,313,2739,44200
29-04-2017,18,17290,18109,6790,2485,44676,1504,869,257,2630,47306
29-04-2017,19,18146,18347,6742,2653,45890,1454,963,221,2638,48528
29-04-2017,20,18121,18361,6705,2524,45711,1439,1048,204,2691,48402
29-04-2017,21,18282,18209,6770,2541,45802,1393,1067,190,2650,48452
29-04-2017,22,17256,17824,6736,2569,44384,1363,940,148,2451,46835
29-04-2017,23,15687,16975,6472,2188,41323,1371,764,152,2287,43610
30-04-2017,0,14348,15320,6175,2105,37948,1157,698,154,2009,39957
30-04-2017,1,13667,14781,6012,2038,36498,1138,688,138,1964,38462
30-04-2017,2,13230,14665,6020,2021,35936,1144,688,146,1978,37914
30-04-2017,3,12768,14823,6036,1956,35583,1153,675,146,1974,37557
30-04-2017,4,12497,14864,6066,1956,35382,1162,680,90,1932,37314
30-04-2017,5,12314,14916,6016,1993,35239,1204,697,73,1974,37213
30-04-2017,6,12224,15004,6019,1995,35243,1210,876,59,2145,37388
30-04-2017,7,12839,15218,6048,2205,36311,1226,1006,53,2285,38596
30-04-2017,8,13466,15416,6033,2411,37326,1339,1001,90,2430,39756
30-04-2017,9,14462,15827,6166,2657,39114,1333,996,111,2440,41554
30-04-2017,10,14425,15987,6141,3049,39602,1337,993,129,2459,42061
30-04-2017,11,14315,15868,5978,3386,39547,1341,994,132,2467,42014
30-04-2017,12,13967,15860,5978,3576,39382,1341,994,133,2468,41850
30-04-2017,13,13375,15583,5871,3783,38613,1346,995,155,2496,41109
30-04-2017,14,12645,15317,5882,3940,37785,1351,1002,125,2478,40263
30-04-2017,15,12532,15215,5749,4118,37615,1238,1004,116,2358,39973
30-04-2017,16,12125,15247,5882,4356,37610,1151,991,109,2251,39861
30-04-2017,17,11898,15307,5771,4482,37457,1152,971,119,2242,39699
30-04-2017,18,12269,15470,5844,4322,37905,1119,931,112,2162,40067
30-04-2017,19,12470,15402,5917,4258,38047,1070,936,119,2125,40172
30-04-2017,20,12651,15830,6166,3953,38601,1050,939,126,2115,40716
30-04-2017,21,13188,16091,6171,3711,39162,1103,1026,124,2253,41415
30-04-2017,22,12792,15774,6080,3693,38338,1132,880,124,2136,40474
30-04-2017,23,12202,15498,5935,3654,37289,1113,671,129,1913,39202
01-05-2017,0,11418,14528,5815,3621,35382,1099,716,137,1952,37334
01-05-2017,1,10992,14210,5738,3679,34620,1056,684,171,1911,36531
01-05-2017,2,10970,14143,5766,3602,34482,1046,674,196,1916,36398
01-05-2017,3,10917,14133,5722,3631,34404,1067,673,199,1939,36343
01-05-2017,4,11023,14101,5724,3807,34655,1046,750,183,1979,36634
01-05-2017,5,10882,14785,5692,3847,35205,1050,910,150,2110,37315
01-05-2017,6,11729,15169,5884,3733,36513,1034,949,112,2095,38608
01-05-2017,7,11962,15535,6079,3831,37407,1067,997,65,2129,39536
01-05-2017,8,12375,15791,6129,4117,38410,1150,1012,69,2231,40641
01-05-2017,9,12840,16014,6042,4146,39043,1168,1116,95,2379,41422
01-05-2017,10,13150,16309,6026,4373,39859,1109,1024,102,2235,42094
01-05-2017,11,12877,16357,6101,4361,39695,1094,1028,123,2245,41940
01-05-2017,12,12360,16236,6220,4201,39019,1091,1037,107,2235,41254
01-05-2017,13,12207,16006,6148,4485,38846,1114,1043,117,2274,41120
01-05-2017,14,12073,15944,6010,4407,38434,1053,1046,121,2220,40654
01-05-2017,15,11487,15818,5953,4694,37953,1025,1047,148,2220,40173
01-05-2017,16,11480,15756,5919,4598,37753,1022,999,180,2201,39954
01-05-2017,17,11406,15691,5904,4893,37895,1026,1033,192,2251,40146
01-05-2017,18,11901,15818,5874,4684,38279,1125,1015,192,2332,40611
01-05-2017,19,12277,15700,5871,4316,38163,1126,1009,176,2311,40474
01-05-2017,20,13236,15994,6064,3944,39238,1128,1200,166,2494,41732
01-05-2017,21,13647,16167,6285,3748,39848,1137,1213,153,2503,42351
01-05-2017,22,12641,16153,6300,3442,38534,1146,1176,171,2493,41027
01-05-2017,23,11898,15496,6019,3302,36715,1121,759,174,2054,38769
02-05-2017,0,11438,14582,5974,3347,35340,1145,875,150,2170,37510
02-05-2017,1,11134,14400,5919,3265,34719,1173,883,102,2158,36877
02-05-2017,2,10932,14417,5879,3177,34406,1192,901,78,2171,36577
02-05-2017,3,10934,14401,5951,3113,34398,1150,943,79,2172,36570
02-05-2017,4,11088,14654,6063,3083,34887,1231,942,90,2263,37150
02-05-2017,5,12216,15468,6207,3287,37179,1430,933,115,2478,39657
02-05-2017,6,15803,17765,6477,3987,44031,1526,1165,147,2838,46869
02-05-2017,7,17996,19346,6920,4308,48571,1533,1179,130,2842,51413
02-05-2017,8,18211,19434,7015,4373,49034,1572,1202,323,3097,52131
02-05-2017,9,17734,18893,6955,4365,47946,1569,1207,125,2901,50847
02-05-2017,10,17325,18354,6760,4707,47145,1523,1212,155,2890,50035
02-05-2017,11,17088,17844,6594,4783,46310,1542,1103,211,2856,49166
02-05-2017,12,16788,17277,6391,4891,45346,1571,1079,206,2856,48202
02-05-2017,13,16397,17084,6343,5112,44936,1589,1012,199,2800,47736
02-05-2017,14,15245,16723,6333,5013,43314,1587,995,212,2794,46108
02-05-2017,15,14138,16441,6307,4909,41795,1593,1042,194,2829,44624
02-05-2017,16,14185,16428,6244,4808,41664,1585,1016,216,2817,44481
02-05-2017,17,15270,16378,6195,4508,42350,1611,1020,226,2857,45207
02-05-2017,18,15641,16478,6186,4341,42647,1603,1029,214,2846,45493
02-05-2017,19,15812,16786,6218,3876,42693,1582,1031,208,2821,45514
02-05-2017,20,15921,16614,6211,3536,42282,1620,1133,231,2984,45266
02-05-2017,21,15943,16494,6344,3300,42080,1621,1134,275,3030,45110
02-05-2017,22,14687,15620,6227,3414,39948,1622,1050,278,2950,42898
02-05-2017,23,12830,15208,6150,3022,37210,1572,842,296,2710,39920
03-05-2017,0,12179,14503,6097,2997,35776,1477,874,271,2622,38398
03-05-2017,1,11954,14139,6024,2910,35029,1420,927,233,2580,37609
03-05-2017,2,11547,13989,5999,2779,34314,1409,930,220,2559,36873
03-05-2017,3,11624,14003,5987,2810,34423,1403,932,163,2498,36921
03-05-2017,4,12203,14199,6215,2845,35462,1439,931,108,2478,37940
03-05-2017,5,13329,14878,6229,3157,37593,1587,935,133,2655,40248
03-05-2017,6,16082,17108,6267,3548,43005,1598,1018,152,2768,45773
03-05-2017,7,17865,18581,6466,4034,46946,1594,1100,120,2814,49760
03-05-2017,8,18367,18787,6581,4046,47783,1597,1120,199,2916,50699
03-05-2017,9,17551,18300,6432,3707,45991,1558,1130,275,2963,48954
03-05-2017,10,17590,17935,6291,4206,46022,1598,1205,282,3085,49107
03-05-2017,11,17230,17477,6233,4440,45381,1613,1212,206,3031,48412
03-05-2017,12,17070,17043,6142,4237,44494,1612,1214,125,2951,47445
03-05-2017,13,16781,17049,6057,4160,44048,1608,1147,135,2890,46938
03-05-2017,14,16313,16750,6044,4195,43303,1591,1156,145,2892,46195
03-05-2017,15,15544,16519,6023,4285,42371,1600,1149,152,2901,45272
03-05-2017,16,15501,16430,5966,4124,42022,1603,1150,150,2903,44925
03-05-2017,17,16017,16838,5938,4075,42869,1590,1151,180,2921,45790
03-05-2017,18,16181,17001,6034,3939,43155,1594,1143,204,2941,46096
03-05-2017,19,16609,16886,6046,3585,43124,1580,1125,209,2914,46038
03-05-2017,20,16871,16843,6028,3101,42844,1588,1129,260,2977,45821
03-05-2017,21,16603,16780,5992,2863,42239,1588,1126,315,3029,45268
03-05-2017,22,15114,15948,6028,2838,39929,1568,955,294,2817,42746
03-05-2017,23,12123,15027,5734,2906,35790,1542,866,293,2701,38491
04-05-2017,0,11255,13908,5722,2626,33512,1419,1016,298,2733,36245
04-05-2017,1,11103,13870,5670,2774,33418,1340,1024,327,2691,36109
04-05-2017,2,10979,13969,5604,2929,33480,1340,1024,341,2705,36185
04-05-2017,3,10873,14077,5861,3004,33814,1309,1042,379,2730,36544
04-05-2017,4,10779,14344,6095,3299,34516,1321,1041,376,2738,37254
04-05-2017,5,11080,15230,6250,3755,36315,1489,1053,359,2901,39216
04-05-2017,6,14900,16861,6564,4088,42414,1545,1051,368,2964,45378
04-05-2017,7,16826,18786,6827,4604,47042,1559,1135,331,3025,50067
04-05-2017,8,17127,18812,6876,5001,47817,1572,1137,274,2983,50800
04-05-2017,9,16763,18110,6696,4871,46440,1589,1145,285,3019,49459
04-05-2017,10,16522,18464,6615,5322,46922,1608,1147,363,3118,50040
04-05-2017,11,15698,18150,6614,5265,45728,1547,1243,412,3202,48930
04-05-2017,12,15483,17805,6704,5209,45204,1517,1249,417,3183,48387
04-05-2017,13,15064,17865,6709,5170,44808,1560,1309,418,3287,48095
04-05-2017,14,14211,17662,6503,5038,43414,1570,1227,419,3216,46630
04-05-2017,15,14031,17187,6413,4952,42584,1554,1222,419,3195,45779
04-05-2017,16,13652,17258,6365,4873,42149,1541,1224,415,3180,45329
04-05-2017,17,14392,17423,6319,4621,42755,1556,1250,413,3219,45974
04-05-2017,18,14901,17348,6477,4310,43034,1564,1229,392,3185,46219
04-05-2017,19,15105,17359,6502,3798,42765,1565,1161,369,3095,45860
04-05-2017,20,14686,17327,6635,3605,42254,1578,1122,301,3001,45255
04-05-2017,21,14740,17037,6729,3383,41890,1582,1114,256,2952,44842
04-05-2017,22,13403,16949,6801,3393,40546,1585,1042,233,2860,43406
04-05-2017,23,10868,16205,6730,3393,37196,1544,1044,246,2834,40030
05-05-2017,0,10592,15239,6717,3310,35857,1269,1147,272,2688,38545
05-05-2017,1,10005,15095,6681,3219,35001,1143,1153,319,2615,37616
05-05-2017,2,9575,15092,6712,3107,34487,1137,1157,338,2632,37119
05-05-2017,3,9616,15237,6762,3052,34668,1153,1160,340,2653,37321
05-05-2017,4,9949,15411,6761,3127,35249,1185,1164,333,2682,37931
05-05-2017,5,11908,16261,6872,3280,38321,1382,1157,319,2858,41179
05-05-2017,6,14957,18129,7069,3485,43639,1535,1147,334,3016,46655
05-05-2017,7,17059,19563,7328,4047,47997,1554,1139,316,3009,51006
05-05-2017,8,17195,19972,7335,4410,48911,1586,1240,272,3098,52009
05-05-2017,9,16923,19804,7175,4410,48313,1602,1260,261,3123,51436
05-05-2017,10,16584,19522,7103,4435,47644,1608,1266,275,3149,50793
05-05-2017,11,16603,19035,7026,4345,47009,1621,1171,245,3037,50046
05-05-2017,12,15934,19075,7103,4169,46281,1627,1166,207,3000,49281
05-05-2017,13,15908,18729,7026,4119,45780,1639,1170,177,2986,48766
05-05-2017,14,15485,18370,6815,3830,44499,1645,1133,157,2935,47434
05-05-2017,15,15118,18112,6799,3501,43530,1538,1127,134,2799,46329
05-05-2017,16,15441,18156,6826,3029,43454,1495,1123,118,2736,46190
05-05-2017,17,16110,18270,6822,2892,44093,1505,1127,119,2751,46844
05-05-2017,18,16076,18157,6858,3063,44153,1523,1123,110,2756,46909
05-05-2017,19,16012,17938,6881,2959,43790,1501,1116,106,2723,46513
05-05-2017,20,15113,17456,7014,2633,42215,1469,1114,124,2707,44922
05-05-2017,21,14974,16805,7071,2572,41424,1476,1110,123,2709,44133
05-05-2017,22,14480,16470,7001,2331,40282,1496,1113,57,2666,42948
05-05-2017,23,13030,16092,6728,2083,37932,1473,1104,59,2636,40568
06-05-2017,0,12534,14912,6667,1834,35947,1284,1003,60,2347,38294
06-05-2017,1,11904,14502,6640,1634,34681,1222,1001,77,2300,36981
06-05-2017,2,11510,14337,6617,1398,33861,1231,1003,85,2319,36180
06-05-2017,3,11121,14135,6675,1360,33291,1260,1004,62,2326,35617
06-05-2017,4,10943,14080,6647,1350,33019,1234,1006,50,2290,35309
06-05-2017,5,11073,14094,6737,1449,33354,1241,1006,47,2294,35648
06-05-2017,6,11358,14261,6949,1451,34018,1231,1009,81,2321,36339
06-05-2017,7,12723,14512,7154,1781,36170,1215,1084,95,2394,38564
06-05-2017,8,14851,14688,7359,2105,39002,1218,1114,96,2428,41430
06-05-2017,9,16055,14762,7489,2286,40593,1205,1113,97,2415,43008
06-05-2017,10,16070,14748,7410,1912,40139,1193,1111,98,2402,42541
06-05-2017,11,14927,14579,7087,1716,38310,1199,1109,101,2409,40719
06-05-2017,12,14231,14431,6948,1703,37314,1165,1025,111,2301,39615
06-05-2017,13,13041,14304,6922,1698,35965,1150,1017,118,2285,38250
06-05-2017,14,11983,14282,6856,1683,34803,1109,1086,123,2318,37121
06-05-2017,15,12070,14242,6831,1748,34890,1127,1100,129,2356,37246
06-05-2017,16,12540,14424,6917,1702,35583,1038,1100,137,2275,37858
06-05-2017,17,14213,14747,6926,1819,37706,1015,1100,148,2263,39969
06-05-2017,18,15724,14991,6910,2322,39946,1002,1103,151,2256,42202
06-05-2017,19,15780,14982,6869,2593,40225,1083,1102,168,2353,42578
06-05-2017,20,15623,14985,6778,2461,39847,1212,1087,178,2477,42324
06-05-2017,21,15626,14967,6929,2472,39994,1244,1003,190,2437,42431
06-05-2017,22,15224,14904,6967,2209,39305,1231,1003,115,2349,41654
06-05-2017,23,12810,14516,6988,2029,36344,1251,1002,126,2379,38723
07-05-2017,0,10888,13644,6517,1472,32522,1000,964,130,2094,34616
07-05-2017,1,10077,13447,6536,1233,31292,906,962,106,1974,33266
07-05-2017,2,9944,13344,6315,1247,30851,900,965,64,1929,32780
07-05-2017,3,9693,13294,6109,1229,30326,901,967,71,1939,32265
07-05-2017,4,10097,13268,5997,1186,30548,881,933,85,1899,32447
07-05-2017,5,9985,13433,6034,1167,30621,868,997,111,1976,32597
07-05-2017,6,9500,13769,6198,1173,30641,859,1025,133,2017,32658
07-05-2017,7,9713,14002,6522,1273,31510,873,1100,91,2064,33574
07-05-2017,8,11115,14598,6753,1471,33938,964,1114,157,2235,36173
07-05-2017,9,12975,14762,6802,1660,36198,994,1114,165,2273,38471
07-05-2017,10,14069,15294,6860,1809,38032,998,1113,127,2238,40270
07-05-2017,11,14280,15432,6876,1848,38435,1012,1111,129,2252,40687
07-05-2017,12,13315,15392,6782,1963,37454,999,1095,128,2222,39676
07-05-2017,13,12490,15494,6777,2023,36783,996,1094,115,2205,38988
07-05-2017,14,11284,15616,6642,1992,35534,926,1085,103,2114,37648
07-05-2017,15,10543,15636,6626,1950,34757,910,1087,113,2110,36867
07-05-2017,16,10477,15719,6567,1956,34721,892,1112,122,2126,36847
07-05-2017,17,11829,16029,6923,1879,36660,896,1123,134,2153,38813
07-05-2017,18,13473,16638,7062,1826,38999,1016,1117,227,2360,41359
07-05-2017,19,14846,16822,6922,1856,40444,991,1119,313,2423,42867
07-05-2017,20,15718,16887,7169,1929,41703,965,1109,328,2402,44105
07-05-2017,21,15832,16925,7262,2092,42111,1009,1026,264,2299,44410
07-05-2017,22,14520,16840,7254,2231,40845,1037,1014,234,2285,43130
07-05-2017,23,11732,16389,7156,2044,37322,922,1000,183,2105,39427
08-05-2017,0,10563,16322,7052,2497,36265,909,865,188,1962,38227
08-05-2017,1,9438,16342,7006,2924,35542,915,809,179,1903,37445
08-05-2017,2,9391,16321,7029,3127,35700,928,809,155,1892,37592
08-05-2017,3,8989,16394,6998,3538,35750,946,811,138,1895,37645
08-05-2017,4,9468,16555,6972,3841,36665,997,813,125,1935,38600
08-05-2017,5,10704,17257,6939,3988,38887,1246,870,139,2255,41142
08-05-2017,6,14190,18227,7073,4196,43687,1408,989,182,2579,46266
08-05-2017,7,16196,19337,7243,4692,47299,1475,1100,163,2738,50037
08-05-2017,8,17006,19581,7382,5227,49198,1509,1101,170,2780,51978
08-05-2017,9,17096,19566,7462,5413,49537,1555,1096,195,2846,52383
08-05-2017,10,17132,19574,7519,5419,49644,1560,1012,191,2763,52407
08-05-2017,11,17433,19563,7577,4986,49561,1539,1015,216,2770,52331
08-05-2017,12,17148,19737,7619,4821,49326,1528,985,268,2781,52107
08-05-2017,13,16853,19644,7639,5143,49279,1522,937,313,2772,52051
08-05-2017,14,16831,19351,7515,4738,48437,1510,953,351,2814,51251
08-05-2017,15,16586,19257,7528,4348,47719,1523,964,355,2842,50561
08-05-2017,16,15885,19159,7589,4143,46776,1529,970,307,2806,49582
08-05-2017,17,17319,18800,7709,3527,47355,1557,1027,254,2838,50193
08-05-2017,18,17222,18813,7781,3572,47389,1517,1037,243,2797,50186
08-05-2017,19,17458,18448,7819,3420,47145,1493,1113,221,2827,49972
08-05-2017,20,17656,18071,7911,3318,46955,1481,1102,224,2807,49762
08-05-2017,21,18370,18046,8025,3042,47482,1471,969,276,2716,50198
08-05-2017,22,17699,17680,7962,2707,46048,1484,907,256,2647,48695
08-05-2017,23,15997,16306,7706,2197,42207,1469,820,231,2520,44727
09-05-2017,0,14066,15394,7822,1911,39194,1469,880,233,2582,41776
09-05-2017,1,13501,15260,7661,1873,38295,1510,882,210,2602,40897
09-05-2017,2,13139,15251,7518,1881,37789,1519,890,178,2587,40376
09-05-2017,3,12944,15291,7476,1864,37574,1510,897,182,2589,40163
09-05-2017,4,13491,15462,7401,1904,38259,1518,910,177,2605,40864
09-05-2017,5,15204,16297,7449,2176,41126,1537,1011,182,2730,43856
09-05-2017,6,17787,17735,7705,2616,45843,1589,1097,221,2907,48750
09-05-2017,7,19386,19364,7954,3041,49746,1614,1120,412,3146,52892
09-05-2017,8,19064,19700,8135,3298,50197,1618,1116,630,3364,53561
09-05-2017,9,18601,19562,8079,3393,49634,1618,1137,584,3339,52973
09-05-2017,10,18842,19488,8054,3449,49834,1630,1293,504,3427,53261
09-05-2017,11,18849,19539,8033,3491,49911,1621,1283,393,3297,53208
09-05-2017,12,18799,19262,8016,3538,49615,1629,1193,222,3044,52659
09-05-2017,13,18479,18840,7907,3613,48839,1630,1139,250,3019,51858
09-05-2017,14,18546,18440,7806,3463,48254,1617,1139,288,3044,51298
09-05-2017,15,18681,18361,7734,3419,48195,1601,1110,356,3067,51262
09-05-2017,16,18550,18146,7774,3391,47861,1569,1011,376,2956,50817
09-05-2017,17,18726,18077,7945,3378,48127,1592,1009,366,2967,51094
09-05-2017,18,18573,17788,7887,3106,47354,1575,1150,320,3045,50399
09-05-2017,19,18599,17852,7879,3105,47436,1574,1162,252,2988,50424
09-05-2017,20,18582,17602,7843,3114,47142,1570,1198,220,2988,50130
09-05-2017,21,18867,17321,7945,3175,47309,1571,1243,203,3017,50326
09-05-2017,22,18396,17117,8037,2830,46380,1567,1032,182,2781,49161
09-05-2017,23,17022,16134,7854,2479,43489,1585,1018,134,2737,46226
10-05-2017,0,15174,14875,7432,2274,39755,1542,1115,143,2800,42555
10-05-2017,1,14173,14514,7232,2251,38172,1541,1111,122,2774,40946
10-05-2017,2,13420,14451,7140,2229,37241,1537,1121,93,2751,39992
10-05-2017,3,13890,14581,7120,2165,37756,1540,1131,67,2738,40494
10-05-2017,4,14642,14769,7218,2000,38629,1540,1137,66,2743,41372
10-05-2017,5,16530,15840,7499,2301,42170,1565,1137,62,2764,44934
10-05-2017,6,18481,18312,7924,2970,47687,1565,1249,160,2974,50661
10-05-2017,7,19187,20214,8170,3545,51116,1538,1418,523,3479,54595
10-05-2017,8,19343,20463,8209,3570,51586,1550,1441,717,3708,55294
10-05-2017,9,19454,20110,8226,3533,51323,1573,1534,634,3741,55064
10-05-2017,10,19221,19636,8192,3281,50332,1591,1402,535,3528,53860
10-05-2017,11,19158,19275,8033,3253,49719,1589,1330,380,3299,53018
10-05-2017,12,19021,18620,7854,3333,48830,1586,1179,370,3135,51965
10-05-2017,13,18535,18271,7760,3400,47966,1594,1171,377,3142,51108
10-05-2017,14,18124,17905,7705,3282,47018,1582,1170,387,3139,50157
10-05-2017,15,18210,17759,7284,3389,46644,1614,1176,368,3158,49802
10-05-2017,16,18471,18393,7159,3335,47359,1612,1133,387,3132,50491
10-05-2017,17,19184,19111,7418,3348,49062,1690,1256,395,3341,52403
10-05-2017,18,19028,19194,7415,3404,49040,1706,1255,633,3594,52634
10-05-2017,19,19307,19233,7449,3094,49083,1697,1227,709,3633,52716
10-05-2017,20,19230,19013,7331,2884,48458,1673,1264,729,3666,52124
10-05-2017,21,19116,18662,7326,2772,47876,1652,1302,735,3689,51565
10-05-2017,22,18610,17930,7228,2656,46423,1651,1300,532,3483,49906
10-05-2017,23,16952,16534,6858,2205,42549,1619,1207,385,3211,45760
11-05-2017,0,14894,15605,6474,1756,38730,1509,1077,364,2950,41680
11-05-2017,1,13673,15300,6311,1693,36978,1493,1083,463,3039,40017
11-05-2017,2,13013,15184,6223,1651,36071,1477,1091,462,3030,39101
11-05-2017,3,12680,15022,6190,1566,35459,1489,1113,482,3084,38543
11-05-2017,4,13211,15282,6352,1652,36497,1472,1107,458,3037,39534
11-05-2017,5,14580,16150,6600,1632,38961,1509,1106,466,3081,42042
11-05-2017,6,18247,18346,7024,1980,45598,1588,1161,535,3284,48882
11-05-2017,7,19742,19982,7372,2793,49890,1605,1321,910,3836,53726
11-05-2017,8,19865,20279,7390,3058,50593,1608,1337,912,3857,54450
11-05-2017,9,19393,20056,7336,3022,49808,1609,1298,684,3591,53399
11-05-2017,10,19480,19695,7208,2932,49315,1608,1270,534,3412,52727
11-05-2017,11,19000,19372,6999,3121,48492,1604,1262,512,3378,51870
11-05-2017,12,19110,18842,6951,3093,47994,1627,1273,513,3413,51407
11-05-2017,13,19056,18566,6750,2962,47334,1636,1162,519,3317,50651
11-05-2017,14,18453,18293,6594,2910,46249,1635,1019,333,2987,49236
11-05-2017,15,18599,18374,6619,2885,46477,1643,1036,490,3169,49646
11-05-2017,16,18390,18461,6655,3070,46577,1658,1042,512,3212,49789
11-05-2017,17,18926,18762,6856,2997,47543,1644,1101,544,3289,50832
11-05-2017,18,19439,18834,6910,3247,48429,1640,1121,547,3308,51737
11-05-2017,19,18971,18777,6749,3465,47963,1632,1165,549,3346,51309
11-05-2017,20,18175,18190,6592,3307,46264,1609,1128,558,3295,49559
11-05-2017,21,17018,17546,6657,3006,44226,1606,1042,571,3219,47445
11-05-2017,22,15085,16732,6550,3077,41445,1616,1070,559,3245,44690
11-05-2017,23,13512,16151,6393,2987,39043,1618,1045,384,3047,42090
12-05-2017,0,12699,15386,6132,3050,37267,1610,575,114,2299,39566
12-05-2017,1,11301,14986,6078,3056,35421,1616,558,116,2290,37711
12-05-2017,2,10822,15005,6214,3180,35222,1612,453,118,2183,37405
12-05-2017,3,10727,14963,6124,3176,34989,1604,386,107,2097,37086
12-05-2017,4,11012,15114,6067,3259,35453,1601,576,109,2286,37739
12-05-2017,5,13001,16023,6239,3620,38885,1599,608,119,2326,41211
12-05-2017,6,16607,17624,6573,4182,44986,1662,991,580,3233,48219
12-05-2017,7,18298,19298,7116,4159,48873,1825,1006,386,3217,52090
12-05-2017,8,18248,19261,7203,4671,49382,1837,1081,502,3420,52802
12-05-2017,9,17495,19096,7177,4999,48767,1791,1074,634,3499,52266
12-05-2017,10,17427,18570,7136,5098,48232,1829,1072,522,3423,51655
12-05-2017,11,16836,18605,7080,5199,47721,1831,1065,358,3254,50975
12-05-2017,12,17057,18169,7057,5321,47604,1586,958,188,2732,50336
12-05-2017,13,16494,18122,6971,5300,46886,1581,876,156,2613,49499
12-05-2017,14,15573,17797,6594,5230,45193,1586,832,153,2571,47764
12-05-2017,15,15577,17466,6289,5078,44410,1596,836,121,2553,46963
12-05-2017,16,15692,17680,6238,4791,44400,1583,836,121,2540,46940
12-05-2017,17,16185,17837,6415,4696,45135,1564,784,116,2464,47599
12-05-2017,18,16570,17764,6556,4668,45558,1545,783,160,2488,48046
12-05-2017,19,16605,17539,6461,4544,45149,1334,743,339,2416,47565
12-05-2017,20,15725,17409,6181,4316,43630,1417,692,297,2406,46036
12-05-2017,21,15368,17131,6091,4242,42832,1529,710,219,2458,45290
12-05-2017,22,14837,17024,6074,4033,41968,1578,601,297,2476,44444
12-05-2017,23,13591,16599,5981,4021,40190,1567,599,321,2487,42677
13-05-2017,0,12059,15539,5983,3789,37371,1497,588,327,2412,39783
13-05-2017,1,11842,15271,5897,3725,36736,1504,588,306,2398,39134
13-05-2017,2,11525,15212,5839,3484,36060,1494,588,289,2371,38431
13-05-2017,3,11430,15142,5797,3307,35676,1502,590,268,2360,38036
13-05-2017,4,10931,15079,5831,3361,35202,1503,607,249,2359,37561
13-05-2017,5,11484,15008,5800,3219,35510,1506,687,213,2406,37916
13-05-2017,6,11884,14731,5738,2916,35270,1483,769,141,2393,37663
13-05-2017,7,14385,14996,5892,2808,38081,1452,802,197,2451,40532
13-05-2017,8,16646,15404,6144,2948,41143,1441,964,200,2605,43748
13-05-2017,9,17471,16080,6228,2931,42710,1424,1013,135,2572,45282
13-05-2017,10,17036,15967,6061,2869,41934,1435,1061,158,2654,44588
13-05-2017,11,16273,15783,5908,2494,40460,1437,918,156,2511,42971
13-05-2017,12,15422,15464,5930,2320,39136,1470,925,99,2494,41630
13-05-2017,13,13360,15105,5793,2300,36558,1587,917,119,2623,39181
13-05-2017,14,12423,15009,5732,2197,35360,1504,870,76,2450,37810
13-05-2017,15,12504,14983,5755,2001,35244,1506,908,75,2489,37733
13-05-2017,16,13171,15005,5826,1841,35845,1534,872,76,2482,38327
13-05-2017,17,15098,15317,5918,1862,38195,1597,910,78,2585,40780
13-05-2017,18,17038,16525,6095,2195,41853,1584,877,78,2539,44392
13-05-2017,19,17222,16940,6152,2011,42325,1584,870,112,2566,44891
13-05-2017,20,16596,16613,6031,1920,41161,1583,870,123,2576,43737
13-05-2017,21,16320,16399,6147,2058,40925,1590,888,155,2633,43558
13-05-2017,22,16078,16440,6237,2022,40779,1497,743,178,2418,43197
13-05-2017,23,15280,15896,6172,1734,39082,1506,746,203,2455,41537
14-05-2017,0,12691,14932,5838,1636,35099,1329,546,177,2052,37151
14-05-2017,1,11679,14654,5617,1453,33404,1166,544,161,1871,35275
14-05-2017,2,10502,14411,5588,1306,31808,1149,542,140,1831,33639
14-05-2017,3,9832,14155,5474,1198,30659,1153,544,112,1809,32468
14-05-2017,4,9501,14012,5520,1136,30169,1143,544,88,1775,31944
14-05-2017,5,9325,13856,5401,1038,29619,1103,542,67,1712,31331
14-05-2017,6,9625,13823,5511,1041,29999,1090,624,46,1760,31759
14-05-2017,7,10483,14014,5639,1140,31275,1059,637,74,1770,33045
14-05-2017,8,12000,14181,5667,1263,33111,1259,634,66,1959,35070
14-05-2017,9,13143,14450,5845,1489,34929,1279,677,88,2044,36973
14-05-2017,10,13603,14562,6035,1805,36005,1307,710,69,2086,38091
14-05-2017,11,13588,14731,5989,1877,36185,1414,581,76,2071,38256
14-05-2017,12,13494,14767,6063,1851,36176,1370,599,90,2059,38235
14-05-2017,13,13150,14567,6000,1847,35565,1402,732,111,2245,37810
14-05-2017,14,12824,14620,5966,1839,35250,1369,750,108,2227,37477
14-05-2017,15,12595,14607,5970,1858,35028,1355,851,82,2288,37316
14-05-2017,16,12987,14597,5935,1788,35306,1353,855,79,2287,37593
14-05-2017,17,13847,15061,6066,1750,36723,1354,788,74,2216,38939
14-05-2017,18,16086,15753,6277,1785,39901,1363,782,75,2220,42121
14-05-2017,19,17182,16208,6459,1983,41832,1363,877,78,2318,44150
14-05-2017,20,17313,16408,6508,1731,41962,1370,903,105,2378,44340
14-05-2017,21,17072,16310,6565,1526,41473,1379,888,110,2377,43850
14-05-2017,22,16403,16194,6434,1394,40426,1381,888,98,2367,42793
14-05-2017,23,15408,15667,6321,1306,38701,1396,760,97,2253,40954
15-05-2017,0,13376,14726,6225,1195,35522,1580,425,90,2095,37617
15-05-2017,1,11746,14325,6009,1138,33218,1592,408,128,2128,35346
15-05-2017,2,11357,14152,6008,1155,32672,1587,409,158,2154,34826
15-05-2017,3,10528,14167,6010,1120,31825,1571,406,165,2142,33967
15-05-2017,4,10696,14155,5966,1156,31974,1598,409,146,2153,34127
15-05-2017,5,13126,15386,6260,1326,36098,1644,565,124,2333,38431
15-05-2017,6,17415,17298,6696,1883,43293,1665,750,131,2546,45839
15-05-2017,7,18913,18906,7127,2053,46999,1662,821,270,2753,49752
15-05-2017,8,19393,19209,7316,2331,48251,1656,952,506,3114,51365
15-05-2017,9,19334,19376,7279,2398,48386,1657,1051,397,3105,51491
15-05-2017,10,19256,19334,7212,2615,48417,1661,1105,283,3049,51466
15-05-2017,11,19201,19235,7117,2756,48309,1664,931,214,2809,51118
15-05-2017,12,19066,19082,7037,2412,47598,1670,814,333,2817,50415
15-05-2017,13,18723,18937,6911,2654,47224,1692,814,303,2809,50033
15-05-2017,14,18311,18170,6690,2784,45954,1700,759,162,2621,48575
15-05-2017,15,17956,17470,6669,2619,44714,1700,760,162,2622,47336
15-05-2017,16,18288,17481,6631,2536,44937,1692,650,175,2517,47454
15-05-2017,17,18354,18071,6692,2599,45717,1704,704,181,2589,48306
15-05-2017,18,18584,18188,6769,2411,45955,1717,703,367,2787,48742
15-05-2017,19,18375,17997,6751,2296,45419,1729,694,355,2778,48197
15-05-2017,20,18343,17401,6621,1913,44278,1740,653,141,2534,46812
15-05-2017,21,18060,17300,6498,1808,43667,1771,664,150,2585,46252
15-05-2017,22,17650,16987,6234,1473,42345,1774,678,153,2605,44950
15-05-2017,23,15705,16507,6038,1317,39568,1757,643,88,2488,42056
16-05-2017,0,13927,14765,5807,1174,35674,1671,613,92,2376,38050
16-05-2017,1,13190,14124,5571,1387,34272,1647,600,84,2331,36603
16-05-2017,2,12472,13973,5577,1545,33568,1643,602,89,2334,35902
16-05-2017,3,12199,13856,5658,1674,33388,1627,602,100,2329,35717
16-05-2017,4,12161,13842,5704,1908,33616,1632,605,83,2320,35936
16-05-2017,5,13398,14675,6056,2116,36246,1654,710,70,2434,38680
16-05-2017,6,16725,16488,6495,2322,42031,1727,788,96,2611,44642
16-05-2017,7,18508,18020,6765,3112,46405,1738,973,306,3017,49422
16-05-2017,8,18891,17878,6878,3535,47183,1715,1019,481,3215,50398
16-05-2017,9,18810,17944,6783,3614,47152,1692,1015,521,3228,50380
16-05-2017,10,18688,17891,6716,3546,46840,1700,972,485,3157,49997
16-05-2017,11,18631,18004,6714,3506,46854,1724,920,453,3097,49951
16-05-2017,12,18237,18179,6761,3386,46562,1733,809,449,2991,49553
16-05-2017,13,18082,18291,6764,3327,46464,1730,851,272,2853,49317
16-05-2017,14,17954,18382,6378,3235,45950,1726,846,88,2660,48610
16-05-2017,15,17492,18433,6159,3045,45129,1722,812,99,2633,47762
16-05-2017,16,17195,18464,6104,2927,44691,1709,907,103,2719,47410
16-05-2017,17,17701,18685,6213,3039,45639,1697,839,122,2658,48297
16-05-2017,18,17970,18709,6455,2846,45978,1684,832,124,2640,48618
16-05-2017,19,17737,18702,6506,2616,45560,1671,740,149,2560,48120
16-05-2017,20,16808,18487,6318,2316,43928,1671,739,120,2530,46458
16-05-2017,21,16081,18477,6277,2173,43008,1670,659,103,2432,45440
16-05-2017,22,14879,18154,6278,2108,41418,1669,666,86,2421,43839
16-05-2017,23,13117,17436,6098,2029,38681,1646,689,147,2482,41163
17-05-2017,0,13181,15901,6140,1960,37184,1245,601,150,1996,39180
17-05-2017,1,12914,15372,6111,1921,36319,1222,591,134,1947,38266
17-05-2017,2,12387,15412,6098,1781,35677,1248,610,140,1998,37675
17-05-2017,3,12252,15186,6049,1819,35305,1275,623,145,2043,37348
17-05-2017,4,12393,15140,5986,1788,35307,1325,619,131,2075,37382
17-05-2017,5,13340,16137,6187,1775,37440,1583,622,133,2338,39778
17-05-2017,6,15940,17402,6553,1899,41794,1697,702,139,2538,44332
17-05-2017,7,17230,19343,6999,2355,45929,1693,862,144,2699,48628
17-05-2017,8,18268,19631,7062,2528,47489,1702,978,322,3002,50491
17-05-2017,9,18380,19334,7170,2645,47528,1683,1019,325,3027,50555
17-05-2017,10,17707,18983,7021,2603,46314,1511,1039,243,2793,49107
17-05-2017,11,17107,18594,6962,2470,45134,1546,954,244,2744,47878
17-05-2017,12,17016,17953,6968,2261,44198,1704,836,393,2933,47131
17-05-2017,13,16997,17512,6876,2212,43596,1706,849,369,2924,46520
17-05-2017,14,16864,17287,6664,1868,42683,1711,841,99,2651,45334
17-05-2017,15,16726,17226,6566,1676,42194,1721,847,80,2648,44842
17-05-2017,16,16714,17298,6450,1797,42261,1714,952,73,2739,45000
17-05-2017,17,16997,18043,6742,2213,43994,1697,852,72,2621,46615
17-05-2017,18,16953,18178,6778,2257,44167,1687,853,494,3034,47201
17-05-2017,19,16876,17817,6605,2102,43399,1698,740,362,2800,46199
17-05-2017,20,16848,16969,6253,2052,42122,1718,745,123,2586,44708
17-05-2017,21,16746,16304,6037,2026,41112,1735,734,113,2582,43694
17-05-2017,22,15935,15630,5820,2336,39721,1744,711,123,2578,42299
17-05-2017,23,13644,14705,5637,2701,36688,1660,680,72,2412,39100
18-05-2017,0,12799,13179,5547,3027,34552,1239,550,60,1849,36401
18-05-2017,1,11660,13085,5362,3326,33434,1203,542,66,1811,35245
18-05-2017,2,10952,13066,5259,3417,32693,1192,539,82,1813,34506
18-05-2017,3,10693,13101,5279,3342,32414,1177,544,91,1812,34226
18-05-2017,4,11035,13151,5355,3309,32850,1173,543,89,1805,34655
18-05-2017,5,12770,14213,5638,3304,35926,1277,648,80,2005,37931
18-05-2017,6,14960,15466,6262,3354,40042,1571,795,88,2454,42496
18-05-2017,7,17566,16767,6586,3415,44334,1662,866,304,2832,47166
18-05-2017,8,18033,17690,6685,3378,45783,1671,970,483,3124,48907
18-05-2017,9,17925,17819,6711,3492,45948,1674,1039,488,3201,49149
18-05-2017,10,17700,17851,6682,3713,45946,1678,1004,467,3149,49095
18-05-2017,11,17952,18534,6737,3218,46442,1669,884,465,3018,49460
18-05-2017,12,17579,18565,6746,3038,45928,1670,878,470,3018,48946
18-05-2017,13,17683,18378,6703,2780,45544,1677,865,484,3026,48570
18-05-2017,14,17768,18467,6329,2809,45373,1677,852,81,2610,47983
18-05-2017,15,17732,18473,6088,2614,44907,1672,801,99,2572,47479
18-05-2017,16,17694,18624,6106,2423,44849,1672,777,77,2526,47375
18-05-2017,17,18039,18640,6281,2259,45220,1672,792,91,2555,47775
18-05-2017,18,18029,18615,6475,2109,45228,1669,767,97,2533,47761
18-05-2017,19,18018,18532,6565,1685,44801,1651,766,101,2518,47319
18-05-2017,20,17624,18257,6337,1577,43795,1640,767,107,2514,46309
18-05-2017,21,17308,17728,6189,1464,42690,1646,769,168,2583,45273
18-05-2017,22,16825,16990,6171,1360,41346,1659,616,110,2385,43731
18-05-2017,23,15664,16336,6024,1160,39184,1364,603,131,2098,41282
19-05-2017,0,14757,15071,6054,810,36693,1214,472,170,1856,38549
19-05-2017,1,14395,14431,6037,828,35692,1242,463,191,1896,37588
19-05-2017,2,14187,13939,6070,786,34983,1248,515,189,1952,36935
19-05-2017,3,14230,13731,6042,712,34717,1243,520,181,1944,36661
19-05-2017,4,14273,13708,6047,621,34650,1246,522,166,1934,36584
19-05-2017,5,14983,14607,6253,632,36475,1374,518,138,2030,38505
19-05-2017,6,17021,16681,6389,743,40835,1606,599,119,2324,43159
19-05-2017,7,18106,18802,6806,1236,44951,1709,743,316,2768,47719
19-05-2017,8,18248,19094,7033,1604,45980,1697,875,476,3048,49028
19-05-2017,9,18415,19243,6910,1772,46340,1704,926,472,3102,49442
19-05-2017,10,18338,19333,6878,1640,46189,1710,955,497,3162,49351
19-05-2017,11,18013,19277,6818,1421,45530,1712,842,559,3113,48643
19-05-2017,12,17942,18853,6690,1340,44824,1716,831,450,2997,47821
19-05-2017,13,17775,18545,6500,1596,44416,1709,819,433,2961,47377
19-05-2017,14,17443,18219,6428,1782,43872,1704,835,220,2759,46631
19-05-2017,15,17473,17919,6220,1621,43233,1659,985,64,2708,45941
19-05-2017,16,17296,17740,6126,1312,42475,1685,933,54,2672,45147
19-05-2017,17,17136,17961,6030,1615,42743,1635,898,59,2592,45335
19-05-2017,18,17080,17580,6026,1610,42297,1641,819,211,2671,44968
19-05-2017,19,17082,17720,6014,1389,42204,1652,783,162,2597,44801
19-05-2017,20,16694,17087,5932,1152,40865,1397,828,55,2280,43145
19-05-2017,21,15906,16716,5894,1111,39626,1212,811,75,2098,41724
19-05-2017,22,15244,16292,5954,1125,38616,1102,705,93,1900,40516
19-05-2017,23,14365,15990,5745,1095,37194,1039,626,116,1781,38975
20-05-2017,0,12860,15091,5733,1238,34922,955,391,127,1473,36395
20-05-2017,1,12298,14587,5751,1391,34027,886,385,101,1372,35399
20-05-2017,2,11815,14294,5739,1466,33315,885,476,83,1444,34759
20-05-2017,3,11658,14200,5852,1468,33176,859,477,67,1403,34579
20-05-2017,4,11425,14088,5864,1466,32843,854,482,56,1392,34235
20-05-2017,5,11614,13942,5824,1516,32896,868,501,40,1409,34305
20-05-2017,6,12298,14076,5718,1636,33728,871,562,28,1461,35189
20-05-2017,7,13520,15227,5734,1778,36260,863,697,22,1582,37842
20-05-2017,8,15159,16306,5740,2019,39224,887,699,28,1614,40838
20-05-2017,9,15079,16783,5782,2287,39932,947,689,129,1765,41697
20-05-2017,10,14212,16445,5811,2434,38903,977,702,120,1799,40702
20-05-2017,11,13707,16350,5848,2456,38362,956,652,97,1705,40067
20-05-2017,12,13313,16408,5772,2485,37978,992,656,78,1726,39704
20-05-2017,13,13118,16346,5687,2408,37559,945,642,80,1667,39226
20-05-2017,14,12955,16363,5664,2481,37463,935,636,73,1644,39107
20-05-2017,15,13020,16616,5644,2409,37688,941,630,84,1655,39343
20-05-2017,16,13847,16755,5684,2331,38618,955,690,90,1735,40353
20-05-2017,17,14731,16825,5792,2159,39506,1021,741,94,1856,41362
20-05-2017,18,16051,17148,5748,2024,40971,1047,740,146,1933,42904
20-05-2017,19,16436,17178,5641,1862,41117,1034,743,155,1932,43049
20-05-2017,20,16341,16885,5655,1568,40450,917,711,150,1778,42228
20-05-2017,21,16238,16747,5715,1380,40080,900,663,162,1725,41805
20-05-2017,22,16293,16425,5741,1335,39793,906,522,136,1564,41357
20-05-2017,23,15345,16191,5659,1257,38452,904,517,122,1543,39995
21-05-2017,0,12946,15767,5663,1174,35550,848,385,77,1310,36860
21-05-2017,1,11407,15612,5667,1083,33769,839,381,76,1296,35065
21-05-2017,2,10800,15314,5663,1045,32823,820,378,69,1267,34090
21-05-2017,3,10552,15212,5563,1077,32404,806,379,54,1239,33643
21-05-2017,4,10244,15004,5500,1049,31798,800,382,48,1230,33028
21-05-2017,5,10034,14633,5493,1104,31265,791,380,39,1210,32475
21-05-2017,6,10104,14540,5442,1155,31241,784,589,31,1404,32645
21-05-2017,7,10694,15308,5379,1236,32617,782,695,26,1503,34120
21-05-2017,8,11186,15887,5450,1454,33976,805,695,29,1529,35505
21-05-2017,9,11564,16064,5601,1897,35128,808,692,76,1576,36704
21-05-2017,10,11771,16105,5652,2196,35723,805,693,132,1630,37353
21-05-2017,11,12017,16265,5601,2250,36134,798,694,99,1591,37725
21-05-2017,12,11823,16352,5633,2169,35977,801,637,100,1538,37515
21-05-2017,13,11558,16306,5553,2298,35715,806,586,118,1510,37225
21-05-2017,14,11611,16414,5390,2209,35625,800,585,167,1552,37177
21-05-2017,15,11582,16735,5423,1946,35686,796,641,168,1605,37291
21-05-2017,16,11982,17048,5400,1805,36235,799,640,196,1635,37870
21-05-2017,17,12969,17386,5436,1631,37423,806,640,238,1684,39107
21-05-2017,18,15202,17655,5468,1465,39789,801,640,255,1696,41485
21-05-2017,19,16205,18015,5550,1424,41194,798,643,274,1715,42909
21-05-2017,20,15800,18049,5515,1597,40963,794,643,250,1687,42650
21-05-2017,21,15704,18091,5524,1489,40809,806,639,224,1669,42478
21-05-2017,22,15536,18019,5537,1383,40475,816,491,150,1457,41932
21-05-2017,23,14710,17643,5503,1133,38990,868,489,137,1494,40484
22-05-2017,0,13740,16428,5503,1006,,887,299,167,1353,
22-05-2017,1,13396,15972,5475,779,35623,924,296,175,1395,37018
22-05-2017,2,13292,15835,5558,766,35450,965,299,155,1419,36869
22-05-2017,3,13120,15766,5558,814,35259,1008,399,145,1552,36811
22-05-2017,4,13256,15771,5647,820,35494,1054,428,138,1620,37114
22-05-2017,5,14206,16382,5805,954,37348,1103,450,171,1724,39072
22-05-2017,6,16187,17643,6037,1355,41223,1293,606,215,2114,43337
22-05-2017,7,17695,19662,6174,1593,45125,1452,748,614,2814,47939
22-05-2017,8,17620,19863,6202,1692,45379,1499,761,927,3187,48566
22-05-2017,9,17498,19705,6207,1685,45095,1520,698,932,3150,48245
22-05-2017,10,17741,19472,6279,1652,45145,1541,597,928,3066,48211
22-05-2017,11,17637,19183,6256,1829,44906,1541,541,912,2994,47900
22-05-2017,12,17735,19258,6181,2040,45213,1543,537,1013,3093,48306
22-05-2017,13,17769,19311,6109,2203,45393,1553,561,869,2983,48376
22-05-2017,14,17697,19230,6049,2047,45023,1568,533,629,2730,47753
22-05-2017,15,17672,19047,6018,1980,44718,1567,528,593,2688,47406
22-05-2017,16,17355,18796,5899,1913,43962,1558,595,444,2597,46559
22-05-2017,17,17317,18831,5859,1869,43877,1556,589,576,2721,46598
22-05-2017,18,17194,18836,5885,1688,43603,1551,547,816,2914,46517
22-05-2017,19,17285,18774,5865,1531,43456,1534,547,793,2874,46330
22-05-2017,20,16971,18246,5779,1396,42391,1521,547,546,2614,45005
22-05-2017,21,16663,17968,5760,1331,41722,1509,546,469,2524,44246
22-05-2017,22,16323,17610,5915,1313,41163,1467,538,304,2309,43472
22-05-2017,23,15268,17095,5869,1178,39408,1387,518,273,2178,41586
23-05-2017,0,13443,16187,5916,882,36429,1184,435,59,1678,38107
23-05-2017,1,12649,15968,5966,858,35441,1155,523,54,1732,37173
23-05-2017,2,12250,15939,6081,887,35159,1158,526,66,1750,36909
23-05-2017,3,12291,15905,6158,1001,35355,1149,596,85,1830,37185
23-05-2017,4,12633,15915,6110,905,35564,1160,607,106,1873,37437
23-05-2017,5,13615,16569,6098,898,37181,1389,707,109,2205,39386
23-05-2017,6,16704,17670,6097,1552,42023,1533,712,145,2390,44413
23-05-2017,7,17805,19539,6446,1820,45611,1522,770,516,2808,48419
23-05-2017,8,17875,19591,6694,1875,46034,1509,787,544,2840,48874
23-05-2017,9,17631,19102,6704,1594,45032,1471,773,568,2812,47844
23-05-2017,10,17393,19102,6620,1638,44753,1483,814,587,2884,47637
23-05-2017,11,17185,19256,6567,1753,44760,1490,714,607,2811,47571
23-05-2017,12,17093,18486,6487,1707,43774,1485,727,653,2865,46639
23-05-2017,13,17786,18235,6492,1802,44316,1460,715,686,2861,47177
23-05-2017,14,17404,17727,6347,1916,43394,1426,700,291,2417,45811
23-05-2017,15,17010,17215,6102,2080,42408,1449,771,220,2440,44848
23-05-2017,16,17094,17163,5977,2090,42325,1483,720,197,2400,44725
23-05-2017,17,17736,17171,6038,1950,42896,1427,705,163,2295,45191
23-05-2017,18,17571,17280,6039,2066,42958,1431,623,163,2217,45175
23-05-2017,19,17000,17134,5985,2191,42310,1438,601,355,2394,44704
23-05-2017,20,16632,16704,5946,2035,41318,1427,505,339,2271,43589
23-05-2017,21,16325,16382,5905,2207,40820,1371,501,278,2150,42970
23-05-2017,22,16040,16016,5946,2428,40431,1259,506,68,1833,42264
23-05-2017,23,14182,15692,5974,2673,38521,1197,494,53,1744,40265
24-05-2017,0,11379,15038,5958,3041,35416,1159,405,46,1610,37026
24-05-2017,1,10718,14648,5992,3172,34531,0,394,49,443,34974
24-05-2017,2,10577,14535,5977,3164,34253,0,373,45,418,34671
24-05-2017,3,10561,14253,6020,3073,33907,1005,483,51,1539,35446
24-05-2017,4,10567,14268,6007,3064,33907,1049,465,49,1563,35470
24-05-2017,5,11803,15446,6210,3086,36545,1254,478,46,1778,38323
24-05-2017,6,15042,16395,6485,3143,41066,1404,567,66,2037,43103
24-05-2017,7,17563,18182,6683,3386,45815,1421,725,110,2256,48071
24-05-2017,8,18028,18451,6695,3738,46913,1409,779,434,2622,49535
24-05-2017,9,17671,18334,6721,3709,46434,1397,754,447,2598,49032
24-05-2017,10,17984,18031,6694,3384,46092,1405,766,363,2534,48626
24-05-2017,11,18254,17997,6666,3579,46497,1401,698,416,2515,49012
24-05-2017,12,18032,17786,6706,3404,45929,1413,720,449,2582,48511
24-05-2017,13,17897,17580,6690,3318,45485,1413,719,277,2409,47894
24-05-2017,14,17423,17639,6441,3361,44865,1400,660,318,2378,47243
24-05-2017,15,16886,17251,6328,3395,43859,1419,732,165,2316,46175
24-05-2017,16,16849,17327,6292,3323,43791,1409,727,184,2320,46111
24-05-2017,17,16777,17880,6244,3330,44231,1404,718,180,2302,46533
24-05-2017,18,16715,17506,6187,3202,43610,1382,710,204,2296,45906
24-05-2017,19,16663,17602,6168,3078,43512,1360,611,188,2159,45671
24-05-2017,20,16034,17344,6096,2834,42307,1311,483,201,1995,44302
24-05-2017,21,15670,16817,6003,2737,41226,1319,462,181,1962,43188
24-05-2017,22,15195,16574,6051,2684,40503,1129,484,146,1759,42262
24-05-2017,23,14070,15979,6168,2607,38825,1097,509,130,1736,40561
25-05-2017,0,12892,14869,6206,2607,36573,1019,411,115,1545,38118
25-05-2017,1,12100,14584,5997,2803,35486,1018,395,113,1526,37012
25-05-2017,2,11727,14334,6029,2745,34835,1029,395,99,1523,36358
25-05-2017,3,11326,14159,6048,2758,34291,1025,397,79,1501,35792
25-05-2017,4,11051,14215,6052,2742,34060,1022,393,71,1486,35546
25-05-2017,5,12055,14414,6046,2703,35219,1030,344,66,1440,36659
25-05-2017,6,12983,15022,5958,2628,36590,1020,469,147,1636,38226
25-05-2017,7,13938,16088,5919,2769,38712,1070,574,310,1954,40666
25-05-2017,8,14829,16366,6032,3018,40245,1271,614,492,2377,42622
25-05-2017,9,14810,16715,6048,3155,40729,1292,671,528,2491,43220
25-05-2017,10,14227,16059,6126,3087,39500,1342,687,560,2589,42089
25-05-2017,11,14994,15907,6186,3051,40139,1381,487,607,2475,42614
25-05-2017,12,13874,15830,6146,2931,38781,1294,497,633,2424,41205
25-05-2017,13,12719,15990,6134,2871,37713,1179,496,671,2346,40059
25-05-2017,14,12346,16301,6081,2678,37406,1148,477,453,2078,39484
25-05-2017,15,11942,16270,5998,2645,36855,1150,540,340,2030,38885
25-05-2017,16,12676,15998,6067,2548,37289,1175,541,326,2042,39331
25-05-2017,17,14612,16246,6102,2471,39432,1177,506,271,1954,41386
25-05-2017,18,16149,16686,6108,2363,41307,1299,474,205,1978,43285
25-05-2017,19,16733,16692,6138,2136,41700,1412,441,199,2052,43752
25-05-2017,20,16295,16532,6201,2004,41033,1381,438,208,2027,43060
25-05-2017,21,16017,16404,6223,2023,40668,1443,435,177,2055,42723
25-05-2017,22,15636,16152,6196,2314,40299,1325,415,108,1848,42147
25-05-2017,23,13841,15401,6257,2395,37893,1163,397,86,1646,39539
26-05-2017,0,11964,14793,6439,2262,35456,1171,186,75,1432,36888
26-05-2017,1,11426,14404,6367,2267,34463,1166,179,56,1401,35864
26-05-2017,2,11143,14222,6421,2175,33962,1136,233,45,1414,35376
26-05-2017,3,10895,13949,6442,1939,33226,1122,236,40,1398,34624
26-05-2017,4,11494,13984,6443,1715,33636,1118,244,37,1399,35035
26-05-2017,5,13123,14416,6486,1610,35635,1332,335,36,1703,37338
26-05-2017,6,15591,15524,6561,1699,39374,1400,372,190,1962,41336
26-05-2017,7,16689,17149,6675,1911,42424,1437,522,214,2173,44597
26-05-2017,8,16961,17788,6691,1922,43361,1445,638,389,2472,45833
26-05-2017,9,17072,17679,6763,1856,43370,1448,554,479,2481,45851
26-05-2017,10,17152,17565,6736,1671,43124,1460,553,485,2498,45622
26-05-2017,11,16957,17289,6687,1542,42474,1461,575,485,2521,44995
26-05-2017,12,16630,16702,6654,1563,41550,1391,485,491,2367,43917
26-05-2017,13,16240,15900,6566,1528,40235,1395,520,498,2413,42648
26-05-2017,14,15992,15706,6466,1573,39738,1300,496,204,2000,41738
26-05-2017,15,15846,15680,6419,1556,39501,1285,570,94,1949,41450
26-05-2017,16,16245,15802,6382,1482,39910,1408,570,123,2101,42011
26-05-2017,17,16732,16655,6398,1603,41388,1500,622,152,2274,43662
26-05-2017,18,16814,17207,6349,1560,41931,1525,580,151,2256,44187
26-05-2017,19,16807,17057,6209,1303,41376,1550,608,137,2295,43671
26-05-2017,20,16404,16007,6110,1160,39682,1503,595,146,2244,41926
26-05-2017,21,15926,15607,6069,1095,38696,1481,412,161,2054,40750
26-05-2017,22,15766,15342,6130,1067,38305,1471,319,170,1960,40265
26-05-2017,23,15397,14742,6078,987,37203,1163,338,175,1676,38879
27-05-2017,0,14184,14105,5905,790,34984,1012,346,149,1507,36491
27-05-2017,1,13439,13777,5838,639,33692,1016,345,128,1489,35181
27-05-2017,2,13046,13577,5870,516,33010,994,348,115,1457,34467
27-05-2017,3,12720,13617,5915,503,32757,957,352,91,1400,34157
27-05-2017,4,12361,13560,5895,439,32256,930,361,76,1367,33623
27-05-2017,5,12169,13545,5936,440,32091,932,446,87,1465,33556
27-05-2017,6,13123,13738,5982,572,33415,933,559,88,1580,34995
27-05-2017,7,14478,14263,5966,768,35475,906,631,66,1603,37078
27-05-2017,8,15423,15620,5902,887,37830,1011,726,63,1800,39630
27-05-2017,9,15629,16077,5919,1090,38715,1043,773,62,1878,40593
27-05-2017,10,14975,15386,5949,1232,37543,1035,765,67,1867,39410
27-05-2017,11,14107,15053,5961,1347,36469,1048,456,47,1551,38020
27-05-2017,12,13741,14969,5968,1371,36050,1061,409,106,1576,37626
27-05-2017,13,13507,14903,6000,1362,35773,1057,419,133,1609,37382
27-05-2017,14,13206,14795,5986,1356,35345,1025,504,134,1663,37008
27-05-2017,15,13182,14828,6024,1425,35460,1042,509,128,1679,37139
27-05-2017,16,13759,14744,6077,1409,35989,1044,504,142,1690,37679
27-05-2017,17,15644,15883,6067,1384,38980,1054,513,138,1705,40685
27-05-2017,18,16093,16714,6011,1307,40124,1060,510,292,1862,41986
27-05-2017,19,15968,16675,5997,1331,39970,1037,558,281,1876,41846
27-05-2017,20,15657,16392,6000,1459,39508,1033,513,145,1691,41199
27-05-2017,21,15198,16008,5965,1642,38812,1049,460,127,1636,40448
27-05-2017,22,14303,15591,5944,1866,37706,904,410,143,1457,39163
27-05-2017,23,13078,14949,5946,2066,36039,900,280,151,1331,37370
28-05-2017,0,10620,13277,5686,2266,31850,802,155,173,1130,32980
28-05-2017,1,9821,12910,5571,2522,30823,815,153,200,1168,31991
28-05-2017,2,9742,13065,5539,2557,30904,817,156,222,1195,32099
28-05-2017,3,9557,13137,5549,2411,30655,812,169,240,1221,31876
28-05-2017,4,9338,13176,5662,2149,30326,790,251,209,1250,31576
28-05-2017,5,9010,12979,5630,1979,29597,796,279,153,1228,30825
28-05-2017,6,9454,13121,5616,1860,30049,791,374,116,1281,31330
28-05-2017,7,10400,13488,5731,1825,31444,826,450,109,1385,32829
28-05-2017,8,10971,14112,5781,1835,32702,854,591,118,1563,34265
28-05-2017,9,11725,14697,5866,1997,34285,877,643,130,1650,35935
28-05-2017,10,12207,15230,5925,2197,35558,885,644,153,1682,37240
28-05-2017,11,11965,15449,5949,2221,35584,903,644,152,1699,37283
28-05-2017,12,11588,15209,5987,2546,35331,884,564,157,1605,36936
28-05-2017,13,11004,15279,5953,2928,35163,907,518,174,1599,36762
28-05-2017,14,11048,15297,5893,3058,35297,925,522,168,1615,36912
28-05-2017,15,11193,15360,5839,3026,35418,937,524,146,1607,37025
28-05-2017,16,11865,15505,5845,3002,36217,971,529,137,1637,37854
28-05-2017,17,13205,16335,5839,3052,38432,973,536,109,1618,40050
28-05-2017,18,14156,17288,5845,3022,40313,980,526,116,1622,41935
28-05-2017,19,14366,17296,5853,2850,40364,1046,473,160,1679,42043
28-05-2017,20,14642,17249,5788,2797,40478,1010,487,238,1735,42213
28-05-2017,21,14490,17234,5834,2597,40155,1003,553,297,1853,42008
28-05-2017,22,13927,16852,6106,2531,39416,977,454,355,1786,41202
28-05-2017,23,12791,16145,6231,2392,37559,963,183,398,1544,39103
29-05-2017,0,11318,14740,6268,2356,,910,165,391,1466,
29-05-2017,1,10877,14450,6300,2351,33979,917,170,334,1421,35400
29-05-2017,2,10853,14206,6338,2282,33679,926,165,314,1405,35084
29-05-2017,3,11102,14015,6333,1905,33355,945,168,301,1414,34769
29-05-2017,4,11529,13786,6323,1721,33360,974,265,276,1515,34875
29-05-2017,5,13247,14393,6347,1726,35715,1071,378,246,1695,37410
29-05-2017,6,15546,16379,6461,1996,40382,1345,537,242,2124,42506
29-05-2017,7,17005,17770,6630,2067,43472,1444,705,533,2682,46154
29-05-2017,8,17815,18125,6685,2150,44775,1452,945,856,3253,48028
29-05-2017,9,17792,18153,6634,2070,44649,1470,890,1007,3367,48016
29-05-2017,10,17601,18004,6670,2097,44373,1469,861,1111,3441,47814
29-05-2017,11,17249,17810,6590,1995,43644,1474,650,1092,3216,46860
29-05-2017,12,17191,17406,6643,1996,43236,1489,640,852,2981,46217
29-05-2017,13,17203,17253,6565,1986,43006,1465,589,846,2900,45906
29-05-2017,14,17113,17114,6484,1845,42554,1438,559,729,2726,45280
29-05-2017,15,17090,17507,6478,1633,42709,1422,558,644,2624,45333
29-05-2017,16,17026,17569,6436,1871,42901,1417,549,942,2908,45809
29-05-2017,17,17154,17576,6497,2033,43261,1410,551,1047,3008,46269
29-05-2017,18,16966,17693,6436,2048,43141,1399,649,996,3044,46185
29-05-2017,19,16723,17662,6400,1916,42701,1386,613,844,2843,45544
29-05-2017,20,16592,17078,6317,1633,41620,1364,563,779,2706,44326
29-05-2017,21,16688,16798,6303,1482,41272,1359,505,616,2480,43752
29-05-2017,22,16169,16239,6320,1424,40152,1349,398,522,2269,42421
29-05-2017,23,15693,15136,6315,1028,38172,1336,212,366,1914,40086
30-05-2017,0,15018,13737,6135,720,35610,1185,209,298,1692,37302
30-05-2017,1,14629,13368,6114,754,34866,1187,208,303,1698,36564
30-05-2017,2,14382,13218,6111,661,34374,1189,208,291,1688,36062
30-05-2017,3,14334,13102,6143,667,34245,1196,211,282,1689,35934
30-05-2017,4,14359,13212,6149,671,34391,1207,212,266,1685,36076
30-05-2017,5,14981,14051,6103,858,35994,1317,223,253,1793,37787
30-05-2017,6,15809,15212,6231,1445,38698,1373,312,390,2075,40773
30-05-2017,7,17017,17250,6378,1878,42524,1416,463,921,2800,45324
30-05-2017,8,17663,17769,6435,2015,43883,1401,862,933,3196,47079
30-05-2017,9,17515,17873,6391,2045,43824,1410,720,932,3062,46886
30-05-2017,10,17554,17933,6432,2315,44234,1425,707,897,3029,47263
30-05-2017,11,17283,17703,6434,2292,43713,1447,563,907,2917,46630
30-05-2017,12,17366,17537,6454,2315,43672,1449,587,783,2819,46491
30-05-2017,13,17566,17591,6381,2290,43829,1463,567,704,2734,46563
30-05-2017,14,17437,17287,6317,2379,43419,1460,551,489,2500,45919
30-05-2017,15,17294,16959,6370,2627,43248,1454,543,495,2492,45740
30-05-2017,16,17139,16562,6399,2703,42803,1442,561,567,2570,45373
30-05-2017,17,16968,16846,6420,2957,43190,1451,566,872,2889,46079
30-05-2017,18,16733,17027,6383,3127,43270,1448,632,741,2821,46091
30-05-2017,19,16828,17042,6355,3126,43352,1454,620,527,2601,45953
30-05-2017,20,16476,16450,6326,3160,42412,1473,509,477,2459,44871
30-05-2017,21,16401,15942,6192,2804,41340,1495,507,471,2473,43813
30-05-2017,22,15777,15513,6099,2508,39898,1481,383,377,2241,42139
30-05-2017,23,14241,14825,6035,2658,37760,1476,216,493,2185,39945
31-05-2017,0,12367,14026,5863,2741,34996,1166,213,225,1604,36600
31-05-2017,1,11668,13621,5834,3089,34212,1062,211,215,1488,35700
31-05-2017,2,11363,13497,5756,3323,33939,1070,212,231,1513,35452
31-05-2017,3,11082,13409,5774,3680,33944,1073,216,264,1553,35497
31-05-2017,4,10781,13400,5838,3980,34000,1075,218,286,1579,35579
31-05-2017,5,11686,14485,5983,4105,36261,1178,223,351,1752,38013
31-05-2017,6,14130,15539,6243,4304,40217,1380,316,365,2061,42278
31-05-2017,7,16060,17663,6263,4591,44577,1423,482,601,2506,47083
31-05-2017,8,16397,18048,6390,4822,45658,1437,528,798,2763,48421
31-05-2017,9,16343,17408,6571,5013,45335,1434,572,675,2681,48016
31-05-2017,10,16182,17483,6680,5121,45466,1447,629,614,2690,48156
31-05-2017,11,16055,17457,6692,5213,45418,1443,589,569,2601,48019
31-05-2017,12,15859,17313,6672,5220,45066,1425,663,412,2500,47566
31-05-2017,13,15945,17446,6554,5205,45152,1411,599,426,2436,47588
31-05-2017,14,15407,17371,6585,5260,44623,1376,607,438,2421,47044
31-05-2017,15,15064,17001,6578,5240,43882,1389,545,436,2370,46252
31-05-2017,16,14907,16674,6525,5196,43303,1382,538,434,2354,45657
31-05-2017,17,15190,16648,6504,5071,43414,1392,536,419,2347,45761
31-05-2017,18,15596,16632,6391,4931,43551,1424,534,499,2457,46008
31-05-2017,19,15975,16521,6389,4743,43629,1429,554,445,2428,46057
31-05-2017,20,15416,16507,6392,4475,42791,1427,475,401,2303,45094
31-05-2017,21,15615,16262,6335,4169,42381,1368,393,351,2112,44493
31-05-2017,22,15048,16110,6385,4024,41566,1209,371,315,1895,43461
31-05-2017,23,13707,15890,6499,3776,39874,1186,304,304,1794,41668
01-06-2017,0,11562,15447,6538,3678,37225,1115,305,270,1690,38915
01-06-2017,1,11355,15212,6550,3581,36699,1103,301,240,1644,38343
01-06-2017,2,11071,15216,6543,3392,36222,1083,303,222,1608,37830
01-06-2017,3,11024,15221,6598,3210,36055,1053,305,224,1582,37637
01-06-2017,4,11189,15257,6491,3065,36002,1093,307,230,1630,37632
01-06-2017,5,12838,15924,6408,2988,38159,1247,321,206,1774,39933
01-06-2017,6,16520,16976,6631,3166,43293,1327,492,157,1976,45269
01-06-2017,7,17497,18696,6721,3771,46684,1380,564,154,2098,48782
01-06-2017,8,17460,18109,6926,3945,46440,1412,760,416,2588,49028
01-06-2017,9,17295,17497,6967,3826,45585,1442,767,163,2372,47957
01-06-2017,10,17269,17418,6978,3688,45353,1470,771,160,2401,47754
01-06-2017,11,17386,17575,7039,3610,45611,1480,721,216,2417,48028
01-06-2017,12,17007,17379,7032,3524,44944,1468,672,270,2410,47354
01-06-2017,13,16901,17343,7051,3462,44756,1463,621,317,2401,47157
01-06-2017,14,16909,17333,7040,3299,44582,1470,576,352,2398,46980
01-06-2017,15,16740,17551,7008,3310,44607,1460,552,298,2310,46917
01-06-2017,16,16473,17492,6986,3309,44259,1435,549,377,2361,46620
01-06-2017,17,16431,17834,7058,3411,44733,1437,597,326,2360,47093
01-06-2017,18,16545,17846,7003,3175,44570,1402,597,313,2312,46882
01-06-2017,19,16957,17961,7106,2868,44892,1393,600,257,2250,47142
01-06-2017,20,16728,17519,7157,2441,43846,1373,462,145,1980,45826
01-06-2017,21,16536,16796,7168,2394,42894,1367,390,155,1912,44806
01-06-2017,22,16446,16044,7254,2358,42100,1367,314,144,1825,43925
01-06-2017,23,15441,15448,7219,2084,40192,1359,210,116,1685,41877
02-06-2017,0,14703,14661,7130,1752,38245,1090,208,109,1407,39652
02-06-2017,1,13681,14561,7072,1705,37020,1084,212,96,1392,38412
02-06-2017,2,13083,14424,7069,1565,36140,1081,211,107,1399,37539
02-06-2017,3,12928,14348,7099,1409,35783,1079,226,128,1433,37216
02-06-2017,4,12997,14291,7148,1350,35785,1092,278,145,1515,37300
02-06-2017,5,14266,15328,7196,1280,38071,1271,406,146,1823,39894
02-06-2017,6,15944,16830,7314,1607,41695,1353,538,119,2010,43705
02-06-2017,7,17151,17898,7360,1828,44237,1373,563,109,2045,46282
02-06-2017,8,17621,17971,7523,1914,45029,1409,704,249,2362,47391
02-06-2017,9,17704,17691,7586,2037,45020,1434,744,201,2379,47399
02-06-2017,10,17596,17427,7613,2057,44693,1442,752,216,2410,47103
02-06-2017,11,17567,17148,7586,1911,44213,1452,697,275,2424,46637
02-06-2017,12,17388,16797,7451,1957,43594,1455,620,329,2404,45998
02-06-2017,13,17249,15989,7417,1902,42558,1451,637,297,2385,44943
02-06-2017,14,17257,15803,7393,1669,42123,1448,624,317,2389,44512
02-06-2017,15,17176,15830,7337,1779,42123,1405,617,328,2350,44473
02-06-2017,16,17202,15860,7276,1741,42080,1400,578,280,2258,44338
02-06-2017,17,17147,16459,7208,1824,42639,1415,567,264,2246,44885
02-06-2017,18,17124,16776,7154,1752,42807,1424,565,252,2241,45048
02-06-2017,19,16856,16979,7104,1573,42513,1345,549,271,2165,44678
02-06-2017,20,16577,16402,7009,1443,41429,1301,553,214,2068,43497
02-06-2017,21,16437,16024,6868,1396,40727,1316,471,174,1961,42688
02-06-2017,22,16317,15573,6847,1421,40159,1296,365,176,1837,41996
02-06-2017,23,15909,14764,6770,1432,38876,1274,300,140,1714,40590
03-06-2017,0,15550,13567,6625,1193,36935,936,213,136,1285,38220
03-06-2017,1,15205,13167,6533,1200,36105,909,209,135,1253,37358
03-06-2017,2,14890,12996,6525,1143,35554,895,209,111,1215,36769
03-06-2017,3,14651,12880,6560,988,35080,902,212,98,1212,36292
03-06-2017,4,13997,12899,6511,1011,34418,902,216,78,1196,35614
03-06-2017,5,13575,12980,6453,999,34008,894,342,62,1298,35306
03-06-2017,6,13504,12880,6486,1085,33954,876,389,43,1308,35262
03-06-2017,7,14208,12984,6581,1135,34909,869,570,42,1481,36390
03-06-2017,8,15205,13506,6629,1209,36547,864,713,265,1842,38389
03-06-2017,9,15960,14018,6751,1227,37956,862,718,257,1837,39793
03-06-2017,10,16156,14351,6699,1213,38420,867,727,259,1853,40273
03-06-2017,11,15982,14290,6617,1277,38166,864,733,261,1858,40024
03-06-2017,12,15614,14149,6636,1474,37873,855,728,252,1835,39708
03-06-2017,13,15838,14137,6478,1589,38042,855,621,233,1709,39751
03-06-2017,14,15853,14142,6426,1563,37984,883,615,264,1762,39746
03-06-2017,15,15906,14144,6378,1569,37998,884,560,63,1507,39505
03-06-2017,16,15669,14234,6357,1353,37613,881,555,65,1501,39114
03-06-2017,17,15906,14553,6374,1237,38069,824,549,54,1427,39496
03-06-2017,18,16107,14568,6359,1252,38286,827,545,47,1419,39705
03-06-2017,19,15968,14462,6281,1202,37913,818,462,42,1322,39235
03-06-2017,20,15721,14147,6240,1091,37198,790,473,36,1299,38497
03-06-2017,21,15619,13958,6158,1099,36835,799,475,32,1306,38141
03-06-2017,22,15667,13902,6115,1187,36871,806,472,32,1310,38181
03-06-2017,23,14931,13558,6089,1187,35766,804,299,33,1136,36902
04-06-2017,0,14029,13121,6057,989,34196,788,195,39,1022,35218
04-06-2017,1,12993,12841,6039,828,32702,772,187,54,1013,33715
04-06-2017,2,11433,12447,6054,722,30656,774,188,68,1030,31686
04-06-2017,3,10837,12291,5982,710,29820,756,188,68,1012,30832
04-06-2017,4,10322,12175,5895,590,28982,752,191,58,1001,29983
04-06-2017,5,9817,11817,5751,620,28004,755,195,52,1002,29006
04-06-2017,6,9937,11641,5767,638,27983,753,282,53,1088,29071
04-06-2017,7,10992,11951,5790,586,29319,767,375,51,1193,30512
04-06-2017,8,12437,12780,5995,589,31802,769,400,39,1208,33010
04-06-2017,9,13525,13206,6070,679,33480,764,426,37,1227,34707
04-06-2017,10,13892,13492,6054,788,34225,761,547,41,1349,35574
04-06-2017,11,13749,13517,6053,1090,34410,762,579,53,1394,35804
04-06-2017,12,13780,13503,6055,1448,34787,768,484,71,1323,36110
04-06-2017,13,13030,13253,6052,1588,33923,772,431,103,1306,35229
04-06-2017,14,12422,13173,6025,2002,33622,769,418,128,1315,34937
04-06-2017,15,12276,13064,5929,2348,33617,765,403,132,1300,34917
04-06-2017,16,12572,13235,5900,2645,34352,762,419,129,1310,35662
04-06-2017,17,12923,13481,5907,2834,35145,758,440,121,1319,36464
04-06-2017,18,13842,13620,5976,2761,36198,765,428,114,1307,37505
04-06-2017,19,15291,13944,5952,2554,37741,773,420,135,1328,39069
04-06-2017,20,15605,14009,5926,2359,37899,772,370,178,1320,39219
04-06-2017,21,15527,14121,5887,2173,37709,787,386,241,1414,39123
04-06-2017,22,16158,14706,5892,2041,38798,856,504,280,1640,40438
04-06-2017,23,14987,14407,5963,1980,37338,960,296,271,1527,38865
05-06-2017,0,13297,13414,5912,1991,34614,939,215,181,1335,35949
05-06-2017,1,12426,13178,5740,1862,33206,977,296,175,1448,34654
05-06-2017,2,11237,13105,5606,1654,31600,974,298,245,1517,33117
05-06-2017,3,10834,13061,5594,1526,31015,977,301,273,1551,32566
05-06-2017,4,10507,13180,5668,1487,30842,1039,313,288,1640,32482
05-06-2017,5,10807,13757,5839,1421,31822,1138,420,334,1892,33714
05-06-2017,6,11644,14192,6131,1282,33249,1320,587,637,2544,35793
05-06-2017,7,12906,14895,6385,1320,35505,1350,720,716,2786,38291
05-06-2017,8,14657,15348,6493,1569,38067,1348,725,948,3021,41088
05-06-2017,9,15255,15937,6548,1788,39529,1332,661,975,2968,42497
05-06-2017,10,14146,15838,6550,1955,38490,1323,674,971,2968,41458
05-06-2017,11,14071,15860,6425,2075,38432,1314,769,1001,3084,41516
05-06-2017,12,13306,15874,6442,2276,37898,1314,726,1014,3054,40952
05-06-2017,13,12803,15778,6341,2687,37610,1323,674,1045,3042,40652
05-06-2017,14,12744,15770,6315,2831,37662,1345,612,952,2909,40571
05-06-2017,15,12913,15784,6253,2756,37705,1350,590,720,2660,40365
05-06-2017,16,13926,16120,6150,2491,38687,1250,591,658,2499,41186
05-06-2017,17,16166,16619,6324,2264,41374,1357,581,522,2460,43834
05-06-2017,18,16536,16972,6500,2059,42069,1357,603,569,2529,44598
05-06-2017,19,16663,16777,6482,1753,41676,1363,573,592,2528,44204
05-06-2017,20,16349,16399,6273,1616,40637,1282,510,512,2304,42941
05-06-2017,21,16030,15851,6173,1639,39693,1283,458,424,2165,41858
05-06-2017,22,15816,15450,6185,1603,39053,1267,439,293,1999,41052
05-06-2017,23,14647,14864,6291,1506,37309,1083,232,277,1592,38901
06-06-2017,0,11922,13505,6266,1614,33306,970,214,266,1450,34756
06-06-2017,1,9967,12636,6012,1817,30433,902,212,269,1383,31816
06-06-2017,2,9098,12197,5837,2028,29161,886,214,271,1371,30532
06-06-2017,3,8213,12244,5734,2173,28364,887,220,272,1379,29743
06-06-2017,4,8343,12201,5720,2280,28545,887,289,273,1449,29994
06-06-2017,5,9990,12679,5997,2315,30981,1068,293,263,1624,32605
06-06-2017,6,13026,14451,6336,2234,36049,1258,475,569,2302,38351
06-06-2017,7,15677,15649,6623,2171,40120,1260,596,713,2569,42689
06-06-2017,8,16388,15935,6625,2408,41356,1271,743,736,2750,44106
06-06-2017,9,16131,15737,6557,2939,41363,1272,748,756,2776,44139
06-06-2017,10,15613,15891,6583,3408,41496,1281,724,733,2738,44234
06-06-2017,11,15172,16056,6530,3784,41542,1295,695,732,2722,44264
06-06-2017,12,14427,15834,6482,3924,40666,1296,726,732,2754,43420
06-06-2017,13,13674,15929,6421,4073,40097,1295,632,700,2627,42724
06-06-2017,14,12845,15732,6285,4117,38979,1290,589,706,2585,41564
06-06-2017,15,12170,14903,5949,4073,37094,1265,554,530,2349,39443
06-06-2017,16,12215,14825,5882,4066,36988,1229,554,492,2275,39263
06-06-2017,17,12529,15527,6028,3689,37773,1283,501,613,2397,40170
06-06-2017,18,13175,16332,6167,3303,38977,1275,502,695,2472,41449
06-06-2017,19,14294,16729,6189,2640,39854,1269,463,674,2406,42260
06-06-2017,20,14154,16664,5888,2206,38913,1253,376,411,2040,40953
06-06-2017,21,12789,16448,5730,1797,36764,1242,354,532,2128,38892
06-06-2017,22,12331,16131,5656,1864,35983,1235,243,582,2060,38043
06-06-2017,23,10834,15218,5460,1654,33166,1032,239,479,1750,34916
07-06-2017,0,9684,14268,5322,1540,30814,920,239,296,1455,32269
07-06-2017,1,9251,13557,5257,1610,29676,884,236,308,1428,31104
07-06-2017,2,8742,12977,5199,1661,28578,895,242,314,1451,30029
07-06-2017,3,8634,12807,5166,1829,28436,883,251,325,1459,29895
07-06-2017,4,8666,12938,5216,1888,28707,891,308,337,1536,30243
07-06-2017,5,9268,13593,5539,1900,30300,997,458,338,1793,32093
07-06-2017,6,11279,14987,5894,1971,34133,1166,822,342,2330,36463
07-06-2017,7,13079,16637,6104,2139,37959,1299,873,494,2666,40625
07-06-2017,8,13642,17161,6224,2403,39431,1335,1099,630,3064,42495
07-06-2017,9,13395,17489,6219,2932,40034,1355,1061,533,2949,42983
07-06-2017,10,13733,17716,6178,3180,40807,1338,1013,546,2897,43704
07-06-2017,11,13465,17685,6198,3315,40663,1409,966,497,2872,43535
07-06-2017,12,12792,17618,6209,3473,40091,1411,958,493,2862,42953
07-06-2017,13,13029,17307,6267,3710,40314,1418,959,371,2748,43062
07-06-2017,14,13054,17703,6283,3802,40841,1386,959,366,2711,43552
07-06-2017,15,13205,17322,6128,3601,40258,1373,933,77,2383,42641
07-06-2017,16,12693,16994,6285,3749,39720,1348,900,55,2303,42023
07-06-2017,17,12850,17042,6242,3908,40043,1335,865,55,2255,42298
07-06-2017,18,12668,17243,6211,3799,39921,1316,804,66,2186,42107
07-06-2017,19,13436,17664,6223,3794,41117,1283,780,43,2106,43223
07-06-2017,20,13019,17066,5959,3807,39851,1253,637,35,1925,41776
07-06-2017,21,12995,16852,5871,3876,39595,1051,598,40,1689,41284
07-06-2017,22,12575,16569,5939,3825,38908,1003,403,57,1463,40371
07-06-2017,23,11426,15352,5843,3734,36356,995,393,61,1449,37805
08-06-2017,0,10519,14356,5943,3701,34519,935,396,66,1397,35916
08-06-2017,1,10230,14187,5709,3778,33905,919,392,90,1401,35306
08-06-2017,2,10214,13872,5651,3809,33546,903,393,101,1397,34943
08-06-2017,3,10163,13689,5672,3893,33418,914,396,108,1418,34836
08-06-2017,4,10060,13618,5725,3906,33309,947,400,103,1450,34759
08-06-2017,5,11184,14175,5789,3818,34967,1212,407,81,1700,36667
08-06-2017,6,14214,15588,6110,3713,39625,1413,487,185,2085,41710
08-06-2017,7,16408,17996,6440,3587,44432,1411,804,267,2482,46914
08-06-2017,8,16899,18301,6563,3601,45365,1412,1023,467,2902,48267
08-06-2017,9,16746,17774,6589,3721,44832,1412,1104,422,2938,47770
08-06-2017,10,17057,18009,6624,3622,45311,1408,1061,437,2906,48217
08-06-2017,11,16846,17782,6675,3379,44682,1406,955,434,2795,47477
08-06-2017,12,16329,17386,6610,3176,43500,1410,969,385,2764,46264
08-06-2017,13,16264,16756,6654,2814,42488,1406,923,390,2719,45207
08-06-2017,14,16360,16655,6524,2420,41960,1411,964,487,2862,44822
08-06-2017,15,16924,16982,6290,2140,42336,1413,692,327,2432,44768
08-06-2017,16,17192,17538,6207,1900,42837,1421,682,259,2362,45199
08-06-2017,17,17082,18128,6317,1870,43398,1414,679,250,2343,45741
08-06-2017,18,16630,17921,6480,1901,42933,1412,606,299,2317,45250
08-06-2017,19,16738,17576,6599,1824,42737,1410,630,281,2321,45058
08-06-2017,20,16932,17183,6325,1778,42218,1393,587,65,2045,44263
08-06-2017,21,17010,16844,6230,1754,41838,1382,480,109,1971,43809
08-06-2017,22,16477,16189,6212,1808,40685,1381,412,84,1877,42562
08-06-2017,23,15863,15071,6140,1743,38816,1399,394,89,1882,40698
09-06-2017,0,15522,13592,6068,1555,36738,1308,381,73,1762,38500
09-06-2017,1,15021,13128,5916,1643,35709,1304,378,70,1752,37461
09-06-2017,2,14727,13025,5871,1464,35087,1284,377,65,1726,36813
09-06-2017,3,14070,13000,5874,1371,34316,1244,377,62,1683,35999
09-06-2017,4,14071,13078,5889,1348,34387,1272,386,62,1720,36107
09-06-2017,5,14865,13969,6045,1426,36305,1284,443,105,1832,38137
09-06-2017,6,15791,15733,6212,1466,39202,1385,722,331,2438,41640
09-06-2017,7,16970,17082,6487,1701,42239,1429,783,585,2797,45036
09-06-2017,8,17048,17281,6508,1778,42616,1451,919,680,3050,45666
09-06-2017,9,16978,17067,6557,1785,42387,1444,906,781,3131,45518
09-06-2017,10,17631,17356,6573,1792,43352,1447,1097,667,3211,46563
09-06-2017,11,17323,17032,6495,1790,42641,1373,1175,669,3217,45858
09-06-2017,12,17195,16639,6513,1673,42020,1427,1169,676,3272,45292
09-06-2017,13,17069,16594,6455,1729,41847,1426,1072,674,3172,45019
09-06-2017,14,16881,16431,6368,1952,41633,1418,814,663,2895,44528
09-06-2017,15,16319,15961,6180,2189,40651,1406,653,534,2593,43244
09-06-2017,16,16267,15614,5993,2233,40108,1367,658,479,2504,42612
09-06-2017,17,16346,15779,6065,2183,40372,1457,703,430,2590,42962
09-06-2017,18,16027,16743,6098,2316,41184,0,575,627,1202,42386
09-06-2017,19,16506,16297,5976,2256,41034,0,568,592,1160,42194
09-06-2017,20,16265,15758,5935,1808,39765,0,566,367,933,40698
09-06-2017,21,16047,15112,5808,1594,38561,820,438,371,1629,40190
09-06-2017,22,15877,14641,5774,1688,37981,801,234,390,1425,39406
09-06-2017,23,15569,14187,5725,1569,37050,791,227,420,1438,38488
10-06-2017,0,15147,13244,5869,1558,35818,783,218,115,1116,36934
10-06-2017,1,14593,12762,5648,1529,34533,789,220,137,1146,35679
10-06-2017,2,13923,12394,5448,1565,33331,797,223,133,1153,34484
10-06-2017,3,13695,12155,5386,1510,32746,801,234,120,1155,33901
10-06-2017,4,13534,11955,5322,1503,32315,800,230,90,1120,33435
10-06-2017,5,13813,11915,5390,1456,32574,777,239,72,1088,33662
10-06-2017,6,14064,12253,5529,1462,33308,797,387,54,1238,34546
10-06-2017,7,14890,13399,5679,1495,35464,819,439,124,1382,36846
10-06-2017,8,15022,14760,5798,1499,37080,822,531,219,1572,38652
10-06-2017,9,15313,15429,5778,1690,38210,823,634,483,1940,40150
10-06-2017,10,15268,14924,5782,1895,37870,826,848,493,2167,40037
10-06-2017,11,15247,14826,5792,2119,37985,826,855,492,2173,40158
10-06-2017,12,15128,13799,5778,2229,36935,811,554,490,1855,38790
10-06-2017,13,15126,13500,5753,2288,36667,803,565,264,1632,38299
10-06-2017,14,14809,13457,5738,2287,36291,802,553,276,1631,37922
10-06-2017,15,14918,13537,5748,2136,36340,806,501,306,1613,37953
10-06-2017,16,14894,13797,5750,2039,36482,801,492,301,1594,38076
10-06-2017,17,15074,14405,5864,1767,37109,803,493,289,1585,38694
10-06-2017,18,15370,15074,5874,1588,37905,801,501,131,1433,39338
10-06-2017,19,15434,14678,5843,1437,37391,800,404,238,1442,38833
10-06-2017,20,15278,14223,5878,1160,36539,801,397,189,1387,37926
10-06-2017,21,15144,14037,5807,1089,36077,801,392,97,1290,37367
10-06-2017,22,15084,13887,5797,1230,35998,798,218,107,1123,37121
10-06-2017,23,14818,13367,5755,1270,35208,819,211,99,1129,36337
11-06-2017,0,14438,12791,5555,1495,34280,821,209,81,1111,35391
11-06-2017,1,13904,12270,5420,1560,33154,814,208,78,1100,34254
11-06-2017,2,12547,12003,5237,1473,31262,811,206,74,1091,32353
11-06-2017,3,11539,11594,5121,1646,29900,799,210,67,1076,30976
11-06-2017,4,11015,11326,5002,1694,29037,796,214,71,1081,30118
11-06-2017,5,10742,11249,4925,1781,28698,790,217,70,1077,29775
11-06-2017,6,10660,11096,4869,1874,28498,788,235,67,1090,29588
11-06-2017,7,11295,11327,4917,1970,29510,805,311,68,1184,30694
11-06-2017,8,12033,11699,5073,2331,31137,818,385,79,1282,32419
11-06-2017,9,12846,12257,5189,2659,32952,813,424,105,1342,34294
11-06-2017,10,13180,12635,5219,2958,33993,823,440,214,1477,35470
11-06-2017,11,13176,12737,5250,3166,34329,833,448,197,1478,35807
11-06-2017,12,13136,12781,5253,3211,34381,835,458,215,1508,35889
11-06-2017,13,12947,12899,5207,3163,34216,837,403,332,1572,35788
11-06-2017,14,13029,13028,5195,2989,34241,833,445,188,1466,35707
11-06-2017,15,13008,13234,5157,2754,34154,786,535,186,1507,35661
11-06-2017,16,13403,13467,5315,2375,34561,736,500,162,1398,35959
11-06-2017,17,14993,14319,5343,1903,36559,732,501,135,1368,37927
11-06-2017,18,16138,15795,5503,1661,39097,725,485,114,1324,40421
11-06-2017,19,16405,15992,5561,1623,39582,731,446,142,1319,40901
11-06-2017,20,16393,15603,5534,1729,39260,743,442,51,1236,40496
11-06-2017,21,16478,15348,5487,1655,38969,778,352,52,1182,40151
11-06-2017,22,16268,15024,5468,1683,38444,849,237,60,1146,39590
11-06-2017,23,15552,14130,5375,1780,36838,863,233,84,1180,38018
12-06-2017,0,13746,12992,5255,1862,33856,881,215,130,1226,35082
12-06-2017,1,12293,12292,5018,1990,31594,881,215,181,1277,32871
12-06-2017,2,12171,12186,5102,1996,31455,867,212,216,1295,32750
12-06-2017,3,11662,12217,5170,1988,31038,862,224,251,1337,32375
12-06-2017,4,11227,12357,5107,2171,30863,874,229,261,1364,32227
12-06-2017,5,12622,12911,5283,2420,33234,886,246,251,1383,34617
12-06-2017,6,15207,14703,5772,2776,38459,924,801,199,1924,40383
12-06-2017,7,16931,16498,6162,2987,42578,944,884,213,2041,44619
12-06-2017,8,17516,17237,6224,3315,44290,945,930,468,2343,46633
12-06-2017,9,17118,16878,6346,3675,44018,945,939,466,2350,46368
12-06-2017,10,16740,16364,6383,3896,43383,917,957,435,2309,45692
12-06-2017,11,16017,15722,6407,3506,41653,927,988,418,2333,43986
12-06-2017,12,14904,15361,6392,4418,41075,971,941,478,2390,43465
12-06-2017,13,14447,15521,6388,4609,40965,960,941,441,2342,43307
12-06-2017,14,14277,15808,6249,4676,41012,927,1016,410,2353,43365
12-06-2017,15,14046,15706,6180,4642,40575,960,942,399,2301,42876
12-06-2017,16,14105,15547,6038,4757,40446,952,884,420,2256,42702
12-06-2017,17,14341,15864,6059,4595,40860,959,804,342,2105,42965
12-06-2017,18,15367,16443,6089,4491,42391,949,742,330,2021,44412
12-06-2017,19,15150,16354,6055,4426,41986,915,621,294,1830,43816
12-06-2017,20,14798,15946,5977,4331,41051,916,616,303,1835,42886
12-06-2017,21,14605,15689,5857,4185,40337,916,528,319,1763,42100
12-06-2017,22,13862,15521,5807,4099,39289,892,443,346,1681,40970
12-06-2017,23,12450,14846,5773,4012,37082,814,453,383,1650,38732
13-06-2017,0,11220,13994,5683,3962,34858,833,341,401,1575,36433
13-06-2017,1,9947,13550,5637,3919,33053,844,337,405,1586,34639
13-06-2017,2,9595,13676,5575,3903,32750,865,324,419,1608,34358
13-06-2017,3,9618,13659,5515,3822,32614,895,314,415,1624,34238
13-06-2017,4,9278,13609,5433,3662,31981,943,322,415,1680,33661
13-06-2017,5,10826,14219,5759,3562,34367,1028,337,399,1764,36131
13-06-2017,6,13690,14994,6166,3590,38441,1192,606,422,2220,40661
13-06-2017,7,16401,16024,6408,3626,42459,1315,754,564,2633,45092
13-06-2017,8,16712,16500,6541,3814,43567,1399,786,609,2794,46361
13-06-2017,9,16442,16324,6690,4017,43474,1290,708,627,2625,46099
13-06-2017,10,16219,16352,6695,4234,43499,1273,712,640,2625,46124
13-06-2017,11,16212,16262,6663,4395,43533,1268,712,586,2566,46099
13-06-2017,12,16045,16131,6705,4372,43253,1255,733,621,2609,45862
13-06-2017,13,16196,16033,6615,4502,43345,1231,753,613,2597,45942
13-06-2017,14,15950,15686,6640,4584,42860,1254,791,528,2573,45433
13-06-2017,15,15545,15329,6386,4560,41821,1229,730,415,2374,44195
13-06-2017,16,15447,14917,6439,4467,41271,1362,594,398,2354,43625
13-06-2017,17,15855,15201,6440,4399,41896,1382,566,445,2393,44289
13-06-2017,18,15807,15378,6549,4162,41897,1420,571,427,2418,44315
13-06-2017,19,15897,15197,6504,3967,41566,1436,467,445,2348,43914
13-06-2017,20,15896,15017,6320,3607,40841,1438,402,418,2258,43099
13-06-2017,21,15764,14692,6260,3088,39803,1456,346,394,2196,41999
13-06-2017,22,15425,14154,6232,2782,38592,1478,313,367,2158,40750
13-06-2017,23,14802,13296,6089,2526,36713,1482,291,330,2103,38816
14-06-2017,0,13669,12358,5814,2370,34213,1208,239,277,1724,35937
14-06-2017,1,13186,12267,5665,2332,33451,1146,237,244,1627,35078
14-06-2017,2,13462,12478,5706,2278,33924,1189,252,255,1696,35620
14-06-2017,3,13393,12532,5635,2267,33826,1206,247,269,1722,35548
14-06-2017,4,13468,12634,5534,2336,33972,1203,247,276,1726,35698
14-06-2017,5,13904,14081,5681,2093,35758,1292,272,258,1822,37580
14-06-2017,6,14952,15519,5997,2149,38617,1513,604,536,2653,41270
14-06-2017,7,16227,16603,6173,2544,41546,1604,831,540,2975,44521
14-06-2017,8,16603,16813,6209,2474,42099,1676,1070,550,3296,45395
14-06-2017,9,16961,16662,6263,2695,42582,1580,1131,549,3260,45842
14-06-2017,10,17163,16605,6262,2568,42597,1597,1123,496,3216,45813
14-06-2017,11,17221,16599,6211,2469,42499,1606,1039,484,3129,45628
14-06-2017,12,17196,16402,6222,2372,42192,1596,1035,469,3100,45292
14-06-2017,13,17168,16322,6272,2230,41993,1576,952,538,3066,45059
14-06-2017,14,17140,16332,6209,2179,41860,1580,932,557,3069,44929
14-06-2017,15,17002,16389,6066,2260,41717,1536,653,562,2751,44468
14-06-2017,16,16981,16385,6088,2309,41763,1529,623,527,2679,44442
14-06-2017,17,16792,16583,6025,2193,41594,1520,646,483,2649,44243
14-06-2017,18,16797,16313,6020,2040,41170,1531,691,482,2704,43874
14-06-2017,19,16786,15997,6023,1864,40671,1531,673,449,2653,43324
14-06-2017,20,16543,15561,5995,1629,39729,1466,441,413,2320,42049
14-06-2017,21,16373,14819,5865,1651,38708,1452,442,340,2234,40942
14-06-2017,22,16047,14502,5720,1444,37714,1457,431,152,2040,39754
14-06-2017,23,15707,13746,5616,1251,36320,1419,388,110,1917,38237
15-06-2017,0,15449,12932,5573,1261,35215,1257,392,80,1729,36944
15-06-2017,1,15076,12620,5484,1049,34229,1252,394,67,1713,35942
15-06-2017,2,14759,12392,5394,945,33489,1255,395,55,1705,35194
15-06-2017,3,14453,12216,5336,774,32780,1260,400,62,1722,34502
15-06-2017,4,14178,12168,5293,717,32357,1266,404,90,1760,34117
15-06-2017,5,14696,13283,5532,694,34206,1336,434,92,1862,36068
15-06-2017,6,15576,14935,5848,765,37125,1476,772,208,2456,39581
15-06-2017,7,16759,16394,5946,914,40014,1576,984,274,2834,42848
15-06-2017,8,17146,16501,5947,980,40575,1577,1203,384,3164,43739
15-06-2017,9,17149,16394,5963,1051,40557,1587,1212,300,3099,43656
15-06-2017,10,17086,15878,6053,1108,40125,1592,1201,306,3099,43224
15-06-2017,11,17087,15794,6048,1188,40117,1594,1107,320,3021,43138
15-06-2017,12,17126,15351,6087,1251,39815,1592,1103,308,3003,42818
15-06-2017,13,17173,15554,6066,1293,40087,1593,1027,362,2982,43069
15-06-2017,14,16864,15758,6118,1307,40047,1589,1013,303,2905,42952
15-06-2017,15,16710,15054,5998,1333,39096,1556,881,165,2602,41698
15-06-2017,16,16987,15798,5936,1435,40156,1600,793,162,2555,42711
15-06-2017,17,16775,16411,5956,1499,40643,1601,784,148,2533,43176
15-06-2017,18,16514,16213,5904,1718,40348,1596,805,234,2635,42983
15-06-2017,19,16568,15957,5840,1844,40209,1540,787,171,2498,42707
15-06-2017,20,16520,15049,5887,1760,39217,1348,606,104,2058,41275
15-06-2017,21,16597,14830,5740,1743,38910,1273,424,86,1783,40693
15-06-2017,22,16271,14349,5741,2040,38400,1273,422,86,1781,40181
15-06-2017,23,15749,13542,5674,2086,37049,1248,425,57,1730,38779
16-06-2017,0,15098,12240,5442,2077,34858,1183,389,46,1618,36476
16-06-2017,1,13680,11919,5237,2331,33166,1118,386,40,1544,34710
16-06-2017,2,12835,11913,5201,2391,32341,1133,389,33,1555,33896
16-06-2017,3,12403,11904,5135,2345,31786,1208,397,32,1637,33423
16-06-2017,4,12461,11967,5123,2442,31995,1224,410,33,1667,33662
16-06-2017,5,13283,12659,5383,2615,33939,1282,510,33,1825,35764
16-06-2017,6,15502,14093,5820,2849,38264,1570,941,130,2641,40905
16-06-2017,7,16883,15855,6101,3176,42015,1574,1150,446,3170,45185
16-06-2017,8,17026,15774,6011,3802,42612,1570,1230,584,3384,45996
16-06-2017,9,16644,14940,6061,3981,41627,1574,1244,660,3478,45105
16-06-2017,10,15992,14006,5948,4285,40231,1572,1298,660,3530,43761
16-06-2017,11,15595,13747,5947,4437,39727,1574,1230,673,3477,43204
16-06-2017,12,15346,13642,6013,4477,39479,1572,1146,681,3399,42878
16-06-2017,13,15116,13618,6056,4574,39364,1577,988,677,3242,42606
16-06-2017,14,14584,13590,5981,4483,38638,1570,1007,584,3161,41799
16-06-2017,15,14262,13444,5558,4456,37720,1358,563,527,2448,40168
16-06-2017,16,13848,13554,5374,4786,37562,1361,521,449,2331,39893
16-06-2017,17,13926,13605,5536,4842,37909,1387,532,448,2367,40276
16-06-2017,18,13907,13447,5774,4592,37720,1400,700,466,2566,40286
16-06-2017,19,14681,13545,5685,4476,38386,1357,662,450,2469,40855
16-06-2017,20,14348,13342,5330,4268,37288,1117,501,375,1993,39281
16-06-2017,21,13993,13104,5094,4130,36321,966,432,255,1653,37974
16-06-2017,22,13899,12702,5057,4001,35659,944,421,252,1617,37276
16-06-2017,23,12752,12452,4949,3861,34015,954,257,251,1462,35477
17-06-2017,0,11717,11467,4612,3755,31553,789,230,44,1063,32616
17-06-2017,1,11140,11190,4462,3635,30427,756,225,41,1022,31449
17-06-2017,2,10651,11104,4324,3499,29577,739,223,39,1001,30578
17-06-2017,3,11098,11076,4320,3412,29906,733,227,40,1000,30906
17-06-2017,4,11202,11122,4338,3221,29883,737,239,39,1015,30898
17-06-2017,5,11736,11299,4388,3012,30437,743,244,36,1023,31460
17-06-2017,6,11934,11706,4500,2862,31001,785,619,35,1439,32440
17-06-2017,7,12729,12320,4681,2838,32568,776,703,34,1513,34081
17-06-2017,8,13796,12737,4979,3028,34540,783,757,34,1574,36114
17-06-2017,9,14526,13142,5083,2921,35674,788,779,82,1649,37323
17-06-2017,10,15202,13422,5087,2773,36483,797,753,34,1584,38067
17-06-2017,11,15431,13560,5035,2660,36685,796,774,39,1609,38294
17-06-2017,12,15246,13682,5037,2497,36460,795,766,43,1604,38064
17-06-2017,13,14605,13445,4988,2477,35516,800,501,47,1348,36864
17-06-2017,14,13718,13273,4893,2494,34378,795,493,60,1348,35726
17-06-2017,15,13936,13022,5013,2468,34439,796,486,76,1358,35797
17-06-2017,16,14478,13206,5147,2139,34970,794,435,100,1329,36299
17-06-2017,17,15845,13439,5201,1868,36354,795,439,105,1339,37693
17-06-2017,18,16391,13403,5174,1772,36740,799,402,107,1308,38048
17-06-2017,19,16101,13245,5124,1690,36160,797,387,116,1300,37460
17-06-2017,20,15331,13074,5141,1553,35101,794,405,110,1309,36410
17-06-2017,21,15043,12948,5103,1502,34595,793,381,109,1283,35878
17-06-2017,22,14688,12675,5125,1448,33935,800,332,102,1234,35169
17-06-2017,23,14292,12483,5085,1594,33454,802,225,114,1141,34595
18-06-2017,0,14265,11790,5019,1577,32652,809,211,124,1144,33796
18-06-2017,1,13575,11619,4933,1419,31546,809,208,99,1116,32662
18-06-2017,2,13114,11509,4774,1442,30840,812,207,74,1093,31933
18-06-2017,3,12773,11416,4674,1471,30335,807,214,73,1094,31429
18-06-2017,4,12315,11480,4494,1462,29751,819,223,61,1103,30854
18-06-2017,5,12324,11559,4508,1378,29769,809,230,59,1098,30867
18-06-2017,6,13105,11722,4632,1246,30705,800,528,53,1381,32086
18-06-2017,7,13988,12082,4951,1278,32299,817,721,42,1580,33879
18-06-2017,8,14697,12571,4973,1391,33631,829,751,61,1641,35272
18-06-2017,9,15074,13127,5162,1520,34882,837,809,82,1728,36610
18-06-2017,10,14768,13505,5254,1837,35363,870,819,160,1849,37212
18-06-2017,11,14225,13566,5295,2024,35110,898,775,208,1881,36991
18-06-2017,12,14449,13868,5307,2196,35820,896,684,286,1866,37686
18-06-2017,13,13691,14191,5149,2291,35321,919,455,310,1684,37005
18-06-2017,14,12436,14364,5221,2369,34390,926,399,428,1753,36143
18-06-2017,15,12514,14297,5247,2399,34459,929,362,452,1743,36202
18-06-2017,16,13327,14354,5242,2382,35304,914,377,350,1641,36945
18-06-2017,17,14213,14541,5307,2304,36366,884,378,350,1612,37978
18-06-2017,18,14607,14853,5371,2040,36871,881,397,372,1650,38521
18-06-2017,19,15154,14663,5424,1803,37044,862,446,377,1685,38729
18-06-2017,20,15393,14558,5319,1524,36794,820,492,238,1550,38344
18-06-2017,21,15310,14500,5433,1526,36769,845,391,201,1437,38206
18-06-2017,22,15881,14448,5686,1475,37492,840,238,114,1192,38684
18-06-2017,23,15726,14021,5700,1263,36710,845,233,109,1187,37897
19-06-2017,0,15165,13529,5478,1134,35308,946,214,112,1272,36580
19-06-2017,1,14053,13217,5493,1024,33788,966,221,103,1290,35078
19-06-2017,2,13456,13018,5485,1058,33016,1002,222,96,1320,34336
19-06-2017,3,13211,12898,5489,982,32580,1032,229,112,1373,33953
19-06-2017,4,13782,12744,5404,789,32720,1073,239,116,1428,34148
19-06-2017,5,15092,13749,5513,722,35076,1143,261,94,1498,36574
19-06-2017,6,16223,14576,5844,774,37417,1285,363,70,1718,39135
19-06-2017,7,17401,15879,6233,901,40416,1399,447,295,2141,42557
19-06-2017,8,17239,16426,6360,1123,41148,1450,707,314,2471,43619
19-06-2017,9,17487,16467,6398,1254,41607,1447,864,346,2657,44264
19-06-2017,10,17662,16409,6487,1321,41880,1437,788,377,2602,44482
19-06-2017,11,17631,16410,6498,2600,43138,1457,880,403,2740,45878
19-06-2017,12,17737,16478,6515,2492,43223,1465,794,417,2676,45899
19-06-2017,13,17802,16628,6393,1826,42649,1477,643,539,2659,45308
19-06-2017,14,17774,16804,6177,1842,42596,1494,594,430,2518,45114
19-06-2017,15,17737,15592,6123,1764,41216,1458,539,206,2203,43419
19-06-2017,16,17639,15375,5993,1891,40898,1431,520,203,2154,43052
19-06-2017,17,17368,15893,6028,2035,41325,1449,550,379,2378,43703
19-06-2017,18,17219,15870,5919,2361,41369,1488,471,566,2525,43894
19-06-2017,19,17310,15379,5817,2462,40969,1521,515,529,2565,43534
19-06-2017,20,17546,14961,5729,2422,40659,1293,376,523,2192,42851
19-06-2017,21,17715,14173,5722,2281,39889,1125,234,114,1473,41362
19-06-2017,22,17145,13670,5705,2306,38826,1149,233,100,1482,40308
19-06-2017,23,16486,13097,5391,2128,37102,1097,218,111,1426,38528
20-06-2017,0,15900,12623,5266,2085,35874,1094,208,140,1442,37316
20-06-2017,1,14924,12646,5116,2171,34858,1090,221,149,1460,36318
20-06-2017,2,14148,12771,5010,2242,34172,1088,228,159,1475,35647
20-06-2017,3,13730,12951,4902,2333,33917,1087,218,194,1499,35416
20-06-2017,4,13713,13038,4723,2440,33913,1101,233,232,1566,35479
20-06-2017,5,14841,13925,4853,2410,36029,1215,247,229,1691,37720
20-06-2017,6,16528,15159,5313,2647,39648,1481,377,190,2048,41696
20-06-2017,7,17396,16387,5559,3107,42449,1510,598,412,2520,44969
20-06-2017,8,17809,16324,5675,3367,43176,1523,772,458,2753,45929
20-06-2017,9,17704,16396,5686,3596,43382,1562,851,700,3113,46495
20-06-2017,10,17707,16509,5716,3728,43660,1595,765,721,3081,46741
20-06-2017,11,18010,16244,5658,3758,43670,1596,746,760,3102,46772
20-06-2017,12,18168,15638,5740,3750,43295,1605,747,594,2946,46241
20-06-2017,13,18056,15191,5768,3705,42719,1623,642,573,2838,45557
20-06-2017,14,17874,15457,5641,4055,43026,1622,571,523,2716,45742
20-06-2017,15,17257,15588,5412,4138,42395,1405,575,371,2351,44746
20-06-2017,16,16867,15570,5296,4106,41839,1355,471,368,2194,44033
20-06-2017,17,16931,15573,5453,4089,42047,1428,447,331,2206,44253
20-06-2017,18,17126,15161,5692,4007,41985,1453,439,275,2167,44152
20-06-2017,19,17368,14712,5644,3843,41566,1435,440,209,2084,43650
20-06-2017,20,17187,14422,5437,3460,40507,1339,367,141,1847,42354
20-06-2017,21,17061,14435,5604,3109,40209,1233,254,114,1601,41810
20-06-2017,22,16401,14057,5712,2836,39008,1206,240,109,1555,40563
20-06-2017,23,15423,13673,5584,2625,37306,1233,218,96,1547,38853
21-06-2017,0,14307,13301,5503,2497,35609,1167,220,92,1479,37088
21-06-2017,1,13096,13277,5420,2427,34220,1139,217,101,1457,35677
21-06-2017,2,12633,13273,5319,2233,33457,1127,220,101,1448,34905
21-06-2017,3,12679,13200,5144,2265,33289,1108,223,101,1432,34721
21-06-2017,4,12974,13098,5077,2186,33336,1112,232,91,1435,34771
21-06-2017,5,14975,13841,5196,2018,36029,1172,244,83,1499,37528
21-06-2017,6,16906,14838,5717,2136,39599,1409,393,69,1871,41470
21-06-2017,7,17958,15958,6110,2465,42492,1507,873,241,2621,45113
21-06-2017,8,18262,16198,6241,2894,43596,1534,884,297,2715,46311
21-06-2017,9,18438,16227,6321,2564,43552,1533,874,501,2908,46460
21-06-2017,10,18044,16711,6275,2765,43795,1573,860,484,2917,46712
21-06-2017,11,18104,16281,6205,2597,43186,1597,816,382,2795,45981
21-06-2017,12,18345,16137,6241,2389,43114,1610,770,434,2814,45928
21-06-2017,13,18434,15972,6024,2465,42895,1599,747,402,2748,45643
21-06-2017,14,18232,16367,5905,2608,43112,1582,685,400,2667,45779
21-06-2017,15,17717,15991,5752,2658,42119,1562,591,324,2477,44596
21-06-2017,16,17663,15885,5648,2631,41827,1561,569,310,2440,44267
21-06-2017,17,17589,16412,5870,2622,42495,1527,550,267,2344,44839
21-06-2017,18,17440,16659,5872,2455,42427,1559,567,217,2343,44770
21-06-2017,19,17639,16744,5953,2321,42657,1541,570,305,2416,45073
21-06-2017,20,17630,15781,5880,2172,41465,1543,488,127,2158,43623
21-06-2017,21,17472,15301,6004,1847,40623,1522,299,132,1953,42576
21-06-2017,22,17272,14528,5910,1701,39410,1504,251,130,1885,41295
21-06-2017,23,16642,13718,5832,1640,37834,1527,274,102,1903,39737
22-06-2017,0,16208,13170,5662,1481,36522,1235,254,99,1588,38110
22-06-2017,1,15795,12837,5690,1159,35482,1168,217,120,1505,36987
22-06-2017,2,15718,12617,5510,1069,34915,1121,213,130,1464,36379
22-06-2017,3,15608,12536,5364,986,34495,1087,215,130,1432,35927
22-06-2017,4,15462,12519,5378,1006,34366,1131,228,113,1472,35838
22-06-2017,5,15718,13467,5562,1022,35771,1425,249,119,1793,37564
22-06-2017,6,16233,15000,5835,1593,38662,1477,371,98,1946,40608
22-06-2017,7,17593,16364,5983,1757,41696,1490,1000,314,2804,44500
22-06-2017,8,18206,16525,6155,1889,42776,1498,1055,578,3131,45907
22-06-2017,9,18200,16312,6191,1776,42480,1509,997,537,3043,45523
22-06-2017,10,18453,16635,6221,1731,43039,1522,990,359,2871,45910
22-06-2017,11,18412,16750,6273,1865,43300,1545,809,322,2676,45976
22-06-2017,12,18144,16412,6270,2082,42907,1556,793,336,2685,45592
22-06-2017,13,17860,15711,6108,1954,41633,1551,788,310,2649,44282
22-06-2017,14,17970,14735,6107,1687,40499,1562,708,397,2667,43166
22-06-2017,15,17775,14405,6121,1539,39840,1481,689,183,2353,42193
22-06-2017,16,17792,14329,6116,1363,39600,1488,601,143,2232,41832
22-06-2017,17,17940,15543,6229,1218,40932,1454,554,124,2132,43064
22-06-2017,18,17700,15702,6183,1262,40848,1442,550,110,2102,42950
22-06-2017,19,17404,14965,6058,1248,39673,1429,456,284,2169,41842
22-06-2017,20,17200,14069,6003,1260,38532,1424,457,65,1946,40478
22-06-2017,21,17256,12958,5829,1282,37325,1430,271,46,1747,39072
22-06-2017,22,17078,12249,5638,1265,36232,1414,253,40,1707,37939
22-06-2017,23,16499,11573,5389,920,34380,1394,248,36,1678,36058
23-06-2017,0,15706,11032,5193,1078,33008,1082,207,33,1322,34330
23-06-2017,1,14178,10733,4994,1106,31012,996,198,32,1226,32238
23-06-2017,2,12924,10814,4815,1153,29706,999,201,35,1235,30941
23-06-2017,3,12573,10728,4796,1165,29262,1011,203,33,1247,30509
23-06-2017,4,12690,10705,4714,1186,29294,974,212,32,1218,30512
23-06-2017,5,14416,11256,4841,1266,31782,972,227,33,1232,33014
23-06-2017,6,16386,12090,5297,1095,34868,1184,340,40,1564,36432
23-06-2017,7,17594,13899,5476,1126,38095,1292,547,39,1878,39973
23-06-2017,8,18034,14666,5595,1179,39474,1298,840,51,2189,41663
23-06-2017,9,18353,14949,5721,1384,40408,1314,839,53,2206,42614
23-06-2017,10,18269,15133,5668,1683,40753,1316,842,231,2389,43142
23-06-2017,11,18043,14865,5510,1984,40400,1318,888,227,2433,42833
23-06-2017,12,18210,14285,5544,1759,39798,1316,751,41,2108,41906
23-06-2017,13,17785,13154,5315,1878,38131,1321,696,36,2053,40184
23-06-2017,14,16852,12567,4936,2359,36714,1261,614,36,1911,38625
23-06-2017,15,16140,12587,4843,2597,36168,1067,554,40,1661,37829
23-06-2017,16,15993,12657,5104,2658,36413,873,555,37,1465,37878
23-06-2017,17,17055,13514,5070,3153,38791,864,552,39,1455,40246
23-06-2017,18,17506,13881,5128,2966,39482,860,457,48,1365,40847
23-06-2017,19,17084,13779,5087,2814,38765,833,429,54,1316,40081
23-06-2017,20,16396,13150,4913,2554,37012,790,413,67,1270,38282
23-06-2017,21,15889,13183,4875,2515,36462,788,265,76,1129,37591
23-06-2017,22,16345,12881,4821,2334,36381,804,239,80,1123,37504
23-06-2017,23,16002,12600,4650,2294,35547,816,210,89,1115,36662
24-06-2017,0,14879,12387,4640,2425,34331,825,170,140,1135,35466
24-06-2017,1,13972,12117,4418,2470,32978,823,157,129,1109,34087
24-06-2017,2,13165,11916,4349,2431,31863,820,160,108,1088,32951
24-06-2017,3,12598,11834,4318,2378,31128,818,164,96,1078,32206
24-06-2017,4,11601,11830,4252,2314,29998,820,165,79,1064,31062
24-06-2017,5,10952,11905,4306,2276,29439,824,172,72,1068,30507
24-06-2017,6,11901,11966,4512,2257,30637,808,216,61,1085,31722
24-06-2017,7,13560,12367,4690,2224,32841,814,253,38,1105,33946
24-06-2017,8,14740,12931,4918,2104,34693,819,271,35,1125,35818
24-06-2017,9,15042,13129,5011,2336,35519,826,336,42,1204,36723
24-06-2017,10,13519,13337,4977,2481,34315,822,338,56,1216,35531
24-06-2017,11,12620,13333,4864,2808,33625,827,339,139,1305,34930
24-06-2017,12,12156,13069,4780,3100,33105,823,337,194,1354,34459
24-06-2017,13,11539,12979,4658,3688,32864,818,354,225,1397,34261
24-06-2017,14,11045,12863,4621,4032,32561,819,358,226,1403,33964
24-06-2017,15,10503,12824,4680,4239,32247,831,366,222,1419,33666
24-06-2017,16,10513,12911,4748,4272,32445,842,365,246,1453,33898
24-06-2017,17,11535,13005,4883,4048,33471,853,362,265,1480,34951
24-06-2017,18,13032,13586,5026,4273,35917,870,452,266,1588,37505
24-06-2017,19,13546,13563,5092,4023,36225,852,455,271,1578,37803
24-06-2017,20,13800,13558,5179,3664,36201,852,456,256,1564,37765
24-06-2017,21,14058,13395,5149,3360,35961,858,264,290,1412,37373
24-06-2017,22,14271,13261,5098,3168,35798,881,265,325,1471,37269
24-06-2017,23,13752,12997,5084,3023,34857,875,274,310,1459,36316
25-06-2017,0,13331,12515,5007,2896,33750,809,172,314,1295,35045
25-06-2017,1,12092,12154,4922,2811,31979,809,167,293,1269,33248
25-06-2017,2,10538,11757,4912,2903,30111,823,174,287,1284,31395
25-06-2017,3,10178,11494,4868,2787,29327,822,179,288,1289,30616
25-06-2017,4,9971,11272,4642,2570,28457,840,178,309,1327,29784
25-06-2017,5,9885,11210,4546,2392,28034,824,180,318,1322,29356
25-06-2017,6,9962,11481,4548,2519,28510,825,184,302,1311,29821
25-06-2017,7,10407,11697,4664,2587,29355,849,284,285,1418,30773
25-06-2017,8,10778,12073,4872,3030,30752,863,284,319,1466,32218
25-06-2017,9,11112,12501,5189,3543,32344,960,345,341,1646,33990
25-06-2017,10,10970,12676,5187,4087,32920,1080,405,346,1831,34751
25-06-2017,11,10951,12937,5144,4414,33446,1068,380,326,1774,35220
25-06-2017,12,10684,13345,5134,4610,33774,1067,350,305,1722,35496
25-06-2017,13,10555,13431,5053,4683,33722,1093,344,234,1671,35393
25-06-2017,14,10157,13535,5062,4853,33608,1100,341,164,1605,35213
25-06-2017,15,10626,13642,5158,4961,34387,1118,334,160,1612,35999
25-06-2017,16,10700,13351,5091,4897,34039,1109,331,133,1573,35612
25-06-2017,17,11230,13331,5066,4776,34405,1135,386,89,1610,36015
25-06-2017,18,12479,13520,5135,4625,35759,1130,384,100,1614,37373
25-06-2017,19,13793,13599,5163,4504,37060,1128,416,165,1709,38769
25-06-2017,20,14003,13595,5123,4293,37014,1129,412,267,1808,38822
25-06-2017,21,14278,13649,5055,3965,36946,1088,277,267,1632,38578
25-06-2017,22,13947,13607,5000,3844,36397,1072,254,266,1592,37989
25-06-2017,23,12763,13218,4948,3839,34769,1067,183,275,1525,36294
26-06-2017,0,11546,13004,4668,3945,33163,1030,177,270,1477,34640
26-06-2017,1,10816,12542,4410,3877,31645,1014,172,291,1477,33122
26-06-2017,2,10423,12311,4423,3856,31013,1027,174,273,1474,32487
26-06-2017,3,10508,12387,4499,3916,31311,1048,175,252,1475,32786
26-06-2017,4,10497,12376,4620,3849,31343,1096,184,239,1519,32862
26-06-2017,5,12052,13046,4723,3806,33627,1267,282,233,1782,35409
26-06-2017,6,14036,14758,5090,3840,37723,1392,592,247,2231,39954
26-06-2017,7,15681,16474,5574,4028,41759,1489,687,253,2429,44188
26-06-2017,8,16396,16947,5759,4425,43527,1507,768,519,2794,46321
26-06-2017,9,16355,17031,5795,4355,43536,1443,917,562,2922,46458
26-06-2017,10,16306,16897,5752,4356,43311,1489,939,555,2983,46294
26-06-2017,11,15990,17137,5705,4392,43225,1486,880,567,2933,46158
26-06-2017,12,15693,16877,5727,4403,42699,1482,877,605,2964,45663
26-06-2017,13,15663,17089,5662,4409,42823,1469,873,614,2956,45779
26-06-2017,14,15608,16646,5583,4434,42273,1444,692,637,2773,45046
26-06-2017,15,15512,16542,5178,4446,41677,1451,546,454,2451,44128
26-06-2017,16,15536,16788,5170,4462,41956,1446,487,427,2360,44316
26-06-2017,17,15899,16851,5381,4454,42585,1498,486,453,2437,45022
26-06-2017,18,15938,16838,5487,4307,42569,1503,485,451,2439,45008
26-06-2017,19,15947,16593,5491,3983,42015,1472,479,427,2378,44393
26-06-2017,20,15939,16096,5285,3698,41020,1189,439,409,2037,43057
26-06-2017,21,15922,16069,5149,3376,40518,1179,293,371,1843,42361
26-06-2017,22,15608,15493,5209,3234,39544,1180,289,356,1825,41369
26-06-2017,23,15113,15030,4994,3039,38175,1183,268,321,1772,39947
27-06-2017,0,14096,14769,4850,2956,36671,1210,241,310,1761,38432
27-06-2017,1,13690,14678,4902,2782,36053,1244,243,301,1788,37841
27-06-2017,2,13419,14475,4851,2573,35319,1253,249,307,1809,37128
27-06-2017,3,13352,14406,4786,2307,34851,1275,247,285,1807,36658
27-06-2017,4,13168,14442,4926,2128,34664,1343,258,266,1867,36531
27-06-2017,5,14123,15520,5362,2060,37063,1531,276,254,2061,39124
27-06-2017,6,15110,17730,5578,2059,40477,1680,371,318,2369,42846
27-06-2017,7,16061,18662,5783,2272,42779,1790,436,479,2705,45484
27-06-2017,8,16395,18542,5809,2437,43183,1811,548,689,3048,46231
27-06-2017,9,16623,18512,5881,2314,43331,1813,618,794,3225,46556
27-06-2017,10,16684,18404,5945,2268,43301,1814,791,829,3434,46735
27-06-2017,11,16855,18284,5918,2168,43225,1832,1029,798,3659,46884
27-06-2017,12,16467,17659,5872,2051,42050,1842,817,772,3431,45481
27-06-2017,13,16609,17174,5872,1782,41436,1858,582,757,3197,44633
27-06-2017,14,16760,17445,5989,1756,41951,1863,574,602,3039,44990
27-06-2017,15,16690,17353,6128,1538,41710,1851,481,490,2822,44532
27-06-2017,16,16240,16922,5903,1427,40493,1841,426,423,2690,43183
27-06-2017,17,16600,17140,6169,1254,41162,1821,421,382,2624,43786
27-06-2017,18,16698,17471,6139,1349,41657,1808,421,342,2571,44228
27-06-2017,19,16297,17168,6150,1229,40844,1808,405,281,2494,43338
27-06-2017,20,16154,16457,6001,1061,39674,1789,364,275,2428,42102
27-06-2017,21,15905,15754,5867,912,38437,1771,273,259,2303,40740
27-06-2017,22,15552,15251,5902,826,37531,1767,261,69,2097,39628
27-06-2017,23,15230,14611,5684,785,36309,1759,228,39,2026,38335
28-06-2017,0,14261,13947,5629,890,34726,1509,204,37,1750,36476
28-06-2017,1,14164,12955,5576,981,33676,1355,202,34,1591,35267
28-06-2017,2,14115,12906,5261,958,33240,1324,203,34,1561,34801
28-06-2017,3,14350,13030,4887,990,33258,1307,202,34,1543,34801
28-06-2017,4,14299,13191,4962,1095,33545,1330,210,46,1586,35131
28-06-2017,5,14017,13657,5188,1154,34017,1581,229,74,1884,35901
28-06-2017,6,14837,15257,5441,1307,36841,1708,407,104,2219,39060
28-06-2017,7,15954,16540,5795,1712,40002,1738,429,104,2271,42273
28-06-2017,8,15808,16958,5952,1966,40685,1745,426,532,2703,43388
28-06-2017,9,15872,17019,5977,2299,41168,1759,559,534,2852,44020
28-06-2017,10,16243,16902,5954,2533,41630,1766,628,533,2927,44557
28-06-2017,11,15868,16853,5939,2797,41456,1760,767,533,3060,44516
28-06-2017,12,15594,16528,5846,3018,40987,1759,730,533,3022,44009
28-06-2017,13,15575,16160,5788,3020,40544,1741,702,533,2976,43520
28-06-2017,14,15636,16005,5769,3401,40810,1737,537,397,2671,43481
28-06-2017,15,15616,15784,5614,3241,40254,1743,443,216,2402,42656
28-06-2017,16,15690,15813,5416,3551,40470,1724,439,209,2372,42842
28-06-2017,17,15680,16269,5399,3899,41248,1712,387,238,2337,43585
28-06-2017,18,15411,16632,5529,3977,41548,1708,379,250,2337,43885
28-06-2017,19,15419,16489,5543,3869,41320,1692,292,228,2212,43532
28-06-2017,20,15344,16060,5316,3630,40351,1615,286,229,2130,42481
28-06-2017,21,15421,15400,5172,3618,39611,1606,285,299,2190,41801
28-06-2017,22,14913,14869,5149,3774,38704,1622,265,293,2180,40884
28-06-2017,23,14324,14136,4930,3931,37320,1611,281,295,2187,39507
29-06-2017,0,12943,13498,4692,3973,35106,1359,243,299,1901,37007
29-06-2017,1,12384,13318,4532,3794,34029,1254,238,301,1793,35822
29-06-2017,2,12296,13229,4516,3745,33785,1254,244,308,1806,35591
29-06-2017,3,12312,13247,4501,3545,33604,1263,241,274,1778,35382
29-06-2017,4,12535,13561,4518,3318,33931,1293,254,262,1809,35740
29-06-2017,5,13725,14355,4759,3074,35912,1553,279,238,2070,37982
29-06-2017,6,14946,16586,5260,2980,39771,1703,404,239,2346,42117
29-06-2017,7,15930,17922,5507,3024,42385,1704,568,424,2696,45081
29-06-2017,8,16071,18440,5576,3113,43200,1724,654,643,3021,46221
29-06-2017,9,16190,18648,5579,3218,43636,1731,753,625,3109,46745
29-06-2017,10,16274,18603,5664,3188,43728,1753,813,624,3190,46918
29-06-2017,11,16128,18643,5613,3136,43519,1778,771,644,3193,46712
29-06-2017,12,16173,18487,5613,3115,43388,1811,630,663,3104,46492
29-06-2017,13,15981,18410,5508,2893,42792,1815,580,630,3025,45817
29-06-2017,14,16154,18421,5525,2626,42726,1832,578,423,2833,45559
29-06-2017,15,16079,18432,5507,2442,42461,1860,497,248,2605,45066
29-06-2017,16,15875,18456,5376,2520,42226,1877,490,280,2647,44873
29-06-2017,17,15797,18532,5433,2339,42101,1885,482,248,2615,44716
29-06-2017,18,15422,18004,5455,2211,41091,1876,465,200,2541,43632
29-06-2017,19,15546,17825,5416,2166,40954,1846,428,191,2465,43419
29-06-2017,20,15758,17995,5512,2063,41327,1732,393,154,2279,43606
29-06-2017,21,15755,17600,5432,2056,40841,1682,304,208,2194,43035
29-06-2017,22,15375,17023,5369,2085,39852,1680,262,263,2205,42057
29-06-2017,23,14752,15701,5251,1818,37522,1613,252,230,2095,39617
30-06-2017,0,14485,14780,4918,1977,36160,1410,225,190,1825,37985
30-06-2017,1,13251,14467,4805,2001,34525,1385,216,149,1750,36275
30-06-2017,2,12380,14401,4722,2034,33539,1410,219,138,1767,35306
30-06-2017,3,11848,14360,4705,2122,33036,1404,222,135,1761,34797
30-06-2017,4,11984,14375,4687,2178,33226,1407,223,123,1753,34979
30-06-2017,5,13284,14839,4791,2239,35156,1605,253,122,1980,37136
30-06-2017,6,14633,16945,5067,2317,38964,1815,392,118,2325,41289
30-06-2017,7,15630,18429,5506,2436,42001,1898,511,163,2572,44573
30-06-2017,8,16016,18738,5706,2405,42865,1899,795,585,3279,46144
30-06-2017,9,15973,18675,5700,2483,42832,1896,802,494,3192,46024
30-06-2017,10,16024,18514,5844,2431,42813,1901,733,244,2878,45691
30-06-2017,11,16120,18286,5806,2341,42554,1901,705,227,2833,45387
30-06-2017,12,15918,17898,5842,2357,42016,1913,610,237,2760,44776
30-06-2017,13,15545,17125,5686,2261,40618,1919,593,239,2751,43369
30-06-2017,14,15805,16548,5530,2039,39922,1906,432,322,2660,42582
30-06-2017,15,15947,16588,5332,1936,39803,1731,416,298,2445,42248
30-06-2017,16,15923,17326,5258,1950,40456,1579,411,302,2292,42748
30-06-2017,17,15966,17847,5515,1956,41285,1622,407,311,2340,43625
30-06-2017,18,15841,18382,5693,2236,42153,1743,472,286,2501,44654
30-06-2017,19,15393,18160,5640,2324,41517,1770,335,380,2485,44002
30-06-2017,20,15056,16954,5407,2067,39484,1766,226,350,2342,41826
30-06-2017,21,14909,16089,5349,1955,38302,1762,248,238,2248,40550
30-06-2017,22,14455,15375,5489,2131,37452,1510,227,252,1989,39441
30-06-2017,23,14232,14487,5414,2228,36362,1209,200,263,1672,38034
01-07-2017,0,13781,13227,5207,2140,34355,1107,152,271,1530,35885
01-07-2017,1,13141,12496,5113,2031,32780,1057,144,277,1478,34258
01-07-2017,2,12509,12367,5098,1880,31854,1054,145,282,1481,33335
01-07-2017,3,12405,12137,5115,1699,31354,1067,150,277,1494,32848
01-07-2017,4,12464,11972,4903,1651,30990,1074,150,277,1501,32491
01-07-2017,5,13147,11904,4608,1585,31245,1073,154,283,1510,32755
01-07-2017,6,13869,12615,4543,1546,32572,1086,212,266,1564,34136
01-07-2017,7,14361,13518,4758,1476,34112,1255,240,265,1760,35872
01-07-2017,8,14538,14652,4892,1469,35552,1442,293,266,2001,37553
01-07-2017,9,14854,15362,5088,1636,36939,1440,474,245,2159,39098
01-07-2017,10,14951,15603,5048,1732,37334,1438,610,242,2290,39624
01-07-2017,11,15050,15364,5130,1796,37340,1429,693,316,2438,39778
01-07-2017,12,14881,14336,5073,1932,36221,1429,696,321,2446,38667
01-07-2017,13,14652,13585,5075,1893,35205,1435,444,294,2173,37378
01-07-2017,14,14577,13523,4960,2024,35084,1425,423,309,2157,37241
01-07-2017,15,14580,13443,4789,1977,34789,1374,417,303,2094,36883
01-07-2017,16,14612,13553,4899,2004,35067,1361,418,285,2064,37131
01-07-2017,17,14969,14301,5029,1954,36252,1396,364,263,2023,38275
01-07-2017,18,14994,14641,5117,1886,36639,1381,391,226,1998,38637
01-07-2017,19,14876,14646,5199,1801,36522,1355,475,203,2033,38555
01-07-2017,20,14514,14796,5339,1761,36410,1371,484,240,2095,38505
01-07-2017,21,14433,14564,5247,1767,36012,1358,463,137,1958,37970
01-07-2017,22,14027,14322,5365,1836,35551,1346,321,112,1779,37330
01-07-2017,23,13470,13002,5274,1974,33719,1289,244,100,1633,35352
02-07-2017,0,12774,11913,5079,2150,31916,952,154,100,1206,33122
02-07-2017,1,10733,11474,5085,2235,29526,865,147,105,1117,30643
02-07-2017,2,10043,11281,5060,2342,28725,871,148,140,1159,29884
02-07-2017,3,9854,11172,5040,2338,28403,879,152,173,1204,29607
02-07-2017,4,8317,11035,4846,2398,26596,859,154,175,1188,27784
02-07-2017,5,8134,10891,4623,2511,26157,852,155,181,1188,27345
02-07-2017,6,8761,11074,4485,2496,26817,844,245,185,1274,28091
02-07-2017,7,11282,11230,4519,2472,29502,859,400,180,1439,30941
02-07-2017,8,12165,11575,4666,2549,30956,922,618,669,2209,33165
02-07-2017,9,13256,12069,4817,2631,32773,949,664,777,2390,35163
02-07-2017,10,13055,12505,4794,3091,33445,946,674,278,1898,35343
02-07-2017,11,12948,13124,4860,3627,34558,940,626,297,1863,36421
02-07-2017,12,12434,13154,4842,3867,34297,913,627,303,1843,36140
02-07-2017,13,12306,13116,4785,4096,34303,905,624,272,1801,36104
02-07-2017,14,11741,13414,4805,4402,34362,902,623,300,1825,36187
02-07-2017,15,11348,13722,4863,4649,34582,912,538,323,1773,36355
02-07-2017,16,11092,14079,4823,4661,34654,879,535,295,1709,36363
02-07-2017,17,11563,14311,4876,4620,35372,861,532,279,1672,37044
02-07-2017,18,13064,14922,4916,4616,37518,870,532,266,1668,39186
02-07-2017,19,13606,14992,4904,4360,37863,843,517,265,1625,39488
02-07-2017,20,13982,14927,4823,4156,37889,824,409,271,1504,39393
02-07-2017,21,14058,14914,5096,4028,38098,828,418,243,1489,39587
02-07-2017,22,13620,14774,4969,3861,37225,882,329,421,1632,38857
02-07-2017,23,13567,14334,4870,3853,36624,878,239,430,1547,38171
03-07-2017,0,12241,13710,4715,3245,33911,783,151,220,1154,35065
03-07-2017,1,11276,13353,4684,3655,32969,787,151,229,1167,34136
03-07-2017,2,10994,13296,4696,3487,32474,802,157,223,1182,33656
03-07-2017,3,11006,13367,4730,3316,32420,808,161,249,1218,33638
03-07-2017,4,11014,13382,4763,3205,32363,881,165,275,1321,33684
03-07-2017,5,11802,13800,4869,3021,33490,1164,239,265,1668,35158
03-07-2017,6,13988,14875,5248,2958,37070,1262,524,501,2287,39357
03-07-2017,7,15662,16255,5519,3104,40540,1298,813,504,2615,43155
03-07-2017,8,16065,16885,5680,3422,42052,1304,892,750,2946,44998
03-07-2017,9,16261,16885,5732,3745,42623,1328,937,782,3047,45670
03-07-2017,10,16552,17190,5735,3693,43170,1342,969,790,3101,46271
03-07-2017,11,16474,17300,5805,3682,43263,1365,791,816,2972,46235
03-07-2017,12,16327,17028,5722,3793,42872,1373,881,808,3062,45934
03-07-2017,13,16666,16827,5761,3698,42952,1388,819,828,3035,45987
03-07-2017,14,16398,16831,5729,3229,42186,1402,896,630,2928,45114
03-07-2017,15,16027,17000,5588,3064,41679,1384,811,626,2821,44500
03-07-2017,16,15978,16778,5553,3385,41695,1373,799,440,2612,44307
03-07-2017,17,16207,16926,5554,3265,41951,1393,696,487,2576,44527
03-07-2017,18,15767,17091,5551,3570,41979,1392,636,584,2612,44591
03-07-2017,19,15795,16327,5536,3454,41112,1377,637,556,2570,43682
03-07-2017,20,15650,16193,5317,3292,40451,1375,619,391,2385,42836
03-07-2017,21,15352,15811,5335,3129,39626,1375,569,314,2258,41884
03-07-2017,22,15135,15038,5186,3065,38424,1389,478,282,2149,40573
03-07-2017,23,14701,14422,5068,3228,37420,1376,301,235,1912,39332
04-07-2017,0,13941,13534,4742,3305,35521,1116,200,234,1550,37071
04-07-2017,1,13423,13235,4656,3340,34654,1022,198,224,1444,36098
04-07-2017,2,12833,13183,4582,3365,33963,1118,200,206,1524,35487
04-07-2017,3,12521,13196,4547,3379,33644,1132,203,196,1531,35175
04-07-2017,4,12181,13271,4748,3260,33460,1061,214,174,1449,34909
04-07-2017,5,12634,13567,5090,3041,34331,1237,233,161,1631,35962
04-07-2017,6,14675,14443,5486,3005,37610,1352,752,257,2361,39971
04-07-2017,7,15782,16618,5678,3037,41116,1368,898,369,2635,43751
04-07-2017,8,16290,17307,5813,3151,42561,1375,1083,629,3087,45648
04-07-2017,9,16519,17812,5854,3116,43300,1382,1080,622,3084,46384
04-07-2017,10,16740,18221,5834,2825,43620,1394,1067,636,3097,46717
04-07-2017,11,16319,17795,5813,3021,42946,1390,985,681,3056,46002
04-07-2017,12,16171,17280,5984,2860,42296,1388,859,748,2995,45291
04-07-2017,13,16358,17258,5957,3071,42645,1381,808,766,2955,45600
04-07-2017,14,16493,17043,5959,3153,42650,1386,860,587,2833,45483
04-07-2017,15,16227,17283,5930,3137,42577,1399,789,598,2786,45363
04-07-2017,16,16192,17358,5959,3109,42616,1365,624,508,2497,45113
04-07-2017,17,16019,17686,5868,3157,42731,1377,628,308,2313,45044
04-07-2017,18,15714,17814,6024,3065,42616,1427,703,273,2403,45019
04-07-2017,19,15930,17753,6042,2843,42567,1421,627,266,2314,44881
04-07-2017,20,15760,17672,5956,2501,41888,1412,599,206,2217,44105
04-07-2017,21,16101,17189,5883,2191,41364,1412,446,171,2029,43393
04-07-2017,22,15868,16511,5708,1983,40070,1426,417,162,2005,42075
04-07-2017,23,15513,15923,5403,1882,38721,1447,391,171,2009,40730
05-07-2017,0,14578,14787,5253,1769,36386,1438,390,160,1988,38374
05-07-2017,1,14267,14235,5123,1678,35304,1423,392,143,1958,37262
05-07-2017,2,14108,13889,4985,1598,34580,1433,394,108,1935,36515
05-07-2017,3,14194,13714,4959,1545,34412,1431,394,90,1915,36327
05-07-2017,4,14196,13793,4974,1541,34503,1403,394,96,1893,36396
05-07-2017,5,14184,14761,5357,1704,36006,1470,411,70,1951,37957
05-07-2017,6,14887,16390,5853,2021,39151,1439,438,75,1952,41103
05-07-2017,7,15617,17465,6195,2342,41618,1425,696,349,2470,44088
05-07-2017,8,16332,17688,6355,2391,42765,1452,822,354,2628,45393
05-07-2017,9,16374,17669,6331,2487,42861,1490,950,274,2714,45575
05-07-2017,10,16370,17669,6332,2508,42878,1489,904,273,2666,45544
05-07-2017,11,16431,17276,6301,2530,42538,1496,897,306,2699,45237
05-07-2017,12,16280,16919,6361,2614,42175,1524,811,331,2666,44841
05-07-2017,13,15931,16777,6279,2655,41643,1538,811,311,2660,44303
05-07-2017,14,15701,16610,6257,2695,41263,1570,815,316,2701,43964
05-07-2017,15,15635,16712,6220,2770,41339,1580,681,210,2471,43810
05-07-2017,16,15590,16849,6336,2776,41551,1586,673,161,2420,43971
05-07-2017,17,15942,17277,6431,2717,42368,1564,671,141,2376,44744
05-07-2017,18,16084,17347,6477,2548,42456,1518,652,213,2383,44839
05-07-2017,19,16277,17219,6494,2481,42468,1456,638,188,2282,44750
05-07-2017,20,16004,17122,6393,2208,41728,1442,633,110,2185,43913
05-07-2017,21,16038,16751,6362,1970,41121,1462,450,111,2023,43144
05-07-2017,22,15578,16041,6208,1949,39776,1463,453,112,2028,41804
05-07-2017,23,15412,15070,5852,1822,38157,1439,405,99,1943,40100
06-07-2017,0,14927,13958,5688,1361,35934,1438,391,88,1917,37851
06-07-2017,1,14480,13352,5590,1157,34578,1449,391,77,1917,36495
06-07-2017,2,14344,13193,5568,1179,34285,1449,391,68,1908,36193
06-07-2017,3,14187,13121,5595,1121,34025,1463,394,57,1914,35939
06-07-2017,4,14062,13081,5641,1141,33925,1400,405,51,1856,35781
06-07-2017,5,14189,13770,5903,1183,35045,1408,424,42,1874,36919
06-07-2017,6,14817,15362,6385,1700,38263,1413,457,46,1916,40179
06-07-2017,7,15946,16557,6792,1995,41290,1474,554,261,2289,43579
06-07-2017,8,16722,16968,6913,1871,42474,1492,818,278,2588,45062
06-07-2017,9,16629,17121,6939,2032,42722,1491,976,289,2756,45478
06-07-2017,10,16568,16551,6846,2220,42184,1500,880,509,2889,45073
06-07-2017,11,16784,16171,6890,2312,42157,1526,872,552,2950,45107
06-07-2017,12,16843,15661,6853,2257,41613,1519,876,530,2925,44538
06-07-2017,13,16696,15546,6797,2254,41295,1517,877,424,2818,44113
06-07-2017,14,16776,15351,6684,2158,40969,1486,771,432,2689,43658
06-07-2017,15,16565,15676,6625,2338,41204,1483,713,294,2490,43694
06-07-2017,16,16481,15816,6489,2380,41166,1490,625,212,2327,43493
06-07-2017,17,16348,16699,6514,2319,41880,1454,631,204,2289,44169
06-07-2017,18,16285,16826,6561,2209,41881,1353,631,471,2455,44336
06-07-2017,19,16086,16837,6516,2170,41610,1333,802,449,2584,44194
06-07-2017,20,15695,16765,6320,2061,40841,1311,648,223,2182,43023
06-07-2017,21,15772,16169,6196,1752,39890,1300,630,98,2028,41918
06-07-2017,22,15456,15770,6076,1539,38839,1292,446,100,1838,40677
06-07-2017,23,15020,14475,5736,1205,36436,1283,414,95,1792,38228
07-07-2017,0,14533,12904,5594,1028,34059,1282,404,74,1760,35819
07-07-2017,1,14360,12065,5382,952,32760,1265,399,58,1722,34482
07-07-2017,2,14030,11825,5291,946,32092,1258,405,46,1709,33801
07-07-2017,3,13981,11856,5300,983,32120,1258,404,42,1704,33824
07-07-2017,4,14079,11803,5326,967,32175,1258,417,47,1722,33897
07-07-2017,5,14207,12283,5620,1003,33113,1256,443,49,1748,34861
07-07-2017,6,14857,14208,6150,1394,36608,1229,591,66,1886,38494
07-07-2017,7,15886,15613,6404,1887,39790,1256,869,39,2164,41954
07-07-2017,8,16301,16133,6290,2077,40801,1262,924,393,2579,43380
07-07-2017,9,16507,16159,6256,2169,41093,1267,983,393,2643,43736
07-07-2017,10,16678,16092,6269,2147,41186,1265,1074,406,2745,43931
07-07-2017,11,16531,15761,6300,2076,40668,1255,983,422,2660,43328
07-07-2017,12,16528,15379,6376,2022,40305,1255,1106,402,2763,43068
07-07-2017,13,16459,14987,6301,2000,39747,1263,1063,401,2727,42474
07-07-2017,14,16353,14822,6268,1662,39106,1280,962,344,2586,41692
07-07-2017,15,16335,14755,6157,1669,38917,1300,766,326,2392,41309
07-07-2017,16,16200,14978,6087,1594,38859,1305,657,51,2013,40872
07-07-2017,17,16044,15750,6002,1826,39622,1302,659,68,2029,41651
07-07-2017,18,15851,16044,6038,1790,39723,1295,657,225,2177,41900
07-07-2017,19,15728,16150,6014,1655,39548,1299,647,172,2118,41666
07-07-2017,20,15549,15787,5984,1555,38876,1274,438,61,1773,40649
07-07-2017,21,15417,15518,5894,1565,38394,1282,265,60,1607,40001
07-07-2017,22,15305,15260,5748,1483,37795,1288,252,49,1589,39384
07-07-2017,23,14826,14906,5512,1423,36667,1274,239,57,1570,38237
08-07-2017,0,14497,13570,5262,1359,34689,1017,236,68,1321,36010
08-07-2017,1,14381,12931,5029,1143,33485,931,231,74,1236,34721
08-07-2017,2,14254,12445,4948,1078,32726,912,232,80,1224,33950
08-07-2017,3,14071,12414,4899,1146,32530,898,242,85,1225,33755
08-07-2017,4,13889,12404,4918,1135,32346,912,256,95,1263,33609
08-07-2017,5,13571,12299,4912,1121,31903,899,250,98,1247,33150
08-07-2017,6,13804,12750,4930,1302,32785,874,259,95,1228,34013
08-07-2017,7,14240,13697,5079,1405,34420,873,272,97,1242,35662
08-07-2017,8,14624,14542,5388,1906,36460,885,283,218,1386,37846
08-07-2017,9,14996,14863,5498,2230,37588,908,306,263,1477,39065
08-07-2017,10,15317,14682,5537,2498,38034,908,330,257,1495,39529
08-07-2017,11,15138,14590,5587,2611,37927,908,317,263,1488,39415
08-07-2017,12,15143,14239,5405,2679,37466,905,397,264,1566,39032
08-07-2017,13,14985,13830,5284,2768,36867,909,446,276,1631,38498
08-07-2017,14,14535,13424,5269,3173,36401,909,453,279,1641,38042
08-07-2017,15,14521,13106,5333,3388,36348,916,402,271,1589,37937
08-07-2017,16,14610,13490,5385,3507,36993,919,452,264,1635,38628
08-07-2017,17,14960,14297,5451,3371,38080,913,411,252,1576,39656
08-07-2017,18,15026,14530,5547,3427,38531,906,361,251,1518,40049
08-07-2017,19,14972,14406,5473,3407,38259,906,276,197,1379,39638
08-07-2017,20,14679,14366,5352,3179,37578,903,271,171,1345,38923
08-07-2017,21,14597,14158,5343,2884,36982,896,285,140,1321,38303
08-07-2017,22,14580,14044,5282,2648,36555,893,305,37,1235,37790
08-07-2017,23,14577,13557,5100,2488,35722,877,253,40,1170,36892
09-07-2017,0,14204,13021,5009,2308,34543,880,225,58,1163,35706
09-07-2017,1,13960,12601,5086,2089,33737,851,224,65,1140,34877
09-07-2017,2,13915,12105,5056,2007,33085,849,222,65,1136,34221
09-07-2017,3,13767,11875,4972,1894,32510,848,226,54,1128,33638
09-07-2017,4,13398,11686,4912,1911,31907,845,237,54,1136,33043
09-07-2017,5,13201,11439,4853,1832,31324,844,249,51,1144,32468
09-07-2017,6,13242,11427,4852,1735,31257,843,249,49,1141,32398
09-07-2017,7,13179,11643,4795,1857,31474,842,260,46,1148,32622
09-07-2017,8,13968,12572,4939,2023,33502,870,285,75,1230,34732
09-07-2017,9,14543,12948,5023,1949,34464,873,412,184,1469,35933
09-07-2017,10,14913,13441,5047,1806,35208,915,473,103,1491,36699
09-07-2017,11,14972,13742,5055,1720,35488,905,468,159,1532,37020
09-07-2017,12,14946,13888,5083,1768,35685,903,416,192,1511,37196
09-07-2017,13,14888,14059,5063,1770,35778,858,370,305,1533,37311
09-07-2017,14,14473,13958,4964,1717,35111,902,404,242,1548,36659
09-07-2017,15,14311,13990,4930,1644,34876,897,369,248,1514,36390
09-07-2017,16,14792,14163,5072,1551,35577,903,391,198,1492,37069
09-07-2017,17,14609,14800,5105,1425,35939,914,388,185,1487,37426
09-07-2017,18,14659,15022,5184,1345,36211,913,433,133,1479,37690
09-07-2017,19,15001,15101,5320,1191,36614,911,439,118,1468,38082
09-07-2017,20,14978,15094,5380,983,36435,899,390,197,1486,37921
09-07-2017,21,14946,15198,5392,893,36428,912,371,88,1371,37799
09-07-2017,22,14668,15448,5622,955,36693,910,287,75,1272,37965
09-07-2017,23,14366,14849,5297,873,35385,991,238,46,1275,36660
10-07-2017,0,14036,13610,5007,694,33346,1139,226,47,1412,34758
10-07-2017,1,13532,12650,4938,678,31798,1138,220,42,1400,33198
10-07-2017,2,13170,12317,4935,629,31050,1172,225,38,1435,32485
10-07-2017,3,13004,12288,5132,719,31143,1185,231,37,1453,32596
10-07-2017,4,12824,12327,5243,809,31203,1234,247,35,1516,32719
10-07-2017,5,13011,13454,5514,1029,33008,1379,359,34,1772,34780
10-07-2017,6,14146,14911,5798,1408,36263,1453,740,32,2225,38488
10-07-2017,7,14367,16228,6140,1710,38445,1440,1020,58,2518,40963
10-07-2017,8,14703,17015,6213,1932,39863,1462,942,488,2892,42755
10-07-2017,9,15089,17003,6358,2074,40523,1465,1100,491,3056,43579
10-07-2017,10,15368,17119,6354,2037,40880,1463,1052,483,2998,43878
10-07-2017,11,15399,17143,6439,1969,40951,1465,1090,486,3041,43992
10-07-2017,12,15363,16831,6421,1887,40501,1463,1090,483,3036,43537
10-07-2017,13,15112,16874,6438,1947,40371,1459,1241,484,3184,43555
10-07-2017,14,14844,16665,6444,1831,39784,1450,852,258,2560,42344
10-07-2017,15,15008,16392,6368,1773,39542,1457,851,223,2531,42073
10-07-2017,16,14833,16236,6313,1770,39154,1460,766,232,2458,41612
10-07-2017,17,14737,16374,6376,1778,39266,1461,732,126,2319,41585
10-07-2017,18,14971,16702,6344,1786,39804,1453,773,123,2349,42153
10-07-2017,19,14820,16673,6353,1742,39588,1453,812,164,2429,42017
10-07-2017,20,14607,16232,6297,1569,38705,1449,655,218,2322,41027
10-07-2017,21,14555,15754,6274,1462,38045,1453,335,289,2077,40122
10-07-2017,22,14090,15522,6159,1483,37255,1415,276,331,2022,39277
10-07-2017,23,13726,14971,5833,1431,35960,1450,281,325,2056,38016
11-07-2017,0,13349,13545,5720,1175,33789,1453,246,306,2005,35794
11-07-2017,1,13105,12747,5654,1044,32552,1470,226,289,1985,34537
11-07-2017,2,12860,12615,5645,853,31972,1465,237,266,1968,33940
11-07-2017,3,12931,12256,5661,752,31600,1461,245,280,1986,33586
11-07-2017,4,12875,12338,5490,786,31490,1469,257,254,1980,33470
11-07-2017,5,12792,13537,5322,835,32486,1489,273,211,1973,34459
11-07-2017,6,13413,15427,5646,1261,35747,1516,300,164,1980,37727
11-07-2017,7,14351,16632,6142,1817,38942,1540,304,144,1988,40930
11-07-2017,8,15083,16853,6153,1770,39858,1597,322,479,2398,42256
11-07-2017,9,15267,17281,6156,2041,40744,1498,943,427,2868,43612
11-07-2017,10,15389,17162,6136,2274,40962,1501,962,320,2783,43745
11-07-2017,11,15404,16982,6071,2419,40876,1512,898,240,2650,43526
11-07-2017,12,15113,16668,6014,2562,40356,1525,698,193,2416,42772
11-07-2017,13,14960,16312,5991,2802,40066,1534,449,356,2339,42405
11-07-2017,14,14919,16170,6060,2734,39883,1528,375,289,2192,42075
11-07-2017,15,14817,16073,5972,2841,39703,1511,398,282,2191,41894
11-07-2017,16,14787,15919,5956,2799,39462,1514,348,297,2159,41621
11-07-2017,17,15588,16288,5944,2868,40687,1527,431,226,2184,42871
11-07-2017,18,15354,16612,5939,2984,40889,1526,461,217,2204,43093
11-07-2017,19,15313,16628,5976,2837,40755,1509,358,241,2108,42863
11-07-2017,20,15077,16442,5948,2689,40156,1495,348,194,2037,42193
11-07-2017,21,14935,16253,5868,2632,39687,1435,290,112,1837,41524
11-07-2017,22,14750,15663,5622,2511,38546,1468,278,75,1821,40367
11-07-2017,23,14658,14969,5498,2094,37220,1519,323,87,1929,39149
12-07-2017,0,14090,13810,5410,1818,35127,1371,253,104,1728,36855
12-07-2017,1,13847,12681,5342,1692,33560,1375,228,120,1723,35283
12-07-2017,2,13773,12322,5294,1577,32966,1348,231,125,1704,34670
12-07-2017,3,13458,12257,5211,1413,32338,1354,230,139,1723,34061
12-07-2017,4,13270,12253,5155,1396,32075,1352,242,139,1733,33808
12-07-2017,5,13611,12989,5199,1322,33122,1400,262,124,1786,34908
12-07-2017,6,14417,15022,5414,1514,36368,1473,277,121,1871,38239
12-07-2017,7,15179,16093,5898,2044,39215,1505,281,309,2095,41310
12-07-2017,8,15121,16600,6068,2352,40142,1576,364,540,2480,42622
12-07-2017,9,15140,16701,6156,2564,40563,1383,875,531,2789,43352
12-07-2017,10,15234,17007,6113,2798,41152,1440,936,532,2908,44060
12-07-2017,11,15346,17201,6071,3028,41647,1461,936,538,2935,44582
12-07-2017,12,15373,17077,6099,3172,41720,1461,932,558,2951,44671
12-07-2017,13,15504,16801,6101,3271,41678,1465,581,579,2625,44303
12-07-2017,14,15241,16409,6038,3450,41140,1471,517,576,2564,43704
12-07-2017,15,15086,16150,5939,3472,40647,1490,382,529,2401,43048
12-07-2017,16,15130,16281,5858,3540,40809,1492,268,326,2086,42895
12-07-2017,17,14691,16395,5822,3544,40453,1514,261,257,2032,42485
12-07-2017,18,14608,16295,5883,3380,40166,1503,261,54,1818,41984
12-07-2017,19,14772,16112,5874,3201,39958,1481,259,41,1781,41739
12-07-2017,20,14590,15515,5520,3140,38765,1471,272,39,1782,40547
12-07-2017,21,14491,15234,5454,3225,38404,1464,260,54,1778,40182
12-07-2017,22,14129,14754,5248,3418,37549,1460,226,115,1801,39350
12-07-2017,23,13500,13959,5214,3488,36161,1435,206,191,1832,37993
13-07-2017,0,11877,12940,5255,3605,33679,1175,188,159,1522,35201
13-07-2017,1,11176,12645,5226,3548,32596,1158,184,89,1431,34027
13-07-2017,2,10772,12678,5195,3364,32009,1165,189,75,1429,33438
13-07-2017,3,10782,12616,5168,3249,31814,1133,193,63,1389,33203
13-07-2017,4,10953,12574,5217,3150,31895,1133,209,74,1416,33311
13-07-2017,5,12106,13177,5205,3059,33547,1262,225,99,1586,35133
13-07-2017,6,13864,14808,5314,3101,37086,1412,237,138,1787,38873
13-07-2017,7,14641,16513,5899,3269,40322,1388,271,186,1845,42167
13-07-2017,8,15005,17023,6061,3660,41747,1372,446,250,2068,43815
13-07-2017,9,15407,17196,6043,3891,42537,1376,527,238,2141,44678
13-07-2017,10,15590,17391,6131,3934,43046,1415,613,272,2300,45346
13-07-2017,11,15506,17406,6080,3882,42876,1416,807,263,2486,45362
13-07-2017,12,15303,16965,6008,3887,42162,1424,830,315,2569,44731
13-07-2017,13,15359,16744,5935,3684,41720,1435,679,346,2460,44180
13-07-2017,14,15154,16635,5806,3582,41177,1469,551,365,2385,43562
13-07-2017,15,15230,16839,5798,3581,41449,1496,433,395,2324,43773
13-07-2017,16,15043,17259,5688,3529,41518,1505,292,419,2216,43734
13-07-2017,17,15531,17264,5681,3333,41807,1503,290,411,2204,44011
13-07-2017,18,15319,17399,5760,3030,41506,1495,285,374,2154,43660
13-07-2017,19,15125,17304,5811,2808,41049,1494,540,307,2341,43390
13-07-2017,20,15140,17041,5764,2488,40433,1490,310,229,2029,42462
13-07-2017,21,15061,16731,5748,2170,39710,1492,287,214,1993,41703
13-07-2017,22,14752,16739,5666,1980,39137,1488,265,223,1976,41113
13-07-2017,23,14170,16217,5434,1976,37796,1441,241,184,1866,39662
14-07-2017,0,13957,14398,5177,1763,35294,1361,221,152,1734,37028
14-07-2017,1,13890,13435,5131,1545,34001,1372,215,122,1709,35710
14-07-2017,2,13862,13228,5081,1443,33613,1362,211,121,1694,35307
14-07-2017,3,13959,13173,5110,1325,33567,1344,218,111,1673,35240
14-07-2017,4,13759,13296,5046,1180,33279,1352,231,95,1678,34957
14-07-2017,5,13857,14373,5171,1220,34621,1385,254,77,1716,36337
14-07-2017,6,14350,15905,5561,1381,37197,1428,452,61,1941,39138
14-07-2017,7,15088,16759,6045,1459,39351,1433,815,69,2317,41668
14-07-2017,8,15606,16869,6334,1512,40320,1438,988,486,2912,43232
14-07-2017,9,16085,17278,6278,1654,41295,1434,1093,487,3014,44309
14-07-2017,10,15989,17689,6283,1818,41780,1432,1086,307,2825,44605
14-07-2017,11,15743,16707,6131,1871,40453,1434,1064,325,2823,43276
14-07-2017,12,15953,16438,6071,1757,40220,1432,1063,349,2844,43064
14-07-2017,13,15804,16494,6228,1779,40305,1432,1065,197,2694,42999
14-07-2017,14,15458,16290,6130,1791,39668,1429,1065,176,2670,42338
14-07-2017,15,15416,16107,5898,1598,39019,1427,866,171,2464,41483
14-07-2017,16,15420,16728,5920,1558,39626,1430,761,170,2361,41987
14-07-2017,17,15108,17012,5883,1457,39460,1428,733,156,2317,41777
14-07-2017,18,14794,17203,5697,1239,38933,1411,626,123,2160,41093
14-07-2017,19,14916,16886,5759,1058,38619,1399,607,113,2119,40738
14-07-2017,20,14678,16205,5649,806,37339,1398,619,100,2117,39456
14-07-2017,21,14664,15726,5596,674,36659,1224,519,93,1836,38495
14-07-2017,22,14709,15492,5705,667,36574,1206,263,81,1550,38124
14-07-2017,23,14539,14945,5594,743,35820,1187,248,60,1495,37315
15-07-2017,0,13931,14152,5337,540,33960,1183,307,77,1567,35527
15-07-2017,1,13790,13589,5255,536,33170,1156,192,72,1420,34590
15-07-2017,2,13664,13392,5132,553,32741,1156,192,43,1391,34132
15-07-2017,3,13531,13251,5120,600,32503,1148,200,42,1390,33893
15-07-2017,4,13358,13218,4926,662,32163,1145,204,39,1388,33551
15-07-2017,5,13114,13384,4888,618,32006,1074,213,38,1325,33331
15-07-2017,6,13087,14099,4770,752,32707,1147,317,61,1525,34232
15-07-2017,7,13341,15043,4814,847,34045,1153,392,56,1601,35646
15-07-2017,8,13913,15703,4908,986,35509,1164,802,55,2021,37530
15-07-2017,9,14526,16078,5051,1270,36925,1147,954,56,2157,39082
15-07-2017,10,14644,16359,5074,1485,37563,1144,915,57,2116,39679
15-07-2017,11,14419,16122,5115,1487,37144,1139,903,57,2099,39243
15-07-2017,12,14625,16001,5178,1514,37318,1137,898,58,2093,39411
15-07-2017,13,14466,15769,5084,1544,36862,1143,629,59,1831,38693
15-07-2017,14,14375,15535,5048,1562,36521,1146,491,64,1701,38222
15-07-2017,15,14291,15413,5062,1701,36467,1140,385,71,1596,38063
15-07-2017,16,14281,15632,5120,1894,36927,1142,378,78,1598,38525
15-07-2017,17,14212,15906,5094,1784,36995,1146,508,73,1727,38722
15-07-2017,18,14291,16160,5099,1700,37249,1146,594,75,1815,39064
15-07-2017,19,14209,16096,5109,1576,36991,1134,471,67,1672,38663
15-07-2017,20,13973,15760,5022,1397,36152,1138,419,75,1632,37784
15-07-2017,21,14005,15794,5093,1259,36151,1144,379,83,1606,37757
15-07-2017,22,13821,15654,5140,1244,35859,1150,197,74,1421,37280
15-07-2017,23,13234,15046,5040,1370,34689,1086,205,66,1357,36046
16-07-2017,0,12841,14333,4942,1527,33644,1013,198,40,1251,34895
16-07-2017,1,12214,14021,4914,1600,32748,906,191,39,1136,33884
16-07-2017,2,12008,13721,4903,1742,32374,851,188,37,1076,33450
16-07-2017,3,11476,13616,4876,1905,31874,853,195,37,1085,32959
16-07-2017,4,10129,13263,4822,2149,30364,856,191,37,1084,31448
16-07-2017,5,9780,12971,4822,2447,30020,841,194,35,1070,31090
16-07-2017,6,10234,13179,4920,2722,31055,830,197,33,1060,32115
16-07-2017,7,11110,13798,4903,2910,32721,874,198,29,1101,33822
16-07-2017,8,11482,14547,4908,3053,33989,878,247,56,1181,35170
16-07-2017,9,12037,15258,4967,2997,35260,858,338,55,1251,36511
16-07-2017,10,12542,15858,5038,2825,36262,924,372,55,1351,37613
16-07-2017,11,12629,16346,5065,2885,36925,855,453,57,1365,38290
16-07-2017,12,12344,16412,5087,3015,36858,841,446,56,1343,38201
16-07-2017,13,12102,16250,5122,3183,36658,841,386,62,1289,37947
16-07-2017,14,11413,15981,5131,3294,35819,846,389,71,1306,37125
16-07-2017,15,11319,15837,5118,3484,35759,843,349,82,1274,37033
16-07-2017,16,12511,15787,5184,3513,36995,836,352,95,1283,38278
16-07-2017,17,13601,16138,5133,3505,38378,844,344,127,1315,39693
16-07-2017,18,13825,16384,5164,3283,38656,842,345,144,1331,39987
16-07-2017,19,13721,16521,5239,3087,38567,833,349,115,1297,39864
16-07-2017,20,13779,16240,5126,2775,37920,852,336,93,1281,39201
16-07-2017,21,14328,16117,5096,2375,37916,860,262,85,1207,39123
16-07-2017,22,14204,16000,5113,2150,37467,790,283,61,1134,38601
16-07-2017,23,13100,15847,5230,2036,36212,786,250,67,1103,37315
17-07-2017,0,12022,14337,5388,2110,,816,200,97,1113,
17-07-2017,1,11278,13774,5571,2127,32750,839,193,107,1139,33889
17-07-2017,2,10946,13682,5597,1982,32206,839,197,113,1149,33355
17-07-2017,3,10908,13597,5544,1844,31893,867,212,126,1205,33098
17-07-2017,4,10867,13664,5545,1806,31884,889,311,160,1360,33244
17-07-2017,5,11414,14302,5559,1962,33236,925,332,170,1427,34663
17-07-2017,6,13050,15923,5586,2044,36603,979,443,195,1617,38220
17-07-2017,7,14613,16811,5811,2263,39498,1110,698,217,2025,41523
17-07-2017,8,15010,17616,5921,2793,41340,1124,849,320,2293,43633
17-07-2017,9,15267,17337,6016,3045,41667,1133,903,485,2521,44188
17-07-2017,10,15545,17203,5890,3219,41858,1109,924,519,2552,44410
17-07-2017,11,15489,17175,5881,3231,41776,1108,898,450,2456,44232
17-07-2017,12,15326,16874,5909,3206,41315,1138,944,447,2529,43844
17-07-2017,13,15119,17005,5904,3262,41289,1148,871,404,2423,43712
17-07-2017,14,14926,16978,5885,3446,41237,1103,857,392,2352,43589
17-07-2017,15,14487,16968,5732,3508,40696,1124,842,379,2345,43041
17-07-2017,16,13805,16862,5744,3478,39889,1131,856,424,2411,42300
17-07-2017,17,14291,16833,5773,3441,40340,1103,777,385,2265,42605
17-07-2017,18,14434,16715,5790,3328,40266,1110,786,358,2254,42520
17-07-2017,19,14550,16448,5744,3038,39779,1087,803,285,2175,41954
17-07-2017,20,14670,16445,5522,2676,39312,1033,593,231,1857,41169
17-07-2017,21,14656,16500,5505,2284,38945,982,508,235,1725,40670
17-07-2017,22,14167,16101,5534,2109,37912,963,502,228,1693,39605
17-07-2017,23,12903,15865,5504,2103,36376,959,293,235,1487,37863
18-07-2017,0,11932,15320,5495,2182,34930,847,229,226,1302,36232
18-07-2017,1,11257,14874,5493,2129,33754,821,205,227,1253,35007
18-07-2017,2,10953,14743,5516,2110,33322,812,203,217,1232,34554
18-07-2017,3,10884,14574,5550,2061,33070,806,205,209,1220,34290
18-07-2017,4,10907,14530,5570,1922,32929,791,210,206,1207,34136
18-07-2017,5,11915,14729,5650,1874,34167,814,219,201,1234,35401
18-07-2017,6,14174,15633,5719,1855,37380,896,391,184,1471,38851
18-07-2017,7,14927,16862,5792,2085,39666,1022,683,197,1902,41568
18-07-2017,8,15100,17595,5991,2143,40830,1066,823,232,2121,42951
18-07-2017,9,15162,17749,6142,2301,41355,1068,865,282,2215,43570
18-07-2017,10,15576,17724,6170,2297,41769,1050,839,328,2217,43986
18-07-2017,11,15498,17712,6165,2151,41526,1001,804,354,2159,43685
18-07-2017,12,15575,17696,6205,2182,41659,994,845,326,2165,43824
18-07-2017,13,15446,17622,6190,2185,41446,1029,748,304,2081,43527
18-07-2017,14,15503,17395,6107,2282,41287,1064,699,338,2101,43388
18-07-2017,15,15483,17384,6099,2275,41244,1060,580,343,1983,43227
18-07-2017,16,15206,17257,6006,2147,40617,1058,554,277,1889,42506
18-07-2017,17,15051,17267,5988,1930,40235,1056,553,238,1847,42082
18-07-2017,18,15085,17282,6017,1706,40090,1050,484,205,1739,41829
18-07-2017,19,15070,17114,5913,1467,39565,1040,493,159,1692,41257
18-07-2017,20,14839,16795,5800,1419,38853,1048,498,126,1672,40525
18-07-2017,21,14696,16534,5689,1262,38181,1050,454,114,1618,39799
18-07-2017,22,14672,16196,5621,1117,37607,1022,376,120,1518,39125
18-07-2017,23,13928,15696,5614,895,36135,896,215,103,1214,37349
19-07-2017,0,12687,14744,5532,726,33689,859,189,86,1134,34823
19-07-2017,1,12004,14443,5452,667,32567,879,186,91,1156,33723
19-07-2017,2,11775,14250,5426,623,32073,867,185,82,1134,33207
19-07-2017,3,11686,14183,5466,602,31938,869,187,77,1133,33071
19-07-2017,4,11722,14170,5406,635,31934,872,192,82,1146,33080
19-07-2017,5,12477,14543,5547,654,33220,876,198,75,1149,34369
19-07-2017,6,13717,15629,5642,771,35759,890,336,69,1295,37054
19-07-2017,7,14631,16534,6073,928,38167,1036,528,79,1643,39810
19-07-2017,8,15232,17122,6221,1012,39587,1060,850,263,2173,41760
19-07-2017,9,15582,17355,6235,1173,40345,1036,946,271,2253,42598
19-07-2017,10,15787,17596,6184,1348,40915,1038,949,405,2392,43307
19-07-2017,11,15816,17571,6160,1462,41009,1085,880,255,2220,43229
19-07-2017,12,15600,17584,6098,1609,40890,1085,879,133,2097,42987
19-07-2017,13,15233,17357,6097,1673,40362,1079,838,92,2009,42371
19-07-2017,14,15196,17071,6127,1819,40214,1083,839,80,2002,42216
19-07-2017,15,15167,17152,6103,1847,40269,1070,864,55,1989,42258
19-07-2017,16,15312,17015,6095,1959,40381,1088,861,78,2027,42408
19-07-2017,17,15274,17218,6146,2052,40689,1083,769,79,1931,42620
19-07-2017,18,14962,17232,6143,1970,40307,1066,654,74,1794,42101
19-07-2017,19,14761,17067,6073,1987,39886,1047,483,68,1598,41484
19-07-2017,20,14630,16151,5940,2031,38752,1033,344,68,1445,40197
19-07-2017,21,14733,15618,5792,2051,38194,1029,291,74,1394,39588
19-07-2017,22,14695,15145,5675,2014,37530,1015,286,77,1378,38908
19-07-2017,23,13891,14682,5539,1929,36041,831,195,63,1089,37130
20-07-2017,0,12755,13848,5487,1812,33902,776,188,69,1033,34935
20-07-2017,1,11954,13553,5505,1835,32847,803,183,83,1069,33916
20-07-2017,2,11774,13431,5522,1855,32582,807,183,103,1093,33675
20-07-2017,3,11657,13428,5524,1915,32523,794,185,145,1124,33647
20-07-2017,4,11487,13465,5473,1949,32374,799,196,138,1133,33507
20-07-2017,5,12005,13780,5617,2000,33402,806,222,160,1188,34590
20-07-2017,6,13699,15170,5743,1966,36577,847,271,165,1283,37860
20-07-2017,7,14784,15997,5946,2053,38781,996,617,117,1730,40511
20-07-2017,8,15313,16704,6116,2247,40378,1021,826,162,2009,42387
20-07-2017,9,15543,16987,6054,2393,40979,1011,964,407,2382,43361
20-07-2017,10,15740,17025,6051,2436,41252,1004,941,512,2457,43709
20-07-2017,11,15676,17097,6186,2379,41337,983,899,495,2377,43714
20-07-2017,12,15273,17261,6261,2268,41063,975,834,499,2308,43371
20-07-2017,13,15199,17010,6123,2414,40746,985,876,480,2341,43087
20-07-2017,14,15271,16864,6038,2461,40635,983,888,273,2144,42779
20-07-2017,15,15345,16882,6119,2450,40797,995,788,79,1862,42659
20-07-2017,16,15342,16615,6139,2272,40368,981,663,75,1719,42087
20-07-2017,17,15422,16611,6122,1974,40130,986,716,81,1783,41913
20-07-2017,18,15101,16978,6163,1746,39989,991,771,79,1841,41830
20-07-2017,19,14938,16806,6136,1710,39590,975,706,90,1771,41361
20-07-2017,20,14848,16325,6039,1547,38759,965,518,105,1588,40347
20-07-2017,21,14685,16264,6003,1449,38400,960,291,135,1386,39786
20-07-2017,22,14339,15925,5928,1258,37449,940,301,145,1386,38835
20-07-2017,23,13945,15000,5770,1184,35898,830,213,136,1179,37077
21-07-2017,0,13641,13486,5615,1165,33907,764,193,168,1125,35032
21-07-2017,1,12608,13139,5580,1229,32556,797,187,170,1154,33710
21-07-2017,2,12303,13009,5441,1274,32027,793,188,171,1152,33179
21-07-2017,3,11564,12940,5464,1164,31132,788,190,148,1126,32258
21-07-2017,4,11540,12882,5486,1267,31174,789,196,152,1137,32311
21-07-2017,5,13088,13084,5584,1315,33072,797,201,155,1153,34225
21-07-2017,6,14158,14638,5718,1208,35723,888,204,135,1227,36950
21-07-2017,7,15028,16605,5884,1472,38989,911,791,94,1796,40785
21-07-2017,8,15507,17385,6071,1670,40633,918,827,167,1912,42545
21-07-2017,9,15763,17944,6075,1802,41584,921,901,421,2243,43827
21-07-2017,10,15975,18118,6075,1823,41991,926,798,457,2181,44172
21-07-2017,11,15865,17968,6167,1848,41849,930,798,452,2180,44029
21-07-2017,12,15615,17538,6182,1626,40962,929,797,442,2168,43130
21-07-2017,13,15891,16939,6176,1496,40501,927,787,260,1974,42475
21-07-2017,14,15794,16756,6142,1531,40224,937,768,76,1781,42005
21-07-2017,15,15494,16744,6021,1565,39825,942,764,58,1764,41589
21-07-2017,16,15493,17212,5940,1674,40318,938,746,63,1747,42065
21-07-2017,17,15395,17141,5949,1650,40136,942,738,67,1747,41883
21-07-2017,18,15428,17134,6034,1527,40123,937,594,67,1598,41721
21-07-2017,19,15247,17015,5989,1365,39616,931,511,70,1512,41128
21-07-2017,20,14751,16077,5858,1203,37887,926,348,71,1345,39232
21-07-2017,21,14668,15493,5896,1106,37163,928,342,73,1343,38506
21-07-2017,22,14630,15189,5902,1049,36769,931,235,75,1241,38010
21-07-2017,23,14191,14094,5818,881,34984,899,145,86,1130,36114
22-07-2017,0,13876,13175,5654,821,33527,569,146,101,816,34343
22-07-2017,1,13640,12883,5480,967,32970,528,142,116,786,33756
22-07-2017,2,13459,12673,5308,959,32399,456,141,138,735,33134
22-07-2017,3,13208,12560,5267,979,32015,441,143,153,737,32752
22-07-2017,4,12835,12606,5321,964,31726,448,148,177,773,32499
22-07-2017,5,12725,12760,5318,962,31766,445,151,189,785,32551
22-07-2017,6,13432,12739,5355,1040,32566,473,150,150,773,33339
22-07-2017,7,13839,13228,5466,1201,33734,515,290,103,908,34642
22-07-2017,8,14190,14482,5678,1384,35733,524,473,89,1086,36819
22-07-2017,9,14651,15146,5701,1542,37039,518,508,98,1124,38163
22-07-2017,10,15035,15390,5743,1687,37856,543,555,103,1201,39057
22-07-2017,11,14925,15429,5792,1872,38019,622,485,87,1194,39213
22-07-2017,12,14767,14651,5688,2022,37127,623,399,78,1100,38227
22-07-2017,13,14648,14106,5654,2169,36576,627,314,70,1011,37587
22-07-2017,14,14613,14078,5581,2100,36372,632,238,62,932,37304
22-07-2017,15,14734,14124,5639,2052,36549,640,233,64,937,37486
22-07-2017,16,14902,14243,5601,2083,36829,651,186,66,903,37732
22-07-2017,17,15007,15132,5683,2037,37861,648,186,66,900,38761
22-07-2017,18,14890,15777,5705,1870,38243,644,185,64,893,39136
22-07-2017,19,14615,15612,5792,1601,37620,639,152,70,861,38481
22-07-2017,20,14666,14638,5830,1405,36540,638,147,91,876,37416
22-07-2017,21,14613,14344,5961,1379,36298,646,147,136,929,37227
22-07-2017,22,14431,14212,6030,1416,36090,652,144,194,990,37080
22-07-2017,23,13815,13725,5919,1529,34989,613,145,236,994,35983
23-07-2017,0,13477,12780,5686,1723,33665,616,143,214,973,34638
23-07-2017,1,12532,12175,5491,1764,31962,516,132,219,867,32829
23-07-2017,2,11186,11833,5284,1759,30063,467,134,201,802,30865
23-07-2017,3,9895,11708,5198,1765,28566,470,137,181,788,29354
23-07-2017,4,9366,11600,5147,1824,27937,468,139,159,766,28703
23-07-2017,5,9227,11633,5130,1881,27872,433,140,142,715,28587
23-07-2017,6,9271,11703,5063,1919,27957,461,140,120,721,28678
23-07-2017,7,9905,11843,5142,2108,28999,467,141,53,661,29660
23-07-2017,8,10914,12300,5360,2164,30738,497,143,39,679,31417
23-07-2017,9,11694,13215,5442,2380,32731,487,143,38,668,33399
23-07-2017,10,12200,13606,5456,2416,33678,495,144,36,675,34353
23-07-2017,11,12682,13799,5488,2374,34343,505,161,40,706,35049
23-07-2017,12,12356,13787,5529,2193,33865,488,228,42,758,34623
23-07-2017,13,11517,13699,5627,1983,32825,488,235,42,765,33590
23-07-2017,14,10662,13537,5623,1904,31726,497,237,51,785,32511
23-07-2017,15,11398,13601,5651,1929,32578,495,238,58,791,33369
23-07-2017,16,11877,13858,5614,2094,33443,504,239,81,824,34267
23-07-2017,17,13120,14601,5551,2011,35283,519,271,84,874,36157
23-07-2017,18,14415,15310,5658,1864,37247,555,310,86,951,38198
23-07-2017,19,14747,15564,5794,1688,37792,649,325,93,1067,38859
23-07-2017,20,14561,15429,5807,1545,37342,650,323,383,1356,38698
23-07-2017,21,13979,15216,5792,1410,36397,701,323,771,1795,38192
23-07-2017,22,14030,14952,5793,1306,36081,744,308,583,1635,37716
23-07-2017,23,13508,14499,5806,1224,35039,682,241,413,1336,36375
24-07-2017,0,13114,13749,5581,1036,33481,685,150,239,1074,34555
24-07-2017,1,12560,13401,5530,855,32346,641,147,182,970,33316
24-07-2017,2,12068,13362,5481,698,31610,628,150,163,941,32551
24-07-2017,3,11561,13498,5525,583,31167,665,153,165,983,32150
24-07-2017,4,11332,13610,5443,501,30884,733,157,151,1041,31925
24-07-2017,5,12410,14048,5588,440,32484,843,163,257,1263,33747
24-07-2017,6,13507,15241,5766,514,35028,1036,271,549,1856,36884
24-07-2017,7,14132,16117,6005,645,36899,1081,575,523,2179,39078
24-07-2017,8,14961,17010,6161,947,39078,1103,682,600,2385,41463
24-07-2017,9,15423,17318,6248,1250,40239,1121,742,442,2305,42544
24-07-2017,10,15345,17810,6303,1475,40933,1112,727,550,2389,43322
24-07-2017,11,15483,17834,6280,1443,41042,1167,778,578,2523,43565
24-07-2017,12,15220,17834,5714,1428,40196,1184,809,728,2721,42917
24-07-2017,13,15166,17589,5683,1402,39841,1262,812,646,2720,42561
24-07-2017,14,15067,17343,5651,1365,39426,1274,824,544,2642,42068
24-07-2017,15,15116,17106,5582,1451,39255,1275,810,466,2551,41806
24-07-2017,16,14951,17004,5601,1458,39016,1278,806,382,2466,41482
24-07-2017,17,14856,16860,5493,1457,38667,1272,724,447,2443,41110
24-07-2017,18,15130,16671,5503,1354,38658,1315,707,396,2418,41076
24-07-2017,19,15303,16492,5487,1248,38530,1308,622,389,2319,40849
24-07-2017,20,14821,16067,5439,1316,37643,1170,458,505,2133,39776
24-07-2017,21,14641,15798,5423,1085,36946,1173,411,503,2087,39033
24-07-2017,22,14436,15629,5242,972,36278,1178,351,492,2021,38299
24-07-2017,23,13666,14673,4996,931,34266,1184,236,144,1564,35830
25-07-2017,0,13740,13364,4891,878,32872,1062,246,172,1480,34352
25-07-2017,1,13476,12971,4752,904,32102,1046,245,156,1447,33549
25-07-2017,2,12611,12512,4691,925,30739,1050,244,188,1482,32221
25-07-2017,3,12739,12468,4665,971,30843,951,280,167,1398,32241
25-07-2017,4,11761,12490,4655,1113,30020,1023,371,124,1518,31538
25-07-2017,5,11770,12972,5091,1307,31139,1045,409,127,1581,32720
25-07-2017,6,13452,14148,5707,1325,34632,1087,517,129,1733,36365
25-07-2017,7,14406,15088,6045,1460,37000,1109,831,130,2070,39070
25-07-2017,8,15033,15807,6165,1659,38665,1169,944,218,2331,40996
25-07-2017,9,15489,16205,6122,1858,39675,1172,923,333,2428,42103
25-07-2017,10,15612,16500,6101,2125,40338,1173,907,339,2419,42757
25-07-2017,11,15404,16373,6095,2382,40253,1175,907,324,2406,42659
25-07-2017,12,15438,16279,6150,2480,40347,1174,911,338,2423,42770
25-07-2017,13,15577,16110,6234,2536,40457,1179,658,353,2190,42647
25-07-2017,14,15686,16046,6249,2431,40414,1115,836,200,2151,42565
25-07-2017,15,15542,15952,6171,2236,39900,1148,817,232,2197,42097
25-07-2017,16,15644,16028,6088,1984,39744,1119,454,221,1794,41538
25-07-2017,17,15590,16582,6059,1605,39838,1104,458,224,1786,41624
25-07-2017,18,15390,16895,6055,1325,39665,1126,548,218,1892,41557
25-07-2017,19,15185,16653,6029,1224,39091,1124,508,193,1825,40916
25-07-2017,20,14978,15943,5927,1146,37994,1067,538,168,1773,39767
25-07-2017,21,14952,15330,5956,1180,37418,1120,493,203,1816,39234
25-07-2017,22,14755,14719,5683,1142,36298,1188,396,242,1826,38124
25-07-2017,23,14187,13800,5501,1164,34652,1173,401,231,1805,36457
26-07-2017,0,12168,13094,5356,1184,31802,710,384,215,1309,33111
26-07-2017,1,11314,12988,5188,1171,30661,642,394,201,1237,31898
26-07-2017,2,10719,12922,5173,1028,29841,653,457,195,1305,31146
26-07-2017,3,10140,12929,5107,1017,29194,636,544,198,1378,30572
26-07-2017,4,10175,13161,5229,1002,29567,649,488,230,1367,30934
26-07-2017,5,11215,13615,5512,979,31321,661,412,193,1266,32587
26-07-2017,6,13733,14432,5961,888,35015,768,412,169,1349,36364
26-07-2017,7,14864,15826,6371,952,38012,773,416,341,1530,39542
26-07-2017,8,15243,16657,6568,1118,39586,770,536,363,1669,41255
26-07-2017,9,15576,17034,6557,1290,40457,770,709,374,1853,42310
26-07-2017,10,15624,17285,6536,1240,40685,775,835,360,1970,42655
26-07-2017,11,15664,17504,6453,1304,40927,785,791,350,1926,42853
26-07-2017,12,15624,17570,6390,1355,40940,794,869,342,2005,42945
26-07-2017,13,15652,17372,6402,1327,40754,796,764,347,1907,42661
26-07-2017,14,15583,17290,6290,1322,40484,792,792,342,1926,42410
26-07-2017,15,15453,17197,6235,1241,40125,788,779,406,1973,42098
26-07-2017,16,15203,17299,6244,1189,39935,790,578,237,1605,41540
26-07-2017,17,15317,16812,6239,1106,39473,795,592,179,1566,41039
26-07-2017,18,15171,16612,6198,1028,39008,801,560,319,1680,40688
26-07-2017,19,15064,16471,6132,859,38526,787,554,344,1685,40211
26-07-2017,20,15068,16052,5870,670,37660,760,540,164,1464,39124
26-07-2017,21,15052,15836,5970,646,37503,781,438,145,1364,38867
26-07-2017,22,14917,15755,5886,657,37215,787,419,138,1344,38559
26-07-2017,23,14301,14950,5567,590,35409,793,403,122,1318,36727
27-07-2017,0,13368,13324,5575,596,32863,664,379,109,1152,34015
27-07-2017,1,11450,12531,5470,698,30150,635,392,95,1122,31272
27-07-2017,2,10290,12153,5322,801,28567,635,441,99,1175,29742
27-07-2017,3,10076,11877,5280,892,28126,617,453,92,1162,29288
27-07-2017,4,10071,12267,5324,1013,28676,620,403,94,1117,29793
27-07-2017,5,11294,12810,5489,1094,30687,622,423,92,1137,31824
27-07-2017,6,13492,13848,6032,1257,34630,740,579,88,1407,36037
27-07-2017,7,14633,15219,6330,1469,37652,743,649,259,1651,39303
27-07-2017,8,15323,16089,6487,1577,39476,742,749,420,1911,41387
27-07-2017,9,15895,16707,6559,1712,40874,756,837,424,2017,42891
27-07-2017,10,16111,16853,6587,1776,41327,766,843,444,2053,43380
27-07-2017,11,16017,16836,6518,2011,41382,777,867,451,2095,43477
27-07-2017,12,15859,16844,6575,2183,41461,777,954,324,2055,43516
27-07-2017,13,15894,16601,6577,2101,41174,772,916,311,1999,43173
27-07-2017,14,15933,16327,6539,2006,40806,775,814,334,1923,42729
27-07-2017,15,15805,16214,6472,1949,40439,760,818,339,1917,42356
27-07-2017,16,15766,16160,6468,1780,40177,719,823,146,1688,41865
27-07-2017,17,15877,16254,6373,1579,40083,683,845,143,1671,41754
27-07-2017,18,15595,16354,6298,1388,39634,745,771,177,1693,41327
27-07-2017,19,15502,16135,6327,1427,39392,742,758,125,1625,41017
27-07-2017,20,15387,15660,6166,1207,38421,705,763,154,1622,40043
27-07-2017,21,15438,15532,6181,1042,38192,693,731,185,1609,39801
27-07-2017,22,15151,15490,6110,1041,37793,741,618,213,1572,39365
27-07-2017,23,14733,14480,5771,989,35974,728,417,244,1389,37363
28-07-2017,0,14477,13703,5519,985,34686,684,217,253,1154,35840
28-07-2017,1,14035,13283,5418,913,33648,649,211,266,1126,34774
28-07-2017,2,12878,13051,5403,913,32244,649,239,213,1101,33345
28-07-2017,3,11750,12954,5429,838,30972,656,284,180,1120,32092
28-07-2017,4,11425,12906,5465,813,30609,666,310,169,1145,31754
28-07-2017,5,12678,13236,5629,838,32381,715,284,158,1157,33538
28-07-2017,6,13576,14546,5981,967,35071,855,374,204,1433,36504
28-07-2017,7,14096,15798,6450,1121,37465,879,506,324,1709,39174
28-07-2017,8,14695,16434,6660,1325,39115,900,603,512,2015,41130
28-07-2017,9,15780,17020,6780,1637,41217,914,561,507,1982,43199
28-07-2017,10,15904,16908,6833,1875,41520,955,547,492,1994,43514
28-07-2017,11,15745,16459,6846,1997,41050,958,534,508,2000,43050
28-07-2017,12,14643,15797,6765,1894,39100,968,583,502,2053,41153
28-07-2017,13,13128,15593,6761,2001,37482,990,540,489,2019,39501
28-07-2017,14,12844,15186,6614,2123,36767,970,525,465,1960,38727
28-07-2017,15,12579,14928,6587,2199,36294,1008,524,457,1989,38283
28-07-2017,16,13100,15293,6511,2277,37179,959,492,84,1535,38714
28-07-2017,17,14799,15472,6428,2259,38957,928,537,69,1534,40491
28-07-2017,18,15023,15999,6350,2129,39501,883,559,64,1506,41007
28-07-2017,19,14982,16096,6535,1833,39445,737,479,65,1281,40726
28-07-2017,20,14754,15946,5899,1700,38299,612,410,69,1091,39390
28-07-2017,21,14346,15945,5856,1611,37758,627,375,83,1085,38843
28-07-2017,22,14181,15765,5795,1631,37373,648,327,67,1042,38415
28-07-2017,23,13070,15608,5778,1576,36031,606,305,81,992,37023
29-07-2017,0,11546,14180,5660,1453,32838,519,145,109,773,33611
29-07-2017,1,9727,12838,5514,1268,29347,501,141,114,756,30103
29-07-2017,2,8809,11960,5551,1207,27526,489,141,119,749,28275
29-07-2017,3,8228,11708,5468,1265,26669,478,141,105,724,27393
29-07-2017,4,7941,11526,5413,1539,26420,474,144,101,719,27139
29-07-2017,5,7974,11508,5360,1828,26670,468,145,72,685,27355
29-07-2017,6,8235,11527,5347,2077,27185,468,194,59,721,27906
29-07-2017,7,9404,11963,5384,2195,28946,470,316,62,848,29794
29-07-2017,8,10107,12640,5503,2459,30709,516,562,75,1153,31862
29-07-2017,9,10564,13172,5711,2617,32063,518,703,84,1305,33368
29-07-2017,10,11333,13640,5826,2867,33667,156,705,103,964,34631
29-07-2017,11,11172,13847,5806,3035,33861,507,703,100,1310,35171
29-07-2017,12,10552,14112,5745,3303,33711,507,656,117,1280,34991
29-07-2017,13,10336,13863,5887,3737,33823,496,609,141,1246,35069
29-07-2017,14,10106,13803,5843,4003,33757,474,607,138,1219,34976
29-07-2017,15,10041,13610,5821,4050,33521,467,594,133,1194,34715
29-07-2017,16,10216,13664,5709,4194,33783,463,613,122,1198,34981
29-07-2017,17,11381,14770,5731,3973,35855,469,605,105,1179,37034
29-07-2017,18,12440,15894,5761,3459,37554,470,595,84,1149,38703
29-07-2017,19,12934,15833,5700,2853,37321,476,594,61,1131,38452
29-07-2017,20,13330,15945,5683,1961,36920,479,639,58,1176,38096
29-07-2017,21,13707,16180,5833,1447,37167,478,632,54,1164,38331
29-07-2017,22,13764,16067,5854,1159,36844,474,510,48,1032,37876
29-07-2017,23,12754,15591,5859,997,35200,497,236,54,787,35987
30-07-2017,0,10735,14171,5746,804,31456,473,142,80,695,32151
30-07-2017,1,9757,12679,5738,768,28943,462,142,103,707,29650
30-07-2017,2,9407,11929,5724,730,27792,466,141,103,710,28502
30-07-2017,3,9386,11454,5682,631,27154,460,144,101,705,27859
30-07-2017,4,9222,11162,5533,687,26604,465,147,94,706,27310
30-07-2017,5,9272,10987,5389,739,26388,459,150,77,686,27074
30-07-2017,6,9350,11127,5222,734,26433,456,149,51,656,27089
30-07-2017,7,9777,11434,5188,954,27353,463,150,43,656,28009
30-07-2017,8,10434,12065,5286,1190,28975,458,157,48,663,29638
30-07-2017,9,10817,12800,5331,1575,30523,476,296,54,826,31349
30-07-2017,10,11426,13380,5404,1938,32150,473,330,85,888,33038
30-07-2017,11,11653,13579,5450,1912,32594,472,329,96,897,33491
30-07-2017,12,11629,14103,5454,2097,33285,457,329,91,877,34162
30-07-2017,13,11554,13617,5622,2380,33173,452,329,84,865,34038
30-07-2017,14,11262,13458,5768,2909,33396,444,332,71,847,34243
30-07-2017,15,10650,13320,5741,3239,32953,459,328,61,848,33801
30-07-2017,16,10391,13342,5670,3264,32667,468,324,45,837,33504
30-07-2017,17,10323,14134,5737,3180,33374,465,324,37,826,34200
30-07-2017,18,11219,14805,5740,3247,35011,460,321,40,821,35832
30-07-2017,19,12723,15233,5769,3332,37058,467,279,57,803,37861
30-07-2017,20,13307,15327,5718,2989,37342,466,332,92,890,38232
30-07-2017,21,14022,15344,5757,2440,37563,473,329,171,973,38536
30-07-2017,22,13661,15531,5853,2130,37175,487,163,242,892,38067
30-07-2017,23,12677,15295,5733,1760,35465,523,162,273,958,36423
31-07-2017,0,11611,14165,5566,1582,32923,576,158,269,1003,33926
31-07-2017,1,11021,13442,5505,1527,31494,611,160,222,993,32487
31-07-2017,2,10982,13141,5567,1313,31004,639,170,159,968,31972
31-07-2017,3,10443,12636,5417,1080,29577,667,176,84,927,30504
31-07-2017,4,10355,12659,5330,982,29325,697,179,93,969,30294
31-07-2017,5,11105,13236,5341,1026,30709,1007,289,109,1405,32114
31-07-2017,6,12930,14821,5610,1124,34485,1196,592,112,1900,36385
31-07-2017,7,14818,15669,6110,1177,37773,1203,704,401,2308,40081
31-07-2017,8,15759,16546,6309,1363,39978,1202,704,488,2394,42372
31-07-2017,9,15861,16688,6443,1925,40917,1222,774,466,2462,43379
31-07-2017,10,15808,16611,6542,2311,41273,1229,777,470,2476,43749
31-07-2017,11,15575,16473,6460,2593,41101,1237,912,443,2592,43693
31-07-2017,12,15308,16555,6504,2731,41099,1253,878,444,2575,43674
31-07-2017,13,14823,16477,6482,2713,40496,1259,825,476,2560,43056
31-07-2017,14,14996,16652,6429,2902,40979,1249,803,495,2547,43526
31-07-2017,15,14661,16550,6297,2975,40483,1232,840,482,2554,43037
31-07-2017,16,14391,16660,6193,2788,40033,1230,854,160,2244,42277
31-07-2017,17,14522,16650,6123,2604,39901,1205,844,119,2168,42069
31-07-2017,18,14440,16552,6068,2386,39446,1246,804,304,2354,41800
31-07-2017,19,14765,16333,5887,2076,39061,1228,784,292,2304,41365
31-07-2017,20,14821,16410,5904,1659,38795,992,754,72,1818,40613
31-07-2017,21,14808,16277,6092,1397,38575,929,680,99,1708,40283
31-07-2017,22,14826,15913,5920,1305,37964,919,466,102,1487,39451
31-07-2017,23,13499,15342,5441,1247,35531,879,347,91,1317,36848
01-08-2017,0,12818,14303,5384,1058,33564,643,228,62,933,34497
01-08-2017,1,12180,13852,5334,910,32275,596,224,56,876,33151
01-08-2017,2,11775,13657,5337,783,31553,586,225,48,859,32412
01-08-2017,3,11747,13340,5391,761,31239,593,227,41,861,32100
01-08-2017,4,11777,13276,5371,722,31146,592,236,36,864,32010
01-08-2017,5,12394,13820,5520,704,32438,603,306,42,951,33389
01-08-2017,6,13758,14783,5999,694,35234,753,472,71,1296,36530
01-08-2017,7,15097,15822,6428,860,38207,792,750,266,1808,40015
01-08-2017,8,15925,16213,6630,1217,39986,787,853,484,2124,42110
01-08-2017,9,16231,16512,6699,1370,40812,815,850,209,1874,42686
01-08-2017,10,16266,16790,6713,1427,41196,842,823,336,2001,43197
01-08-2017,11,16178,17097,6746,1487,41509,857,835,432,2124,43633
01-08-2017,12,16102,17153,6771,1483,41508,861,859,453,2173,43681
01-08-2017,13,16109,16852,6652,1343,40957,843,902,456,2201,43158
01-08-2017,14,16124,16879,6536,1318,40857,832,812,406,2050,42907
01-08-2017,15,15923,16859,6412,1326,40520,815,895,178,1888,42408
01-08-2017,16,15795,16620,6371,1148,39935,731,583,265,1579,41514
01-08-2017,17,15890,16526,6434,990,39839,800,697,253,1750,41589
01-08-2017,18,15836,16458,6374,981,39649,823,558,315,1696,41345
01-08-2017,19,15640,16186,6322,922,39070,806,579,285,1670,40740
01-08-2017,20,15433,15876,5956,900,38167,621,393,392,1406,39573
01-08-2017,21,15266,15304,5928,924,37422,569,349,96,1014,38436
01-08-2017,22,14870,14749,5907,1011,36537,570,252,88,910,37447
01-08-2017,23,14050,13992,5646,1022,34710,568,234,96,898,35608
02-08-2017,0,13064,12806,5493,1098,32462,611,214,121,946,33408
02-08-2017,1,12436,12525,5417,1231,31610,672,214,190,1076,32686
02-08-2017,2,12292,12281,5354,1340,31267,683,215,256,1154,32421
02-08-2017,3,12126,12028,5220,1322,30696,727,209,178,1114,31810
02-08-2017,4,12239,11934,5109,1279,30562,822,273,132,1227,31789
02-08-2017,5,13251,12659,5063,1224,32197,883,337,121,1341,33538
02-08-2017,6,14205,14794,5117,1239,35356,1156,384,296,1836,37192
02-08-2017,7,15228,16263,5529,1328,38349,1334,625,286,2245,40594
02-08-2017,8,15824,17054,5824,1451,40154,1374,792,343,2509,42663
02-08-2017,9,15926,17320,6075,1600,40921,1398,764,290,2452,43373
02-08-2017,10,15893,17579,6124,1726,41322,1395,698,519,2612,43934
02-08-2017,11,15925,17669,6104,1913,41612,1431,654,412,2497,44109
02-08-2017,12,15827,17578,6073,2153,41631,1429,705,405,2539,44170
02-08-2017,13,15639,17067,6075,2230,41010,1437,670,453,2560,43570
02-08-2017,14,15769,16808,6125,2217,40921,1419,673,225,2317,43238
02-08-2017,15,15499,16793,5982,2138,40412,1437,699,160,2296,42708
02-08-2017,16,15697,16710,5768,1994,40170,1437,571,194,2202,42372
02-08-2017,17,15726,17404,5892,1738,40761,1450,551,191,2192,42953
02-08-2017,18,15420,17524,5835,1447,40227,1446,561,196,2203,42430
02-08-2017,19,15436,17267,5685,1223,39611,1424,552,150,2126,41737
02-08-2017,20,15388,16300,5492,904,38084,1186,551,135,1872,39956
02-08-2017,21,15271,16075,5407,747,37501,1162,431,121,1714,39215
02-08-2017,22,15010,15273,5226,653,36161,1153,423,138,1714,37875
02-08-2017,23,14749,13926,4935,721,34330,976,306,118,1400,35730
03-08-2017,0,14175,12987,4851,845,32858,934,202,124,1260,34118
03-08-2017,1,12866,12633,4843,771,31112,950,200,113,1263,32375
03-08-2017,2,11840,12521,4822,916,30099,957,204,100,1261,31360
03-08-2017,3,11568,12340,4824,1067,29800,947,206,93,1246,31046
03-08-2017,4,11434,12233,4847,1278,29792,945,216,88,1249,31041
03-08-2017,5,11961,12678,4966,1449,31054,990,239,81,1310,32364
03-08-2017,6,13896,14430,5161,1674,35160,1222,448,95,1765,36925
03-08-2017,7,15289,15401,5639,1708,38037,1418,589,90,2097,40134
03-08-2017,8,16122,15901,5945,2014,39981,1446,714,166,2326,42307
03-08-2017,9,16591,16129,6091,2295,41107,1459,697,176,2332,43439
03-08-2017,10,16641,16148,5998,2700,41486,1480,691,257,2428,43914
03-08-2017,11,16596,16181,6048,2473,41297,1472,669,258,2399,43696
03-08-2017,12,15965,15584,6078,2768,40394,1455,647,265,2367,42761
03-08-2017,13,15161,15168,6135,3033,39497,1440,635,264,2339,41836
03-08-2017,14,14672,15100,5970,3237,38979,1432,651,256,2339,41318
03-08-2017,15,14023,14984,5714,3395,38115,1405,653,342,2400,40515
03-08-2017,16,13706,15018,5548,3608,37881,1366,602,108,2076,39957
03-08-2017,17,13743,15178,5655,3811,38386,1377,693,125,2195,40581
03-08-2017,18,14590,15023,5636,3398,38647,1366,642,169,2177,40824
03-08-2017,19,15344,15066,5564,2872,38847,1349,624,209,2182,41029
03-08-2017,20,15408,14439,5184,2586,37617,936,530,201,1667,39284
03-08-2017,21,15383,14352,4891,2423,37050,839,507,160,1506,38556
03-08-2017,22,14677,14075,4816,2457,36025,834,408,161,1403,37428
03-08-2017,23,12815,13412,4876,2338,33442,850,279,112,1241,34683
04-08-2017,0,11202,12534,4811,2511,31057,854,143,124,1121,32178
04-08-2017,1,10281,12132,4699,2926,30038,881,141,149,1171,31209
04-08-2017,2,10022,12016,4717,2903,29658,892,142,205,1239,30897
04-08-2017,3,9497,12077,4748,2887,29209,902,144,318,1364,30573
04-08-2017,4,9108,12058,4806,2936,28906,920,157,342,1419,30325
04-08-2017,5,10185,12452,4990,2853,30481,955,250,322,1527,32008
04-08-2017,6,12564,14015,5252,2563,34395,1212,514,287,2013,36408
04-08-2017,7,13664,15432,5613,2694,37403,1469,628,300,2397,39800
04-08-2017,8,14561,15728,5945,2827,39061,1472,649,656,2777,41838
04-08-2017,9,14588,15857,5920,3163,39528,1461,651,726,2838,42366
04-08-2017,10,14536,15830,6002,3853,40222,1460,654,613,2727,42949
04-08-2017,11,13323,15721,6070,4237,39353,1486,641,507,2634,41987
04-08-2017,12,12881,15497,6076,4460,38915,1492,638,501,2631,41546
04-08-2017,13,12589,15229,5876,4546,38241,1504,648,575,2727,40968
04-08-2017,14,12438,15116,5707,4512,37774,1528,640,489,2657,40431
04-08-2017,15,12069,15158,5529,4455,37209,1506,652,480,2638,39847
04-08-2017,16,11604,15383,5598,4665,37250,1314,519,287,2120,39370
04-08-2017,17,12547,15462,5685,4458,38152,1457,534,204,2195,40347
04-08-2017,18,13464,15944,5721,3789,38920,1432,519,185,2136,41056
04-08-2017,19,13363,15343,5755,3644,38105,1311,509,178,1998,40103
04-08-2017,20,12916,14821,5481,3590,36807,715,467,126,1308,38115
04-08-2017,21,12796,14519,5405,3469,36190,657,465,196,1318,37508
04-08-2017,22,12216,14403,5401,3335,35354,627,383,224,1234,36588
04-08-2017,23,11038,13872,5365,3330,33606,619,285,268,1172,34778
05-08-2017,0,10481,13070,5305,3492,32346,575,185,311,1071,33417
05-08-2017,1,10148,12985,5179,3391,31703,575,177,344,1096,32799
05-08-2017,2,9801,12967,5160,3312,31239,545,177,352,1074,32313
05-08-2017,3,9550,12892,5114,3261,30818,539,178,331,1048,31866
05-08-2017,4,9477,12905,5086,3170,30638,543,183,312,1038,31676
05-08-2017,5,9443,12970,5057,3086,30557,533,185,290,1008,31565
05-08-2017,6,10173,13319,5026,3015,31533,539,187,285,1011,32544
05-08-2017,7,11393,13805,5227,2990,33414,568,185,312,1065,34479
05-08-2017,8,12922,14230,5378,3032,35562,585,193,377,1155,36717
05-08-2017,9,13964,14543,5334,3224,37065,577,323,433,1333,38398
05-08-2017,10,14352,14553,5366,3302,37573,600,323,441,1364,38937
05-08-2017,11,14283,14593,5380,3256,37512,593,450,440,1483,38995
05-08-2017,12,13271,14500,5220,3045,36036,596,465,435,1496,37532
05-08-2017,13,12010,14484,5210,2993,34697,608,464,433,1505,36202
05-08-2017,14,12237,14441,5202,2846,34725,614,464,409,1487,36212
05-08-2017,15,12846,14430,5254,2781,35312,598,465,404,1467,36779
05-08-2017,16,13492,14473,5226,2805,35996,598,466,399,1463,37459
05-08-2017,17,15221,14592,5262,2617,37694,588,466,359,1413,39107
05-08-2017,18,15793,14864,5366,2468,38491,573,466,295,1334,39825
05-08-2017,19,15368,14862,5430,2377,38037,578,466,302,1346,39383
05-08-2017,20,15085,14596,5447,2178,37306,585,521,286,1392,38698
05-08-2017,21,14960,14488,5582,2101,37132,592,519,262,1373,38505
05-08-2017,22,14458,14381,5463,2077,36380,618,518,229,1365,37745
05-08-2017,23,13935,13807,5240,2124,35107,587,286,222,1095,36202
06-08-2017,0,12312,12440,5161,2078,31990,592,179,184,955,32945
06-08-2017,1,10391,11874,4999,2071,29336,563,164,185,912,30248
06-08-2017,2,9649,11501,4974,1944,28068,568,166,187,921,28989
06-08-2017,3,9388,11363,4835,2057,27643,581,168,138,887,28530
06-08-2017,4,9169,11351,4689,2238,27448,605,159,141,905,28353
06-08-2017,5,9129,11426,4549,2246,27351,607,158,129,894,28245
06-08-2017,6,8984,11334,4515,2207,27040,615,164,123,902,27942
06-08-2017,7,9719,11601,4572,2409,28302,604,172,124,900,29202
06-08-2017,8,10554,12020,4774,2804,30151,639,231,136,1006,31157
06-08-2017,9,10619,12535,4812,3334,31301,653,322,169,1144,32445
06-08-2017,10,11270,12845,4855,3751,32723,664,400,232,1296,34019
06-08-2017,11,11526,13219,4783,3894,33423,673,395,289,1357,34780
06-08-2017,12,11737,13355,4733,3894,33718,667,411,299,1377,35095
06-08-2017,13,11031,13529,4689,3716,32965,660,508,318,1486,34451
06-08-2017,14,10794,13585,4678,3772,32829,672,495,363,1530,34359
06-08-2017,15,10820,13577,4682,3662,32741,652,470,376,1498,34239
06-08-2017,16,11391,13767,4664,3523,33345,638,456,375,1469,34814
06-08-2017,17,12098,14265,4659,3156,34179,641,483,360,1484,35663
06-08-2017,18,14426,14857,4687,2842,36813,617,572,337,1526,38339
06-08-2017,19,15412,14905,4800,2551,37668,687,569,306,1562,39230
06-08-2017,20,15587,15136,4957,2154,37834,724,567,277,1568,39402
06-08-2017,21,15738,15243,5298,1977,38256,727,561,296,1584,39840
06-08-2017,22,15243,15449,5217,1783,37692,731,556,316,1603,39295
06-08-2017,23,14684,14354,4943,1630,35610,729,505,276,1510,37120
07-08-2017,0,14338,13059,4757,1368,33521,760,170,270,1200,34721
07-08-2017,1,13945,12689,4611,1185,32430,800,165,263,1228,33658
07-08-2017,2,13429,12555,4590,1087,31661,848,170,252,1270,32931
07-08-2017,3,12637,12427,4580,1015,30660,906,168,251,1325,31985
07-08-2017,4,12508,12489,4691,1022,30710,922,167,220,1309,32019
07-08-2017,5,13623,13396,4813,1024,32858,1102,176,204,1482,34340
07-08-2017,6,14698,15245,5126,1124,36193,1321,641,210,2172,38365
07-08-2017,7,15669,16476,5655,1428,39228,1365,737,363,2465,41693
07-08-2017,8,15906,16706,5825,1777,40215,1392,736,577,2705,42920
07-08-2017,9,16079,16410,5980,2165,40634,1396,895,628,2919,43553
07-08-2017,10,16346,16359,6059,2538,41303,1402,895,627,2924,44227
07-08-2017,11,16293,16465,6123,3038,41919,1419,898,593,2910,44829
07-08-2017,12,16462,15938,6194,3310,41903,1418,896,620,2934,44837
07-08-2017,13,16573,15669,6044,3498,41785,1420,899,630,2949,44734
07-08-2017,14,16746,15887,5951,3511,42096,1399,898,575,2872,44968
07-08-2017,15,16327,15937,5718,3387,41370,1380,896,593,2869,44239
07-08-2017,16,15928,15950,5330,3164,40374,1352,882,359,2593,42967
07-08-2017,17,16258,16418,5313,2637,40625,1361,833,503,2697,43322
07-08-2017,18,16426,16998,5343,2084,40850,1350,828,470,2648,43498
07-08-2017,19,16442,17092,5327,1728,40588,1350,719,450,2519,43107
07-08-2017,20,16119,16848,5128,1401,39496,1335,730,448,2513,42009
07-08-2017,21,15903,16762,5156,1207,39028,1318,733,200,2251,41279
07-08-2017,22,15603,16385,4997,1118,38104,1299,280,74,1653,39757
07-08-2017,23,14971,15397,4749,947,36064,1156,220,44,1420,37484
08-08-2017,0,14468,13630,4579,705,33382,848,194,40,1082,34464
08-08-2017,1,13910,13086,4530,692,32219,802,191,38,1031,33250
08-08-2017,2,13108,12725,4573,651,31057,809,193,38,1040,32097
08-08-2017,3,12403,12595,4636,559,30193,793,197,38,1028,31221
08-08-2017,4,12688,12680,4810,544,30722,797,215,38,1050,31772
08-08-2017,5,13969,13396,5156,573,33094,1055,394,41,1490,34584
08-08-2017,6,15040,15573,5525,770,36907,1280,520,70,1870,38777
08-08-2017,7,16214,16803,5903,899,39820,1276,660,75,2011,41831
08-08-2017,8,16416,17304,6135,1031,40888,1284,664,317,2265,43153
08-08-2017,9,16601,17378,6002,1177,41159,1256,665,456,2377,43536
08-08-2017,10,16395,17547,6120,1584,41647,1211,703,447,2361,44008
08-08-2017,11,16336,17457,6203,1730,41727,1220,782,456,2458,44185
08-08-2017,12,16182,16845,6218,1813,41058,1220,768,474,2462,43520
08-08-2017,13,16362,16204,6175,2037,40778,1208,811,454,2473,43251
08-08-2017,14,16508,16190,6083,2113,40894,1196,670,449,2315,43209
08-08-2017,15,16477,16479,6057,2068,41080,1196,588,401,2185,43265
08-08-2017,16,16418,16662,5831,2031,40943,1199,589,69,1857,42800
08-08-2017,17,16484,17054,5852,1967,41358,1196,593,228,2017,43375
08-08-2017,18,16019,16877,5609,2033,40540,1184,598,260,2042,42582
08-08-2017,19,16085,16609,5674,2153,40523,1183,496,301,1980,42503
08-08-2017,20,15682,16158,5416,2281,39537,1189,408,207,1804,41341
08-08-2017,21,15722,15670,5124,2294,38810,1163,411,253,1827,40637
08-08-2017,22,14892,15265,4994,2196,37348,920,309,281,1510,38858
08-08-2017,23,13195,14660,4993,2131,34979,776,260,295,1331,36310
09-08-2017,0,11987,12969,5009,2191,32155,729,231,299,1259,33414
09-08-2017,1,11122,12671,4941,2041,30776,726,221,292,1239,32015
09-08-2017,2,10497,12588,4922,1800,29808,742,285,275,1302,31110
09-08-2017,3,9680,12575,4867,1634,28756,748,295,274,1317,30073
09-08-2017,4,9821,12541,4890,1555,28808,753,323,285,1361,30169
09-08-2017,5,11931,13407,5043,1646,32027,943,329,302,1574,33601
09-08-2017,6,14464,15530,5397,1665,37054,1158,532,262,1952,39006
09-08-2017,7,15697,17500,5592,1795,40584,1189,630,568,2387,42971
09-08-2017,8,16402,17435,5857,1976,41670,1210,709,537,2456,44126
09-08-2017,9,16696,17119,5950,1970,41733,1209,714,668,2591,44324
09-08-2017,10,16634,17388,6003,2320,42346,1234,726,682,2642,44988
09-08-2017,11,16330,16854,6082,2783,42051,1240,790,705,2735,44786
09-08-2017,12,16642,16501,6096,3258,42497,1237,790,720,2747,45244
09-08-2017,13,16614,16407,6018,3145,42183,1238,786,671,2695,44878
09-08-2017,14,16512,16408,5972,3341,42232,1229,777,607,2613,44845
09-08-2017,15,16264,16319,5850,3769,42204,1216,774,468,2458,44662
09-08-2017,16,15629,16397,5631,3838,41495,1208,773,246,2227,43722
09-08-2017,17,15569,16622,5606,3938,41736,1213,800,450,2463,44199
09-08-2017,18,15864,16369,5821,3544,41597,1200,782,315,2297,43894
09-08-2017,19,15981,16276,5860,2986,41104,1206,813,158,2177,43281
09-08-2017,20,15865,16021,5343,2921,40150,1215,616,127,1958,42108
09-08-2017,21,16031,15799,5241,2664,39735,1033,532,128,1693,41428
09-08-2017,22,15673,15217,4907,2339,38138,866,390,126,1382,39520
09-08-2017,23,14670,14228,4677,2030,35604,828,398,99,1325,36929
10-08-2017,0,14518,13453,4686,1728,34385,887,202,94,1183,35568
10-08-2017,1,14205,13139,4638,1547,33528,874,195,81,1150,34678
10-08-2017,2,13946,12824,4622,1486,32878,870,194,76,1140,34018
10-08-2017,3,14004,12809,4602,1466,32882,856,202,54,1112,33994
10-08-2017,4,13721,12884,4669,1397,32671,832,292,50,1174,33845
10-08-2017,5,14004,13915,4929,1248,34096,1079,310,70,1459,35555
10-08-2017,6,14840,15639,5399,1261,37142,1307,464,115,1886,39028
10-08-2017,7,16186,17187,5762,1355,40489,1306,526,267,2099,42588
10-08-2017,8,15974,18092,6127,1766,41959,1300,632,455,2387,44346
10-08-2017,9,16109,18096,6270,2148,42623,1295,665,502,2462,45085
10-08-2017,10,16421,18069,6234,2097,42822,1312,615,498,2425,45247
10-08-2017,11,16726,18079,6397,1996,43200,1352,603,538,2493,45693
10-08-2017,12,16500,18147,6455,1985,43088,1357,601,453,2411,45499
10-08-2017,13,16160,18282,6397,2148,42986,1346,603,522,2471,45457
10-08-2017,14,16176,17817,6432,2130,42555,1355,609,522,2486,45041
10-08-2017,15,16085,17555,6189,2047,41875,1333,629,462,2424,44299
10-08-2017,16,15988,17398,5876,1850,41113,1323,633,68,2024,43137
10-08-2017,17,15898,17285,5965,1875,41023,1326,585,259,2170,43193
10-08-2017,18,16015,17416,5991,1645,41068,1317,587,201,2105,43173
10-08-2017,19,15979,17233,5825,1368,40404,1306,580,161,2047,42451
10-08-2017,20,15891,16925,5413,992,39222,1291,474,68,1833,41055
10-08-2017,21,16090,16700,5348,829,38969,1234,504,83,1821,40790
10-08-2017,22,15770,16316,5313,871,38269,1217,286,73,1576,39845
10-08-2017,23,15288,14653,4964,801,35706,1078,282,70,1430,37136
11-08-2017,0,14792,13378,4890,808,33867,895,201,86,1182,35049
11-08-2017,1,14459,13060,4875,742,33135,881,195,95,1171,34306
11-08-2017,2,14187,12711,4820,717,32436,887,191,88,1166,33602
11-08-2017,3,14085,12666,4751,750,32251,868,197,71,1136,33387
11-08-2017,4,14127,12623,4774,692,32217,882,206,75,1163,33380
11-08-2017,5,14380,13242,4939,631,33193,1147,353,76,1576,34769
11-08-2017,6,14982,14742,5555,710,35990,1276,498,97,1871,37861
11-08-2017,7,16267,16461,5834,775,39337,1265,724,235,2224,41561
11-08-2017,8,16349,17064,5926,917,40256,1263,726,474,2463,42719
11-08-2017,9,16408,17252,6031,1086,40777,1249,702,479,2430,43207
11-08-2017,10,16691,17530,6246,1141,41609,1257,711,487,2455,44064
11-08-2017,11,16588,17972,6413,1204,42175,1261,758,490,2509,44684
11-08-2017,12,16366,17909,6474,1208,41957,1267,703,468,2438,44395
11-08-2017,13,16150,17567,6390,1111,41220,1264,702,462,2428,43648
11-08-2017,14,16202,17147,6292,987,40628,1255,702,259,2216,42844
11-08-2017,15,16216,17047,6178,926,40368,1249,709,98,2056,42424
11-08-2017,16,16192,16905,5871,880,39850,1255,581,69,1905,41755
11-08-2017,17,16026,16790,5858,871,39545,1251,663,71,1985,41530
11-08-2017,18,15841,16603,5716,933,39094,1247,652,117,2016,41110
11-08-2017,19,15796,16410,5544,941,38689,1247,552,110,1909,40598
11-08-2017,20,15429,16108,5330,711,37578,1208,443,115,1766,39344
11-08-2017,21,15473,15835,5373,648,37330,1181,461,191,1833,39163
11-08-2017,22,15167,15698,5460,663,36988,675,442,165,1282,38270
11-08-2017,23,14857,14436,5256,587,35136,553,285,150,988,36124
12-08-2017,0,13242,13176,5178,484,32080,577,194,181,952,33032
12-08-2017,1,11323,12306,5102,507,29238,591,194,149,934,30172
12-08-2017,2,10432,11813,5105,573,27924,605,195,246,1046,28970
12-08-2017,3,10187,11607,5096,662,27552,602,197,160,959,28511
12-08-2017,4,9689,11518,5052,706,26966,612,193,179,984,27950
12-08-2017,5,9557,11447,5000,798,26802,615,195,217,1027,27829
12-08-2017,6,10454,11472,4951,737,27615,590,203,208,1001,28616
12-08-2017,7,12238,12363,4956,702,30257,557,193,208,958,31215
12-08-2017,8,13430,13957,5070,768,33225,545,380,205,1130,34355
12-08-2017,9,14786,14644,5329,725,35484,521,386,233,1140,36624
12-08-2017,10,15103,14797,5427,742,36069,551,374,232,1157,37226
12-08-2017,11,14914,14766,5306,875,35860,598,387,195,1180,37040
12-08-2017,12,14288,14614,5221,1041,35167,645,396,211,1252,36419
12-08-2017,13,14367,14333,5302,1252,35253,625,403,179,1207,36460
12-08-2017,14,14101,14124,5149,1526,34900,559,382,176,1117,36017
12-08-2017,15,13338,13943,5044,1709,34034,549,475,174,1198,35232
12-08-2017,16,13719,13969,5034,1844,34566,558,474,151,1183,35749
12-08-2017,17,13694,14167,4922,2006,34790,606,485,97,1188,35978
12-08-2017,18,13909,14275,5022,2103,35308,637,476,100,1213,36521
12-08-2017,19,13687,14269,5041,2025,35023,599,387,158,1144,36167
12-08-2017,20,13898,14240,4725,1930,34793,600,384,184,1168,35961
12-08-2017,21,13801,14166,4945,1971,34883,591,385,154,1130,36013
12-08-2017,22,12039,13701,4749,2437,32926,581,386,179,1146,34072
12-08-2017,23,11078,13093,4547,2595,31315,605,367,206,1178,32493
13-08-2017,0,10732,11897,4467,2780,29877,615,147,178,940,30817
13-08-2017,1,9985,11438,4352,2794,28569,609,145,187,941,29510
13-08-2017,2,9424,11240,4326,2743,27731,618,152,113,883,28614
13-08-2017,3,8716,11102,4288,2737,26843,638,156,104,898,27741
13-08-2017,4,8366,11187,4289,2582,26424,640,152,128,920,27344
13-08-2017,5,8092,11241,4288,2429,26051,636,150,136,922,26973
13-08-2017,6,8253,11097,4378,2394,26123,624,153,137,914,27037
13-08-2017,7,9134,11351,4485,2434,27404,625,151,136,912,28316
13-08-2017,8,10610,12107,4621,2691,30029,610,163,161,934,30963
13-08-2017,9,11361,13188,4808,3004,32362,623,311,181,1115,33477
13-08-2017,10,11736,13711,4902,3064,33414,633,332,180,1145,34559
13-08-2017,11,12005,13821,4988,3034,33848,626,324,174,1124,34972
13-08-2017,12,12121,14045,4941,3008,34115,598,333,210,1141,35256
13-08-2017,13,11871,13970,4931,3117,33888,610,340,260,1210,35098
13-08-2017,14,11647,13849,4931,3169,33596,601,339,304,1244,34840
13-08-2017,15,11766,13307,4942,3123,33138,638,339,334,1311,34449
13-08-2017,16,12236,13342,4949,2961,33489,635,336,330,1301,34790
13-08-2017,17,12821,14126,5031,2691,34670,658,350,307,1315,35985
13-08-2017,18,14807,15253,5187,2384,37631,667,352,273,1292,38923
13-08-2017,19,15557,15790,5286,2053,38687,670,429,232,1331,40018
13-08-2017,20,15690,16395,5346,1716,39148,662,418,232,1312,40460
13-08-2017,21,16027,17240,5670,1491,40428,643,394,220,1257,41685
13-08-2017,22,15544,16576,5563,1566,39250,630,298,201,1129,40379
13-08-2017,23,14828,15599,5397,1354,37177,598,138,177,913,38090
14-08-2017,0,14164,14101,5240,1251,34756,611,136,149,896,35652
14-08-2017,1,13416,13069,5051,1021,32557,659,135,121,915,33472
14-08-2017,2,13089,12755,5045,816,31703,715,135,113,963,32666
14-08-2017,3,12917,12682,5043,691,31332,749,135,109,993,32325
14-08-2017,4,12970,12624,5218,623,31437,822,138,99,1059,32496
14-08-2017,5,13930,13287,5411,585,33214,1095,278,89,1462,34676
14-08-2017,6,15203,15466,5726,590,36984,1216,373,73,1662,38646
14-08-2017,7,16443,17266,6098,847,40655,1271,529,45,1845,42500
14-08-2017,8,16676,17363,6456,1005,41500,1279,593,233,2105,43605
14-08-2017,9,16930,17016,6468,1120,41534,1264,612,259,2135,43669
14-08-2017,10,17096,16878,6521,1320,41816,1256,612,225,2093,43909
14-08-2017,11,17019,16790,6582,1435,41826,1270,595,107,1972,43798
14-08-2017,12,17017,16762,6448,1398,41626,1365,593,162,2120,43746
14-08-2017,13,17072,16712,6445,1369,41599,1346,539,110,1995,43594
14-08-2017,14,17029,16469,6308,1314,41120,1369,555,101,2025,43145
14-08-2017,15,16999,16365,6172,1277,40815,1359,552,91,2002,42817
14-08-2017,16,16962,16380,6152,1193,40689,1356,531,75,1962,42651
14-08-2017,17,16969,16714,6303,1135,41120,1360,536,65,1961,43081
14-08-2017,18,16581,16589,6441,1247,40857,1331,529,62,1922,42779
14-08-2017,19,16899,16459,6319,1232,40909,1241,525,268,2034,42943
14-08-2017,20,16758,16482,6364,1231,40835,1255,524,62,1841,42676
14-08-2017,21,16594,16396,6312,1320,40622,1284,508,55,1847,42469
14-08-2017,22,16028,15423,5806,1567,38826,1277,341,46,1664,40490
14-08-2017,23,15652,13743,5158,1708,36262,1216,196,41,1453,37715
15-08-2017,0,14921,11913,5035,1745,33615,869,123,37,1029,34644
15-08-2017,1,13930,11347,4966,1772,32016,822,121,32,975,32991
15-08-2017,2,12628,11197,4856,1753,30434,844,123,31,998,31432
15-08-2017,3,12373,11267,4862,1764,30266,827,125,32,984,31250
15-08-2017,4,12325,11424,4934,1818,30504,855,128,33,1016,31520
15-08-2017,5,12893,11885,5170,1960,31909,1117,133,32,1282,33191
15-08-2017,6,14502,14009,5667,2147,36325,1254,288,32,1574,37899
15-08-2017,7,16211,15708,5896,2334,40149,1337,465,106,1908,42057
15-08-2017,8,17068,16138,5992,2417,41615,1410,498,394,2302,43917
15-08-2017,9,17170,16196,6217,2522,42105,1350,328,432,2110,44215
15-08-2017,10,17200,16653,6214,2693,42760,1359,326,436,2121,44881
15-08-2017,11,17146,16306,6179,2818,42448,1373,314,434,2121,44569
15-08-2017,12,17322,15989,6184,2902,42396,1270,306,422,1998,44394
15-08-2017,13,17404,15975,6231,2826,42435,1271,302,418,1991,44426
15-08-2017,14,17305,15924,6167,2808,42204,1273,316,444,2033,44237
15-08-2017,15,17304,15976,6263,2693,42235,1271,323,223,1817,44052
15-08-2017,16,17092,15971,5902,2436,41402,1270,509,38,1817,43219
15-08-2017,17,17157,16311,6130,2169,41766,1268,529,32,1829,43595
15-08-2017,18,17051,17161,6200,1989,42402,1247,511,31,1789,44191
15-08-2017,19,16932,17386,6206,1969,42494,1245,535,34,1814,44308
15-08-2017,20,16479,17337,6070,1946,41832,1259,536,47,1842,43674
15-08-2017,21,16449,16840,5957,1550,40796,1267,473,63,1803,42599
15-08-2017,22,16088,16295,5740,1270,39392,1251,452,72,1775,41167
15-08-2017,23,15244,14998,5360,1104,36706,1059,233,84,1376,38082
16-08-2017,0,14574,13159,5232,923,33887,916,177,92,1185,35072
16-08-2017,1,13988,12812,5172,896,32869,908,175,98,1181,34050
16-08-2017,2,13842,12656,5207,942,32647,907,179,98,1184,33831
16-08-2017,3,13988,12591,5182,1020,32780,902,188,106,1196,33976
16-08-2017,4,14186,12469,5322,1104,33083,971,198,113,1282,34365
16-08-2017,5,14702,13240,5472,1231,34645,1215,224,119,1558,36203
16-08-2017,6,15515,15680,5761,1213,38169,1324,526,131,1981,40150
16-08-2017,7,16484,17561,6022,1399,41467,1365,654,284,2303,43770
16-08-2017,8,16979,18134,6127,1470,42712,1415,712,460,2587,45299
16-08-2017,9,16919,18199,6254,1765,43138,1280,595,518,2393,45531
16-08-2017,10,17305,18124,6333,1951,43713,1290,608,538,2436,46149
16-08-2017,11,17137,18067,6358,2272,43834,1300,564,530,2394,46228
16-08-2017,12,16860,18053,6379,2340,43634,1301,555,520,2376,46010
16-08-2017,13,16717,17796,6406,2188,43106,1284,555,515,2354,45460
16-08-2017,14,16824,17633,6399,2025,42883,1285,370,499,2154,45037
16-08-2017,15,16531,17111,6409,1785,41837,1272,382,484,2138,43975
16-08-2017,16,16647,17248,6266,1523,41685,1259,618,105,1982,43667
16-08-2017,17,16513,17747,6326,1420,42006,1339,599,285,2223,44229
16-08-2017,18,16531,17901,6328,1245,42005,1356,517,327,2200,44205
16-08-2017,19,16495,17644,6383,999,41521,1320,482,275,2077,43598
16-08-2017,20,16151,17089,6406,969,40615,1312,525,77,1914,42529
16-08-2017,21,16374,16520,6279,911,40084,1334,468,86,1888,41972
16-08-2017,22,15797,15887,6206,816,38707,1334,237,67,1638,40345
16-08-2017,23,15262,14591,5741,806,36399,1412,187,62,1661,38060
17-08-2017,0,14709,12573,5519,955,33756,1090,186,75,1351,35107
17-08-2017,1,14407,11856,5366,1156,32786,905,182,87,1174,33960
17-08-2017,2,14331,11405,5187,1227,32150,898,182,61,1141,33291
17-08-2017,3,14200,11277,5115,1351,31945,897,196,83,1176,33121
17-08-2017,4,13787,11370,5109,1525,31790,902,260,86,1248,33038
17-08-2017,5,13381,12030,5372,1825,32607,1223,242,115,1580,34187
17-08-2017,6,14709,13944,5808,2249,36711,1336,469,97,1902,38613
17-08-2017,7,15734,15640,6075,2804,40252,1454,585,223,2262,42514
17-08-2017,8,16551,16115,6070,2891,41627,1454,564,552,2570,44197
17-08-2017,9,16544,16578,6286,3092,42502,1441,522,543,2506,45008
17-08-2017,10,16676,16629,6179,3361,42845,1431,555,563,2549,45394
17-08-2017,11,16760,16417,6115,3468,42759,1428,528,629,2585,45344
17-08-2017,12,16799,16414,6118,3670,43004,1433,680,587,2700,45704
17-08-2017,13,16687,16278,6081,3863,42909,1436,699,627,2762,45671
17-08-2017,14,16431,15975,6193,3838,42437,1428,676,513,2617,45054
17-08-2017,15,16533,16055,6015,3843,42445,1428,577,542,2547,44992
17-08-2017,16,16162,16262,6049,3909,42384,1454,608,277,2339,44723
17-08-2017,17,16383,16528,5987,3706,42603,1565,697,182,2444,45047
17-08-2017,18,16227,16736,5992,3657,42612,1549,700,74,2323,44935
17-08-2017,19,16055,16731,5958,3368,42114,1508,524,256,2288,44402
17-08-2017,20,16100,16471,5852,2869,41293,1440,583,166,2189,43482
17-08-2017,21,16144,16261,5941,2391,40736,1424,471,57,1952,42688
17-08-2017,22,15563,16096,5665,1991,39315,1120,224,68,1412,40727
17-08-2017,23,15206,15212,5309,1713,37443,962,204,79,1245,38688
18-08-2017,0,14858,13640,4997,1488,34983,979,207,76,1262,36245
18-08-2017,1,14457,13229,4832,1395,33914,986,210,117,1313,35227
18-08-2017,2,14340,12881,4803,1253,33278,981,214,161,1356,34634
18-08-2017,3,14057,12892,4722,1150,32822,979,224,192,1395,34217
18-08-2017,4,13855,13282,4836,1122,33095,991,296,223,1510,34605
18-08-2017,5,13966,13887,5220,1091,34165,1165,543,258,1966,36131
18-08-2017,6,14741,15533,5800,1224,37298,1355,582,271,2208,39506
18-08-2017,7,16251,17077,6081,1636,41045,1467,851,269,2587,43632
18-08-2017,8,16652,18046,6170,2036,42904,1435,874,500,2809,45713
18-08-2017,9,16761,17931,6158,2372,43221,1462,885,526,2873,46094
18-08-2017,10,17032,17914,6220,2760,43926,1472,781,518,2771,46697
18-08-2017,11,16676,17631,6261,3136,43706,1483,844,537,2864,46570
18-08-2017,12,16683,17381,6248,3204,43516,1488,944,555,2987,46503
18-08-2017,13,16660,17054,6205,3107,43025,1490,826,600,2916,45941
18-08-2017,14,16543,16792,6166,2912,42413,1496,548,578,2622,45035
18-08-2017,15,16314,16384,6188,2831,41718,1512,546,486,2544,44262
18-08-2017,16,16213,15684,6116,2460,40473,1538,560,106,2204,42677
18-08-2017,17,16267,15625,6078,2290,40259,1526,585,182,2293,42552
18-08-2017,18,15834,15825,5926,1922,39508,1551,588,170,2309,41817
18-08-2017,19,15968,15713,5925,1520,39126,1553,565,69,2187,41313
18-08-2017,20,15733,15662,5891,1417,38704,1324,510,61,1895,40599
18-08-2017,21,15591,15371,5807,1284,38053,1049,519,77,1645,39698
18-08-2017,22,15289,14560,5444,1281,36575,1043,210,113,1366,37941
18-08-2017,23,15095,13390,5047,1365,34897,875,187,157,1219,36116
19-08-2017,0,13345,10791,4804,1361,30300,723,126,199,1048,31348
19-08-2017,1,12149,9713,4697,1271,27831,632,128,245,1005,28836
19-08-2017,2,11763,9549,4645,1317,27274,633,133,262,1028,28302
19-08-2017,3,11429,9426,4656,1444,26955,633,139,287,1059,28014
19-08-2017,4,11280,9370,4621,1702,26972,642,150,317,1109,28081
19-08-2017,5,11130,9520,4591,1895,27135,680,161,338,1179,28314
19-08-2017,6,11245,9937,4782,1896,27860,695,170,298,1163,29023
19-08-2017,7,12050,11147,4974,1865,30036,732,335,215,1282,31318
19-08-2017,8,12951,12801,5025,2027,32803,748,394,135,1277,34080
19-08-2017,9,13877,13545,5166,2370,34958,775,431,196,1402,36360
19-08-2017,10,14388,13655,5285,2792,36120,778,506,229,1513,37633
19-08-2017,11,14418,13794,5197,3156,36565,775,590,141,1506,38071
19-08-2017,12,14072,13695,5250,3235,36252,800,533,147,1480,37732
19-08-2017,13,13845,13586,5210,3207,35848,798,501,156,1455,37303
19-08-2017,14,13256,13317,5145,3487,35205,806,430,113,1349,36554
19-08-2017,15,12974,13361,5182,3328,34846,760,379,94,1233,36079
19-08-2017,16,12703,13316,5357,3456,34831,713,358,105,1176,36007
19-08-2017,17,12924,13335,5351,3501,35111,746,351,104,1201,36312
19-08-2017,18,13338,13419,5361,3140,35258,804,346,94,1244,36502
19-08-2017,19,14347,13457,5454,2847,36105,722,345,88,1155,37260
19-08-2017,20,14177,13276,5527,2573,35555,709,321,71,1101,36656
19-08-2017,21,14315,13181,5493,2424,35413,716,233,60,1009,36422
19-08-2017,22,13042,13028,5604,2437,34111,712,144,54,910,35021
19-08-2017,23,11857,12049,5446,2424,31778,706,141,48,895,32673
20-08-2017,0,10796,11490,5462,2397,30147,625,140,52,817,30964
20-08-2017,1,9825,11237,5413,2519,28994,610,133,46,789,29783
20-08-2017,2,9208,10917,5376,2633,28134,580,136,38,754,28888
20-08-2017,3,9028,10853,5390,2672,27942,560,135,41,736,28678
20-08-2017,4,8754,11016,5397,2627,27794,536,138,53,727,28521
20-08-2017,5,8664,11036,5353,2551,27606,532,146,60,738,28344
20-08-2017,6,9264,10985,5495,2460,28205,521,147,53,721,28926
20-08-2017,7,10543,11258,5574,2506,29882,522,146,48,716,30598
20-08-2017,8,11568,11837,5694,2589,31689,511,156,35,702,32391
20-08-2017,9,12262,12606,5725,2743,33339,538,255,38,831,34170
20-08-2017,10,12573,13175,5722,3110,34580,544,305,61,910,35490
20-08-2017,11,12799,13269,5688,3189,34943,566,306,66,938,35881
20-08-2017,12,12785,13378,5693,3222,35079,561,313,69,943,36022
20-08-2017,13,12825,13420,5730,3345,35321,548,308,70,926,36247
20-08-2017,14,13068,13252,5785,3190,35294,526,260,73,859,36153
20-08-2017,15,12972,13289,5843,3286,35391,520,256,77,853,36244
20-08-2017,16,13097,13443,5832,3330,35702,518,252,77,847,36549
20-08-2017,17,13601,13440,5866,3389,36297,554,233,65,852,37149
20-08-2017,18,14036,13695,5673,3137,36543,573,176,68,817,37360
20-08-2017,19,14869,13734,5829,2914,37347,581,189,54,824,38171
20-08-2017,20,15469,14210,6004,2806,38489,592,195,50,837,39326
20-08-2017,21,15533,14590,6084,2732,38939,614,202,45,861,39800
20-08-2017,22,14593,13820,5829,2668,36908,579,154,39,772,37680
20-08-2017,23,12958,12048,5407,2730,33143,588,130,40,758,33901
21-08-2017,0,11558,11129,5375,2804,30867,633,127,39,799,31666
21-08-2017,1,11497,10708,5323,2861,30389,689,123,50,862,31251
21-08-2017,2,10960,10608,5344,2930,29841,732,125,51,908,30749
21-08-2017,3,10982,10601,5304,2973,29861,727,129,55,911,30772
21-08-2017,4,11015,11264,5304,3067,30650,833,132,64,1029,31679
21-08-2017,5,11688,12469,5322,3172,32652,1064,146,72,1282,33934
21-08-2017,6,14676,14933,5842,3198,38651,1177,460,79,1716,40367
21-08-2017,7,16200,16511,6153,3379,42244,1191,703,262,2156,44400
21-08-2017,8,16381,16594,6386,3537,42898,1190,812,488,2490,45388
21-08-2017,9,16609,16287,6426,3702,43025,1202,764,514,2480,45505
21-08-2017,10,16632,16568,6537,3872,43610,1201,627,466,2294,45904
21-08-2017,11,16420,16529,6494,3973,43416,1200,534,522,2256,45672
21-08-2017,12,16288,16376,6396,4055,43115,1191,534,543,2268,45383
21-08-2017,13,16338,16307,6292,4067,43004,1198,527,493,2218,45222
21-08-2017,14,16184,16289,6294,3956,42723,1259,502,393,2154,44877
21-08-2017,15,16263,16013,6018,3938,42232,1357,498,280,2135,44367
21-08-2017,16,16200,15837,5796,3850,41684,1372,495,56,1923,43607
21-08-2017,17,16213,15933,5888,3744,41778,1402,496,109,2007,43785
21-08-2017,18,16134,15788,6031,3576,41530,1412,497,62,1971,43501
21-08-2017,19,16231,16038,5930,3428,41627,1434,501,33,1968,43595
21-08-2017,20,16173,16340,5917,3246,41676,1442,473,35,1950,43626
21-08-2017,21,15977,16270,5819,3004,41070,1458,277,44,1779,42849
21-08-2017,22,15448,15210,5358,2692,38709,1421,220,41,1682,40391
21-08-2017,23,14905,14123,4950,2449,36428,1362,187,41,1590,38018
22-08-2017,0,14489,12886,4793,2377,34545,1084,165,37,1286,35831
22-08-2017,1,14277,12377,4670,2379,33703,1033,179,32,1244,34947
22-08-2017,2,14184,12159,4667,2359,33370,1054,186,32,1272,34642
22-08-2017,3,14083,12197,4572,2388,33239,1061,195,29,1285,34524
22-08-2017,4,14015,12332,4555,2414,33316,1095,198,30,1323,34639
22-08-2017,5,14132,13642,5039,2298,35111,1368,229,29,1626,36737
22-08-2017,6,15000,15251,5598,2276,38126,1515,266,64,1845,39971
22-08-2017,7,16614,16385,5825,2472,41296,1534,602,129,2265,43561
22-08-2017,8,16956,16855,5967,2608,42385,1552,873,530,2955,45340
22-08-2017,9,17196,16313,5807,2703,42020,1566,975,750,3291,45311
22-08-2017,10,17204,16111,5901,2619,41833,1557,1018,767,3342,45175
22-08-2017,11,16973,15933,6017,2727,41650,1571,1009,776,3356,45006
22-08-2017,12,16827,15837,6142,2770,41576,1596,1009,753,3358,44934
22-08-2017,13,16760,15751,6260,2680,41451,1584,974,601,3159,44610
22-08-2017,14,16579,15796,6347,2569,41290,1568,721,524,2813,44103
22-08-2017,15,16610,15559,6423,2365,40957,1559,550,536,2645,43602
22-08-2017,16,16594,15269,6338,2314,40514,1563,554,486,2603,43117
22-08-2017,17,16587,15705,6404,2348,41043,1581,560,347,2488,43531
22-08-2017,18,16281,16105,6486,2374,41245,1578,566,335,2479,43724
22-08-2017,19,16364,16234,6573,2218,41390,1577,566,542,2685,44075
22-08-2017,20,16294,15891,6532,2086,40801,1580,542,544,2666,43467
22-08-2017,21,16169,15755,6386,2027,40338,1579,344,437,2360,42698
22-08-2017,22,15659,14746,6181,1872,38457,1512,248,386,2146,40603
22-08-2017,23,14971,13701,5687,1401,35760,1414,253,286,1953,37713
23-08-2017,0,14416,11797,5270,1283,32767,1325,223,107,1655,34422
23-08-2017,1,14224,11258,5146,1288,31916,1313,225,102,1640,33556
23-08-2017,2,13974,11049,5003,1348,31375,1269,245,95,1609,32984
23-08-2017,3,13793,10944,5179,1348,31264,1332,249,96,1677,32941
23-08-2017,4,13715,11184,5242,1349,31488,1470,253,98,1821,33309
23-08-2017,5,13875,12448,5545,1344,33212,1504,278,94,1876,35088
23-08-2017,6,14808,14363,6168,1677,37016,1539,451,166,2156,39172
23-08-2017,7,16179,15924,6541,1941,40585,1630,1009,472,3111,43696
23-08-2017,8,16695,16355,6606,1929,41587,1663,1068,743,3474,45061
23-08-2017,9,16656,15876,6463,2124,41119,1678,1062,946,3686,44805
23-08-2017,10,16705,15784,6369,2235,41092,1696,1042,969,3707,44799
23-08-2017,11,16601,15857,6348,2403,41207,1723,1051,1009,3783,44990
23-08-2017,12,16504,15712,6382,2380,40980,1723,1051,1017,3791,44771
23-08-2017,13,16358,15671,6328,2392,40747,1649,958,842,3449,44196
23-08-2017,14,16474,15570,6343,2280,40666,1771,954,936,3661,44327
23-08-2017,15,16385,15488,6341,2113,40328,1795,980,762,3537,43865
23-08-2017,16,16169,14993,6332,1982,39476,1859,550,726,3135,42611
23-08-2017,17,16205,15058,6386,1850,39498,1883,947,805,3635,43133
23-08-2017,18,16072,15400,6296,1674,39443,1892,422,681,2995,42438
23-08-2017,19,16232,15409,6448,1533,39622,1890,370,1002,3262,42884
23-08-2017,20,16154,15486,6407,1417,39464,1902,381,607,2890,42354
23-08-2017,21,16137,14796,6260,1478,38672,1898,346,594,2838,41510
23-08-2017,22,15904,13677,6003,1240,36824,1909,271,594,2774,39598
23-08-2017,23,15128,12630,5592,1460,34810,1874,248,550,2672,37482
24-08-2017,0,14320,11237,5179,1559,32296,1536,241,440,2217,34513
24-08-2017,1,13746,10869,5121,1735,31470,1449,244,464,2157,33627
24-08-2017,2,13154,10520,5162,1780,30617,1490,247,476,2213,32830
24-08-2017,3,12964,10599,5198,1782,30543,1471,254,503,2228,32771
24-08-2017,4,13197,11170,5205,1741,31314,1687,270,512,2469,33783
24-08-2017,5,14157,12339,5500,1750,33746,1849,297,502,2648,36394
24-08-2017,6,15125,14038,5961,1824,36948,1870,413,516,2799,39747
24-08-2017,7,16441,15899,6349,2272,40961,1876,644,705,3225,44186
24-08-2017,8,16903,16072,6525,2411,41912,1855,702,1122,3679,45591
24-08-2017,9,16832,16073,6535,2462,41900,1827,753,1139,3719,45619
24-08-2017,10,16730,16336,6492,2590,42149,1833,751,1215,3799,45948
24-08-2017,11,16495,16183,6492,2747,41917,1755,781,1144,3680,45597
24-08-2017,12,16477,15945,6497,2805,41724,1712,832,1174,3718,45442
24-08-2017,13,16520,15768,6420,2903,41611,1699,826,1222,3747,45358
24-08-2017,14,16585,15648,6386,2963,41582,1708,644,1149,3501,45083
24-08-2017,15,16623,15874,6455,3224,42175,1718,576,697,2991,45166
24-08-2017,16,16275,15484,6309,3461,41528,1688,553,575,2816,44344
24-08-2017,17,16371,15567,6372,3679,41987,1672,494,637,2803,44790
24-08-2017,18,16321,15523,6439,3633,41917,1695,388,580,2663,44580
24-08-2017,19,16780,15519,6361,3532,42193,1690,388,570,2648,44841
24-08-2017,20,16865,15793,6335,3442,42436,1658,357,494,2509,44945
24-08-2017,21,16507,15226,6266,3459,41457,1661,318,476,2455,43912
24-08-2017,22,15779,14077,5960,3282,39099,1656,261,384,2301,41400
24-08-2017,23,15099,12688,5555,2846,36187,1620,234,366,2220,38407
25-08-2017,0,14388,11387,5171,2923,33869,1443,224,81,1748,35617
25-08-2017,1,14210,10957,5059,2833,33059,1344,221,98,1663,34722
25-08-2017,2,14032,10781,5069,2734,32616,1285,220,101,1606,34222
25-08-2017,3,13771,10866,5035,2663,32336,1536,225,136,1897,34233
25-08-2017,4,13878,11206,5061,2691,32837,1570,237,156,1963,34800
25-08-2017,5,14074,12477,5418,2738,34708,1574,262,149,1985,36693
25-08-2017,6,15056,14615,5893,2865,38430,1579,409,123,2111,40541
25-08-2017,7,16475,16819,6270,2987,42551,1571,603,115,2289,44840
25-08-2017,8,16724,17345,6410,3354,43832,1547,909,350,2806,46638
25-08-2017,9,16467,17170,6410,3671,43719,1509,869,383,2761,46480
25-08-2017,10,16577,17060,6407,4035,44078,1416,847,424,2687,46765
25-08-2017,11,16239,16900,6375,4314,43829,1324,755,442,2521,46350
25-08-2017,12,16188,16398,6285,4356,43228,1482,656,404,2542,45770
25-08-2017,13,16052,16323,6195,4119,42689,1511,662,399,2572,45261
25-08-2017,14,16000,16255,6138,4016,42408,1380,784,530,2694,45102
25-08-2017,15,15791,16348,6001,3860,42000,1461,841,489,2791,44791
25-08-2017,16,15924,16125,5863,3569,41481,1490,1038,387,2915,44396
25-08-2017,17,16016,16678,6140,3298,42132,1482,722,384,2588,44720
25-08-2017,18,15906,17081,6355,3048,42388,1478,729,344,2551,44939
25-08-2017,19,15614,17089,6348,2677,41729,1490,809,362,2661,44390
25-08-2017,20,15625,16836,6395,2326,41181,1499,692,360,2551,43732
25-08-2017,21,15722,16242,6323,2341,40628,1485,474,333,2292,42920
25-08-2017,22,15272,15134,5964,2071,38441,1427,272,294,1993,40434
25-08-2017,23,14742,14146,5575,1652,36115,1404,259,249,1912,38027
26-08-2017,0,14578,12558,5476,1349,33962,1235,288,207,1730,35692
26-08-2017,1,14185,11881,5174,1188,32428,1261,284,162,1707,34135
26-08-2017,2,13922,11433,5055,1161,31571,1258,283,120,1661,33232
26-08-2017,3,13832,11236,5077,1060,31206,1241,227,89,1557,32763
26-08-2017,4,13860,11315,5093,1022,31289,1222,226,71,1519,32808
26-08-2017,5,13763,11627,5061,988,31439,1191,483,40,1714,33153
26-08-2017,6,13812,12254,5119,1020,32205,1203,687,34,1924,34129
26-08-2017,7,14410,13245,5274,1042,33971,1148,881,30,2059,36030
26-08-2017,8,15369,15118,5622,1116,37225,1148,835,31,2014,39239
26-08-2017,9,15783,15653,5835,1155,38424,1195,835,60,2090,40514
26-08-2017,10,15773,15764,6000,1378,38916,1241,837,88,2166,41082
26-08-2017,11,15938,15324,5872,1445,38579,1245,835,156,2236,40815
26-08-2017,12,15829,14692,5726,1267,37514,1232,791,166,2189,39703
26-08-2017,13,15606,14146,5745,1159,36656,1236,828,165,2229,38885
26-08-2017,14,15488,13952,5586,1114,36141,1269,813,160,2242,38383
26-08-2017,15,15654,13948,5739,1068,36410,1315,794,150,2259,38669
26-08-2017,16,15494,14092,5853,1004,36442,1326,786,129,2241,38683
26-08-2017,17,15570,14639,6103,1104,37417,1350,885,105,2340,39757
26-08-2017,18,15766,14869,6313,1137,38085,1361,852,81,2294,40379
26-08-2017,19,15660,14764,6346,1098,37870,1313,855,71,2239,40109
26-08-2017,20,15676,14749,6350,1112,37886,1305,852,63,2220,40106
26-08-2017,21,15726,14468,6289,1100,37583,1284,771,52,2107,39690
26-08-2017,22,15279,13785,6091,1130,36285,1269,542,40,1851,38136
26-08-2017,23,14768,12344,5837,1081,34031,1227,429,33,1689,35720
27-08-2017,0,14348,10589,5480,880,31297,1233,365,28,1626,32923
27-08-2017,1,14055,9804,5302,769,29932,1211,291,26,1528,31460
27-08-2017,2,13667,9588,5168,737,29161,1035,291,27,1353,30514
27-08-2017,3,12955,9431,5164,750,28301,1004,295,30,1329,29630
27-08-2017,4,13023,9396,5205,782,28406,1000,280,27,1307,29713
27-08-2017,5,12904,9186,5201,847,28140,1029,401,28,1458,29598
27-08-2017,6,12719,9462,5201,922,28305,1183,583,28,1794,30099
27-08-2017,7,13116,10100,5260,1018,29495,1153,639,32,1824,31319
27-08-2017,8,13761,10968,5405,1187,31321,1122,864,33,2019,33340
27-08-2017,9,14041,12035,5605,1459,33138,1128,802,34,1964,35102
27-08-2017,10,14445,12708,5645,1687,34484,1167,685,44,1896,36380
27-08-2017,11,14643,12514,5582,1923,34662,1130,661,49,1840,36502
27-08-2017,12,14458,12735,5334,1882,34411,1126,665,89,1880,36291
27-08-2017,13,13953,12764,5241,1820,33779,1142,665,85,1892,35671
27-08-2017,14,13882,12438,5167,1777,33267,1178,679,65,1922,35189
27-08-2017,15,13961,12447,5135,1599,33142,1152,740,65,1957,35099
27-08-2017,16,14316,12667,5168,1495,33647,1159,791,44,1994,35641
27-08-2017,17,14990,12882,5293,1459,34623,1185,792,41,2018,36641
27-08-2017,18,15873,13248,5283,1223,35628,1186,801,51,2038,37666
27-08-2017,19,16162,13838,5562,1192,36753,1193,808,78,2079,38832
27-08-2017,20,16165,14340,5900,1090,37495,1201,829,75,2105,39600
27-08-2017,21,16245,14098,5770,1100,37213,1297,791,50,2138,39351
27-08-2017,22,16114,13524,5555,1141,36335,1299,677,66,2042,38377
27-08-2017,23,15521,12606,5347,1076,34548,1271,408,64,1743,36291
28-08-2017,0,15048,11148,5137,1099,32433,1149,566,66,1781,34214
28-08-2017,1,14683,10562,4908,1003,31157,1074,572,63,1709,32866
28-08-2017,2,14044,10660,4939,939,30582,1093,558,66,1717,32299
28-08-2017,3,13860,10573,5060,969,30462,1154,654,68,1876,32338
28-08-2017,4,13892,10652,5089,1035,30668,1319,841,63,2223,32891
28-08-2017,5,14841,11547,5320,1288,32996,1466,853,92,2411,35407
28-08-2017,6,16059,13969,5873,1617,37518,1522,973,142,2637,40155
28-08-2017,7,17215,15987,6366,1993,41563,1530,1349,421,3300,44863
28-08-2017,8,17624,16358,6529,2208,42718,1580,1476,715,3771,46489
28-08-2017,9,17667,16159,6538,2381,42745,1548,1447,817,3812,46557
28-08-2017,10,17758,15997,6498,2447,42701,1546,1426,897,3869,46570
28-08-2017,11,17694,15968,6293,2537,42493,1550,1417,879,3846,46339
28-08-2017,12,17698,16084,6344,2634,42760,1554,1462,850,3866,46626
28-08-2017,13,17692,15999,6298,2757,42746,1552,1129,859,3540,46286
28-08-2017,14,17591,16012,6301,2767,42672,1553,1219,644,3416,46088
28-08-2017,15,17550,15840,6271,2711,42373,1550,1214,479,3243,45616
28-08-2017,16,17595,16016,6196,2602,42410,1548,1097,331,2976,45386
28-08-2017,17,17393,15930,6435,2512,42271,1539,1070,525,3134,45405
28-08-2017,18,17062,16454,6341,2414,42270,1533,1136,727,3396,45666
28-08-2017,19,16993,16386,6268,2230,41878,1529,1232,788,3549,45427
28-08-2017,20,17052,16116,6297,2210,41676,1526,1294,580,3400,45076
28-08-2017,21,16573,15369,6180,2065,40186,1524,1321,316,3161,43347
28-08-2017,22,16265,14278,6015,1820,38378,1464,1017,288,2769,41147
28-08-2017,23,14921,13317,5926,1787,35952,1428,815,33,2276,38228
29-08-2017,0,14205,12125,5986,1835,34151,1168,627,29,1824,35975
29-08-2017,1,13410,11768,6103,1915,33196,1068,580,27,1675,34871
29-08-2017,2,13055,11752,6079,1875,32761,1023,526,26,1575,34336
29-08-2017,3,12766,11745,6159,1903,32575,1005,551,27,1583,34158
29-08-2017,4,12946,11964,6129,1969,33009,1139,648,28,1815,34824
29-08-2017,5,13956,12956,6179,2177,35268,1230,684,30,1944,37212
29-08-2017,6,15646,14677,6447,2506,39276,1328,841,39,2208,41484
29-08-2017,7,16830,16158,6873,2713,42573,1328,1038,45,2411,44984
29-08-2017,8,17264,16455,7371,2913,44004,1328,1101,39,2468,46472
29-08-2017,9,17449,16296,7352,3082,44180,1348,1167,251,2766,46946
29-08-2017,10,17372,16292,7247,3256,44167,1366,1198,437,3001,47168
29-08-2017,11,17414,16119,7313,3555,44402,1370,1210,247,2827,47229
29-08-2017,12,16814,15819,7211,3496,43341,1373,1208,308,2889,46230
29-08-2017,13,16597,15744,7285,3698,43325,1391,1205,64,2660,45985
29-08-2017,14,16582,15558,7124,3731,42995,1392,1189,45,2626,45621
29-08-2017,15,17387,15335,7030,3525,43278,1399,1198,49,2646,45924
29-08-2017,16,17258,15525,6920,3418,43120,1389,1140,51,2580,45700
29-08-2017,17,17305,15951,7071,3280,43608,1381,911,50,2342,45950
29-08-2017,18,17206,16320,7263,3258,44046,1368,961,50,2379,46425
29-08-2017,19,17326,16309,7453,2952,44039,1359,979,58,2396,46435
29-08-2017,20,17275,16186,7261,2698,43420,1362,996,74,2432,45852
29-08-2017,21,16947,15422,6876,2429,41675,1370,931,106,2407,44082
29-08-2017,22,16404,14045,6442,1904,38795,1377,762,149,2288,41083
29-08-2017,23,15447,12632,6118,1758,35953,1285,733,209,2227,38180
30-08-2017,0,14645,11401,5994,1654,33692,1078,636,220,1934,35626
30-08-2017,1,13452,11074,5856,1650,32033,1033,628,231,1892,33925
30-08-2017,2,12702,10961,5866,1511,31041,1035,620,243,1898,32939
30-08-2017,3,12414,10871,5790,1338,30414,1037,614,248,1899,32313
30-08-2017,4,12759,11152,5661,1239,30810,1059,700,241,2000,32810
30-08-2017,5,14494,12386,5807,1284,33971,1261,840,220,2321,36292
30-08-2017,6,16406,14713,6242,1684,39045,1423,963,204,2590,41635
30-08-2017,7,17573,16685,6792,2254,43304,1368,988,156,2512,45816
30-08-2017,8,17830,16759,7141,2367,44096,1412,996,247,2655,46751
30-08-2017,9,17876,16449,7221,2406,43952,1426,878,491,2795,46747
30-08-2017,10,17909,16172,7259,2377,43715,1452,881,546,2879,46594
30-08-2017,11,18088,16190,7197,2260,43736,1450,884,571,2905,46641
30-08-2017,12,17626,16229,7266,2382,43503,1459,844,586,2889,46392
30-08-2017,13,17709,16119,7078,2415,43320,1471,846,591,2908,46228
30-08-2017,14,17337,16059,7037,2469,42903,1473,875,574,2922,45825
30-08-2017,15,17465,15878,7044,2448,42835,1438,870,554,2862,45697
30-08-2017,16,17234,15695,6870,2461,42261,1404,979,429,2812,45073
30-08-2017,17,17325,15776,7085,2534,42718,1376,1012,330,2718,45436
30-08-2017,18,17318,16004,7317,2561,43201,1345,1005,227,2577,45778
30-08-2017,19,17261,15508,7354,2545,42668,1339,997,186,2522,45190
30-08-2017,20,17277,14875,7196,2534,41881,1345,991,257,2593,44474
30-08-2017,21,17017,14243,6849,2219,40327,1346,920,287,2553,42880
30-08-2017,22,15983,12879,6361,1857,37081,1282,808,293,2383,39464
30-08-2017,23,14788,11748,6109,1738,34384,1158,773,298,2229,36613
31-08-2017,0,13154,10901,6077,1696,31828,1115,616,295,2026,33854
31-08-2017,1,11875,10691,5997,1831,30394,1134,618,292,2044,32438
31-08-2017,2,11332,10595,5925,1767,29618,1144,604,292,2040,31658
31-08-2017,3,10621,10460,5920,1842,28844,1144,615,271,2030,30874
31-08-2017,4,10841,10622,5944,1910,29317,1152,623,272,2047,31364
31-08-2017,5,12592,11885,6368,1819,32664,1341,666,291,2298,34962
31-08-2017,6,15846,13767,6771,1804,38189,1512,832,279,2623,40812
31-08-2017,7,17629,15470,7068,2025,42192,1519,972,225,2716,44908
31-08-2017,8,17884,16321,7257,2300,43762,1497,994,214,2705,46467
31-08-2017,9,17966,16147,7273,2338,43726,1435,869,405,2709,46435
31-08-2017,10,17976,16214,7196,2500,43884,1456,886,560,2902,46786
31-08-2017,11,17700,16238,7059,2703,43699,1441,867,640,2948,46647
31-08-2017,12,17738,16205,7087,2653,43683,1295,867,737,2899,46582
31-08-2017,13,17836,16002,7028,2885,43752,1324,884,390,2598,46350
31-08-2017,14,17731,15701,6838,3050,43321,1333,829,345,2507,45828
31-08-2017,15,17659,15537,6799,3079,43072,1327,855,322,2504,45576
31-08-2017,16,17577,15316,6770,3047,42709,1322,971,246,2539,45248
31-08-2017,17,17817,15284,6818,3198,43117,1341,1028,207,2576,45693
31-08-2017,18,17542,15600,6881,3283,43306,1344,1006,171,2521,45827
31-08-2017,19,18175,15666,6793,3239,43871,1316,1001,156,2473,46344
31-08-2017,20,18178,15467,6718,3017,43380,1285,997,156,2438,45818
31-08-2017,21,17605,14309,6538,2716,41168,1280,988,128,2396,43564
31-08-2017,22,16846,13114,6083,2368,38410,1285,828,132,2245,40655
31-08-2017,23,15768,11687,5792,2105,35352,1299,711,139,2149,37501
01-09-2017,0,14990,11101,5746,2065,33902,1282,528,119,1929,35831
01-09-2017,1,12706,10780,5776,2000,31262,1276,454,136,1866,33128
01-09-2017,2,11658,10587,5790,1856,29889,1267,433,172,1872,31761
01-09-2017,3,11296,10527,5802,1704,29330,1268,438,154,1860,31190
01-09-2017,4,11826,10980,5931,1565,30302,1270,445,164,1879,32181
01-09-2017,5,14241,12076,6118,1575,34011,1340,681,147,2168,36179
01-09-2017,6,16362,14411,6732,1788,39294,1311,884,114,2309,41603
01-09-2017,7,17860,15679,7182,2327,43048,1320,963,89,2372,45420
01-09-2017,8,18211,16256,7441,2594,44503,1342,971,135,2448,46951
01-09-2017,9,18202,16117,7551,2692,44565,1339,858,349,2546,47111
01-09-2017,10,18097,15832,7446,2656,44033,1301,827,520,2648,46681
01-09-2017,11,18205,15706,7435,2636,43981,1217,803,505,2525,46506
01-09-2017,12,18152,15481,7354,2660,43646,1219,797,289,2305,45951
01-09-2017,13,17716,15430,7083,2435,42665,1201,780,96,2077,44742
01-09-2017,14,17420,14846,6873,2315,41453,1185,752,92,2029,43482
01-09-2017,15,17232,14772,6919,2315,41241,1168,766,95,2029,43270
01-09-2017,16,17309,14568,6929,2153,40959,1126,892,94,2112,43071
01-09-2017,17,17369,14689,6952,2045,41055,1077,872,95,2044,43099
01-09-2017,18,17381,15178,6872,2127,41558,1062,769,120,1951,43509
01-09-2017,19,17343,15305,6896,2097,41642,1056,795,104,1955,43597
01-09-2017,20,17589,15028,6571,2030,41218,1056,786,109,1951,43169
01-09-2017,21,17278,14241,6297,1883,39700,1053,790,97,1940,41640
01-09-2017,22,16726,13167,6122,1637,37652,1050,728,104,1882,39534
01-09-2017,23,16021,11884,6114,1397,35416,1038,461,143,1642,37058
02-09-2017,0,15145,10958,5972,919,32994,877,426,144,1447,34441
02-09-2017,1,14189,10501,5816,793,31298,893,344,198,1435,32733
02-09-2017,2,13060,10161,5707,800,29728,895,288,181,1364,31092
02-09-2017,3,12818,10042,5703,811,29373,898,292,135,1325,30698
02-09-2017,4,12786,9958,5699,851,29292,890,346,129,1365,30657
02-09-2017,5,12940,10045,5691,804,29480,888,445,161,1494,30974
02-09-2017,6,13519,10156,5748,839,30262,886,623,168,1677,31939
02-09-2017,7,14812,11489,5888,908,33098,853,688,178,1719,34817
02-09-2017,8,16271,13628,6146,1205,37251,872,707,180,1759,39010
02-09-2017,9,16702,14593,6166,1414,38875,874,720,165,1759,40634
02-09-2017,10,17001,14612,6052,1521,39187,881,680,122,1683,40870
02-09-2017,11,16952,14525,5993,1555,39026,876,687,115,1678,40704
02-09-2017,12,16737,13967,5759,1538,38001,877,693,119,1689,39690
02-09-2017,13,16414,13460,5549,1359,36781,877,705,111,1693,38474
02-09-2017,14,15700,13230,5480,1310,35720,883,710,90,1683,37403
02-09-2017,15,15314,13148,5356,1276,35095,887,655,88,1630,36725
02-09-2017,16,15622,12983,5332,1286,35222,903,686,90,1679,36901
02-09-2017,17,16362,13551,5453,1275,36642,936,699,81,1716,38358
02-09-2017,18,16096,14040,5639,1310,37082,945,706,88,1739,38821
02-09-2017,19,16290,14376,5775,1309,37751,914,742,94,1750,39501
02-09-2017,20,16382,14609,5971,1180,38143,935,722,87,1744,39887
02-09-2017,21,16235,14553,6028,1127,37944,938,709,83,1730,39674
02-09-2017,22,15768,13110,5733,961,35572,921,617,84,1622,37194
02-09-2017,23,15376,10923,5417,707,32422,932,507,96,1535,33957
03-09-2017,0,14985,9935,5330,628,30879,882,321,87,1290,32169
03-09-2017,1,13434,9582,5289,637,28942,906,265,89,1260,30202
03-09-2017,2,12775,9339,5251,678,28045,908,264,84,1256,29301
03-09-2017,3,12821,9432,5281,687,28220,899,268,69,1236,29456
03-09-2017,4,12985,9479,5310,637,28410,899,313,62,1274,29684
03-09-2017,5,13199,9330,5314,646,28487,893,435,59,1387,29874
03-09-2017,6,13325,9398,5419,639,28781,928,579,63,1570,30351
03-09-2017,7,14025,9700,5583,778,30087,952,624,68,1644,31731
03-09-2017,8,14554,10736,5703,961,31956,919,623,70,1612,33568
03-09-2017,9,15095,11667,5853,1066,33681,852,742,76,1670,35351
03-09-2017,10,15463,12387,5875,1199,34924,873,696,83,1652,36576
03-09-2017,11,15368,12768,5749,1275,35161,888,695,76,1659,36820
03-09-2017,12,15226,12815,5662,1306,35010,909,691,78,1678,36688
03-09-2017,13,15053,12669,5614,1304,34640,912,690,76,1678,36318
03-09-2017,14,14938,12448,5484,1319,34188,926,632,70,1628,35816
03-09-2017,15,14911,12493,5461,1195,34060,933,622,72,1627,35687
03-09-2017,16,14934,12515,5527,1142,34118,953,676,74,1703,35821
03-09-2017,17,15394,12878,5415,1140,34828,964,614,69,1647,36475
03-09-2017,18,16050,13869,5543,1221,36682,953,612,72,1637,38319
03-09-2017,19,16353,14689,5881,1220,38144,957,616,79,1652,39796
03-09-2017,20,16586,14968,6149,1285,38989,969,614,85,1668,40657
03-09-2017,21,16441,14566,6129,1261,38397,969,613,74,1656,40053
03-09-2017,22,15991,13624,6026,1233,36875,983,552,66,1601,38476
03-09-2017,23,15176,12113,5693,936,33918,1003,441,63,1507,35425
04-09-2017,0,14154,10737,5426,871,31189,999,222,85,1306,32495
04-09-2017,1,12666,10358,5390,833,29247,1024,212,80,1316,30563
04-09-2017,2,11882,10347,5349,787,28363,1030,217,66,1313,29676
04-09-2017,3,11798,10409,5368,879,28454,1001,221,78,1300,29754
04-09-2017,4,12648,10659,5455,997,29758,1009,237,79,1325,31083
04-09-2017,5,13888,12164,5574,1232,32857,1085,414,79,1578,34435
04-09-2017,6,15634,15375,6083,1800,38892,1108,760,93,1961,40853
04-09-2017,7,16907,16765,6477,2352,42503,1120,955,334,2409,44912
04-09-2017,8,17362,16867,6684,2572,43486,1133,1025,593,2751,46237
04-09-2017,9,17601,16854,6625,2708,43789,1114,879,589,2582,46371
04-09-2017,10,17493,16958,6644,2826,43922,1107,860,612,2579,46501
04-09-2017,11,17324,16871,6717,2887,43799,1101,902,617,2620,46419
04-09-2017,12,17219,16661,6683,2754,43317,1091,904,647,2642,45959
04-09-2017,13,16927,16218,6457,2489,42091,1085,896,625,2606,44697
04-09-2017,14,17168,15778,6387,2309,41644,1098,891,393,2382,44026
04-09-2017,15,17463,15855,6493,2517,42329,1112,846,250,2208,44537
04-09-2017,16,17403,15975,6593,2484,42455,1102,872,196,2170,44625
04-09-2017,17,17412,15938,6690,2357,42397,1109,924,181,2214,44611
04-09-2017,18,17286,16347,6822,2264,42720,1104,963,189,2256,44976
04-09-2017,19,17240,16204,6975,2147,42566,1096,845,337,2278,44844
04-09-2017,20,17289,15813,6819,2028,41950,1125,767,516,2408,44358
04-09-2017,21,16826,14957,6732,1864,40378,1123,757,182,2062,42440
04-09-2017,22,16184,13759,6557,1615,38117,1099,710,158,1967,40084
04-09-2017,23,15126,12102,6303,985,34516,1006,365,128,1499,36015
05-09-2017,0,14712,11266,6280,932,33191,1010,358,120,1488,34679
05-09-2017,1,13372,10854,6170,883,31280,998,257,154,1409,32689
05-09-2017,2,12909,10698,6060,874,30542,1001,276,230,1507,32049
05-09-2017,3,13041,10605,6287,877,30809,936,278,258,1472,32281
05-09-2017,4,13294,10958,6211,945,31408,965,484,255,1704,33112
05-09-2017,5,14178,12109,6302,1063,33653,1026,841,253,2120,35773
05-09-2017,6,15932,14820,6734,1713,39199,1051,987,268,2306,41505
05-09-2017,7,16982,16164,6714,2135,41993,1123,1075,782,2980,44973
05-09-2017,8,17239,16111,6636,2394,42379,1156,1435,862,3453,45832
05-09-2017,9,17334,16033,6554,2434,42355,1187,1232,820,3239,45594
05-09-2017,10,17291,16059,6624,2580,42554,1213,1300,800,3313,45867
05-09-2017,11,17180,15756,6510,2608,42054,1209,1504,747,3460,45514
05-09-2017,12,17064,15750,6491,2557,41862,1215,1495,762,3472,45334
05-09-2017,13,17342,15752,6349,2650,42092,1188,840,595,2623,44715
05-09-2017,14,17139,15758,6224,2653,41774,1205,827,492,2524,44298
05-09-2017,15,17091,15848,6180,2780,41898,1206,814,502,2522,44420
05-09-2017,16,17216,15703,6390,2910,42218,1203,915,609,2727,44945
05-09-2017,17,17145,15670,6591,2911,42317,1180,945,519,2644,44961
05-09-2017,18,17359,15806,6593,2737,42496,1144,923,539,2606,45102
05-09-2017,19,17271,15812,6842,2723,42649,1114,932,618,2664,45313
05-09-2017,20,17153,15687,6885,2708,42433,1126,909,496,2531,44964
05-09-2017,21,16863,14788,6605,2427,40685,1084,743,476,2303,42988
05-09-2017,22,16637,13661,6414,2179,38891,1036,641,275,1952,40843
05-09-2017,23,15131,12249,6107,1834,35321,1046,466,267,1779,37100
06-09-2017,0,14365,11397,5939,1671,33373,968,359,284,1611,34984
06-09-2017,1,13675,11148,5797,1626,32246,996,350,275,1621,33867
06-09-2017,2,13082,11117,5836,1448,31482,996,346,283,1625,33107
06-09-2017,3,13212,11064,5984,1357,31618,980,358,292,1630,33248
06-09-2017,4,13687,11387,6150,1186,32410,1000,376,295,1671,34081
06-09-2017,5,14606,12475,6209,1171,34461,1073,606,303,1982,36443
06-09-2017,6,16269,15117,6792,1719,39897,1098,808,287,2193,42090
06-09-2017,7,17048,16460,7056,1941,42506,1151,928,512,2591,45097
06-09-2017,8,17410,16523,7021,2103,43058,1141,1036,902,3079,46137
06-09-2017,9,17338,16500,6946,2151,42936,1152,1219,933,3304,46240
06-09-2017,10,17292,16481,6954,2178,42904,1174,1220,944,3338,46242
06-09-2017,11,17255,16414,6975,2397,43041,1181,1213,929,3323,46364
06-09-2017,12,17262,16337,6965,2283,42848,1182,1182,919,3283,46131
06-09-2017,13,17445,16073,6872,2156,42546,1206,841,664,2711,45257
06-09-2017,14,17575,15759,6877,2171,42380,1240,799,448,2487,44867
06-09-2017,15,17203,15917,6729,2208,42057,1231,753,447,2431,44488
06-09-2017,16,17021,16153,6841,2268,42282,1274,887,453,2614,44896
06-09-2017,17,17099,16277,6925,2286,42587,1281,897,329,2507,45094
06-09-2017,18,16782,16288,6852,2510,42431,1269,909,301,2479,44910
06-09-2017,19,17109,16157,6859,2863,42988,1247,871,397,2515,45503
06-09-2017,20,16497,16112,6876,3031,42516,1240,877,283,2400,44916
06-09-2017,21,15756,15230,6642,3032,40659,1210,867,259,2336,42995
06-09-2017,22,14533,13248,6281,3025,37085,1142,723,254,2119,39204
06-09-2017,23,13373,11920,5969,3111,34373,1132,429,239,1800,36173
07-09-2017,0,12528,11159,5990,3219,32896,856,344,240,1440,34336
07-09-2017,1,12177,10722,5914,3246,32060,821,340,229,1390,33450
07-09-2017,2,11853,10636,5879,3146,31514,816,344,231,1391,32905
07-09-2017,3,11882,10578,5953,2983,31396,826,401,231,1458,32854
07-09-2017,4,12030,10994,6003,2943,31970,883,411,243,1537,33507
07-09-2017,5,12809,11930,6231,2936,33905,1131,653,253,2037,35942
07-09-2017,6,14955,14445,6813,3317,39530,1251,787,243,2281,41811
07-09-2017,7,16769,15829,7254,3489,43341,1230,988,285,2503,45844
07-09-2017,8,17492,16033,7219,3322,44065,1225,998,883,3106,47171
07-09-2017,9,17525,15798,7122,3196,43641,1215,895,921,3031,46672
07-09-2017,10,17580,15425,7183,3179,43366,1221,882,923,3026,46392
07-09-2017,11,17532,14903,7278,3183,42897,1225,928,921,3074,45971
07-09-2017,12,17458,15008,7280,3151,42898,1227,934,907,3068,45966
07-09-2017,13,17481,14980,7207,3082,42751,1223,901,363,2487,45238
07-09-2017,14,17501,14932,6996,2905,42335,1221,791,394,2406,44741
07-09-2017,15,17433,15234,7031,2864,42562,1223,778,554,2555,45117
07-09-2017,16,17458,15142,7173,2776,42549,1229,887,694,2810,45359
07-09-2017,17,17501,15539,7206,2527,42775,1212,888,469,2569,45344
07-09-2017,18,17481,15550,7303,2350,42684,1215,888,492,2595,45279
07-09-2017,19,17494,15584,7460,2197,42736,1212,881,924,3017,45753
07-09-2017,20,17216,15537,7534,2284,42572,1209,880,603,2692,45264
07-09-2017,21,17124,14881,7292,2340,41637,1207,742,273,2222,43859
07-09-2017,22,16683,13593,7024,2091,39390,1208,724,231,2163,41553
07-09-2017,23,16029,11733,6725,1577,36064,1206,488,217,1911,37975
08-09-2017,0,14957,10638,6572,1301,33469,947,343,48,1338,34807
08-09-2017,1,13702,10536,6422,1398,32058,938,338,44,1320,33378
08-09-2017,2,13077,10551,6333,1289,31251,937,344,47,1328,32579
08-09-2017,3,12972,10652,6392,1378,31394,940,348,63,1351,32745
08-09-2017,4,12977,10982,6447,1690,32096,936,359,85,1380,33476
08-09-2017,5,14030,12164,6590,1883,34667,1026,500,104,1630,36297
08-09-2017,6,15656,14360,6942,2177,39136,1228,627,125,1980,41116
08-09-2017,7,17120,16100,7243,2468,42932,1330,903,121,2354,45286
08-09-2017,8,17317,15990,7296,2952,43555,1343,997,505,2845,46400
08-09-2017,9,17388,15705,7216,2945,43255,1345,1108,491,2944,46199
08-09-2017,10,17274,15865,7074,3167,43380,1347,1190,494,3031,46411
08-09-2017,11,17140,16183,7050,3283,43656,1355,1181,464,3000,46656
08-09-2017,12,16917,16219,7095,3239,43469,1353,1008,469,2830,46299
08-09-2017,13,16544,15985,7004,3292,42827,1355,1001,150,2506,45333
08-09-2017,14,16189,16151,6773,3519,42631,1357,954,117,2428,45059
08-09-2017,15,15909,16141,6729,3627,42404,1365,946,122,2433,44837
08-09-2017,16,16567,16168,6761,3577,43072,1361,1015,131,2507,45579
08-09-2017,17,17417,16156,6797,3476,43844,1350,997,125,2472,46316
08-09-2017,18,17531,16176,6812,3388,43907,1348,932,143,2423,46330
08-09-2017,19,17835,16234,6866,3096,44031,1358,848,210,2416,46447
08-09-2017,20,17831,16116,6677,2726,43350,1370,751,244,2365,45715
08-09-2017,21,17313,15299,6419,2215,41246,1401,748,261,2410,43656
08-09-2017,22,15649,13953,6130,1793,37525,1243,686,233,2162,39687
08-09-2017,23,14416,12713,5839,1638,34607,1228,452,234,1914,36521
09-09-2017,0,13809,11766,5965,1553,33093,899,258,253,1410,34503
09-09-2017,1,13074,11250,5911,1502,31738,837,254,231,1322,33060
09-09-2017,2,12719,11059,5868,1462,31108,850,259,224,1333,32441
09-09-2017,3,12720,10932,5850,1396,30898,836,261,230,1327,32225
09-09-2017,4,12709,11041,5887,1406,31043,849,280,221,1350,32393
09-09-2017,5,12691,11384,5927,1279,31282,855,375,235,1465,32747
09-09-2017,6,13045,12567,5936,1134,32682,869,382,237,1488,34170
09-09-2017,7,14415,13608,6167,1090,35280,941,504,200,1645,36925
09-09-2017,8,15776,15223,6272,1279,38550,952,698,177,1827,40377
09-09-2017,9,16211,16169,6345,1609,40334,967,700,144,1811,42145
09-09-2017,10,16634,16323,6465,1667,41089,952,690,147,1789,42878
09-09-2017,11,16653,16454,6469,1672,41248,943,547,148,1638,42886
09-09-2017,12,16339,16474,6443,1502,40758,928,549,174,1651,42409
09-09-2017,13,16276,16044,6396,1344,40059,912,545,169,1626,41685
09-09-2017,14,15659,15863,6443,1339,39304,900,545,165,1610,40914
09-09-2017,15,15350,16220,6330,1322,39221,866,542,163,1571,40792
09-09-2017,16,15997,16414,6400,1445,40254,859,541,206,1606,41860
09-09-2017,17,15879,16370,6453,1553,40255,874,541,137,1552,41807
09-09-2017,18,16071,16252,6481,1925,40730,886,547,183,1616,42346
09-09-2017,19,16161,15973,6725,1791,40650,902,552,263,1717,42367
09-09-2017,20,16174,15808,6631,1630,40242,890,571,324,1785,42027
09-09-2017,21,15996,15186,6481,1631,39295,911,567,298,1776,41071
09-09-2017,22,15445,14697,6460,1652,38254,875,460,299,1634,39888
09-09-2017,23,15040,13505,6303,1599,36447,880,360,269,1509,37956
10-09-2017,0,14659,11454,6291,1115,33520,855,312,247,1414,34934
10-09-2017,1,12901,10874,6148,1104,31026,856,305,215,1376,32402
10-09-2017,2,11822,10568,6190,1095,29675,839,307,186,1332,31007
10-09-2017,3,11039,10424,6196,1132,28791,832,308,122,1262,30053
10-09-2017,4,10954,10360,6210,1268,28792,871,320,103,1294,30086
10-09-2017,5,11051,10341,6432,1307,29131,894,408,88,1390,30521
10-09-2017,6,11194,10879,6494,1369,29936,848,478,79,1405,31341
10-09-2017,7,11541,11463,6598,1577,31179,833,481,66,1380,32559
10-09-2017,8,13123,12620,6860,1871,34475,821,520,52,1393,35868
10-09-2017,9,14073,13477,6935,2091,36577,795,609,60,1464,38041
10-09-2017,10,13704,14015,6951,2499,37169,780,662,60,1502,38671
10-09-2017,11,13296,14032,6999,3105,37433,771,664,53,1488,38921
10-09-2017,12,12864,13793,7022,3221,36900,765,645,57,1467,38367
10-09-2017,13,12411,13745,6996,3420,36571,764,569,59,1392,37963
10-09-2017,14,12235,13381,6930,3369,35916,763,556,61,1380,37296
10-09-2017,15,12072,13908,6871,3561,36412,752,580,60,1392,37804
10-09-2017,16,12364,13962,6826,3361,36513,760,634,79,1473,37986
10-09-2017,17,13162,14559,6865,3320,37906,751,652,79,1482,39388
10-09-2017,18,13809,15215,6811,3006,38842,766,630,71,1467,40309
10-09-2017,19,14623,15953,6839,2759,40174,817,586,82,1485,41659
10-09-2017,20,14305,15741,6748,3030,39826,804,557,91,1452,41278
10-09-2017,21,13258,14844,6620,3132,37855,775,526,78,1379,39234
10-09-2017,22,12357,13640,6506,3149,35651,764,488,65,1317,36968
10-09-2017,23,11282,12992,6203,3555,34033,741,480,48,1269,35302
11-09-2017,0,10530,12222,5968,3528,32249,771,305,48,1124,33373
11-09-2017,1,9722,11912,5797,3419,30849,782,301,48,1131,31980
11-09-2017,2,9617,11835,5689,3532,30674,782,302,53,1137,31811
11-09-2017,3,9598,11805,5751,3613,30768,796,315,57,1168,31936
11-09-2017,4,10163,11998,5779,3715,31654,830,411,75,1316,32970
11-09-2017,5,10963,13223,5927,4168,34281,923,570,77,1570,35851
11-09-2017,6,13060,15302,6440,4147,38951,920,705,234,1859,40810
11-09-2017,7,15326,17183,6511,4134,43155,915,798,353,2066,45221
11-09-2017,8,16283,17821,6564,4131,44801,915,849,489,2253,47054
11-09-2017,9,16422,18047,6454,4080,45002,921,899,580,2400,47402
11-09-2017,10,16409,18050,6513,3898,44869,920,900,572,2392,47261
11-09-2017,11,16212,18144,6511,3812,44680,931,852,492,2275,46955
11-09-2017,12,15922,17627,6414,3963,43926,924,849,539,2312,46238
11-09-2017,13,15757,17797,6355,4002,43911,933,850,272,2055,45966
11-09-2017,14,15334,17853,6246,4105,43539,947,827,222,1996,45535
11-09-2017,15,15186,17817,6167,4055,43224,980,788,226,1994,45218
11-09-2017,16,15079,17700,6261,4076,43116,961,791,232,1984,45100
11-09-2017,17,15669,17649,6248,4017,43582,1007,798,235,2040,45622
11-09-2017,18,15691,17773,6549,3749,43762,946,795,249,1990,45752
11-09-2017,19,15995,17344,6737,3658,43734,947,846,449,2242,45976
11-09-2017,20,15389,17521,6708,3832,43450,968,842,247,2057,45507
11-09-2017,21,14935,16129,6510,3487,41060,972,747,227,1946,43006
11-09-2017,22,13646,14514,6189,3377,37725,970,678,225,1873,39598
11-09-2017,23,12388,13536,5916,3421,35263,953,447,220,1620,36883
12-09-2017,0,11831,12582,5846,3521,33780,871,391,234,1496,35276
12-09-2017,1,11398,12488,5852,3515,33253,861,386,229,1476,34729
12-09-2017,2,10671,12338,5830,3416,32256,870,390,211,1471,33727
12-09-2017,3,10645,12286,5697,3280,31908,874,393,208,1475,33383
12-09-2017,4,11262,12792,5833,3224,33110,886,403,206,1495,34605
12-09-2017,5,12221,13871,6065,3164,35321,969,571,222,1762,37083
12-09-2017,6,14424,16177,6414,3366,40382,1029,705,217,1951,42333
12-09-2017,7,16361,18042,6658,3526,44585,1085,766,221,2072,46657
12-09-2017,8,17325,18276,6716,3651,45968,1102,761,645,2508,48476
12-09-2017,9,17266,18156,6818,3687,45928,1114,873,629,2616,48544
12-09-2017,10,17226,18093,6813,3903,46036,1099,882,635,2616,48652
12-09-2017,11,16608,18217,6684,4135,45643,1112,872,630,2614,48257
12-09-2017,12,16242,18156,6599,4342,45338,1114,916,625,2655,47993
12-09-2017,13,16088,17324,6485,4355,44252,1088,924,457,2469,46721
12-09-2017,14,15476,17399,6438,4295,43607,1085,945,344,2374,45981
12-09-2017,15,15535,17384,6279,4312,43511,1074,935,391,2400,45911
12-09-2017,16,16080,17706,6331,3877,43995,1058,789,329,2176,46171
12-09-2017,17,16373,18103,6344,3661,44481,1054,744,556,2354,46835
12-09-2017,18,16567,17747,6338,3359,44012,1051,755,578,2384,46396
12-09-2017,19,16991,17707,6475,3056,44229,1052,757,617,2426,46655
12-09-2017,20,16972,17753,6310,2998,44031,1059,755,277,2091,46122
12-09-2017,21,16309,16258,6247,2891,41704,1059,738,183,1980,43684
12-09-2017,22,15117,14793,6006,2830,38746,1060,692,161,1913,40659
12-09-2017,23,13496,13740,5834,2658,35727,952,460,163,1575,37302
13-09-2017,0,12856,12342,5659,2482,33338,911,443,177,1531,34869
13-09-2017,1,11237,11940,5522,2360,31059,905,386,202,1493,32552
13-09-2017,2,10576,11755,5502,2321,30154,895,386,212,1493,31647
13-09-2017,3,10271,11700,5454,2403,29828,898,390,242,1530,31358
13-09-2017,4,10635,11894,5650,2455,30633,904,412,256,1572,32205
13-09-2017,5,11875,13170,5961,2630,33635,925,600,255,1780,35415
13-09-2017,6,13661,15616,6153,2982,38411,957,693,258,1908,40319
13-09-2017,7,15443,16992,6386,3738,42560,960,783,480,2223,44783
13-09-2017,8,16238,16997,6301,3796,43332,957,844,784,2585,45917
13-09-2017,9,16185,17560,6225,3949,43919,957,887,736,2580,46499
13-09-2017,10,15891,17647,6237,4326,44102,938,890,704,2532,46634
13-09-2017,11,15231,17485,6343,4197,43257,930,892,753,2575,45832
13-09-2017,12,15229,17236,6317,4217,43000,932,891,717,2540,45540
13-09-2017,13,15332,17268,6207,3940,42748,926,866,391,2183,44931
13-09-2017,14,15358,17308,6172,3660,42498,930,864,419,2213,44711
13-09-2017,15,15339,17644,6171,3510,42665,897,914,479,2290,44955
13-09-2017,16,15558,17824,6190,3351,42923,896,907,447,2250,45173
13-09-2017,17,15748,17931,6278,2992,42947,908,822,361,2091,45038
13-09-2017,18,15824,18153,6318,2738,43034,910,814,616,2340,45374
13-09-2017,19,16024,18033,6457,2891,43406,910,824,855,2589,45995
13-09-2017,20,15565,17912,6468,3080,43024,921,827,577,2325,45349
13-09-2017,21,15241,16615,6202,3046,41105,925,785,525,2235,43340
13-09-2017,22,14011,14983,5910,2904,37808,938,663,396,1997,39805
13-09-2017,23,13023,13858,5731,2778,35390,955,468,397,1820,37210
14-09-2017,0,12274,12246,5651,2713,32884,921,461,403,1785,34669
14-09-2017,1,12268,11788,5632,2598,32285,913,409,428,1750,34035
14-09-2017,2,12433,11745,5582,2302,32062,900,425,424,1749,33811
14-09-2017,3,12370,11960,5573,2208,32113,916,435,429,1780,33893
14-09-2017,4,12560,12209,5681,2086,32536,923,442,431,1796,34332
14-09-2017,5,13436,13277,5914,1962,34589,939,659,428,2026,36615
14-09-2017,6,15431,15552,6228,2015,39225,946,798,426,2170,41395
14-09-2017,7,17544,17123,6387,2595,43650,953,951,757,2661,46311
14-09-2017,8,18272,17938,6472,2793,45474,955,942,872,2769,48243
14-09-2017,9,18226,17692,6408,2774,45100,961,931,874,2766,47866
14-09-2017,10,18067,17746,6407,2637,44857,959,931,873,2763,47620
14-09-2017,11,17753,17707,6391,2602,44453,976,931,793,2700,47153
14-09-2017,12,17062,17337,6407,2264,43070,976,928,857,2761,45831
14-09-2017,13,16488,16983,6276,2282,42028,998,932,614,2544,44572
14-09-2017,14,16338,16885,6363,2411,41998,1026,940,533,2499,44497
14-09-2017,15,15976,17039,6285,2541,41843,1021,942,391,2354,44197
14-09-2017,16,16054,16771,6270,2560,41655,1022,936,543,2501,44156
14-09-2017,17,16262,16693,6312,2512,41778,1021,940,572,2533,44311
14-09-2017,18,16712,16861,6429,2769,42772,1016,941,585,2542,45314
14-09-2017,19,17102,17156,6679,2801,43742,1021,947,809,2777,46519
14-09-2017,20,16886,17007,6608,2948,43449,1034,896,427,2357,45806
14-09-2017,21,15694,15463,6496,2635,40288,1019,799,424,2242,42530
14-09-2017,22,14458,14138,6167,2558,37321,997,765,422,2184,39505
14-09-2017,23,13038,13253,5951,2582,34825,978,467,395,1840,36665
15-09-2017,0,12058,11950,5857,2788,32654,927,545,422,1894,34548
15-09-2017,1,11777,11441,5830,2817,31867,909,486,417,1812,33679
15-09-2017,2,11623,11382,5783,2894,31683,902,488,397,1787,33470
15-09-2017,3,11701,11421,5775,2763,31660,923,500,388,1811,33471
15-09-2017,4,11877,11615,5874,2745,32112,902,554,399,1855,33967
15-09-2017,5,12864,12911,6067,2853,34697,932,818,418,2168,36865
15-09-2017,6,15239,15723,6313,3324,40600,928,906,405,2239,42839
15-09-2017,7,17374,17323,6551,3251,44500,919,1000,433,2352,46852
15-09-2017,8,17958,17900,6651,3162,45671,901,1005,590,2496,48167
15-09-2017,9,17770,17834,6578,3343,45526,901,1001,623,2525,48051
15-09-2017,10,17681,17726,6626,3322,45355,898,1011,535,2444,47799
15-09-2017,11,17415,17543,6544,3306,44809,910,1017,425,2352,47161
15-09-2017,12,17316,17175,6540,3106,44137,909,981,518,2408,46545
15-09-2017,13,17310,16589,6319,2882,43100,915,1005,396,2316,45416
15-09-2017,14,17108,16468,6253,2620,42450,928,1013,402,2343,44793
15-09-2017,15,16818,16547,6241,2677,42284,927,1007,368,2302,44586
15-09-2017,16,16689,16739,6274,2771,42473,926,1042,387,2355,44828
15-09-2017,17,16537,17069,6373,3088,43065,943,1016,544,2503,45568
15-09-2017,18,16548,16996,6447,3220,43210,940,909,531,2380,45590
15-09-2017,19,16924,17119,6537,3004,43585,957,946,727,2630,46215
15-09-2017,20,16925,17177,6281,2798,43181,998,949,346,2293,45474
15-09-2017,21,16485,16751,6022,2485,41742,1026,951,320,2297,44039
15-09-2017,22,15736,15450,5780,2179,39146,1023,936,300,2259,41405
15-09-2017,23,14941,14480,5799,1493,36713,1078,536,270,1884,38597
16-09-2017,0,14942,13451,5877,1286,35556,1030,437,238,1705,37261
16-09-2017,1,14694,12890,5877,1305,34766,1042,437,246,1725,36491
16-09-2017,2,14100,12667,5806,1217,33789,1044,438,250,1732,35521
16-09-2017,3,13793,12533,5782,1172,33279,1052,446,203,1701,34980
16-09-2017,4,13910,12487,5815,1100,33313,1080,453,219,1752,35065
16-09-2017,5,14283,12815,5879,1039,34016,1160,570,217,1947,35963
16-09-2017,6,14699,13500,5945,1123,35267,1173,616,213,2002,37269
16-09-2017,7,15505,14440,6038,1312,37295,1171,743,183,2097,39392
16-09-2017,8,16082,15481,6196,1841,39601,1156,836,143,2135,41736
16-09-2017,9,16626,16117,6236,1924,40904,1146,690,161,1997,42901
16-09-2017,10,16753,16808,6173,1983,41718,1177,683,152,2012,43730
16-09-2017,11,16643,16412,6224,2042,41320,1169,674,175,2018,43338
16-09-2017,12,16588,16239,6131,2014,40970,1183,673,188,2044,43014
16-09-2017,13,16100,15916,6170,1752,39939,1178,669,129,1976,41915
16-09-2017,14,15821,15304,6093,1495,38711,1146,670,122,1938,40649
16-09-2017,15,16042,15165,6079,1463,38749,1165,682,92,1939,40688
16-09-2017,16,16166,15566,6077,1551,39360,1157,888,71,2116,41476
16-09-2017,17,16290,16184,6101,1867,40443,1146,949,54,2149,42592
16-09-2017,18,16265,16476,6069,1933,40743,1132,955,76,2163,42906
16-09-2017,19,16615,16592,6189,1917,41314,1122,952,302,2376,43690
16-09-2017,20,16352,17038,6207,1946,41542,1130,898,314,2342,43884
16-09-2017,21,16095,15924,6132,1840,39991,1129,794,131,2054,42045
16-09-2017,22,15754,14754,5992,1749,38249,1134,689,111,1934,40183
16-09-2017,23,15301,13820,5733,1153,36007,1130,522,91,1743,37750
17-09-2017,0,15122,12410,5631,911,34073,984,390,64,1438,35511
17-09-2017,1,13975,11692,5543,713,31924,988,388,49,1425,33349
17-09-2017,2,13704,11458,5512,686,31361,988,386,43,1417,32778
17-09-2017,3,12931,11482,5467,683,30564,980,387,56,1423,31987
17-09-2017,4,12586,11544,5468,696,30294,973,391,80,1444,31738
17-09-2017,5,12858,11782,5559,802,31002,970,462,81,1513,32515
17-09-2017,6,13309,12206,5659,879,32053,970,556,72,1598,33651
17-09-2017,7,13720,12925,5674,921,33241,967,635,70,1672,34913
17-09-2017,8,15078,13967,5902,1078,36026,982,683,85,1750,37776
17-09-2017,9,15931,14904,5973,1206,38015,980,694,91,1765,39780
17-09-2017,10,15796,15455,6049,1242,38542,978,726,53,1757,40299
17-09-2017,11,16179,15475,6070,1312,39036,976,709,75,1760,40796
17-09-2017,12,15716,15383,6038,1253,38391,978,706,52,1736,40127
17-09-2017,13,15065,15162,5979,1263,37468,982,707,55,1744,39212
17-09-2017,14,14732,15034,5970,1233,36970,938,711,43,1692,38662
17-09-2017,15,14770,15017,5955,1222,36966,701,713,251,1665,38631
17-09-2017,16,15197,15183,5953,1276,37608,699,765,194,1658,39266
17-09-2017,17,15870,15565,5971,1412,38818,724,819,75,1618,40436
17-09-2017,18,16445,16417,6118,1907,40888,788,891,84,1763,42651
17-09-2017,19,16681,16667,6294,1905,41549,800,1241,491,2532,44081
17-09-2017,20,16789,16648,6223,1880,41542,816,1158,462,2436,43978
17-09-2017,21,16557,16013,6099,1793,40461,846,867,109,1822,42283
17-09-2017,22,16256,14912,6069,1579,38817,894,675,101,1670,40487
17-09-2017,23,15259,13839,5960,1159,36217,935,476,118,1529,37746
18-09-2017,0,14738,12592,5996,1123,34450,1068,435,155,1658,36108
18-09-2017,1,14222,12195,5978,982,33378,1114,427,189,1730,35108
18-09-2017,2,13591,12170,5998,954,32713,1167,440,254,1861,34574
18-09-2017,3,13053,12120,6042,983,32198,1215,466,296,1977,34175
18-09-2017,4,13089,12321,6113,1049,32574,1314,548,332,2194,34768
18-09-2017,5,14410,13332,6318,1214,35274,1385,640,350,2375,37649
18-09-2017,6,16361,16060,6620,1828,40869,1411,783,378,2572,43441
18-09-2017,7,17492,17532,6862,2218,44105,1418,997,743,3158,47263
18-09-2017,8,17691,17733,7029,2527,44979,1428,1428,804,3660,48639
18-09-2017,9,17589,17661,7076,2585,44910,1433,1338,799,3570,48480
18-09-2017,10,17415,17378,7055,2585,44432,1464,1452,791,3707,48139
18-09-2017,11,17133,17430,7110,2589,44263,1483,1164,787,3434,47697
18-09-2017,12,17068,17612,7170,2486,44335,1489,1070,572,3131,47466
18-09-2017,13,16870,17535,7097,2395,43897,1503,949,426,2878,46775
18-09-2017,14,16746,17269,7114,2233,43364,1507,903,477,2887,46251
18-09-2017,15,16945,16937,7161,2210,43255,1493,951,432,2876,46131
18-09-2017,16,16889,16942,7354,2181,43364,1479,945,457,2881,46245
18-09-2017,17,16873,17138,7496,2071,43577,1478,1004,538,3020,46597
18-09-2017,18,16864,17332,7608,2232,44036,1475,1020,685,3180,47216
18-09-2017,19,17052,17546,7769,2018,44385,1447,1062,837,3346,47731
18-09-2017,20,16978,17177,7604,1872,43630,1430,973,724,3127,46757
18-09-2017,21,16587,16126,7329,1703,41746,1408,898,354,2660,44406
18-09-2017,22,15659,15333,7122,1582,39698,1393,665,312,2370,42068
18-09-2017,23,14176,14382,7032,1331,36922,1394,446,276,2116,39038
19-09-2017,0,13674,13598,6972,1241,35485,1308,484,243,2035,37520
19-09-2017,1,13156,13386,6922,1329,34793,1284,431,168,1883,36676
19-09-2017,2,12683,13206,6870,1364,34122,1276,430,148,1854,35976
19-09-2017,3,12527,13101,6813,1469,33909,1266,474,144,1884,35793
19-09-2017,4,12837,13280,6924,1652,34693,1280,488,159,1927,36620
19-09-2017,5,14117,14199,7079,1785,37180,1324,837,190,2351,39531
19-09-2017,6,16019,16180,7358,2204,41761,1327,950,213,2490,44251
19-09-2017,7,16986,17416,7754,2807,44963,1324,984,317,2625,47588
19-09-2017,8,17498,17759,7814,3109,46181,1297,1027,449,2773,48954
19-09-2017,9,17826,17961,7755,3110,46651,1282,1032,255,2569,49220
19-09-2017,10,17806,18177,7725,3221,46929,1286,1037,260,2583,49512
19-09-2017,11,17485,18069,7672,3357,46583,1293,1037,279,2609,49192
19-09-2017,12,17102,18045,7682,3375,46203,1288,1041,474,2803,49006
19-09-2017,13,17067,17802,7516,3232,45618,1274,1041,330,2645,48263
19-09-2017,14,17089,17507,7494,3124,45215,1260,1048,254,2562,47777
19-09-2017,15,17106,17163,7509,3121,44898,1280,1040,239,2559,47457
19-09-2017,16,17008,17239,7580,3236,45065,1282,1028,170,2480,47545
19-09-2017,17,17190,17638,7637,3226,45691,1277,1023,129,2429,48120
19-09-2017,18,17254,17568,7670,3191,45683,1278,1049,120,2447,48130
19-09-2017,19,17706,17582,7675,3153,46119,1272,1080,528,2880,48999
19-09-2017,20,17491,17666,7430,2979,45566,1281,1066,436,2783,48349
19-09-2017,21,17067,16674,7228,2459,43430,1285,786,125,2196,45626
19-09-2017,22,16524,15384,7090,1836,40834,1290,652,134,2076,42910
19-09-2017,23,15382,14135,6807,1608,37934,1293,592,137,2022,39956
20-09-2017,0,13537,13338,6646,1705,35226,1087,745,103,1935,37161
20-09-2017,1,13080,13057,6492,1879,34508,1018,722,92,1832,36340
20-09-2017,2,12679,13028,6489,1787,33983,882,730,86,1698,35681
20-09-2017,3,12626,13046,6467,1755,33893,858,731,92,1681,35574
20-09-2017,4,12808,13188,6418,1724,34138,1033,825,84,1942,36080
20-09-2017,5,13836,14170,6551,1904,36461,1209,977,88,2274,38735
20-09-2017,6,16272,16826,6871,2239,42207,1294,1021,101,2416,44623
20-09-2017,7,17632,18468,7108,2775,45983,1313,1028,276,2617,48600
20-09-2017,8,17951,18617,7248,2898,46714,1303,1038,518,2859,49573
20-09-2017,9,17707,18456,7275,2932,46371,1296,1073,523,2892,49263
20-09-2017,10,17570,18789,7334,2938,46632,1305,1066,518,2889,49521
20-09-2017,11,17470,18606,7252,2907,46235,1319,1067,529,2915,49150
20-09-2017,12,17179,18236,7275,2899,45589,1324,1066,487,2877,48466
20-09-2017,13,17212,18236,7158,2792,45398,1314,1081,103,2498,47896
20-09-2017,14,17332,17733,7102,2463,44631,1300,1076,33,2409,47040
20-09-2017,15,17162,17362,7183,2168,43875,1301,1076,36,2413,46288
20-09-2017,16,17489,17510,7353,2313,44666,1309,1074,40,2423,47089
20-09-2017,17,17715,17564,7501,2568,45348,1313,1075,68,2456,47804
20-09-2017,18,17648,18113,7501,2576,45839,1311,1076,175,2562,48401
20-09-2017,19,17794,18382,7637,2555,46367,1318,1080,541,2939,49306
20-09-2017,20,17867,17975,7626,2328,45798,1311,1052,91,2454,48252
20-09-2017,21,17493,16938,7290,1754,43475,1319,923,95,2337,45812
20-09-2017,22,16953,15473,6999,1166,40592,1319,862,115,2296,42888
20-09-2017,23,15938,14009,6763,1130,37840,1330,797,88,2215,40055
21-09-2017,0,15442,13201,6536,1130,36308,1239,829,79,2147,38455
21-09-2017,1,14278,12792,6470,1108,34650,1200,825,76,2101,36751
21-09-2017,2,13878,12525,6442,1132,33977,1223,779,72,2074,36051
21-09-2017,3,13644,12462,6440,987,33532,1164,777,87,2028,35560
21-09-2017,4,13814,12653,6463,959,33889,1198,867,102,2167,36056
21-09-2017,5,15169,13825,6776,1033,36804,1291,1001,119,2411,39215
21-09-2017,6,16871,16745,7140,1586,42342,1335,1067,127,2529,44871
21-09-2017,7,18242,18008,7499,2266,46015,1357,1078,536,2971,48986
21-09-2017,8,18447,18197,7651,2468,46764,1356,1074,588,3018,49782
21-09-2017,9,18326,18179,7602,2622,46729,1349,1063,589,3001,49730
21-09-2017,10,18435,17976,7601,2544,46557,1347,1063,506,2916,49473
21-09-2017,11,18216,18117,7505,2479,46316,1357,1061,536,2954,49270
21-09-2017,12,17896,18072,7401,2368,45737,1367,1058,310,2735,48472
21-09-2017,13,17771,17259,7280,2478,44788,1383,1056,261,2700,47488
21-09-2017,14,17485,16922,7185,2404,43997,1398,1060,168,2626,46623
21-09-2017,15,17600,16734,7232,2110,43677,1409,1083,147,2639,46316
21-09-2017,16,17664,17014,7371,2211,44260,1415,1082,170,2667,46927
21-09-2017,17,17777,17467,7376,2633,45254,1418,1085,301,2804,48058
21-09-2017,18,17784,17603,7481,2634,45501,1426,1041,395,2862,48363
21-09-2017,19,18213,17949,7702,2629,46493,1425,1032,623,3080,49573
21-09-2017,20,17957,17364,7658,2250,45229,1454,1032,187,2673,47902
21-09-2017,21,17600,16260,7167,1762,42788,1463,1024,121,2608,45396
21-09-2017,22,16726,14933,7035,1381,40074,1442,928,124,2494,42568
21-09-2017,23,15418,13922,6723,1234,37296,1383,827,125,2335,39631
22-09-2017,0,14664,13037,6632,1126,35458,1348,709,118,2175,37633
22-09-2017,1,13731,12679,6607,1175,34193,1356,693,124,2173,36366
22-09-2017,2,13273,12661,6493,1214,33641,1327,689,128,2144,35785
22-09-2017,3,13271,12538,6498,1116,33423,1311,693,128,2132,35555
22-09-2017,4,13772,12711,6604,1100,34189,1377,696,105,2178,36367
22-09-2017,5,15088,13912,6885,1359,37242,1371,867,106,2344,39586
22-09-2017,6,16613,16658,7379,1835,42484,1391,942,112,2445,44929
22-09-2017,7,17706,18104,7644,2317,45773,1395,1034,337,2766,48539
22-09-2017,8,18265,18218,7622,2400,46505,1370,1047,577,2994,49499
22-09-2017,9,18367,18108,7550,2490,46516,1345,1047,599,2991,49507
22-09-2017,10,18394,18190,7503,2637,46723,1316,1048,566,2930,49653
22-09-2017,11,18139,18246,7454,2628,46468,1298,1047,523,2868,49336
22-09-2017,12,17791,18106,7422,2611,45930,1316,1046,523,2885,48815
22-09-2017,13,17633,17769,7203,2471,45075,1336,1038,534,2908,47983
22-09-2017,14,17567,17103,7092,2093,43854,1344,951,327,2622,46476
22-09-2017,15,17598,17127,6928,1768,43421,1366,949,138,2453,45874
22-09-2017,16,17668,17493,6956,2048,44165,1357,965,103,2425,46590
22-09-2017,17,17586,18268,7094,2270,45217,1329,962,136,2427,47644
22-09-2017,18,17567,18272,7204,2309,45352,1314,942,527,2783,48135
22-09-2017,19,17723,18180,7381,2323,45609,1315,960,520,2795,48404
22-09-2017,20,17173,16839,7161,2003,43175,1325,955,530,2810,45985
22-09-2017,21,16953,15471,6916,1749,41090,1321,849,106,2276,43366
22-09-2017,22,16323,14721,6683,1678,39406,1315,837,107,2259,41665
22-09-2017,23,15845,13446,6486,1488,37265,1313,872,95,2280,39545
23-09-2017,0,15795,12615,6425,1045,35881,1187,700,123,2010,37891
23-09-2017,1,15209,12218,6279,978,34684,1159,618,137,1914,36598
23-09-2017,2,14881,12143,6260,938,34221,1164,618,147,1929,36150
23-09-2017,3,14871,11955,6273,893,33992,1153,621,170,1944,35936
23-09-2017,4,14869,11952,6304,800,33926,1157,628,172,1957,35883
23-09-2017,5,14943,12117,6410,920,34389,1155,606,192,1953,36342
23-09-2017,6,15332,12888,6534,911,35666,1145,479,192,1816,37482
23-09-2017,7,15713,13936,6557,1308,37514,1118,407,191,1716,39230
23-09-2017,8,16471,14876,6577,1473,39396,1106,371,203,1680,41076
23-09-2017,9,17279,15888,6681,1555,41404,1100,271,233,1604,43008
23-09-2017,10,17372,16160,6748,1650,41930,1103,270,161,1534,43464
23-09-2017,11,17121,16206,6759,1650,41737,1093,262,173,1528,43265
23-09-2017,12,16364,15833,6601,1273,40071,1100,255,148,1503,41574
23-09-2017,13,16452,15461,6375,1217,39506,1072,253,163,1488,40994
23-09-2017,14,16718,15737,6308,1247,40010,1086,253,175,1514,41524
23-09-2017,15,16487,16196,6341,1171,40196,1154,250,191,1595,41791
23-09-2017,16,16762,16408,6488,1237,40896,1159,538,174,1871,42767
23-09-2017,17,17127,16866,6624,1117,41733,1165,599,172,1936,43669
23-09-2017,18,17072,17262,6711,1452,42496,1188,783,226,2197,44693
23-09-2017,19,17216,17684,6707,1542,43148,1214,855,267,2336,45484
23-09-2017,20,16587,16799,6634,1482,41502,1227,957,273,2457,43959
23-09-2017,21,16140,15780,6566,1357,39843,1198,893,224,2315,42158
23-09-2017,22,15741,14289,6486,1163,37681,1206,880,210,2296,39977
23-09-2017,23,15317,13261,6219,854,35651,1205,842,160,2207,37858
24-09-2017,0,15009,12201,6135,837,34183,1073,877,168,2118,36301
24-09-2017,1,14688,11840,6047,698,33273,1052,872,171,2095,35368
24-09-2017,2,14309,11533,6069,747,32658,1041,873,145,2059,34717
24-09-2017,3,14040,11481,6030,708,32257,1023,871,164,2058,34315
24-09-2017,4,13916,11585,6046,714,32262,1045,872,188,2105,34367
24-09-2017,5,14454,11787,6128,863,33233,1066,865,183,2114,35347
24-09-2017,6,14313,12393,6337,976,34018,1080,780,164,2024,36042
24-09-2017,7,14470,13072,6411,1027,34980,1079,621,173,1873,36853
24-09-2017,8,15430,13941,6435,1057,36863,1062,496,168,1726,38589
24-09-2017,9,16412,15059,6438,1296,39206,1082,421,211,1714,40920
24-09-2017,10,16512,15564,6494,1274,39845,1105,370,195,1670,41515
24-09-2017,11,16536,15704,6487,1280,40007,1121,613,225,1959,41966
24-09-2017,12,16358,15255,6486,1330,39429,1110,526,238,1874,41303
24-09-2017,13,15732,14662,6295,1283,37973,1079,431,200,1710,39683
24-09-2017,14,15366,14180,6230,1322,37098,1084,264,170,1518,38616
24-09-2017,15,15391,14175,6247,1491,37304,1092,246,172,1510,38814
24-09-2017,16,16225,14543,6314,1635,38717,1055,704,184,1943,40660
24-09-2017,17,16807,15916,6411,1903,41038,1039,798,186,2023,43061
24-09-2017,18,17084,16451,6574,2228,42338,1049,776,253,2078,44416
24-09-2017,19,17143,17439,6722,2393,43698,1081,819,328,2228,45926
24-09-2017,20,16459,17065,6711,2486,42723,1098,829,336,2263,44986
24-09-2017,21,16177,15886,6637,2264,40964,1095,813,283,2191,43155
24-09-2017,22,15348,15113,6364,2163,38989,1082,667,287,2036,41025
24-09-2017,23,13983,14186,6213,2050,36433,1081,683,280,2044,38477
25-09-2017,0,13679,12781,5989,2017,34466,1053,505,273,1831,36297
25-09-2017,1,13739,12281,5925,1874,33817,898,501,265,1664,35481
25-09-2017,2,13787,12210,5865,1709,33571,951,503,256,1710,35281
25-09-2017,3,14073,12336,5875,1617,33901,1008,505,260,1773,35674
25-09-2017,4,14406,12634,5852,1550,34443,1065,509,270,1844,36287
25-09-2017,5,15058,14089,6091,1885,37124,1229,630,275,2134,39258
25-09-2017,6,16449,16651,6600,2312,42013,1299,835,290,2424,44437
25-09-2017,7,17522,18230,7034,2592,45379,1288,899,286,2473,47852
25-09-2017,8,17825,18373,7056,3007,46262,1279,992,497,2768,49030
25-09-2017,9,17874,18245,6873,3299,46291,1269,1032,553,2854,49145
25-09-2017,10,17828,18257,6784,3260,46129,1287,1036,547,2870,48999
25-09-2017,11,17636,18051,6713,3141,45544,1298,1040,443,2781,48325
25-09-2017,12,17371,17676,6707,3171,44925,1292,1028,378,2698,47623
25-09-2017,13,17287,17154,6479,3368,44289,1272,1014,233,2519,46808
25-09-2017,14,16979,16737,6455,3442,43613,1259,1017,258,2534,46147
25-09-2017,15,17255,16827,6556,3205,43843,1271,1013,263,2547,46390
25-09-2017,16,17636,16821,6654,3144,44255,1279,1013,235,2527,46782
25-09-2017,17,17683,17084,6633,3060,44460,1287,1013,228,2528,46988
25-09-2017,18,17674,17457,6772,2890,44794,1319,1034,299,2652,47446
25-09-2017,19,17883,17642,6970,2807,45301,1342,1030,437,2809,48110
25-09-2017,20,17359,17147,6660,2525,43691,1344,1032,336,2712,46403
25-09-2017,21,16839,15515,6441,2425,41222,1339,911,338,2588,43810
25-09-2017,22,15589,14616,6181,2162,38549,1334,846,305,2485,41034
25-09-2017,23,14088,13954,6062,2081,36185,1312,650,271,2233,38418
26-09-2017,0,13568,12378,6014,1858,33817,1262,593,270,2125,35942
26-09-2017,1,13068,12116,5926,1866,32976,1204,588,259,2051,35027
26-09-2017,2,12897,12031,5927,1869,32725,1196,592,246,2034,34759
26-09-2017,3,12903,12003,5958,1848,32713,1202,595,231,2028,34741
26-09-2017,4,13510,12300,6011,1858,33679,1258,599,223,2080,35759
26-09-2017,5,14892,13746,6241,2069,36949,1262,677,231,2170,39119
26-09-2017,6,16496,16269,6799,2349,41913,1265,859,219,2343,44256
26-09-2017,7,17554,18110,6980,2797,45441,1274,1055,319,2648,48089
26-09-2017,8,17852,18315,7089,2992,46250,1271,1037,413,2721,48971
26-09-2017,9,17562,18249,6995,3179,45986,1272,1115,590,2977,48963
26-09-2017,10,17400,17968,6957,3166,45491,1261,1124,584,2969,48460
26-09-2017,11,17293,17854,6952,3221,45321,1267,1043,441,2751,48072
26-09-2017,12,17497,17613,6963,3104,45177,1268,1051,360,2679,47856
26-09-2017,13,17261,17292,6861,3166,44582,1271,1050,254,2575,47157
26-09-2017,14,17053,16908,6615,3091,43668,1269,1039,236,2544,46212
26-09-2017,15,17297,17045,6661,3039,44042,1268,1027,228,2523,46565
26-09-2017,16,17244,17523,6843,2889,44499,1268,984,224,2476,46975
26-09-2017,17,17292,17686,6944,2780,44702,1267,986,232,2485,47187
26-09-2017,18,17254,17927,6954,2669,44805,1272,1043,691,3006,47811
26-09-2017,19,17616,17880,6980,2813,45291,1275,1046,720,3041,48332
26-09-2017,20,17115,17318,6897,2454,43785,1286,1035,335,2656,46441
26-09-2017,21,16247,15943,6584,2285,41059,1287,949,280,2516,43575
26-09-2017,22,15386,14869,6286,2142,38684,1283,759,251,2293,40977
26-09-2017,23,14379,13633,6033,1955,36000,1282,603,224,2109,38109
27-09-2017,0,14172,12557,6055,1888,34672,1252,367,214,1833,36505
27-09-2017,1,13831,12148,5986,1883,33849,1186,369,196,1751,35600
27-09-2017,2,13680,11886,5889,1832,33287,1172,354,187,1713,35000
27-09-2017,3,13789,11805,5938,1700,33231,1176,339,191,1706,34937
27-09-2017,4,13969,12168,5958,1833,33929,1238,383,196,1817,35746
27-09-2017,5,14735,13872,6120,2054,36781,1242,528,208,1978,38759
27-09-2017,6,15989,16640,6656,2192,41477,1239,675,271,2185,43662
27-09-2017,7,17321,17947,6918,2561,44747,1240,946,645,2831,47578
27-09-2017,8,17696,18499,7045,2662,45902,1244,957,627,2828,48730
27-09-2017,9,17649,18497,7008,2818,45973,1248,957,576,2781,48754
27-09-2017,10,17583,18492,7008,2956,46038,1243,957,559,2759,48797
27-09-2017,11,17307,18246,7004,3066,45624,1249,960,535,2744,48368
27-09-2017,12,16916,17581,6992,3203,44693,1244,962,502,2708,47401
27-09-2017,13,16995,17354,6763,3311,44424,1245,887,242,2374,46798
27-09-2017,14,16892,17071,6709,3280,43952,1258,808,222,2288,46240
27-09-2017,15,17101,17117,6717,3272,44208,1255,807,235,2297,46505
27-09-2017,16,17289,17198,6849,3365,44701,1253,763,235,2251,46952
27-09-2017,17,17381,17228,6964,3611,45184,1259,847,258,2364,47548
27-09-2017,18,17339,17392,6998,3737,45466,1263,851,326,2440,47906
27-09-2017,19,17530,17559,6975,3641,45706,1265,853,663,2781,48487
27-09-2017,20,17286,16760,6837,3338,44222,1274,780,307,2361,46583
27-09-2017,21,16614,15699,6490,3032,41836,1270,676,319,2265,44101
27-09-2017,22,15605,14703,6157,2995,39460,1252,561,240,2053,41513
27-09-2017,23,13980,14049,6031,2800,36860,1202,471,219,1892,38752
28-09-2017,0,13817,12939,5998,2739,35494,1208,243,189,1640,37134
28-09-2017,1,13490,12670,5937,2709,34806,1206,202,162,1570,36376
28-09-2017,2,13439,12574,5922,2772,34709,1200,177,125,1502,36211
28-09-2017,3,13455,12529,5839,2725,34549,1189,177,103,1469,36018
28-09-2017,4,14003,12748,5927,2602,35281,1196,186,105,1487,36768
28-09-2017,5,15376,13598,6279,2631,37884,1234,374,113,1721,39605
28-09-2017,6,16424,15848,6708,2604,41583,1224,668,170,2062,43645
28-09-2017,7,17768,17293,7027,2990,45079,1185,826,382,2393,47472
28-09-2017,8,17923,17565,7123,3187,45799,1204,912,556,2672,48471
28-09-2017,9,17889,17458,7172,3328,45845,1217,913,549,2679,48524
28-09-2017,10,17880,17357,7112,3463,45811,1219,912,538,2669,48480
28-09-2017,11,17714,17834,7211,3588,46349,1221,967,523,2711,49060
28-09-2017,12,17340,17291,7112,3662,45404,1224,967,356,2547,47951
28-09-2017,13,17423,17138,6937,3623,45123,1213,964,156,2333,47456
28-09-2017,14,17217,16918,6665,3610,44412,1217,894,108,2219,46631
28-09-2017,15,17388,16790,6725,3633,44536,1219,891,131,2241,46777
28-09-2017,16,17504,17075,6784,3338,44700,1208,894,341,2443,47143
28-09-2017,17,17704,17241,6961,3276,45182,1207,896,369,2472,47654
28-09-2017,18,18054,17601,7104,3256,46016,1215,898,452,2565,48581
28-09-2017,19,18303,17754,7203,3056,46316,1229,1048,605,2882,49198
28-09-2017,20,17962,17463,6880,2797,45103,1242,829,240,2311,47414
28-09-2017,21,17449,16002,6621,2399,42473,1239,666,202,2107,44580
28-09-2017,22,16564,15011,6362,2042,39979,1235,510,111,1856,41835
28-09-2017,23,15505,14290,6214,1878,37888,1211,427,105,1743,39631
29-09-2017,0,15662,12833,6044,1808,36347,1229,251,111,1591,37938
29-09-2017,1,15384,12538,5966,1819,35707,1246,180,102,1528,37235
29-09-2017,2,15142,12515,5928,1886,35472,1267,179,70,1516,36988
29-09-2017,3,15314,12438,5974,1810,35536,1242,182,70,1494,37030
29-09-2017,4,15246,12983,6133,1847,36209,1312,190,67,1569,37778
29-09-2017,5,15706,14771,6368,2116,38961,1332,367,89,1788,40749
29-09-2017,6,16878,16558,6944,2438,42820,1365,667,129,2161,44981
29-09-2017,7,18256,17919,7190,2779,46145,1362,822,367,2551,48696
29-09-2017,8,18458,18170,7251,2951,46831,1380,871,562,2813,49644
29-09-2017,9,18462,18059,7255,3021,46797,1391,916,524,2831,49628
29-09-2017,10,18631,18159,7246,3181,47218,1387,885,539,2811,50029
29-09-2017,11,18219,17927,7119,3404,46669,1403,936,442,2781,49450
29-09-2017,12,17955,17302,7083,3428,45769,1407,999,393,2799,48568
29-09-2017,13,17777,17102,7065,3479,45423,1417,1022,150,2589,48012
29-09-2017,14,17330,16952,6796,3448,44528,1401,875,130,2406,46934
29-09-2017,15,17422,16489,6879,3362,44153,1418,912,84,2414,46567
29-09-2017,16,17452,16474,6955,3380,44260,1412,822,83,2317,46577
29-09-2017,17,17598,16839,6964,3425,44827,1411,914,107,2432,47259
29-09-2017,18,17540,16877,7016,3759,45193,1414,929,510,2853,48046
29-09-2017,19,17581,16819,7230,3652,45282,1419,884,606,2909,48191
29-09-2017,20,16844,16449,6703,3687,43684,1379,761,156,2296,45980
29-09-2017,21,15564,15360,6266,3652,40843,1279,760,149,2188,43031
29-09-2017,22,14993,14421,6073,3732,39220,1125,666,142,1933,41153
29-09-2017,23,14417,13734,6036,3765,37953,1055,424,118,1597,39550
30-09-2017,0,13560,12381,6045,3667,35653,937,154,109,1200,36853
30-09-2017,1,12756,12260,6049,3784,34848,903,148,114,1165,36013
30-09-2017,2,12518,12186,5996,3653,34354,903,149,119,1171,35525
30-09-2017,3,12661,12137,5999,3577,34375,904,152,89,1145,35520
30-09-2017,4,12825,12126,5993,3543,34487,906,154,76,1136,35623
30-09-2017,5,13460,12379,6072,3673,35584,892,156,74,1122,36706
30-09-2017,6,14210,13274,6096,3657,37238,904,321,77,1302,38540
30-09-2017,7,15128,13982,6174,3660,38943,947,435,94,1476,40419
30-09-2017,8,15787,14940,6451,3689,40868,1079,530,135,1744,42612
30-09-2017,9,16367,15580,6679,3790,42419,1085,625,65,1775,44194
30-09-2017,10,16557,15652,6759,3890,42858,1078,594,74,1746,44604
30-09-2017,11,16282,15712,6807,3851,42652,1080,590,101,1771,44423
30-09-2017,12,16184,15418,6734,3683,42019,1078,596,143,1817,43836
30-09-2017,13,16218,15352,6490,3403,41462,1085,595,129,1809,43271
30-09-2017,14,16081,15257,6516,3295,41150,1075,595,115,1785,42935
30-09-2017,15,16176,15082,6569,3252,41079,1073,677,114,1864,42943
30-09-2017,16,16263,15239,6700,3361,41563,1074,738,133,1945,43508
30-09-2017,17,16267,15516,6914,3470,42167,1026,721,137,1884,44051
30-09-2017,18,16638,16072,7100,3546,43358,987,766,409,2162,45520
30-09-2017,19,16475,15970,7116,3583,43144,1060,704,584,2348,45492
30-09-2017,20,16106,15739,6760,3540,42146,1089,590,234,1913,44059
30-09-2017,21,15777,14829,6634,3477,40717,1105,449,223,1777,42494
30-09-2017,22,15310,14461,6621,3330,39721,1028,194,244,1466,41187
30-09-2017,23,14815,13691,6047,2723,37276,906,170,229,1305,38581
01-10-2017,0,14419,12596,5963,2384,35361,914,165,224,1303,36664
01-10-2017,1,13799,12134,5954,2790,34678,911,160,220,1291,35969
01-10-2017,2,13240,12003,5941,2590,33775,915,161,201,1277,35052
01-10-2017,3,13206,11943,5949,2343,33440,907,163,178,1248,34688
01-10-2017,4,12929,11968,5944,2045,32888,912,164,174,1250,34138
01-10-2017,5,13034,12067,6022,1776,32899,913,173,171,1257,34156
01-10-2017,6,13516,12382,6026,1641,33566,915,408,169,1492,35058
01-10-2017,7,14340,12875,6046,1617,34879,958,553,178,1689,36568
01-10-2017,8,15488,14227,6080,1580,37374,956,615,154,1725,39099
01-10-2017,9,15950,15282,6280,1515,39025,1086,637,133,1856,40881
01-10-2017,10,16284,15637,6439,1587,39948,1093,665,139,1897,41845
01-10-2017,11,16369,15634,6506,1746,40256,1099,654,145,1898,42154
01-10-2017,12,16374,15548,6562,1824,40309,1101,680,175,1956,42265
01-10-2017,13,15860,15307,6498,1813,39478,1095,636,182,1913,41391
01-10-2017,14,15078,14602,6525,1824,38030,1043,634,186,1863,39893
01-10-2017,15,15092,14579,6562,1974,38209,1071,636,197,1904,40113
01-10-2017,16,15627,14984,6640,2052,39303,1090,638,202,1930,41233
01-10-2017,17,16622,15658,6810,1753,40844,1100,650,179,1929,42773
01-10-2017,18,17325,16119,6951,1720,42113,1100,855,203,2158,44271
01-10-2017,19,17199,16446,7016,2024,42687,1100,970,317,2387,45074
01-10-2017,20,16428,16218,6891,2261,41799,1103,690,235,2028,43827
01-10-2017,21,15692,15522,6644,2600,40457,956,480,252,1688,42145
01-10-2017,22,14186,14564,6524,2873,38148,990,397,260,1647,39795
01-10-2017,23,12637,13565,6392,3194,35788,966,411,255,1632,37420
02-10-2017,0,11823,12581,6416,3303,34122,936,304,261,1501,35623
02-10-2017,1,11090,12715,6413,3590,33810,934,221,268,1423,35233
02-10-2017,2,10843,12670,6439,3599,33552,945,222,269,1436,34988
02-10-2017,3,10670,12868,6488,3615,33642,933,222,266,1421,35063
02-10-2017,4,10636,13165,6546,3922,34269,1010,237,254,1501,35770
02-10-2017,5,11224,14213,6746,4207,,1175,559,243,1977,
02-10-2017,6,13172,15866,7279,4207,40525,1350,867,272,2489,43014
02-10-2017,7,14624,17097,7694,4127,43543,1451,1034,523,3008,46551
02-10-2017,8,15103,17495,7988,3979,44565,1468,1051,463,2982,47547
02-10-2017,9,15118,17954,8073,3869,45014,1472,1046,454,2972,47986
02-10-2017,10,15251,18281,8173,3754,45460,1496,1078,410,2984,48444
02-10-2017,11,15249,18576,8125,4133,46085,1532,1008,508,3048,49133
02-10-2017,12,14847,18397,8093,4509,45845,1529,991,581,3101,48946
02-10-2017,13,14915,18222,8200,4579,45917,1413,956,622,2991,48908
02-10-2017,14,14919,18157,8233,4549,45858,1376,937,423,2736,48594
02-10-2017,15,14836,17989,8187,4110,45121,1366,935,443,2744,47865
02-10-2017,16,15082,17896,8216,4033,45229,1363,945,407,2715,47944
02-10-2017,17,16030,18445,8201,3869,46546,1362,945,430,2737,49283
02-10-2017,18,16379,18495,8316,3578,46768,1390,946,652,2988,49756
02-10-2017,19,16429,18328,8343,3577,46679,1446,940,658,3044,49723
02-10-2017,20,15438,17870,7867,3853,45028,1289,849,405,2543,47571
02-10-2017,21,14113,16686,7715,3345,41858,1377,648,392,2417,44275
02-10-2017,22,13334,15700,7484,3161,39678,1283,346,386,2015,41693
02-10-2017,23,12596,14406,7266,3277,37547,1231,247,374,1852,39399
03-10-2017,0,11609,13353,7311,2925,35196,1093,257,352,1702,36898
03-10-2017,1,11495,13002,7257,2957,34713,1038,259,336,1633,36346
03-10-2017,2,11690,12855,7287,2829,34661,1034,260,331,1625,36286
03-10-2017,3,12027,12721,7434,2844,35026,1057,310,314,1681,36707
03-10-2017,4,12388,12869,7538,2798,35593,1086,341,279,1706,37299
03-10-2017,5,13541,13819,7786,3171,38318,1197,577,255,2029,40347
03-10-2017,6,15650,16760,8255,3308,43974,1373,686,357,2416,46390
03-10-2017,7,17381,17962,8546,3381,47270,1438,931,492,2861,50131
03-10-2017,8,17658,18258,8588,4243,48746,1373,1012,478,2863,51609
03-10-2017,9,17901,18370,8540,3651,48464,1321,1025,464,2810,51274
03-10-2017,10,17531,18161,8542,4103,48338,1377,1019,462,2858,51196
03-10-2017,11,17068,17829,8542,4714,48154,1343,1107,444,2894,51048
03-10-2017,12,16052,17380,8397,4608,46439,1381,1115,434,2930,49369
03-10-2017,13,15227,17022,8271,4522,45041,1345,1113,455,2913,47954
03-10-2017,14,14979,16828,8438,4308,44555,1294,1044,392,2730,47285
03-10-2017,15,14369,16868,8497,4623,44357,1281,1019,305,2605,46962
03-10-2017,16,14728,17149,8442,4912,45231,1280,967,354,2601,47832
03-10-2017,17,15561,17433,8569,4807,46371,1268,944,366,2578,48949
03-10-2017,18,16636,17870,8778,4311,47595,1304,940,460,2704,50299
03-10-2017,19,16977,18188,8735,4219,48119,1283,936,490,2709,50828
03-10-2017,20,16023,17629,8106,4413,46171,1288,843,251,2382,48553
03-10-2017,21,15298,16873,7552,4387,44112,1194,591,280,2065,46177
03-10-2017,22,14380,15840,7279,4054,41553,1145,358,294,1797,43350
03-10-2017,23,13225,14196,7255,3957,38632,1173,270,318,1761,40393
04-10-2017,0,12507,13439,7010,3799,36756,1034,254,309,1597,38353
04-10-2017,1,12242,13040,6832,3690,35805,997,256,326,1579,37384
04-10-2017,2,12138,12970,6793,3491,35393,975,258,326,1559,36952
04-10-2017,3,12119,12999,6787,3301,35207,974,256,320,1550,36757
04-10-2017,4,12436,13201,6795,3369,35801,1006,318,315,1639,37440
04-10-2017,5,13011,14226,7065,3221,37523,1170,692,342,2204,39727
04-10-2017,6,15452,16963,7354,3484,43255,1342,769,341,2452,45707
04-10-2017,7,17368,18881,7779,3654,47683,1358,962,317,2637,50320
04-10-2017,8,17896,19025,7957,4005,48883,1366,1022,442,2830,51713
04-10-2017,9,17748,18701,7906,4318,48672,1289,1019,446,2754,51426
04-10-2017,10,17714,18757,7834,4359,48664,1253,1043,439,2735,51399
04-10-2017,11,17607,18115,7456,4507,47684,1304,1051,399,2754,50438
04-10-2017,12,17154,17668,7342,4385,46549,1350,1051,388,2789,49338
04-10-2017,13,16536,17437,7369,4668,46011,1445,967,384,2796,48807
04-10-2017,14,16491,17300,7471,4693,45956,1448,972,393,2813,48769
04-10-2017,15,16618,17286,7434,4641,45981,1430,879,407,2716,48697
04-10-2017,16,16370,17558,7518,4436,45884,1434,888,408,2730,48614
04-10-2017,17,16998,17847,7674,4644,47163,1315,895,370,2580,49743
04-10-2017,18,17446,18527,7879,4208,48060,1316,970,362,2648,50708
04-10-2017,19,17498,18617,7752,4001,47868,1286,1030,353,2669,50537
04-10-2017,20,16834,17422,7282,3786,45326,1120,777,371,2268,47594
04-10-2017,21,15349,16331,7035,3892,42607,1100,641,380,2121,44728
04-10-2017,22,14038,15410,6830,3705,39983,976,394,402,1772,41755
04-10-2017,23,12617,14077,6623,3974,37291,819,254,412,1485,38776
05-10-2017,0,12219,13521,6456,3890,36087,841,242,400,1483,37570
05-10-2017,1,11850,13341,6452,3877,35519,853,239,338,1430,36949
05-10-2017,2,11963,13084,6412,3874,35333,838,254,366,1458,36791
05-10-2017,3,12308,13095,6460,3640,35504,792,319,374,1485,36989
05-10-2017,4,12528,13458,6481,3174,35643,787,427,379,1593,37236
05-10-2017,5,13832,14479,6532,2859,37702,918,507,385,1810,39512
05-10-2017,6,16690,16899,6979,2761,43330,1216,647,400,2263,45593
05-10-2017,7,18776,19319,7260,2718,48073,1218,1038,446,2702,50775
05-10-2017,8,19191,19353,7503,2567,48614,1211,1034,682,2927,51541
05-10-2017,9,19660,19225,7501,2419,48805,1195,1030,674,2899,51704
05-10-2017,10,19201,18998,7308,2627,48134,1200,1037,664,2901,51035
05-10-2017,11,18452,18472,7262,2896,47083,1155,1058,653,2866,49949
05-10-2017,12,18600,17628,7213,2771,46212,1170,1064,656,2890,49102
05-10-2017,13,18238,17261,7305,3420,46227,1171,1064,621,2856,49083
05-10-2017,14,17868,16735,7223,3981,45809,1158,1063,569,2790,48599
05-10-2017,15,17213,16494,7169,4091,44967,1170,1056,551,2777,47744
05-10-2017,16,17108,16233,6872,4296,44509,1166,1061,491,2718,47227
05-10-2017,17,17335,16315,7120,4203,44974,1138,1048,443,2629,47603
05-10-2017,18,18099,16823,7365,4131,46419,1163,1040,403,2606,49025
05-10-2017,19,18520,17282,7477,3633,46913,1166,1035,375,2576,49489
05-10-2017,20,17723,16814,7076,3767,45380,1169,1015,146,2330,47710
05-10-2017,21,17174,16036,6661,3618,43488,1181,526,76,1783,45271
05-10-2017,22,15663,15112,6483,4040,41298,1072,296,82,1450,42748
05-10-2017,23,14086,13984,6324,3802,38197,918,260,79,1257,39454
06-10-2017,0,13444,12493,6257,3765,35959,753,236,83,1072,37031
06-10-2017,1,12873,12344,6259,3831,35308,703,239,94,1036,36344
06-10-2017,2,12778,12259,6230,3668,34935,698,242,122,1062,35997
06-10-2017,3,12891,12302,6282,3542,35015,688,254,157,1099,36114
06-10-2017,4,13216,12470,6322,3501,35509,716,393,183,1292,36801
06-10-2017,5,14634,13573,6558,3459,38225,899,554,195,1648,39873
06-10-2017,6,17083,15424,7004,3469,42981,1054,949,222,2225,45206
06-10-2017,7,19216,17232,7326,3797,47570,1064,1063,313,2440,50010
06-10-2017,8,20032,17121,7497,3606,48258,1020,1087,434,2541,50799
06-10-2017,9,20199,16955,7648,3509,48312,940,1079,443,2462,50774
06-10-2017,10,20026,16753,7525,3565,47869,1027,1084,510,2621,50490
06-10-2017,11,19771,16318,7516,3762,47367,1033,1098,551,2682,50049
06-10-2017,12,19463,16141,7475,3759,46839,1026,1068,571,2665,49504
06-10-2017,13,19023,15724,7408,3880,46037,1054,1066,571,2691,48728
06-10-2017,14,18386,15428,7317,3754,44886,1078,1071,561,2710,47596
06-10-2017,15,18633,15493,7155,3491,44774,1067,1070,552,2689,47463
06-10-2017,16,19199,15927,7204,3125,45455,1075,1068,555,2698,48153
06-10-2017,17,19420,16457,7423,2955,46255,1082,1082,507,2671,48926
06-10-2017,18,19188,17350,7574,2913,47027,1088,1068,475,2631,49658
06-10-2017,19,18965,17235,7577,3203,46980,1097,1172,485,2754,49734
06-10-2017,20,18057,16188,7220,3315,44780,1028,1039,263,2330,47110
06-10-2017,21,17668,15218,6697,3341,42923,1035,710,186,1931,44854
06-10-2017,22,16689,14756,6394,3305,41144,1028,450,147,1625,42769
06-10-2017,23,15214,13614,6194,3607,38629,856,256,143,1255,39884
07-10-2017,0,14497,11622,6252,3726,36098,652,246,116,1014,37112
07-10-2017,1,13668,11007,6228,3913,34816,582,240,111,933,35749
07-10-2017,2,12908,10790,6203,3832,33733,520,242,131,893,34626
07-10-2017,3,12671,10708,6208,3590,33176,516,243,109,868,34044
07-10-2017,4,12821,10837,6222,3618,33499,538,245,119,902,34401
07-10-2017,5,13673,11120,6289,3767,34849,542,260,128,930,35779
07-10-2017,6,14511,11996,6301,3685,36492,578,417,147,1142,37634
07-10-2017,7,15106,12490,6412,3502,37511,686,587,143,1416,38927
07-10-2017,8,15822,13574,6568,3134,39100,672,912,124,1708,40808
07-10-2017,9,17252,14047,6661,2844,40805,685,1019,106,1810,42615
07-10-2017,10,17748,14390,6698,2834,41669,705,1039,120,1864,43533
07-10-2017,11,17640,14438,6688,2802,41570,700,1013,161,1874,43444
07-10-2017,12,17757,14368,6610,2550,41288,691,977,218,1886,43174
07-10-2017,13,17568,14385,6507,2540,40999,695,895,194,1784,42783
07-10-2017,14,17486,14159,6412,2689,40745,692,894,221,1807,42552
07-10-2017,15,17116,14260,6496,2793,40664,685,894,270,1849,42513
07-10-2017,16,17192,14208,6572,2857,40830,639,868,267,1774,42604
07-10-2017,17,17708,14663,6804,2802,41977,675,890,288,1853,43830
07-10-2017,18,18465,15327,6988,2720,43499,695,978,290,1963,45462
07-10-2017,19,18286,15201,7004,2696,43188,738,982,307,2027,45215
07-10-2017,20,17296,14863,6805,2621,41583,777,829,328,1934,43517
07-10-2017,21,16090,13922,6665,2598,39275,789,744,333,1866,41141
07-10-2017,22,15355,13172,6475,2507,37509,700,564,306,1570,39079
07-10-2017,23,14796,12295,6333,2229,35654,639,261,286,1186,36840
08-10-2017,0,13951,11264,6318,2385,33919,602,250,305,1157,35076
08-10-2017,1,13093,11204,6300,2282,32881,614,250,311,1175,34056
08-10-2017,2,12350,11516,6300,2355,32522,614,254,326,1194,33716
08-10-2017,3,12014,11461,6288,2453,32216,598,260,352,1210,33426
08-10-2017,4,12079,11547,6289,2531,32447,584,268,372,1224,33671
08-10-2017,5,11936,11605,6363,2443,32348,575,279,387,1241,33589
08-10-2017,6,12176,12257,6549,2336,33318,584,503,388,1475,34793
08-10-2017,7,12822,12593,6573,2415,34403,614,679,368,1661,36064
08-10-2017,8,14996,13397,6786,2438,37617,613,758,350,1721,39338
08-10-2017,9,16794,14034,6939,2597,40365,672,751,291,1714,42079
08-10-2017,10,17873,15259,7029,2727,42888,682,884,339,1905,44793
08-10-2017,11,17902,15752,7088,3135,43878,672,979,260,1911,45789
08-10-2017,12,17123,15176,6870,3302,42471,674,893,270,1837,44308
08-10-2017,13,15601,14747,6687,3342,40378,672,778,341,1791,42169
08-10-2017,14,14741,14568,6623,3378,39310,604,737,369,1710,41020
08-10-2017,15,14440,14631,6726,3370,39168,583,718,329,1630,40798
08-10-2017,16,15661,15193,6856,3206,40917,606,764,261,1631,42548
08-10-2017,17,17391,16431,7141,2889,43851,634,900,216,1750,45601
08-10-2017,18,17844,17925,7420,3105,46293,688,1053,218,1959,48252
08-10-2017,19,17954,18221,7489,3212,46875,705,1086,480,2271,49146
08-10-2017,20,18715,17083,7308,2521,45628,707,1020,143,1870,47498
08-10-2017,21,18714,16249,7131,2242,44338,646,883,124,1653,45991
08-10-2017,22,17550,15543,6917,2172,42183,659,652,162,1473,43656
08-10-2017,23,16145,14237,6746,2142,39269,656,318,224,1198,40467
09-10-2017,0,15219,13470,6710,2223,37622,751,270,283,1304,38926
09-10-2017,1,14994,13378,6748,2292,37414,767,278,323,1368,38782
09-10-2017,2,14628,13422,6794,2391,37236,794,277,349,1420,38656
09-10-2017,3,14718,13433,6818,2414,37383,836,283,343,1462,38845
09-10-2017,4,15475,13684,6924,2490,38573,909,342,327,1578,40151
09-10-2017,5,17077,14790,7052,2581,41500,1066,517,282,1865,43365
09-10-2017,6,19296,17575,7675,2959,47506,1184,623,248,2055,49561
09-10-2017,7,20242,18640,8076,3585,50545,1198,982,662,2842,53387
09-10-2017,8,20339,18720,8251,3882,51192,1200,1309,734,3243,54435
09-10-2017,9,20288,18581,8266,3730,50867,1169,1208,699,3076,53943
09-10-2017,10,20202,18726,8242,3489,50659,1203,1181,708,3092,53751
09-10-2017,11,20127,18324,8221,3507,50182,1212,1011,554,2777,52959
09-10-2017,12,19748,18248,8156,3604,49757,1210,847,315,2372,52129
09-10-2017,13,19623,17964,8091,3317,48995,1201,825,259,2285,51280
09-10-2017,14,19743,17994,7904,3267,48909,1274,848,259,2381,51290
09-10-2017,15,19651,17962,8002,3399,49015,1303,849,319,2471,51486
09-10-2017,16,19473,17905,8154,3248,48780,1311,1006,454,2771,51551
09-10-2017,17,19616,17722,8354,3306,48998,1323,1037,663,3023,52021
09-10-2017,18,19815,17869,8555,3391,49631,1364,1244,661,3269,52900
09-10-2017,19,19786,17879,8577,3484,49726,1365,1317,646,3328,53054
09-10-2017,20,19730,17519,8557,2949,48754,1357,857,431,2645,51399
09-10-2017,21,19518,16566,8336,2232,46651,1346,838,263,2447,49098
09-10-2017,22,18834,15194,7979,2028,44035,1339,753,212,2304,46339
09-10-2017,23,18006,13711,7752,1606,41074,1328,567,166,2061,43135
10-10-2017,0,16957,13248,7490,1642,39338,1333,493,156,1982,41320
10-10-2017,1,16283,12859,7466,1580,38188,1314,478,142,1934,40122
10-10-2017,2,16447,12604,7507,1548,38107,1304,479,124,1907,40014
10-10-2017,3,16547,12668,7546,1440,38200,1302,484,128,1914,40114
10-10-2017,4,17028,13010,7582,1534,39155,1348,489,140,1977,41132
10-10-2017,5,17658,14300,7815,1744,41518,1497,689,98,2284,43802
10-10-2017,6,19072,16620,8438,2455,46585,1515,861,251,2627,49212
10-10-2017,7,19196,17332,8805,3122,48455,1518,1124,578,3220,51675
10-10-2017,8,19439,17157,8864,3340,48800,1464,1147,556,3167,51967
10-10-2017,9,19487,16872,8792,3384,48536,1544,1119,547,3210,51746
10-10-2017,10,19338,16969,8796,3215,48319,1594,872,587,3053,51372
10-10-2017,11,19088,16927,8581,3299,47893,1610,971,602,3183,51076
10-10-2017,12,18647,16786,8451,3270,47154,1603,831,411,2845,49999
10-10-2017,13,18739,16780,8512,3385,47417,1570,828,256,2654,50071
10-10-2017,14,18368,16692,8432,3416,46908,1556,831,288,2675,49583
10-10-2017,15,18622,16776,8428,3121,46948,1544,837,330,2711,49659
10-10-2017,16,18847,16801,8652,3222,47522,1461,1027,315,2803,50325
10-10-2017,17,18662,16818,8481,3503,47464,1523,1055,565,3143,50607
10-10-2017,18,18748,16880,8413,3618,47660,1545,1175,727,3447,51107
10-10-2017,19,18559,16808,8370,3824,47563,1567,1181,726,3474,51037
10-10-2017,20,18488,16428,8078,3554,46549,1577,1174,261,3012,49561
10-10-2017,21,17486,15683,7690,3541,44399,1485,1158,271,2914,47313
10-10-2017,22,15976,13714,7223,3521,40432,1452,995,277,2724,43156
10-10-2017,23,14282,12688,6918,3177,37065,1382,642,281,2305,39370
11-10-2017,0,13235,12073,6798,2962,35068,1355,556,245,2156,37224
11-10-2017,1,12816,11906,6707,2568,33999,1339,563,209,2111,36110
11-10-2017,2,12735,11838,6659,2297,33530,1377,561,208,2146,35676
11-10-2017,3,12977,11929,6650,1859,33416,1356,558,191,2105,35521
11-10-2017,4,13750,12003,6683,1766,34201,1424,552,130,2106,36307
11-10-2017,5,15489,13532,6859,1723,37602,1632,680,125,2437,40039
11-10-2017,6,17832,16128,7459,2399,43819,1679,926,242,2847,46666
11-10-2017,7,19153,16973,7811,2747,46685,1699,1311,661,3671,50356
11-10-2017,8,19476,17042,7942,2618,47078,1699,1284,768,3751,50829
11-10-2017,9,19433,16885,7842,2960,47120,1714,1271,807,3792,50912
11-10-2017,10,19423,16927,7717,3126,47194,1709,1217,782,3708,50902
11-10-2017,11,19099,16748,7656,3177,46679,1704,1218,877,3799,50478
11-10-2017,12,18964,16658,7725,2993,46341,1680,1214,843,3737,50078
11-10-2017,13,18568,16513,7793,3403,46277,1687,1215,610,3512,49789
11-10-2017,14,18100,16444,7711,3363,45618,1681,1216,654,3551,49169
11-10-2017,15,17921,16610,7640,3783,45953,1664,1142,524,3330,49283
11-10-2017,16,17799,16804,7705,4192,46500,1658,1141,527,3326,49826
11-10-2017,17,18181,16944,7784,4212,47122,1654,1140,984,3778,50900
11-10-2017,18,18186,17114,7870,4346,47517,1637,1429,1022,4088,51605
11-10-2017,19,17670,17600,7858,4427,47555,1636,1433,937,4006,51561
11-10-2017,20,17374,17085,7517,4431,46408,1629,1201,185,3015,49423
11-10-2017,21,16518,16128,7142,4363,44152,1624,1183,66,2873,47025
11-10-2017,22,14949,15456,6811,4428,41645,1601,1006,77,2684,44329
11-10-2017,23,13244,14319,6442,4296,38302,1408,794,74,2276,40578
12-10-2017,0,12861,13749,6444,4489,37544,1106,673,77,1856,39400
12-10-2017,1,12180,13451,6381,4294,36305,1036,671,95,1802,38107
12-10-2017,2,11923,13479,6406,4147,35954,1039,672,110,1821,37775
12-10-2017,3,11783,13501,6400,3882,35565,1027,675,150,1852,37417
12-10-2017,4,11890,13762,6474,3939,36066,1040,674,161,1875,37941
12-10-2017,5,13264,14905,6711,4075,38956,1253,808,235,2296,41252
12-10-2017,6,15646,16562,7089,4518,43815,1479,901,277,2657,46472
12-10-2017,7,17932,17848,7521,4946,48248,1484,1048,302,2834,51082
12-10-2017,8,18881,18013,7723,4858,49476,1498,1007,338,2843,52319
12-10-2017,9,18004,18111,7677,4864,48657,1513,962,330,2805,51462
12-10-2017,10,17214,18358,7565,5409,48546,1531,969,408,2908,51454
12-10-2017,11,16321,18444,7584,5506,47855,1535,968,423,2926,50781
12-10-2017,12,16268,18081,7595,5006,46949,1545,965,438,2948,49897
12-10-2017,13,16304,18148,7557,5307,47317,1545,957,373,2875,50192
12-10-2017,14,16049,18195,7564,5004,46810,1561,917,397,2875,49685
12-10-2017,15,15622,18049,7433,5305,46410,1546,819,399,2764,49174
12-10-2017,16,15980,18188,7336,5120,46624,1507,961,399,2867,49491
12-10-2017,17,17119,18180,7473,5546,48319,1586,1067,430,3083,51402
12-10-2017,18,17386,19023,7732,5401,49542,1589,1173,480,3242,52784
12-10-2017,19,17579,18934,7605,5176,49295,1581,1127,432,3140,52435
12-10-2017,20,16721,17669,7480,4923,46793,1581,1112,440,3133,49926
12-10-2017,21,15347,16580,7231,4690,43848,1452,1104,441,2997,46845
12-10-2017,22,14200,15953,7009,4207,41369,1293,949,444,2686,44055
12-10-2017,23,13232,15102,6820,3753,38908,1266,770,444,2480,41388
13-10-2017,0,12664,14824,6830,3368,37687,1106,707,443,2256,39943
13-10-2017,1,12286,14491,6792,3293,36862,1039,695,441,2175,39037
13-10-2017,2,12619,14233,6806,2822,36481,1036,692,438,2166,38647
13-10-2017,3,12835,14075,6827,2790,36527,1022,683,439,2144,38671
13-10-2017,4,13742,14096,6900,2463,37201,1050,678,420,2148,39349
13-10-2017,5,16106,14898,7107,1976,40087,1257,834,412,2503,42590
13-10-2017,6,19091,16773,7566,2553,45982,1535,938,407,2880,48862
13-10-2017,7,20560,18189,7959,3322,50029,1535,1102,453,3090,53119
13-10-2017,8,20861,17963,8073,3598,50495,1505,781,794,3080,53575
13-10-2017,9,20874,17616,8080,3658,50228,1525,768,826,3119,53347
13-10-2017,10,20955,17233,7967,3711,49867,1544,751,841,3136,53003
13-10-2017,11,20577,16971,7737,3562,48848,1537,757,867,3161,52009
13-10-2017,12,20772,16908,7720,3260,48661,1515,762,532,2809,51470
13-10-2017,13,20687,16793,7611,2938,48029,1513,754,485,2752,50781
13-10-2017,14,20271,16676,7433,3017,47397,1503,743,474,2720,50117
13-10-2017,15,19689,16442,7428,3109,46668,1474,772,479,2725,49393
13-10-2017,16,19372,16255,7519,3572,46717,1458,1087,677,3222,49939
13-10-2017,17,19313,16648,7616,3826,47403,1468,1122,683,3273,50676
13-10-2017,18,19521,16705,7800,4119,48146,1465,1266,725,3456,51602
13-10-2017,19,18920,16656,7661,4018,47256,1465,1262,548,3275,50531
13-10-2017,20,17231,16586,7079,3927,44823,1438,1094,316,2848,47671
13-10-2017,21,15964,16073,6888,3968,42894,1177,914,195,2286,45180
13-10-2017,22,14796,15381,6741,3914,40834,1020,767,126,1913,42747
13-10-2017,23,13366,15118,6551,3422,38457,875,550,118,1543,40000
14-10-2017,0,12985,14293,6606,3171,37055,866,274,123,1263,38318
14-10-2017,1,12365,14153,6451,3227,36197,817,175,126,1118,37315
14-10-2017,2,12083,14108,6487,3374,36052,774,175,129,1078,37130
14-10-2017,3,11868,13996,6557,3275,35697,797,173,90,1060,36757
14-10-2017,4,12110,13964,6586,3193,35854,814,173,84,1071,36925
14-10-2017,5,12867,13985,6645,3077,36574,799,226,94,1119,37693
14-10-2017,6,13368,14611,6817,3004,37801,797,344,116,1257,39058
14-10-2017,7,13943,14987,7004,2958,38893,803,704,189,1696,40589
14-10-2017,8,14613,15612,7209,3048,40480,792,935,247,1974,42454
14-10-2017,9,15458,15960,7283,3093,41795,842,955,256,2053,43848
14-10-2017,10,15400,15937,7273,3436,42046,968,1087,260,2315,44361
14-10-2017,11,14858,15433,7226,3247,40765,892,1092,279,2263,43028
14-10-2017,12,14312,15281,7164,3504,40260,865,1097,329,2291,42551
14-10-2017,13,13541,15234,7083,3298,39157,982,1110,371,2463,41620
14-10-2017,14,13773,15119,6964,3166,39023,1022,1123,385,2530,41553
14-10-2017,15,14194,15328,6852,2843,39217,991,1121,425,2537,41754
14-10-2017,16,15135,15978,6948,2862,40924,1027,1039,441,2507,43431
14-10-2017,17,16093,16413,6958,3190,42654,1104,1010,441,2555,45209
14-10-2017,18,17326,16678,7116,3145,44265,1150,964,456,2570,46835
14-10-2017,19,16958,16735,7052,2952,43698,1200,951,479,2630,46328
14-10-2017,20,15224,16560,6937,2868,41590,1239,897,481,2617,44207
14-10-2017,21,14490,15992,6907,2999,40388,1225,540,476,2241,42629
14-10-2017,22,13934,15623,6822,2731,39110,1085,265,368,1718,40828
14-10-2017,23,12926,14926,6538,2492,36884,1044,198,352,1594,38478
15-10-2017,0,12478,14506,6462,2064,35511,1031,196,339,1566,37077
15-10-2017,1,11968,14318,6342,2079,34708,1016,200,369,1585,36293
15-10-2017,2,11914,14204,6312,2231,34661,1030,204,381,1615,36276
15-10-2017,3,12241,14229,6305,2024,34800,1025,203,376,1604,36404
15-10-2017,4,12811,14240,6338,1738,35128,998,203,342,1543,36671
15-10-2017,5,13080,14562,6410,1618,35670,996,209,303,1508,37178
15-10-2017,6,13038,15041,6615,1477,36170,1006,285,266,1557,37727
15-10-2017,7,13190,14755,6647,1815,36409,991,637,229,1857,38266
15-10-2017,8,14111,14951,6991,1775,37829,967,937,226,2130,39959
15-10-2017,9,15236,15340,6956,1676,39209,1054,960,232,2246,41455
15-10-2017,10,15582,15358,6939,1912,39791,1066,961,203,2230,42021
15-10-2017,11,15553,15496,6885,2247,40180,1062,951,214,2227,42407
15-10-2017,12,14954,15187,6791,2662,39595,954,930,220,2104,41699
15-10-2017,13,14335,14974,6745,2961,39015,913,942,229,2084,41099
15-10-2017,14,14093,14978,6711,3030,38813,853,938,222,2013,40826
15-10-2017,15,14818,15143,6723,3039,39723,925,934,200,2059,41782
15-10-2017,16,15323,15833,6860,3069,41085,1042,933,180,2155,43240
15-10-2017,17,16347,16544,6968,3217,43076,1087,934,134,2155,45231
15-10-2017,18,17126,16822,7152,3520,44621,1109,936,130,2175,46796
15-10-2017,19,16597,16745,7190,3601,44133,1113,936,136,2185,46318
15-10-2017,20,14858,16837,7165,3293,42153,1101,938,127,2166,44319
15-10-2017,21,14260,16604,7252,3242,41358,946,648,108,1702,43060
15-10-2017,22,12688,16051,7054,3145,38938,941,403,94,1438,40376
15-10-2017,23,10723,15211,6906,3299,36141,901,183,92,1176,37317
16-10-2017,0,10413,14813,6768,2746,34740,941,184,100,1225,35965
16-10-2017,1,10481,14784,6782,2545,34592,900,199,123,1222,35814
16-10-2017,2,10621,14755,6865,2266,34508,918,206,124,1248,35756
16-10-2017,3,10692,14980,7018,2187,34879,950,299,142,1391,36270
16-10-2017,4,10952,15196,7162,1863,35174,1008,303,164,1475,36649
16-10-2017,5,12864,16353,7455,1845,38517,1012,543,189,1744,40261
16-10-2017,6,16262,17850,7961,1700,43773,1167,950,187,2304,46077
16-10-2017,7,17949,19004,8339,2353,47646,1222,970,489,2681,50327
16-10-2017,8,18358,19078,8317,2399,48152,1281,1042,643,2966,51118
16-10-2017,9,18343,19082,8393,2405,48225,1185,1044,618,2847,51072
16-10-2017,10,18284,19059,8273,2694,48310,1202,997,412,2611,50921
16-10-2017,11,18369,18834,8311,2866,48380,1223,984,259,2466,50846
16-10-2017,12,18228,18681,8421,2824,48155,1228,983,246,2457,50612
16-10-2017,13,17988,18613,8229,2289,47121,1251,971,438,2660,49781
16-10-2017,14,17860,18379,8109,2412,46759,1259,972,439,2670,49429
16-10-2017,15,17900,18200,8032,1971,46103,1265,998,469,2732,48835
16-10-2017,16,17888,18166,7959,2322,46336,1250,1011,548,2809,49145
16-10-2017,17,18671,17979,8119,2377,47148,1257,952,640,2849,49997
16-10-2017,18,19252,18424,8378,2510,48565,1232,964,724,2920,51485
16-10-2017,19,18955,18279,8226,2370,47830,1237,942,687,2866,50696
16-10-2017,20,17548,17483,8095,2237,45363,1208,904,373,2485,47848
16-10-2017,21,16468,17023,7965,2259,43715,1175,792,203,2170,45885
16-10-2017,22,14992,16597,7770,1885,41245,1017,745,163,1925,43170
16-10-2017,23,13375,15688,7750,2089,38902,975,441,129,1545,40447
17-10-2017,0,13346,14236,7640,2268,37490,953,172,95,1220,38710
17-10-2017,1,12613,13747,7534,2752,36647,959,173,87,1219,37866
17-10-2017,2,12012,13861,7504,3165,36542,980,179,95,1254,37796
17-10-2017,3,11751,13806,7462,3285,36305,979,314,102,1395,37700
17-10-2017,4,12452,13951,7373,3285,37061,1016,511,93,1620,38681
17-10-2017,5,13574,15111,7482,3450,39618,1081,722,89,1892,41510
17-10-2017,6,16311,16511,7848,3460,44130,1289,933,160,2382,46512
17-10-2017,7,18121,17645,8132,3805,47702,1299,957,447,2703,50405
17-10-2017,8,18636,17963,8099,4080,48777,1300,1034,500,2834,51611
17-10-2017,9,18122,17661,7869,4215,47867,1262,1105,407,2774,50641
17-10-2017,10,18183,17929,7732,4388,48233,1297,1120,328,2745,50978
17-10-2017,11,18102,18154,7590,4343,48191,1273,1145,284,2702,50893
17-10-2017,12,17445,18067,7540,4577,47628,1279,1142,343,2764,50392
17-10-2017,13,17386,18118,7567,4747,47817,1302,1142,297,2741,50558
17-10-2017,14,16953,18226,7448,4813,47441,1317,1155,326,2798,50239
17-10-2017,15,17005,17838,7478,4853,47175,1335,1055,331,2721,49896
17-10-2017,16,16991,17908,7371,4672,46940,1359,1158,648,3165,50105
17-10-2017,17,17396,18163,7636,4596,47792,1380,1157,602,3139,50931
17-10-2017,18,17922,18516,7691,4558,48687,1393,1152,834,3379,52066
17-10-2017,19,17313,19066,7570,4368,48316,1390,1105,710,3205,51521
17-10-2017,20,16295,17700,7027,4148,45171,1366,955,582,2903,48074
17-10-2017,21,15568,17185,6626,4217,43598,1190,774,326,2290,45888
17-10-2017,22,13985,16737,6542,4206,41468,1136,689,299,2124,43592
17-10-2017,23,12635,15941,6430,4128,39134,1139,525,282,1946,41080
18-10-2017,0,12024,15313,6350,4155,37842,1117,211,341,1669,39511
18-10-2017,1,11145,15016,6349,4009,36519,1091,214,271,1576,38095
18-10-2017,2,11052,14990,6409,3827,36278,1125,220,274,1619,37897
18-10-2017,3,10988,14991,6398,3651,36030,1173,278,267,1718,37748
18-10-2017,4,11824,15047,6234,3459,36565,1370,357,295,2022,38587
18-10-2017,5,14249,16032,6469,3344,40094,1654,578,315,2547,42641
18-10-2017,6,16556,17959,6986,3239,44741,1775,969,397,3141,47882
18-10-2017,7,18961,19160,7324,3614,49060,1778,994,389,3161,52221
18-10-2017,8,19156,19873,7505,3594,50129,1840,1117,491,3448,53577
18-10-2017,9,19425,19700,7532,3716,50375,1737,1202,571,3510,53885
18-10-2017,10,19033,19763,7530,3803,50129,1750,1237,615,3602,53731
18-10-2017,11,18707,19644,7495,3528,49375,1716,1281,682,3679,53054
18-10-2017,12,18468,19173,7473,3230,48344,1722,1256,659,3637,51981
18-10-2017,13,18294,18956,7423,3113,47787,1676,1183,671,3530,51317
18-10-2017,14,18464,18793,7352,3005,47614,1660,1072,622,3354,50968
18-10-2017,15,18413,18663,7460,3094,47632,1687,1175,588,3450,51082
18-10-2017,16,18503,18494,7528,3271,47796,1680,1240,569,3489,51285
18-10-2017,17,19754,18972,7811,3155,49692,1709,1314,208,3231,52923
18-10-2017,18,20109,19130,7926,3381,50546,1755,1339,566,3660,54206
18-10-2017,19,20225,19404,7784,3524,50937,1751,1358,557,3666,54603
18-10-2017,20,20006,18690,7401,3355,49452,1712,1042,541,3295,52747
18-10-2017,21,19984,17771,6930,3080,47765,1661,955,125,2741,50506
18-10-2017,22,19099,17547,6610,2417,45675,1624,942,110,2676,48351
18-10-2017,23,18088,17228,6426,1837,43579,1632,669,45,2346,45925
19-10-2017,0,17262,16479,6299,1484,41523,1631,350,62,2043,43566
19-10-2017,1,16633,15896,6247,1545,40322,1617,332,75,2024,42346
19-10-2017,2,16481,15689,6310,1571,40050,1626,331,86,2043,42093
19-10-2017,3,16530,15645,6315,1533,40024,1626,385,77,2088,42112
19-10-2017,4,16965,15835,6318,1580,40696,1636,565,93,2294,42990
19-10-2017,5,18327,16994,6705,1879,43905,1644,997,90,2731,46636
19-10-2017,6,19793,18693,7247,2826,48559,1634,1221,194,3049,51608
19-10-2017,7,20873,19251,7636,3612,51371,1649,1338,234,3221,54592
19-10-2017,8,21241,19034,7600,3933,51808,1629,1364,481,3474,55282
19-10-2017,9,21072,19097,7430,4206,51806,1636,1371,495,3502,55308
19-10-2017,10,21153,19384,7296,4340,52173,1625,1370,481,3476,55649
19-10-2017,11,20661,18683,7140,4182,50666,1629,1370,263,3262,53928
19-10-2017,12,20518,18689,7176,4076,50458,1645,1364,117,3126,53584
19-10-2017,13,20204,18339,7147,3951,49642,1629,1260,98,2987,52629
19-10-2017,14,19999,18509,7097,4076,49681,1631,1249,110,2990,52671
19-10-2017,15,19944,18680,7203,4195,50022,1637,1246,111,2994,53016
19-10-2017,16,20063,18588,7350,4403,50406,1635,1275,112,3022,53428
19-10-2017,17,20303,18988,7405,4618,51314,1633,1281,476,3390,54704
19-10-2017,18,20356,19261,7486,4947,52050,1648,1357,532,3537,55587
19-10-2017,19,20344,19127,7468,4495,51435,1641,1362,537,3540,54975
19-10-2017,20,20588,18522,7025,3680,49817,1639,1186,152,2977,52794
19-10-2017,21,20099,17952,6599,3600,48251,1624,1081,104,2809,51060
19-10-2017,22,19175,17611,6256,3402,46445,1601,985,117,2703,49148
19-10-2017,23,18049,16746,6181,3515,44492,1548,586,130,2264,46756
20-10-2017,0,17313,15651,6140,3377,42482,1571,356,133,2060,44542
20-10-2017,1,16508,14876,6213,3139,40736,1586,358,155,2099,42835
20-10-2017,2,16113,14630,6311,3124,40179,1579,357,160,2096,42275
20-10-2017,3,16218,14637,6388,3175,40417,1598,359,149,2106,42523
20-10-2017,4,16844,14863,6508,3177,41391,1640,453,162,2255,43646
20-10-2017,5,17549,16165,6831,3058,43605,1722,818,249,2789,46394
20-10-2017,6,19197,18019,7333,3375,47924,1761,1176,214,3151,51075
20-10-2017,7,20965,19325,7776,4085,52152,1769,1219,607,3595,55747
20-10-2017,8,21027,19565,7808,4524,52925,1753,1189,619,3561,56486
20-10-2017,9,21144,19773,7767,4523,53206,1748,1158,593,3499,56705
20-10-2017,10,21036,19895,7695,4349,52975,1745,1086,619,3450,56425
20-10-2017,11,20951,19706,7691,4112,52459,1741,1114,389,3244,55703
20-10-2017,12,21000,19197,7617,3530,51345,1751,1116,363,3230,54575
20-10-2017,13,20581,18648,7515,3717,50460,1745,1121,369,3235,53695
20-10-2017,14,20389,18566,7515,3347,49818,1746,1132,387,3265,53083
20-10-2017,15,20539,18652,7543,3329,50064,1744,1133,239,3116,53180
20-10-2017,16,20541,18869,7589,3427,50427,1760,1142,245,3147,53574
20-10-2017,17,21064,19267,7691,3433,51455,1762,1151,275,3188,54643
20-10-2017,18,21036,19825,7770,3425,52057,1767,1318,434,3519,55576
20-10-2017,19,20829,19318,7757,3117,51021,1765,1168,357,3290,54311
20-10-2017,20,19716,18876,7063,2731,48385,1747,1118,244,3109,51494
20-10-2017,21,18929,18608,6630,2474,46642,1327,932,196,2455,49097
20-10-2017,22,17894,18225,6453,2323,44893,1191,785,189,2165,47058
20-10-2017,23,16909,17615,6326,2276,43127,1149,454,188,1791,44918
21-10-2017,0,17516,15827,6276,2123,41744,1081,199,170,1450,43194
21-10-2017,1,17029,15594,6234,1973,40831,1012,186,151,1349,42180
21-10-2017,2,16482,15291,6235,1826,39833,998,186,141,1325,41158
21-10-2017,3,16388,15416,6240,1748,39791,991,190,144,1325,41116
21-10-2017,4,16208,15542,6309,1660,39719,991,220,155,1366,41085
21-10-2017,5,17275,16054,6428,1705,41462,1011,509,176,1696,43158
21-10-2017,6,17294,16702,6449,1800,42246,1032,761,210,2003,44249
21-10-2017,7,17263,17535,6671,2041,43510,1036,954,253,2243,45753
21-10-2017,8,18318,17849,6790,2288,45246,1036,960,299,2295,47541
21-10-2017,9,19247,18399,6875,2467,46988,1039,954,292,2285,49273
21-10-2017,10,19643,18613,6801,2656,47715,1022,953,298,2273,49988
21-10-2017,11,19283,18531,6804,2921,47538,1029,940,309,2278,49816
21-10-2017,12,19002,18225,6762,2882,46871,1010,950,329,2289,49160
21-10-2017,13,18455,17916,6703,3040,46114,1009,937,324,2270,48384
21-10-2017,14,18149,17816,6647,3099,45711,1058,949,308,2315,48026
21-10-2017,15,18153,17779,6610,3190,45731,1108,946,314,2368,48099
21-10-2017,16,18793,17814,6679,3244,46530,1106,927,278,2311,48841
21-10-2017,17,20198,18453,6924,3352,48927,1143,942,276,2361,51288
21-10-2017,18,20336,18667,7235,3744,49982,1187,947,293,2427,52409
21-10-2017,19,19477,18577,6919,3718,48692,1159,954,267,2380,51072
21-10-2017,20,17985,18205,6743,3418,46353,1158,956,288,2402,48755
21-10-2017,21,16961,17662,6581,3221,44424,1182,501,293,1976,46400
21-10-2017,22,15284,16837,6517,2976,41613,1131,491,261,1883,43496
21-10-2017,23,13516,15858,6338,2853,38565,997,226,254,1477,40042
22-10-2017,0,13984,14569,6260,2631,37444,971,199,216,1386,38830
22-10-2017,1,13183,14397,6215,2525,36319,923,197,181,1301,37620
22-10-2017,2,12605,14138,6207,2447,35398,912,192,193,1297,36695
22-10-2017,3,12488,13917,6200,2503,35108,912,193,223,1328,36436
22-10-2017,4,12297,13895,6215,2447,34854,912,196,206,1314,36168
22-10-2017,5,12384,14020,6269,2400,35073,919,195,204,1318,36391
22-10-2017,6,13544,14284,6383,2411,36622,968,195,220,1383,38005
22-10-2017,7,14138,14808,6418,2432,37797,962,372,212,1546,39343
22-10-2017,8,15243,15991,6557,2497,40287,1111,527,204,1842,42129
22-10-2017,9,16066,16375,6697,2517,41655,1166,637,222,2025,43680
22-10-2017,10,16909,16607,6685,2521,42721,1147,636,224,2007,44728
22-10-2017,11,17150,16727,6685,2457,43019,1146,718,213,2077,45096
22-10-2017,12,17088,16602,6763,2421,42874,1149,727,207,2083,44957
22-10-2017,13,16911,16629,6782,2398,42720,1146,730,214,2090,44810
22-10-2017,14,17065,16679,6779,2265,42788,1145,729,204,2078,44866
22-10-2017,15,17979,17122,6862,2075,44038,1179,735,185,2099,46137
22-10-2017,16,18396,17351,6988,2061,44796,1188,741,171,2100,46896
22-10-2017,17,20180,18293,7107,1999,47580,1233,875,165,2273,49853
22-10-2017,18,20746,18988,7163,2128,49025,1224,954,402,2580,51605
22-10-2017,19,20676,18608,7173,2106,48563,1246,930,398,2574,51137
22-10-2017,20,20139,18089,7183,1843,47254,1177,895,312,2384,49638
22-10-2017,21,19687,17721,6973,1672,46053,1161,795,166,2122,48175
22-10-2017,22,19102,17250,6737,1523,44612,1083,724,152,1959,46571
22-10-2017,23,17343,16700,6629,1414,42087,1062,355,165,1582,43669
23-10-2017,0,15092,15557,6469,1443,38562,1205,197,177,1579,40141
23-10-2017,1,14017,15156,6377,1477,37028,1234,195,182,1611,38639
23-10-2017,2,13059,15115,6366,1420,35960,1220,193,189,1602,37562
23-10-2017,3,13016,15143,6283,1426,35869,1297,195,196,1688,37557
23-10-2017,4,14065,15387,6390,1452,37293,1434,210,198,1842,39135
23-10-2017,5,17185,17078,7041,1744,43048,1574,345,197,2116,45164
23-10-2017,6,19971,18384,7719,2155,48229,1735,1011,262,3008,51237
23-10-2017,7,21613,20150,7919,2496,52178,1748,1267,673,3688,55866
23-10-2017,8,22144,20406,7938,2817,53306,1760,1385,731,3876,57182
23-10-2017,9,22310,20579,7904,3127,53920,1766,1482,726,3974,57894
23-10-2017,10,21984,20384,7890,3327,53587,1759,1508,676,3943,57530
23-10-2017,11,21692,20437,7754,3474,53357,1756,1400,672,3828,57185
23-10-2017,12,21306,20115,7785,3159,52365,1765,1489,685,3939,56304
23-10-2017,13,21706,19906,7738,2891,52242,1769,1307,677,3753,55995
23-10-2017,14,21518,20177,7727,3110,52535,1780,1305,667,3752,56287
23-10-2017,15,21742,20134,7741,2948,52565,1783,1295,670,3748,56313
23-10-2017,16,21789,20210,7803,3069,52870,1787,1294,696,3777,56647
23-10-2017,17,22048,20804,7864,3444,54160,1785,1470,709,3964,58124
23-10-2017,18,22270,21009,7884,4049,55212,1808,1587,734,4129,59341
23-10-2017,19,21437,20520,7876,3788,53619,1807,1469,733,4009,57628
23-10-2017,20,21564,19430,7543,3138,51674,1813,1043,645,3501,55175
23-10-2017,21,21487,18826,7159,3021,50492,1815,809,275,2899,53391
23-10-2017,22,20353,18693,6889,2742,48677,1776,630,193,2599,51276
23-10-2017,23,18887,18084,6503,2475,45951,1761,465,171,2397,48348
24-10-2017,0,17874,16767,6341,2511,43493,1677,462,173,2312,45805
24-10-2017,1,17531,16338,6330,2588,42786,1669,413,193,2275,45061
24-10-2017,2,17074,16282,6306,2559,42223,1678,409,199,2286,44509
24-10-2017,3,16781,16686,6442,2698,42607,1675,413,174,2262,44869
24-10-2017,4,16680,16719,6586,2824,42809,1669,431,172,2272,45081
24-10-2017,5,17570,17257,7299,2894,45021,1705,862,191,2758,47779
24-10-2017,6,19496,18906,7894,3156,49451,1768,1274,241,3283,52734
24-10-2017,7,21586,19978,8014,3577,53153,1785,1526,612,3923,57076
24-10-2017,8,22008,20368,8079,3657,54114,1784,1681,620,4085,58199
24-10-2017,9,21699,20242,8149,3516,53607,1778,1746,594,4118,57725
24-10-2017,10,21593,20131,8146,3476,53346,1784,1750,361,3895,57241
24-10-2017,11,21340,19962,8059,3826,53187,1827,1696,382,3905,57092
24-10-2017,12,21175,19777,8046,3724,52723,1900,1552,398,3850,56573
24-10-2017,13,21008,19817,8060,3613,52499,1900,1481,382,3763,56262
24-10-2017,14,20729,19856,7927,3438,51948,1887,1470,343,3700,55648
24-10-2017,15,20405,19957,7916,3575,51853,1867,1456,166,3489,55342
24-10-2017,16,20180,20260,7985,3824,52250,1877,1392,151,3420,55670
24-10-2017,17,20578,20919,8060,3950,53507,1899,1535,181,3615,57122
24-10-2017,18,20667,21254,8109,3970,54001,1915,1691,606,4212,58213
24-10-2017,19,20079,21405,8131,3805,53421,1912,1483,454,3849,57270
24-10-2017,20,19027,20989,7781,3729,51525,1914,983,269,3166,54691
24-10-2017,21,17717,20428,7378,3217,48740,1932,896,249,3077,51817
24-10-2017,22,15557,20013,7119,3198,45887,1916,881,271,3068,48955
24-10-2017,23,13208,18939,6992,3150,42288,1839,490,266,2595,44883
25-10-2017,0,11873,17938,7144,3100,40055,1409,430,278,2117,42172
25-10-2017,1,10905,17620,7137,3056,38718,1145,432,297,1874,40592
25-10-2017,2,10613,17402,7084,2946,38046,1154,436,320,1910,39956
25-10-2017,3,10605,17421,7135,2819,37982,1204,437,332,1973,39955
25-10-2017,4,11352,17899,7195,2642,39087,1267,434,326,2027,41114
25-10-2017,5,13408,19033,7411,2257,42110,1692,476,339,2507,44617
25-10-2017,6,17401,20653,7896,2402,48351,1856,1208,394,3458,51809
25-10-2017,7,19986,21247,8279,2892,52404,1902,1435,366,3703,56107
25-10-2017,8,20317,21130,8227,3223,52897,1879,1472,578,3929,56826
25-10-2017,9,20080,20846,8231,3817,52974,1877,1382,422,3681,56655
25-10-2017,10,19914,20747,8062,4006,52730,1918,1354,433,3705,56435
25-10-2017,11,19579,20660,8005,4244,52489,1936,1316,450,3702,56191
25-10-2017,12,18878,20300,8009,4197,51385,1954,1312,455,3721,55106
25-10-2017,13,18516,20170,8003,4636,51326,1924,1292,461,3677,55003
25-10-2017,14,18808,20205,7933,4357,51302,1925,1279,462,3666,54968
25-10-2017,15,18534,19973,7890,4314,50711,1972,1273,480,3725,54436
25-10-2017,16,18743,20306,8049,4197,51295,1966,1217,480,3663,54958
25-10-2017,17,20106,20363,8295,3838,52604,1977,1334,541,3852,56456
25-10-2017,18,20684,20596,8336,3637,53252,1980,1474,457,3911,57163
25-10-2017,19,20091,20394,8309,3681,52476,1940,1272,454,3666,56142
25-10-2017,20,18527,19820,7789,3758,49894,1958,1017,410,3385,53279
25-10-2017,21,17042,19210,7522,3631,47406,1953,927,427,3307,50713
25-10-2017,22,14888,18602,7370,3600,44460,1957,699,395,3051,47511
25-10-2017,23,13496,17986,7174,3386,42043,1927,469,422,2818,44861
26-10-2017,0,13256,16686,7009,3540,40493,1537,439,435,2411,42904
26-10-2017,1,12926,16501,6932,3275,39635,1394,441,425,2260,41895
26-10-2017,2,12802,16438,6856,3258,39355,1370,441,425,2236,41591
26-10-2017,3,13094,16347,6811,3182,39433,1345,452,421,2218,41651
26-10-2017,4,13643,16392,6867,3382,40286,1494,466,396,2356,42642
26-10-2017,5,15701,17717,6974,3187,43578,1671,576,413,2660,46238
26-10-2017,6,18111,21120,7442,3101,49775,1806,1001,446,3253,53028
26-10-2017,7,21093,22032,7880,3150,54155,1798,1306,660,3764,57919
26-10-2017,8,21453,22216,8022,3161,54853,1794,1471,739,4004,58857
26-10-2017,9,21262,21826,8008,3274,54371,1786,1510,725,4021,58392
26-10-2017,10,20640,21593,7922,3842,53996,1786,1612,633,4031,58027
26-10-2017,11,20049,21446,7923,3927,53345,1787,1629,545,3961,57306
26-10-2017,12,19459,20012,7856,4049,51377,1770,1623,450,3843,55220
26-10-2017,13,19140,19956,7524,3880,50501,1752,1630,448,3830,54331
26-10-2017,14,19073,19824,7358,3921,50177,1760,1641,450,3851,54028
26-10-2017,15,19137,19076,7298,4098,49610,1752,1638,441,3831,53441
26-10-2017,16,19393,19038,7255,3959,49646,1761,1633,413,3807,53453
26-10-2017,17,20063,19210,7581,4043,50898,1769,1629,780,4178,55076
26-10-2017,18,20550,19209,7688,4346,51793,1773,1713,749,4235,56028
26-10-2017,19,20207,18952,7657,4216,51031,1767,1558,619,3944,54975
26-10-2017,20,19429,18576,7263,4147,49416,1755,905,244,2904,52320
26-10-2017,21,18237,18218,6747,4339,47541,1765,725,187,2677,50218
26-10-2017,22,16902,17508,6266,4308,44985,1642,595,207,2444,47429
26-10-2017,23,14871,16803,5999,4252,41926,1600,443,168,2211,44137
27-10-2017,0,13547,15615,5826,4454,39443,1431,423,144,1998,41441
27-10-2017,1,13489,15251,5884,4356,38980,1209,419,85,1713,40693
27-10-2017,2,13253,15081,5861,4076,38272,1198,416,55,1669,39941
27-10-2017,3,13208,15167,5829,3939,38143,1188,416,39,1643,39786
27-10-2017,4,13041,15390,6063,3849,38342,1237,420,40,1697,40039
27-10-2017,5,14421,16587,6806,3504,41319,1572,681,35,2288,43607
27-10-2017,6,17925,18347,7644,3359,47275,1778,1193,189,3160,50435
27-10-2017,7,20989,19487,8072,3392,51942,1802,1348,164,3314,55256
27-10-2017,8,21620,20042,7963,3352,52979,1802,1442,379,3623,56602
27-10-2017,9,21547,20001,7870,3220,52639,1794,1569,454,3817,56456
27-10-2017,10,21206,20244,7813,3235,52499,1774,1573,502,3849,56348
27-10-2017,11,20730,19900,7746,3277,51653,1748,1493,335,3576,55229
27-10-2017,12,18708,19521,7862,3435,49527,1726,1506,200,3432,52959
27-10-2017,13,17275,18978,7592,3997,47843,1741,1644,278,3663,51506
27-10-2017,14,16336,18732,7556,4163,46789,1741,1579,188,3508,50297
27-10-2017,15,16401,18912,7504,4298,47115,1746,1509,207,3462,50577
27-10-2017,16,17759,19497,7763,3886,48904,1743,1599,212,3554,52458
27-10-2017,17,18854,19857,7913,3816,50439,1736,1635,533,3904,54343
27-10-2017,18,18871,20043,7703,4509,51127,1737,1631,607,3975,55102
27-10-2017,19,17052,20015,7687,4717,49473,1726,1487,233,3446,52919
27-10-2017,20,15784,19267,7197,4659,46907,1467,931,157,2555,49462
27-10-2017,21,15152,18898,6806,4367,45223,1153,685,136,1974,47197
27-10-2017,22,14012,18400,6667,4442,43522,953,517,64,1534,45056
27-10-2017,23,12012,17368,6538,4697,40616,749,418,44,1211,41827
28-10-2017,0,11870,15920,6598,4356,38744,655,247,41,943,39687
28-10-2017,1,11837,16309,6660,4161,38968,672,242,49,963,39931
28-10-2017,2,11197,16256,6793,3992,38238,677,243,76,996,39234
28-10-2017,3,10701,16100,6864,3909,37574,697,211,109,1017,38591
28-10-2017,4,10808,15942,6930,3657,37337,727,242,119,1088,38425
28-10-2017,5,11176,15906,6890,3797,37769,740,440,147,1327,39096
28-10-2017,6,11651,16257,6912,4100,38920,793,539,211,1543,40463
28-10-2017,7,12792,16952,6929,4544,41215,851,573,247,1671,42886
28-10-2017,8,13245,17399,7023,4753,42419,945,578,300,1823,44242
28-10-2017,9,13724,17824,7163,4932,43643,1009,577,326,1912,45555
28-10-2017,10,13823,18570,7250,4949,44592,1006,573,325,1904,46496
28-10-2017,11,13774,18522,7204,4979,44479,973,663,405,2041,46520
28-10-2017,12,13373,18389,7089,4729,43581,962,714,390,2066,45647
28-10-2017,13,13133,18258,6937,4502,42831,963,657,380,2000,44831
28-10-2017,14,13149,18148,6840,4395,42533,956,706,371,2033,44566
28-10-2017,15,13341,17978,6951,4292,42560,989,834,292,2115,44675
28-10-2017,16,13606,18446,6995,4359,43406,1115,887,261,2263,45669
28-10-2017,17,14442,19409,7086,4535,45474,1091,986,266,2343,47817
28-10-2017,18,14966,19525,7282,4667,46439,1061,1182,267,2510,48949
28-10-2017,19,14569,18969,7043,4525,45107,1054,993,321,2368,47475
28-10-2017,20,13761,18058,6904,4475,43196,1025,838,356,2219,45415
28-10-2017,21,13535,17479,6766,4025,41805,921,663,345,1929,43734
28-10-2017,22,12963,17083,6662,3969,40677,851,388,228,1467,42144
28-10-2017,23,12424,16587,6490,3763,39265,703,249,269,1221,40486
29-10-2017,0,11782,15444,6506,3646,37379,815,194,197,1206,38585
29-10-2017,1,10982,15612,6457,3228,36280,820,186,171,1177,37457
29-10-2017,2,10677,15841,6386,2791,35694,813,187,127,1127,36821
29-10-2017,2,10375,16040,6434,2782,35632,816,188,117,1121,36753
29-10-2017,3,10544,16307,6486,2642,35980,813,187,107,1107,37087
29-10-2017,4,10959,16829,6489,2741,37017,810,194,97,1101,38118
29-10-2017,5,10798,17265,6479,3080,37621,801,591,89,1481,39102
29-10-2017,6,11247,17692,6606,3343,38888,800,673,94,1567,40455
29-10-2017,7,11462,18087,6782,3792,40123,797,678,83,1558,41681
29-10-2017,8,11715,18612,6931,4355,41612,804,678,169,1651,43263
29-10-2017,9,12479,19329,7125,4392,43325,800,754,212,1766,45091
29-10-2017,10,12751,19301,7102,4477,43630,794,779,222,1795,45425
29-10-2017,11,12350,19149,7156,4664,43320,796,870,254,1920,45240
29-10-2017,12,12113,19032,7323,4594,43063,796,865,351,2012,45075
29-10-2017,13,12059,18719,7467,4464,42709,801,876,372,2049,44758
29-10-2017,14,12067,18905,7498,4445,42916,842,885,401,2128,45044
29-10-2017,15,12503,19039,7699,4395,43637,880,876,422,2178,45815
29-10-2017,16,13378,20047,7931,4531,45888,942,878,449,2269,48157
29-10-2017,17,14318,21095,8201,4435,48049,1050,877,437,2364,50413
29-10-2017,18,14353,21589,8206,4291,48439,1049,890,435,2374,50813
29-10-2017,19,13746,21610,7951,3993,47300,1062,892,433,2387,49687
29-10-2017,20,12571,20575,7690,4097,44933,984,718,422,2124,47057
29-10-2017,21,12302,19757,7670,3869,43598,980,677,372,2029,45627
29-10-2017,22,11936,19583,7562,3643,42724,869,402,352,1623,44347
29-10-2017,23,11480,18786,7439,3438,41144,803,213,305,1321,42465
30-10-2017,0,11705,17729,7225,3386,40045,839,215,315,1369,41414
30-10-2017,1,11545,18634,7255,3248,40681,831,215,337,1383,42064
30-10-2017,2,11534,18731,7244,3184,40695,852,242,361,1455,42150
30-10-2017,3,11558,18784,7259,3127,40729,867,569,377,1813,42542
30-10-2017,4,11593,19012,7280,3102,40988,896,850,377,2123,43111
30-10-2017,5,12868,20881,7598,3153,44500,1128,856,391,2375,46875
30-10-2017,6,16439,22852,7981,3446,50719,1293,864,406,2563,53282
30-10-2017,7,19339,23576,8402,3682,54998,1314,1093,480,2887,57885
30-10-2017,8,20508,23509,8695,3264,55977,1326,1096,483,2905,58882
30-10-2017,9,20538,22990,8617,3289,55433,1337,1212,481,3030,58463
30-10-2017,10,19843,22767,8492,3421,54524,1339,1239,490,3068,57592
30-10-2017,11,18963,22464,8365,3630,53422,1338,1202,495,3035,56457
30-10-2017,12,19031,22130,8546,3504,53213,1344,1210,467,3021,56234
30-10-2017,13,19127,21870,8441,3345,52784,1347,1143,488,2978,55762
30-10-2017,14,19336,21927,8537,3464,53263,1353,1100,462,2915,56178
30-10-2017,15,20330,22184,8660,3465,54640,1336,1137,495,2968,57608
30-10-2017,16,21032,22553,8985,3244,55814,1350,1217,484,3051,58865
30-10-2017,17,21368,22931,9059,3544,56902,1353,1290,880,3523,60425
30-10-2017,18,21295,22649,8985,3253,56182,1332,1212,880,3424,59606
30-10-2017,19,20911,22030,8485,3090,54516,1350,958,854,3162,57678
30-10-2017,20,20040,21412,8199,2912,52564,1355,862,586,2803,55367
30-10-2017,21,19704,20677,7877,2752,51010,1373,859,371,2603,53613
30-10-2017,22,18435,19741,7623,2688,48487,1384,828,368,2580,51067
30-10-2017,23,16890,18660,7301,2782,45632,1403,424,350,2177,47809
31-10-2017,0,16903,17237,7196,2273,43608,1301,262,325,1888,45496
31-10-2017,1,16581,17106,7157,2126,42970,1301,273,298,1872,44842
31-10-2017,2,16369,16828,7140,2185,42523,1332,281,313,1926,44449
31-10-2017,3,16256,16750,7096,2205,42309,1334,740,284,2358,44667
31-10-2017,4,17198,16863,7244,2194,43499,1359,889,269,2517,46016
31-10-2017,5,18948,18440,7583,2427,47399,1450,923,364,2737,50136
31-10-2017,6,20106,20119,7919,2717,50861,1560,1164,322,3046,53907
31-10-2017,7,21358,21139,8489,2846,53831,1563,1159,501,3223,57054
31-10-2017,8,21591,21275,8584,3298,54750,1554,1181,656,3391,58141
31-10-2017,9,21358,21160,8515,2998,54030,1543,1178,610,3331,57361
31-10-2017,10,21228,21150,8491,2998,53869,1546,1186,523,3255,57124
31-10-2017,11,20722,21246,8267,3144,53379,1524,1195,498,3217,56596
31-10-2017,12,20452,20946,8149,2911,52459,1497,1196,519,3212,55671
31-10-2017,13,20276,20615,8174,2799,51865,1520,1207,472,3199,55064
31-10-2017,14,20355,20864,8103,2981,52304,1487,1194,623,3304,55608
31-10-2017,15,20615,21070,8358,3001,53046,1482,1193,653,3328,56374
31-10-2017,16,21114,21272,8683,3057,54126,1476,1331,634,3441,57567
31-10-2017,17,21198,21889,8753,3506,55347,1471,1466,616,3553,58900
31-10-2017,18,20417,21387,8485,3441,53731,1438,1456,617,3511,57242
31-10-2017,19,19885,20884,8309,3084,52162,1426,1172,571,3169,55331
31-10-2017,20,19702,20478,7739,2741,50659,1416,979,250,2645,53304
31-10-2017,21,19292,19845,7400,2411,48947,1403,883,135,2421,51368
31-10-2017,22,18135,18788,7036,2372,46332,1388,850,199,2437,48769
31-10-2017,23,16594,17854,6787,2149,43384,1373,535,107,2015,45399
01-11-2017,0,15518,16529,6851,2268,41166,1263,396,46,1705,42871
01-11-2017,1,14799,16388,6848,2358,40393,1267,385,74,1726,42119
01-11-2017,2,14027,16273,6912,2431,39644,1247,397,108,1752,41396
01-11-2017,3,13605,16375,6881,2430,39291,1088,750,127,1965,41256
01-11-2017,4,14040,16588,6978,2641,40247,1291,1030,160,2481,42728
01-11-2017,5,15505,17819,7367,2724,43416,1400,1032,176,2608,46024
01-11-2017,6,17936,19490,7859,2664,47951,1458,956,291,2705,50656
01-11-2017,7,20024,20520,7898,2962,51403,1472,1091,305,2868,54271
01-11-2017,8,20688,20812,8061,2996,52558,1468,1158,294,2920,55478
01-11-2017,9,20537,20589,7942,3145,52214,1472,1155,271,2898,55112
01-11-2017,10,20270,20682,7507,3585,52044,1419,1150,268,2837,54881
01-11-2017,11,19895,20625,7333,4007,51859,1466,987,297,2750,54609
01-11-2017,12,19213,20435,7521,4390,51559,1472,1009,313,2794,54353
01-11-2017,13,18621,20280,7706,4738,51344,1451,1125,327,2903,54247
01-11-2017,14,18731,20490,7637,4121,50981,1444,1129,301,2874,53855
01-11-2017,15,18946,20811,7977,3888,51622,1449,1132,310,2891,54513
01-11-2017,16,19626,21376,8310,4030,53344,1436,1126,426,2988,56332
01-11-2017,17,20140,21612,8273,3982,54007,1444,1126,512,3082,57089
01-11-2017,18,19789,21696,8163,3867,53517,1445,1127,444,3016,56533
01-11-2017,19,18702,21551,7960,3907,52119,1445,954,342,2741,54860
01-11-2017,20,17275,20996,7513,3963,49746,1434,811,193,2438,52184
01-11-2017,21,16068,20216,7148,3970,47404,1277,809,172,2258,49662
01-11-2017,22,14274,19271,7019,3751,44316,1181,800,180,2161,46477
01-11-2017,23,12924,18137,7216,4362,42640,911,408,165,1484,44124
02-11-2017,0,11844,17138,7357,4445,40785,850,237,211,1298,42083
02-11-2017,1,11226,16780,7380,4304,39692,856,237,244,1337,41029
02-11-2017,2,11273,16600,7415,4281,39571,867,243,265,1375,40946
02-11-2017,3,11695,16582,7283,4053,39614,858,242,284,1384,40998
02-11-2017,4,12159,16811,7283,4160,40415,893,260,284,1437,41852
02-11-2017,5,13753,18349,7702,4045,43849,1252,705,336,2293,46142
02-11-2017,6,16828,19805,8114,3824,48572,1408,1013,314,2735,51307
02-11-2017,7,18643,20852,8276,4251,52022,1472,1355,315,3142,55164
02-11-2017,8,19147,20793,8430,4199,52569,1449,1369,519,3337,55906
02-11-2017,9,18962,20991,8274,4094,52320,1450,1234,340,3024,55344
02-11-2017,10,18673,20974,8051,4216,51914,1467,1214,314,2995,54909
02-11-2017,11,18343,21138,7878,4160,51520,1460,1214,325,2999,54519
02-11-2017,12,18153,21311,8059,4186,51710,1456,1316,321,3093,54803
02-11-2017,13,18289,21563,8214,3976,52042,1447,1326,307,3080,55122
02-11-2017,14,18545,21808,8074,3700,52127,1442,1316,259,3017,55144
02-11-2017,15,18806,21842,8384,3480,52514,1444,1322,403,3169,55683
02-11-2017,16,19573,22143,8749,3334,53797,1461,1348,387,3196,56993
02-11-2017,17,20025,21959,8707,3572,54264,1465,1556,476,3497,57761
02-11-2017,18,20023,21927,8625,3169,53743,1444,1567,522,3533,57276
02-11-2017,19,19879,21578,8237,3001,52695,1438,1326,433,3197,55892
02-11-2017,20,19801,21142,7636,2639,51218,1430,1153,173,2756,53974
02-11-2017,21,19546,20565,7427,2404,49941,1430,989,169,2588,52529
02-11-2017,22,18903,19829,7308,2217,48257,1427,526,159,2112,50369
02-11-2017,23,18169,18860,7063,2230,46322,1425,391,100,1916,48238
03-11-2017,0,16995,17550,7071,2058,43674,1407,392,134,1933,45607
03-11-2017,1,16634,17372,7101,2299,43407,1411,389,127,1927,45334
03-11-2017,2,16547,17373,7161,2246,43327,1445,387,130,1962,45289
03-11-2017,3,16528,17471,7314,2400,43712,1404,389,130,1923,45635
03-11-2017,4,16513,17782,7620,2510,44426,1459,860,115,2434,46860
03-11-2017,5,17566,19281,8121,2792,47762,1563,1067,141,2771,50533
03-11-2017,6,18588,20952,8638,3294,51471,1555,1224,134,2913,54384
03-11-2017,7,19963,21891,8788,3758,54400,1555,1292,499,3346,57746
03-11-2017,8,20327,21675,8911,3911,54824,1556,1381,533,3470,58294
03-11-2017,9,19992,21626,8657,3758,54035,1524,1188,505,3217,57252
03-11-2017,10,19770,21854,8142,3641,53406,1544,1085,481,3110,56516
03-11-2017,11,19508,21767,7960,3522,52756,1542,1085,486,3113,55869
03-11-2017,12,19204,21821,8015,3356,52397,1604,1325,519,3448,55845
03-11-2017,13,18692,21767,8256,3196,51912,1585,1159,551,3295,55207
03-11-2017,14,18140,21860,8363,3072,51436,1650,1158,500,3308,54744
03-11-2017,15,18395,22048,8589,2944,51975,1599,1247,535,3381,55356
03-11-2017,16,18735,22449,8937,3047,53169,1660,1474,566,3700,56869
03-11-2017,17,19063,22563,8826,3366,53818,1717,1497,551,3765,57583
03-11-2017,18,18806,22469,8590,3168,53033,1692,1491,539,3722,56755
03-11-2017,19,17855,22250,8146,2974,51225,1633,1402,425,3460,54685
03-11-2017,20,16530,21136,7977,2990,48634,1516,1280,155,2951,51585
03-11-2017,21,15948,20234,7741,2973,46896,1367,1074,197,2638,49534
03-11-2017,22,15342,19190,7735,2923,45191,1230,744,204,2178,47369
03-11-2017,23,14454,18692,7653,2985,43785,1177,216,129,1522,45307
04-11-2017,0,13705,17569,7655,3109,42040,1131,208,135,1474,43514
04-11-2017,1,13514,17262,7580,2996,41353,1048,213,143,1404,42757
04-11-2017,2,12947,17097,7516,2794,40355,970,208,142,1320,41675
04-11-2017,3,13377,17077,7492,2504,40450,940,214,140,1294,41744
04-11-2017,4,13541,17170,7473,2550,40734,938,406,151,1495,42229
04-11-2017,5,14039,17591,7490,2344,41464,1141,421,138,1700,43164
04-11-2017,6,14893,18098,7523,2273,42788,1167,710,210,2087,44875
04-11-2017,7,15508,18549,7594,2347,43997,1194,953,250,2397,46394
04-11-2017,8,16552,18885,7688,2433,45557,1221,1027,275,2523,48080
04-11-2017,9,17686,19356,7544,2687,47275,1235,1031,274,2540,49815
04-11-2017,10,18260,19445,7378,2960,48043,1234,1030,277,2541,50584
04-11-2017,11,18124,19391,7335,2934,47784,1218,1042,289,2549,50333
04-11-2017,12,17929,19238,7329,2756,47252,1210,1118,273,2601,49853
04-11-2017,13,17665,19084,7297,2677,46726,1224,1117,286,2627,49353
04-11-2017,14,17625,19047,7308,2752,46734,1230,1117,263,2610,49344
04-11-2017,15,17862,19121,7435,2639,47057,1242,1125,281,2648,49705
04-11-2017,16,18877,19631,7537,2780,48825,1249,1177,307,2733,51558
04-11-2017,17,19114,20021,7565,3220,49921,1243,1173,458,2874,52795
04-11-2017,18,18738,19666,7501,3295,49201,1205,1174,307,2686,51887
04-11-2017,19,17951,19287,7358,3299,47895,1205,1114,287,2606,50501
04-11-2017,20,16146,18496,7084,3311,45038,1203,1117,273,2593,47631
04-11-2017,21,14486,17578,6888,3375,42328,1177,1027,266,2470,44798
04-11-2017,22,13479,17111,6821,3156,40567,1090,946,213,2249,42816
04-11-2017,23,12101,16548,6856,3070,38575,1061,566,221,1848,40423
05-11-2017,0,11824,15475,6865,2997,37161,965,424,238,1627,38788
05-11-2017,1,11276,15183,6841,2917,36217,928,429,244,1601,37818
05-11-2017,2,11064,15098,6802,2922,35887,906,426,256,1588,37475
05-11-2017,3,11416,14986,6778,2741,35921,899,429,256,1584,37505
05-11-2017,4,11437,14963,6648,2589,35637,921,523,265,1709,37346
05-11-2017,5,11263,15126,6623,2361,35373,965,655,267,1887,37260
05-11-2017,6,11468,15488,6616,2244,35817,985,795,307,2087,37904
05-11-2017,7,12455,15918,6725,2175,37273,1023,938,313,2274,39547
05-11-2017,8,14940,16677,6699,1924,40240,1065,997,284,2346,42586
05-11-2017,9,17239,17650,6919,2199,44007,1100,1012,240,2352,46359
05-11-2017,10,17984,18141,7008,2401,45535,1137,1014,206,2357,47892
05-11-2017,11,18357,18455,7035,2248,46095,1147,1021,188,2356,48451
05-11-2017,12,18006,18964,7040,2156,46166,1159,1109,183,2451,48617
05-11-2017,13,18153,18960,6978,2065,46156,1142,1126,169,2437,48593
05-11-2017,14,18110,19223,7047,1980,46360,1142,1133,178,2453,48813
05-11-2017,15,18661,19576,7141,2043,47423,1150,1104,225,2479,49902
05-11-2017,16,19851,20304,7347,2056,49558,1138,1158,265,2561,52119
05-11-2017,17,19920,20565,7531,2651,50669,1151,1157,280,2588,53257
05-11-2017,18,19493,20387,7571,2826,50276,1154,1160,295,2609,52885
05-11-2017,19,18710,19917,7369,2869,48866,1152,1162,291,2605,51471
05-11-2017,20,18293,19422,7218,2826,47759,1156,1123,287,2566,50325
05-11-2017,21,18156,19042,7226,2290,46714,1042,1130,248,2420,49134
05-11-2017,22,16714,18584,7363,2164,44825,1061,1042,242,2345,47170
05-11-2017,23,15410,17796,7293,2159,42657,1067,691,184,1942,44599
06-11-2017,0,14177,16762,7224,2224,,1067,552,183,1802,
06-11-2017,1,13478,16500,7092,2291,39360,1072,553,191,1816,41176
06-11-2017,2,12945,16511,7048,2416,38922,1024,555,183,1762,40684
06-11-2017,3,12988,16545,7061,2383,38978,999,565,167,1731,40709
06-11-2017,4,13729,17270,7133,2413,40544,1083,644,159,1886,42430
06-11-2017,5,15241,18903,7297,2447,43886,1184,825,204,2213,46099
06-11-2017,6,18404,20500,7603,2611,49118,1187,1035,225,2447,51565
06-11-2017,7,20936,21800,7840,2705,53281,1195,1081,210,2486,55767
06-11-2017,8,21469,22391,7800,2900,54560,1191,1152,281,2624,57184
06-11-2017,9,21146,22138,7912,3218,54414,1161,1154,290,2605,57019
06-11-2017,10,21177,22054,7879,3275,54386,1153,1138,244,2535,56921
06-11-2017,11,20822,21992,7782,3461,54057,1130,1157,123,2410,56467
06-11-2017,12,21005,21548,7717,3415,53687,1118,1141,118,2377,56064
06-11-2017,13,21013,21607,7696,3338,53656,1105,1103,119,2327,55983
06-11-2017,14,20883,21715,7699,3056,53354,1114,1164,121,2399,55753
06-11-2017,15,21229,21966,7897,2955,54047,1128,1183,176,2487,56534
06-11-2017,16,21745,22534,8117,3197,55593,1134,1256,344,2734,58327
06-11-2017,17,22203,22724,8217,3590,56734,1139,1251,340,2730,59464
06-11-2017,18,21809,22749,8168,3458,56185,1131,1230,339,2700,58885
06-11-2017,19,21499,22303,8219,3279,55301,1132,1165,220,2517,57818
06-11-2017,20,20500,21677,8244,2908,53330,1136,1103,154,2393,55723
06-11-2017,21,19764,21150,7991,2619,51525,1123,1091,155,2369,53894
06-11-2017,22,18265,20352,7913,2514,49045,1119,1088,158,2365,51410
06-11-2017,23,16574,19697,7817,2159,46248,1119,889,150,2158,48406
07-11-2017,0,16401,18516,7804,2356,45076,1134,719,136,1989,47065
07-11-2017,1,15476,18253,7883,2198,43810,1183,700,120,2003,45813
07-11-2017,2,15126,18308,7938,2232,43605,1229,699,109,2037,45642
07-11-2017,3,15315,18162,7965,2162,43606,1249,817,103,2169,45775
07-11-2017,4,16384,18421,8216,2132,45153,1265,1008,103,2376,47529
07-11-2017,5,18454,19781,8526,2214,48976,1356,1050,103,2509,51485
07-11-2017,6,20631,21533,8677,2545,53385,1413,1255,102,2770,56155
07-11-2017,7,21966,22728,8797,3189,56681,1417,1271,314,3002,59683
07-11-2017,8,22333,22381,8802,3214,56730,1412,1360,314,3086,59816
07-11-2017,9,22255,22150,8392,3054,55850,1413,1290,319,3022,58872
07-11-2017,10,22028,22184,7979,3164,55355,1407,1284,319,3010,58365
07-11-2017,11,21822,21872,7866,3308,54869,1400,1254,319,2973,57842
07-11-2017,12,21655,21616,8062,3283,54617,1382,1282,215,2879,57496
07-11-2017,13,21481,21520,8319,3338,54657,1338,1286,314,2938,57595
07-11-2017,14,21931,21393,8357,2932,54614,1358,1283,315,2956,57570
07-11-2017,15,22089,21721,8678,2860,55349,1426,1283,306,3015,58364
07-11-2017,16,22403,22275,8788,2907,56374,1525,1285,336,3146,59520
07-11-2017,17,22496,22642,8896,3291,57324,1448,1388,345,3181,60505
07-11-2017,18,22068,22502,8730,3172,56471,1444,1411,355,3210,59681
07-11-2017,19,21932,21972,8152,2944,54999,1463,1223,289,2975,57974
07-11-2017,20,21060,21238,7666,2932,52896,1422,1095,172,2689,55585
07-11-2017,21,20106,20425,7428,2846,50805,1428,1099,169,2696,53501
07-11-2017,22,18428,19394,7441,2756,48019,1440,1105,160,2705,50724
07-11-2017,23,16519,18730,7380,2856,45485,1455,1131,161,2747,48232
08-11-2017,0,15801,18054,7258,2699,43811,1273,1010,176,2459,46270
08-11-2017,1,15427,17894,7218,2455,42994,1259,1006,183,2448,45442
08-11-2017,2,15346,17759,7210,2248,42563,1268,1003,184,2455,45018
08-11-2017,3,15556,17733,7274,2227,42791,1282,1003,188,2473,45264
08-11-2017,4,16470,17913,7446,2324,44153,1281,1010,186,2477,46630
08-11-2017,5,17840,19432,7771,2501,47544,1270,1099,191,2560,50104
08-11-2017,6,20291,21098,8228,3141,52758,1265,1095,182,2542,55300
08-11-2017,7,22068,22397,8800,3451,56715,1278,1170,315,2763,59478
08-11-2017,8,22317,22335,8944,3502,57098,1280,1315,358,2953,60051
08-11-2017,9,22202,22065,8549,3466,56282,1288,1306,362,2956,59238
08-11-2017,10,22005,21817,8345,3548,55715,1274,1264,358,2896,58611
08-11-2017,11,21688,21826,8383,3451,55348,1265,1229,313,2807,58155
08-11-2017,12,21668,21683,8548,3448,55347,1260,1228,322,2810,58157
08-11-2017,13,21520,21593,8637,3355,55105,1256,1223,389,2868,57973
08-11-2017,14,21745,21627,8690,3240,55301,1251,1222,397,2870,58171
08-11-2017,15,22059,22053,9074,3162,56349,1281,1241,402,2924,59273
08-11-2017,16,22294,23630,9391,3317,58633,1365,1264,444,3073,61706
08-11-2017,17,22184,23931,9513,3462,59090,1258,1256,479,2993,62083
08-11-2017,18,21840,22276,9512,3491,57119,1261,1224,461,2946,60065
08-11-2017,19,21202,21522,9275,3279,55280,1271,1110,421,2802,58082
08-11-2017,20,19945,21107,9072,3183,53308,1274,1058,249,2581,55889
08-11-2017,21,18828,20500,8719,2896,50943,1245,1059,252,2556,53499
08-11-2017,22,17495,19580,8432,2686,48192,1230,1056,293,2579,50771
08-11-2017,23,15965,18925,8103,2462,45457,1194,1069,219,2482,47939
09-11-2017,0,14963,17798,7916,2423,43101,979,813,198,1990,45091
09-11-2017,1,14221,17607,7734,2334,41896,974,814,210,1998,43894
09-11-2017,2,13755,17689,7697,2393,41537,1014,812,192,2018,43555
09-11-2017,3,13495,17908,7601,2578,41582,987,815,163,1965,43547
09-11-2017,4,13678,18269,7722,2750,42419,1052,958,147,2157,44576
09-11-2017,5,14907,19070,7970,2984,44931,1229,1077,145,2451,47382
09-11-2017,6,17804,20682,8380,3348,50214,1381,1134,204,2719,52933
09-11-2017,7,19466,21940,8629,3732,53768,1400,1141,379,2920,56688
09-11-2017,8,19701,21853,8766,3997,54317,1410,1136,398,2944,57261
09-11-2017,9,18599,22052,8568,4189,53408,1423,1069,358,2850,56258
09-11-2017,10,17940,22188,8475,4694,53296,1423,1066,197,2686,55982
09-11-2017,11,17442,22180,8217,4775,52615,1451,1068,203,2722,55337
09-11-2017,12,17352,22247,8362,4956,52917,1478,1072,209,2759,55676
09-11-2017,13,17778,22632,8558,4926,53892,1472,1152,201,2825,56717
09-11-2017,14,17744,22964,8596,4429,53734,1475,1149,195,2819,56553
09-11-2017,15,18666,22617,8721,4256,54260,1506,1159,201,2866,57126
09-11-2017,16,19414,22764,8806,4388,55374,1512,1164,259,2935,58309
09-11-2017,17,20094,22775,8770,4401,56040,1518,1150,239,2907,58947
09-11-2017,18,19536,22497,8637,4312,54981,1532,1076,252,2860,57841
09-11-2017,19,18386,22040,8470,4174,53071,1529,1098,260,2887,55958
09-11-2017,20,16855,21666,8364,4186,51070,1522,1078,285,2885,53955
09-11-2017,21,16050,21247,8198,4316,49812,1518,1083,274,2875,52687
09-11-2017,22,14653,20515,8138,4111,47419,1526,1088,287,2901,50320
09-11-2017,23,12943,19148,8025,3910,44027,1413,1048,256,2717,46744
10-11-2017,0,12841,18010,7787,3684,42324,1170,729,252,2151,44475
10-11-2017,1,12359,17488,7695,3628,41171,1141,732,295,2168,43339
10-11-2017,2,12312,17374,7546,3349,40582,1106,736,316,2158,42740
10-11-2017,3,12432,17332,7532,3528,40823,1075,730,330,2135,42958
10-11-2017,4,12849,17517,7565,3601,41531,1107,720,329,2156,43687
10-11-2017,5,15227,18853,7661,3716,45458,1246,952,337,2535,47993
10-11-2017,6,18758,20457,8090,3451,50756,1351,1008,357,2716,53472
10-11-2017,7,21233,21592,8630,3878,55334,1354,1135,344,2833,58167
10-11-2017,8,21779,21614,8770,4469,56632,1225,1228,514,2967,59599
10-11-2017,9,21378,21547,8365,4613,55903,1210,1018,307,2535,58438
10-11-2017,10,21302,21473,8069,4627,55472,1087,984,279,2350,57822
10-11-2017,11,21163,21024,8062,4551,54799,1044,989,256,2289,57088
10-11-2017,12,20994,20921,8323,4548,54786,1034,1060,342,2436,57222
10-11-2017,13,20592,20947,8460,4860,54860,1028,1109,387,2524,57384
10-11-2017,14,19837,21023,8675,4938,54475,1023,1129,347,2499,56974
10-11-2017,15,19851,20561,8768,4994,54175,1034,1109,261,2404,56579
10-11-2017,16,20975,20793,8960,4992,55721,1029,1129,244,2402,58123
10-11-2017,17,21741,21042,8962,5118,56864,1033,1129,298,2460,59324
10-11-2017,18,20821,20742,8878,5145,55588,1025,1132,339,2496,58084
10-11-2017,19,19206,20101,8371,5112,52792,1016,1011,280,2307,55099
10-11-2017,20,16774,18673,7897,5219,48563,1016,1030,309,2355,50918
10-11-2017,21,15371,17975,7644,5121,46112,1035,1012,334,2381,48493
10-11-2017,22,13638,17585,7453,5114,43790,1035,998,298,2331,46121
10-11-2017,23,12708,17121,7259,4770,41860,1036,584,342,1962,43822
11-11-2017,0,12967,16089,7042,4942,41041,842,598,358,1798,42839
11-11-2017,1,12315,15970,7099,4617,40001,804,605,315,1724,41725
11-11-2017,2,12083,15982,7124,4431,39620,808,595,277,1680,41300
11-11-2017,3,11979,15991,7027,4393,39390,732,589,328,1649,41039
11-11-2017,4,12081,15825,6961,4302,39168,719,586,349,1654,40822
11-11-2017,5,12362,15881,6947,4332,39522,722,826,372,1920,41442
11-11-2017,6,13397,16180,7174,3928,40679,800,832,452,2084,42763
11-11-2017,7,14327,16704,7357,4008,42395,816,828,479,2123,44518
11-11-2017,8,15349,17725,7544,4134,44754,844,788,489,2121,46875
11-11-2017,9,16283,18529,7791,4356,46961,874,794,462,2130,49091
11-11-2017,10,16714,18838,7791,4668,48011,875,797,436,2108,50119
11-11-2017,11,16856,19111,7781,4657,48405,899,789,473,2161,50566
11-11-2017,12,16322,19699,7718,4834,48574,898,768,491,2157,50731
11-11-2017,13,16123,19759,7732,4765,48379,901,770,499,2170,50549
11-11-2017,14,16605,19856,7847,4871,49180,916,797,488,2201,51381
11-11-2017,15,17959,20291,7760,5060,51071,924,781,454,2159,53230
11-11-2017,16,19486,20591,7910,5074,53061,944,795,499,2238,55299
11-11-2017,17,20529,20740,7877,4907,54056,941,903,486,2330,56386
11-11-2017,18,20117,20671,7772,4873,53434,916,906,500,2322,55756
11-11-2017,19,18879,20502,7748,4797,51926,915,977,496,2388,54314
11-11-2017,20,17721,19981,7644,4457,49803,900,982,476,2358,52161
11-11-2017,21,17047,19103,7461,4350,47960,913,743,481,2137,50097
11-11-2017,22,16073,18315,7336,4348,46072,918,679,417,2014,48086
11-11-2017,23,14235,17370,7154,4299,43058,880,673,407,1960,45018
12-11-2017,0,14063,16356,7245,4458,42123,780,539,441,1760,43883
12-11-2017,1,13417,16088,7246,4399,41151,767,532,406,1705,42856
12-11-2017,2,13229,15920,7243,4286,40680,790,476,411,1677,42357
12-11-2017,3,13314,15825,7241,4173,40554,780,477,389,1646,42200
12-11-2017,4,13298,15815,7149,3876,40138,783,529,399,1711,41849
12-11-2017,5,13492,16032,7216,3683,40423,779,766,383,1928,42351
12-11-2017,6,13824,16532,7331,3459,41146,763,778,440,1981,43127
12-11-2017,7,14754,17157,7410,3372,42693,772,830,421,2023,44716
12-11-2017,8,17645,17983,7465,3406,46499,772,774,409,1955,48454
12-11-2017,9,20055,19213,7574,3453,50295,762,822,395,1979,52274
12-11-2017,10,20830,19525,7682,3470,51509,772,831,381,1984,53493
12-11-2017,11,21069,19637,7806,3569,52081,799,826,368,1993,54074
12-11-2017,12,20799,19500,7929,3495,51722,812,821,361,1994,53716
12-11-2017,13,20512,19466,7949,3345,51272,837,818,339,1994,53266
12-11-2017,14,20513,19637,8026,3201,51377,853,808,320,1981,53358
12-11-2017,15,21178,20089,8156,3099,52521,858,802,327,1987,54508
12-11-2017,16,21728,20702,8156,3424,54011,868,919,353,2140,56151
12-11-2017,17,21823,20869,8099,3726,54516,903,1120,558,2581,57097
12-11-2017,18,21782,20783,8035,3523,54125,914,1109,347,2370,56495
12-11-2017,19,21280,20708,8016,3198,53202,939,1027,349,2315,55517
12-11-2017,20,20667,20597,7967,2779,52012,958,839,327,2124,54136
12-11-2017,21,20056,20339,7757,2718,50870,938,650,274,1862,52732
12-11-2017,22,18795,19776,7524,2795,48890,884,589,162,1635,50525
12-11-2017,23,17560,18547,7265,2616,45989,875,454,179,1508,47497
13-11-2017,0,16672,17882,7183,2433,44172,1051,449,193,1693,45865
13-11-2017,1,16200,17809,7176,2378,43565,1107,251,155,1513,45078
13-11-2017,2,15639,17701,7144,2535,43018,1105,253,151,1509,44527
13-11-2017,3,15422,17614,7147,2625,42808,1159,264,126,1549,44357
13-11-2017,4,15828,18214,7160,2672,43875,1271,545,119,1935,45810
13-11-2017,5,18955,20048,7474,2885,49361,1454,955,134,2543,51904
13-11-2017,6,21464,21519,7997,3455,54435,1541,1219,192,2952,57387
13-11-2017,7,23298,22735,8445,3347,57826,1556,1246,357,3159,60985
13-11-2017,8,23443,23229,8403,3515,58591,1548,1234,370,3152,61743
13-11-2017,9,23364,23073,8159,3560,58157,1535,1221,349,3105,61262
13-11-2017,10,22947,22886,7976,3694,57505,1526,1218,322,3066,60571
13-11-2017,11,22568,22790,7911,3619,56888,1518,1182,310,3010,59898
13-11-2017,12,22508,22403,8169,3385,56465,1526,1290,111,2927,59392
13-11-2017,13,22914,22369,8449,3434,57165,1509,1317,112,2938,60103
13-11-2017,14,22777,22493,8523,3336,57127,1499,1353,233,3085,60212
13-11-2017,15,23190,22878,8524,3267,57858,1499,1495,331,3325,61183
13-11-2017,16,23423,23401,8686,3572,59083,1523,1569,326,3418,62501
13-11-2017,17,23688,23467,8729,3937,59821,1530,1573,324,3427,63248
13-11-2017,18,22917,23455,8497,3992,58861,1528,1524,320,3372,62233
13-11-2017,19,22363,23139,8177,3609,57288,1496,1215,310,3021,60309
13-11-2017,20,22182,22358,7749,3139,55430,1482,1051,311,2844,58274
13-11-2017,21,22142,21628,7589,2965,54323,1493,958,109,2560,56883
13-11-2017,22,21201,20918,7569,2758,52446,1494,798,32,2324,54770
13-11-2017,23,19609,20339,7433,2735,50116,1493,609,38,2140,52256
14-11-2017,0,18236,19169,7490,2632,47528,1450,501,90,2041,49569
14-11-2017,1,17634,18748,7452,2598,46432,1454,416,87,1957,48389
14-11-2017,2,17290,18415,7491,2677,45873,1443,417,83,1943,47816
14-11-2017,3,17046,18206,7437,2891,45580,1445,498,85,2028,47608
14-11-2017,4,17513,18701,7544,2879,46638,1459,695,90,2244,48882
14-11-2017,5,18858,20220,7648,2994,49721,1500,1102,89,2691,52412
14-11-2017,6,21665,21705,8061,3384,54816,1511,1437,130,3078,57894
14-11-2017,7,23226,22903,8460,3916,58505,1509,1486,361,3356,61861
14-11-2017,8,23258,23023,8488,4344,59115,1505,1491,370,3366,62481
14-11-2017,9,22728,22633,8232,4634,58227,1500,1481,146,3127,61354
14-11-2017,10,22772,22380,7745,5192,58088,1503,1488,155,3146,61234
14-11-2017,11,22230,22051,7675,5463,57419,1504,1494,168,3166,60585
14-11-2017,12,22239,22044,7901,5531,57717,1473,1481,189,3143,60860
14-11-2017,13,22236,22057,8208,5589,58091,1501,1489,220,3210,61301
14-11-2017,14,22185,22345,8267,5525,58322,1540,1511,224,3275,61597
14-11-2017,15,22541,22479,8483,4992,58495,1530,1499,421,3450,61945
14-11-2017,16,23463,22816,8645,5027,59951,1541,1437,494,3472,63423
14-11-2017,17,24214,23069,8641,4724,60648,1548,1366,532,3446,64094
14-11-2017,18,23755,22991,8591,4493,59830,1609,1272,487,3368,63198
14-11-2017,19,22757,22708,8184,4327,57976,1641,1084,336,3061,61037
14-11-2017,20,21623,22071,7804,3788,55286,1633,1081,357,3071,58357
14-11-2017,21,20657,21582,7761,3594,53594,1630,871,388,2889,56483
14-11-2017,22,18749,20669,7757,3299,50475,1728,815,353,2896,53371
14-11-2017,23,17413,19364,7639,3122,47538,1662,666,379,2707,50245
15-11-2017,0,17030,18367,7538,2826,45762,1621,461,357,2439,48201
15-11-2017,1,16396,18188,7516,2783,44884,1638,452,304,2394,47278
15-11-2017,2,15982,18179,7465,2763,44389,1711,454,320,2485,46874
15-11-2017,3,16121,18156,7445,2850,44573,1672,467,297,2436,47009
15-11-2017,4,16663,18345,7530,2814,45351,1647,745,282,2674,48025
15-11-2017,5,18403,19485,7575,2812,48275,1747,1191,278,3216,51491
15-11-2017,6,21523,21430,7774,2989,53717,1824,1372,358,3554,57271
15-11-2017,7,23352,23043,7986,3504,57886,1698,1518,405,3621,61507
15-11-2017,8,23130,23250,8284,3580,58245,1715,1503,434,3652,61897
15-11-2017,9,22497,23228,8200,3398,57324,1780,1524,250,3554,60878
15-11-2017,10,22029,23384,8064,3328,56806,1811,1509,256,3576,60382
15-11-2017,11,21267,23509,7894,3605,56276,1814,1502,292,3608,59884
15-11-2017,12,21154,23550,7961,3252,55916,1861,1471,330,3662,59578
15-11-2017,13,21392,23642,8021,3130,56186,1944,1586,330,3860,60046
15-11-2017,14,21312,23651,8252,3034,56249,1951,1549,331,3831,60080
15-11-2017,15,21914,23674,8448,3020,57058,1985,1537,345,3867,60925
15-11-2017,16,22717,23589,8719,3668,58694,2006,1600,530,4136,62830
15-11-2017,17,22945,23925,8758,4048,59678,1946,1541,609,4096,63774
15-11-2017,18,22592,23708,8645,3894,58839,1993,1302,583,3878,62717
15-11-2017,19,21993,23370,8231,3681,57276,1952,1142,453,3547,60823
15-11-2017,20,20778,23082,7915,3249,55025,1970,1124,583,3677,58702
15-11-2017,21,20004,22590,7968,2988,53551,1892,1095,421,3408,56959
15-11-2017,22,18342,21654,7899,2671,50566,1892,990,342,3224,53790
15-11-2017,23,16924,20557,7753,2459,47693,1877,675,257,2809,50502
16-11-2017,0,16702,19547,7443,2161,45852,1801,562,253,2616,48468
16-11-2017,1,16124,19220,7454,1857,44657,1770,514,249,2533,47190
16-11-2017,2,16172,19003,7470,1835,44480,1776,512,245,2533,47013
16-11-2017,3,16302,18931,7482,1904,44619,1777,696,228,2701,47320
16-11-2017,4,17162,19114,7533,2022,45833,1779,904,228,2911,48744
16-11-2017,5,18841,20776,7683,2240,49540,1801,1089,235,3125,52665
16-11-2017,6,21374,22164,8197,2533,54269,1851,1197,598,3646,57915
16-11-2017,7,23520,23131,8608,3144,58404,1855,1326,416,3597,62001
16-11-2017,8,23401,23202,8596,3793,58993,1873,1331,349,3553,62546
16-11-2017,9,22726,22839,8282,3794,57641,1883,1221,361,3465,61106
16-11-2017,10,22931,22012,8011,4111,57067,1859,1191,205,3255,60322
16-11-2017,11,22145,21935,8005,4347,56433,1843,1177,185,3205,59638
16-11-2017,12,21979,21902,8111,4061,56053,1829,1175,189,3193,59246
16-11-2017,13,21729,21943,8234,4341,56246,1855,1270,228,3353,59599
16-11-2017,14,21270,22226,8334,4363,56194,1847,1156,229,3232,59426
16-11-2017,15,21372,22679,8679,4429,57159,1832,1325,282,3439,60598
16-11-2017,16,21312,23197,8803,4678,57990,1813,1339,329,3481,61471
16-11-2017,17,21185,23333,8815,4705,58037,1804,1336,241,3381,61418
16-11-2017,18,20401,23095,8539,4720,56756,1775,1310,386,3471,60227
16-11-2017,19,19435,23158,8133,4432,55158,1642,1063,308,3013,58171
16-11-2017,20,18392,22693,7666,4551,53303,1603,1067,284,2954,56257
16-11-2017,21,17260,22161,7475,4298,51196,1572,1026,281,2879,54075
16-11-2017,22,15398,21253,7512,4272,48437,1588,934,224,2746,51183
16-11-2017,23,13842,20092,7476,4148,45559,1573,645,222,2440,47999
17-11-2017,0,13367,19308,7587,3843,44106,1452,479,226,2157,46263
17-11-2017,1,12569,19256,7560,3772,43158,1488,470,244,2202,45360
17-11-2017,2,12274,18940,7528,3870,42611,1515,474,238,2227,44838
17-11-2017,3,12333,18836,7571,3746,42487,1568,562,251,2381,44868
17-11-2017,4,13340,19367,7591,3494,43792,1605,771,260,2636,46428
17-11-2017,5,14317,21579,7717,3549,47162,1621,1073,289,2983,50145
17-11-2017,6,17211,23378,8126,3515,52232,1808,1071,369,3248,55480
17-11-2017,7,20257,24578,8437,3599,56870,1840,1303,542,3685,60555
17-11-2017,8,20542,24631,8491,4004,57669,1810,1358,588,3756,61425
17-11-2017,9,19873,24446,8325,3987,56631,1830,1349,487,3666,60297
17-11-2017,10,19078,24348,8402,4129,55957,1831,1318,485,3634,59591
17-11-2017,11,18147,24378,8409,4366,55300,1818,1292,430,3540,58840
17-11-2017,12,17905,24225,8283,4323,54737,1828,1315,497,3640,58377
17-11-2017,13,18144,23922,8281,4452,54800,1630,1300,485,3415,58215
17-11-2017,14,18178,23768,8382,4373,54700,1652,1269,482,3403,58103
17-11-2017,15,18305,24003,8722,4136,55167,1621,1335,480,3436,58603
17-11-2017,16,19131,24201,8854,4278,56465,1689,1372,486,3547,60012
17-11-2017,17,19558,24082,8675,4216,56533,1751,1328,499,3578,60111
17-11-2017,18,18657,23906,8558,4161,55283,1769,1305,524,3598,58881
17-11-2017,19,16876,23541,8266,4257,52940,1804,1211,409,3424,56364
17-11-2017,20,15012,23126,8033,4329,50501,1601,1177,318,3096,53597
17-11-2017,21,14130,22565,7938,4541,49174,1342,1094,313,2749,51923
17-11-2017,22,13304,21050,7728,4526,46608,1146,921,242,2309,48917
17-11-2017,23,12762,19919,7615,4561,44858,1102,698,250,2050,46908
18-11-2017,0,12482,18720,7463,4605,43270,1132,331,268,1731,45001
18-11-2017,1,11882,18064,7443,4686,42074,1118,234,235,1587,43661
18-11-2017,2,11893,17424,7281,4524,41123,1112,236,254,1602,42725
18-11-2017,3,12000,17222,7211,4535,40969,1095,237,257,1589,42558
18-11-2017,4,12415,17381,7244,4529,41569,1090,236,259,1585,43154
18-11-2017,5,12587,17771,7320,4361,42040,1214,442,261,1917,43957
18-11-2017,6,13057,18081,7397,4566,43103,1274,662,237,2173,45276
18-11-2017,7,14237,18537,7474,4708,44956,1278,857,305,2440,47396
18-11-2017,8,14873,19221,7488,4820,46403,1318,1044,359,2721,49124
18-11-2017,9,16086,20070,7556,4496,48208,1324,1107,376,2807,51015
18-11-2017,10,16371,20547,7528,4467,48913,1318,1121,389,2828,51741
18-11-2017,11,16013,20618,7457,4295,48385,1313,1111,410,2834,51219
18-11-2017,12,15598,20807,7353,4451,48209,1322,1107,418,2847,51056
18-11-2017,13,15545,20700,7424,4591,48260,1332,1094,428,2854,51114
18-11-2017,14,15640,20504,7326,4752,48222,1322,1016,424,2762,50984
18-11-2017,15,16736,20759,7420,4698,49614,1314,1055,436,2805,52419
18-11-2017,16,17838,21196,7600,4922,51557,1309,1176,469,2954,54511
18-11-2017,17,18295,21178,7611,5089,52175,1311,1170,483,2964,55139
18-11-2017,18,17669,21114,7547,5154,51483,1325,1063,470,2858,54341
18-11-2017,19,15784,20387,7331,5283,48786,1287,985,470,2742,51528
18-11-2017,20,14800,19623,7275,5143,46842,1300,902,449,2651,49493
18-11-2017,21,14483,19089,7107,4945,45624,1310,813,396,2519,48143
18-11-2017,22,13404,18288,6971,5061,43725,1320,796,369,2485,46210
18-11-2017,23,13245,17281,6880,4626,42034,1293,559,295,2147,44181
19-11-2017,0,13404,16749,6784,4374,41310,1277,188,271,1736,43046
19-11-2017,1,12808,16664,6808,4342,40622,1246,184,237,1667,42289
19-11-2017,2,12570,16605,6745,3965,39884,1238,185,185,1608,41492
19-11-2017,3,12067,16644,6810,3906,39426,1216,186,152,1554,40980
19-11-2017,4,12495,16767,6923,4102,40289,1195,204,144,1543,41832
19-11-2017,5,11950,17085,7054,4153,40241,1193,309,160,1662,41903
19-11-2017,6,12101,17760,7139,3828,40827,1170,403,198,1771,42598
19-11-2017,7,13218,18152,7235,4209,42816,1171,593,187,1951,44767
19-11-2017,8,14179,18776,7308,4168,44432,1156,657,236,2049,46481
19-11-2017,9,15091,19379,7521,4237,46228,1144,710,252,2106,48334
19-11-2017,10,15403,20147,7700,4373,47623,1145,811,247,2203,49826
19-11-2017,11,15483,20451,7707,4511,48152,1138,815,236,2189,50341
19-11-2017,12,15509,20414,7654,4727,48306,1129,814,211,2154,50460
19-11-2017,13,15284,20591,7640,4803,48319,1113,809,250,2172,50491
19-11-2017,14,15931,20495,7655,4591,48672,1105,814,276,2195,50867
19-11-2017,15,17340,20878,7657,4256,50130,1096,868,272,2236,52366
19-11-2017,16,18957,21176,7793,3945,51871,1092,1123,274,2489,54360
19-11-2017,17,19874,21738,7984,3727,53324,1099,1114,264,2477,55801
19-11-2017,18,19745,21479,7900,3455,52580,1096,1087,247,2430,55010
19-11-2017,19,19158,21086,7846,3332,51422,1090,1074,227,2391,53813
19-11-2017,20,18270,20656,7736,3224,49886,1082,936,207,2225,52111
19-11-2017,21,17605,20105,7681,3288,48678,1085,755,139,1979,50657
19-11-2017,22,16579,19146,7557,3248,46530,1117,702,154,1973,48503
19-11-2017,23,15392,18128,7385,3163,44067,1155,402,145,1702,45769
20-11-2017,0,15202,17251,7230,3157,42840,1184,201,94,1479,44319
20-11-2017,1,14677,16963,7249,3107,41997,1206,185,76,1467,43464
20-11-2017,2,14677,16782,7355,3036,41850,1225,190,68,1483,43333
20-11-2017,3,14998,17016,7514,3142,42670,1242,209,67,1518,44188
20-11-2017,4,15818,17343,7666,3151,43979,1314,301,65,1680,45659
20-11-2017,5,18464,18540,7980,3198,48182,1380,494,61,1935,50117
20-11-2017,6,22672,21009,8338,3473,55494,1466,904,319,2689,58183
20-11-2017,7,25129,22844,8769,3725,60468,1491,1118,325,2934,63402
20-11-2017,8,25206,22841,8789,3770,60606,1499,1243,345,3087,63693
20-11-2017,9,25236,22737,8592,3056,59623,1505,1418,130,3053,62676
20-11-2017,10,25308,22340,8721,2955,59324,1508,1436,125,3069,62393
20-11-2017,11,24898,22220,8732,2967,58816,1505,1432,131,3068,61884
20-11-2017,12,24570,22300,8637,2827,58334,1499,1472,399,3370,61704
20-11-2017,13,24775,22391,8798,2850,58813,1490,1527,562,3579,62392
20-11-2017,14,24815,22457,8920,3052,59245,1490,1551,556,3597,62842
20-11-2017,15,25060,22725,9102,3249,60137,1493,1598,581,3672,63809
20-11-2017,16,25311,22764,9243,3502,60820,1502,1714,600,3816,64636
20-11-2017,17,25173,22693,9218,3541,60625,1500,1730,618,3848,64473
20-11-2017,18,24790,22461,9212,3250,59713,1493,1630,608,3731,63444
20-11-2017,19,24954,22189,8944,2937,59025,1492,1491,420,3403,62428
20-11-2017,20,24296,21261,8715,2811,57083,1489,1313,170,2972,60055
20-11-2017,21,24275,20622,8566,2310,55774,1490,1127,159,2776,58550
20-11-2017,22,23552,19427,8252,2282,53514,1489,1024,165,2678,56192
20-11-2017,23,23129,18446,7949,2192,51718,1501,525,132,2158,53876
21-11-2017,0,22411,17055,7809,2038,49312,1504,522,131,2157,51469
21-11-2017,1,21935,16528,7784,1953,48199,1504,521,122,2147,50346
21-11-2017,2,21909,16498,7898,1947,48253,1507,520,120,2147,50400
21-11-2017,3,21959,16498,7985,1929,48371,1504,518,119,2141,50512
21-11-2017,4,22135,16747,8106,1921,48908,1500,684,124,2308,51216
21-11-2017,5,22687,18326,8644,2120,51778,1502,845,146,2493,54271
21-11-2017,6,23709,20238,9087,2722,55756,1500,1139,155,2794,58550
21-11-2017,7,24958,21446,9236,3211,58852,1499,1608,349,3456,62308
21-11-2017,8,24758,21903,9305,3265,59232,1499,1676,564,3739,62971
21-11-2017,9,24806,21866,9390,3008,59071,1496,1685,518,3699,62770
21-11-2017,10,24954,21878,9543,3041,59416,1500,1686,520,3706,63122
21-11-2017,11,24598,21989,9433,3231,59252,1498,1686,486,3670,62922
21-11-2017,12,24464,21991,9395,3126,58976,1493,1687,513,3693,62669
21-11-2017,13,24592,22059,9497,3256,59404,1498,1687,523,3708,63112
21-11-2017,14,24642,22007,9632,3314,59596,1504,1685,521,3710,63306
21-11-2017,15,25253,22123,9678,4208,61262,1504,1683,541,3728,64990
21-11-2017,16,25325,22350,9573,4161,61408,1502,1719,560,3781,65189
21-11-2017,17,25700,22273,9666,3734,61374,1500,1722,576,3798,65172
21-11-2017,18,25697,22385,9627,3724,61432,1487,1723,563,3773,65205
21-11-2017,19,25409,22122,9430,3785,60746,1486,1557,356,3399,64145
21-11-2017,20,24691,21198,9027,3787,58703,1489,1524,166,3179,61882
21-11-2017,21,24359,20165,8749,3999,57273,1489,1327,168,2984,60257
21-11-2017,22,23238,18931,8415,4057,54642,1491,1022,134,2647,57289
21-11-2017,23,20801,17861,8181,4579,51423,1495,705,109,2309,53732
22-11-2017,0,19253,16402,8067,4081,47803,1488,406,86,1980,49783
22-11-2017,1,18536,16295,8018,4198,47047,1482,400,73,1955,49002
22-11-2017,2,17859,16371,8039,3917,46187,1481,399,68,1948,48135
22-11-2017,3,17476,16564,8048,3951,46039,1472,399,60,1931,47970
22-11-2017,4,18483,16971,8116,3849,47420,1487,499,59,2045,49465
22-11-2017,5,19572,18294,8191,3980,50037,1536,710,65,2311,52348
22-11-2017,6,21992,20178,8299,4569,55038,1549,1106,140,2795,57833
22-11-2017,7,24448,22611,9182,5050,61292,1558,1311,186,3055,64347
22-11-2017,8,25119,23071,9361,4901,62453,1557,1438,344,3339,65792
22-11-2017,9,24660,22592,9034,4914,61200,1563,1328,179,3070,64270
22-11-2017,10,25113,22563,8779,4901,61358,1561,1310,216,3087,64445
22-11-2017,11,24589,22917,8623,4872,60999,1569,1286,220,3075,64074
22-11-2017,12,24058,22628,8834,4740,60260,1565,1383,241,3189,63449
22-11-2017,13,24339,22408,9121,4854,60724,1565,1436,368,3369,64093
22-11-2017,14,24877,22869,9297,4903,61946,1569,1436,326,3331,65277
22-11-2017,15,25400,22877,9495,5689,63461,1574,1521,567,3662,67123
22-11-2017,16,25075,23120,9523,6073,63790,1579,1545,576,3700,67490
22-11-2017,17,24958,22946,9451,6104,63460,1576,1536,539,3651,67111
22-11-2017,18,23940,22597,9346,5925,61807,1593,1538,357,3488,65295
22-11-2017,19,22529,22036,9008,5856,59430,1598,1459,406,3463,62893
22-11-2017,20,21016,21668,8652,5180,56515,1609,1218,403,3230,59745
22-11-2017,21,19636,20729,8582,5236,54184,1616,1078,387,3081,57265
22-11-2017,22,17597,20206,8345,5234,51383,1607,883,329,2819,54202
22-11-2017,23,15240,19382,8259,5021,47902,1550,713,340,2603,50505
23-11-2017,0,14554,18241,8239,4645,45679,1309,422,311,2042,47721
23-11-2017,1,14093,17804,8221,4635,44753,1170,416,303,1889,46642
23-11-2017,2,13941,17637,8221,4574,44372,1136,415,302,1853,46225
23-11-2017,3,13329,17725,8255,4530,43839,1172,414,276,1862,45701
23-11-2017,4,12859,18240,8324,4632,44056,1251,513,270,2034,46090
23-11-2017,5,14304,19358,8579,4869,47108,1497,803,276,2576,49684
23-11-2017,6,15958,20653,9218,5003,50832,1596,859,337,2792,53624
23-11-2017,7,19331,22686,9602,5239,56857,1615,1204,341,3160,60017
23-11-2017,8,19474,22603,9524,5421,57021,1618,1320,380,3318,60339
23-11-2017,9,18437,22199,8981,5873,55490,1627,1315,376,3318,58808
23-11-2017,10,17825,22242,8894,5403,54365,1632,1319,399,3350,57715
23-11-2017,11,17661,22180,8845,5340,54027,1645,1280,390,3315,57342
23-11-2017,12,17585,22489,8846,5326,54246,1652,1297,408,3357,57603
23-11-2017,13,17499,22495,9123,5537,54656,1660,1288,421,3369,58025
23-11-2017,14,17552,22433,9276,5589,54850,1671,1308,449,3428,58278
23-11-2017,15,18873,22863,9466,5466,56667,1674,1436,481,3591,60258
23-11-2017,16,19680,23193,9363,5362,57598,1667,1516,547,3730,61328
23-11-2017,17,20132,23421,9289,5380,58223,1672,1503,524,3699,61922
23-11-2017,18,19504,23216,9163,5274,57158,1665,1466,483,3614,60772
23-11-2017,19,18847,22535,9039,5062,55482,1661,1294,495,3450,58932
23-11-2017,20,17470,21869,8705,5203,53247,1668,1167,467,3302,56549
23-11-2017,21,16570,21049,8499,5276,51396,1535,991,373,2899,54295
23-11-2017,22,15073,19902,8333,5006,48316,1461,994,341,2796,51112
23-11-2017,23,14192,18632,8130,4742,45696,1409,641,306,2356,48052
24-11-2017,0,13802,17986,8041,4482,44312,1429,514,269,2212,46524
24-11-2017,1,13381,17803,8070,4423,43677,1414,511,239,2164,45841
24-11-2017,2,13514,17822,7972,4027,43335,1419,507,224,2150,45485
24-11-2017,3,13606,17871,8035,3732,43243,1400,508,220,2128,45371
24-11-2017,4,14971,18049,8078,3461,44559,1448,511,215,2174,46733
24-11-2017,5,17928,19337,8196,3196,48658,1558,844,200,2602,51260
24-11-2017,6,20626,21137,8590,3156,53509,1614,1185,241,3040,56549
24-11-2017,7,23067,22622,8881,3287,57859,1617,1501,222,3340,61199
24-11-2017,8,23388,22612,8908,3855,58762,1607,1530,410,3547,62309
24-11-2017,9,23144,22242,8721,3419,57526,1606,1438,402,3446,60972
24-11-2017,10,22814,22003,8570,3363,56750,1596,1254,368,3218,59968
24-11-2017,11,22356,21302,8614,3312,55584,1572,1260,357,3189,58773
24-11-2017,12,22671,20970,8593,3217,55452,1544,1266,362,3172,58624
24-11-2017,13,22722,20870,8716,3262,55570,1550,1266,387,3203,58773
24-11-2017,14,22868,20841,8851,3331,55891,1543,1348,430,3321,59212
24-11-2017,15,23092,21233,8835,3403,56563,1546,1509,516,3571,60134
24-11-2017,16,23351,21945,8833,3374,57503,1537,1517,736,3790,61293
24-11-2017,17,23071,21748,8735,3497,57052,1525,1484,746,3755,60807
24-11-2017,18,22738,21144,8609,3565,56057,1527,1370,585,3482,59539
24-11-2017,19,22045,20591,8345,3298,54281,1522,1177,410,3109,57390
24-11-2017,20,21363,19611,8139,2995,52107,1394,1099,374,2867,54974
24-11-2017,21,20878,19032,8017,2604,50530,1400,1005,320,2725,53255
24-11-2017,22,19688,18326,7688,2565,48268,1399,795,346,2540,50808
24-11-2017,23,18260,17571,7468,2601,45901,1393,686,279,2358,48259
25-11-2017,0,19387,17135,7475,2594,46591,1290,330,247,1867,48458
25-11-2017,1,18620,16712,7456,2604,45392,1203,242,192,1637,47029
25-11-2017,2,18152,16413,7387,2667,44617,1201,239,152,1592,46209
25-11-2017,3,18066,16308,7366,2707,44447,1197,244,135,1576,46023
25-11-2017,4,18448,16333,7332,2656,44769,1199,421,127,1747,46516
25-11-2017,5,18646,16898,7383,2541,45468,1206,771,97,2074,47542
25-11-2017,6,19336,17944,7452,2710,47442,1213,818,79,2110,49552
25-11-2017,7,19976,19151,7592,2744,49462,1274,829,153,2256,51718
25-11-2017,8,20146,19894,7634,2765,50440,1301,1084,153,2538,52978
25-11-2017,9,21345,20013,7588,2876,51822,1301,1086,150,2537,54359
25-11-2017,10,21974,20183,7661,3030,52849,1293,1135,131,2559,55408
25-11-2017,11,21976,20166,7600,2999,52741,1279,1136,251,2666,55407
25-11-2017,12,21576,20126,7614,3139,52455,1270,1140,131,2541,54996
25-11-2017,13,21214,20010,7597,2995,51816,1267,1224,138,2629,54445
25-11-2017,14,21220,19927,7691,2836,51675,1265,1235,158,2658,54333
25-11-2017,15,22401,20131,7964,2801,53299,1259,1239,208,2706,56005
25-11-2017,16,23389,20560,8104,2762,54816,1277,1242,265,2784,57600
25-11-2017,17,23531,20644,8282,2954,55411,1278,1246,295,2819,58230
25-11-2017,18,22897,20661,8419,2939,54916,1264,1265,334,2863,57779
25-11-2017,19,21935,20234,8469,2994,53632,1260,1005,359,2624,56256
25-11-2017,20,21209,19907,8357,2811,52285,1278,840,365,2483,54768
25-11-2017,21,19678,19366,8283,2850,50177,1272,799,335,2406,52583
25-11-2017,22,17820,18727,7935,2960,47442,1272,713,278,2263,49705
25-11-2017,23,15602,17596,7735,3045,43979,1205,568,302,2075,46054
26-11-2017,0,15675,16030,7709,3257,42671,1116,250,338,1704,44375
26-11-2017,1,14675,15552,7705,3404,41335,1067,249,294,1610,42945
26-11-2017,2,13873,15715,7589,3584,40762,1002,247,307,1556,42318
26-11-2017,3,13535,15621,7561,3711,40430,1032,256,336,1624,42054
26-11-2017,4,13226,15744,7532,3779,40281,967,382,342,1691,41972
26-11-2017,5,13114,15999,7613,3678,40403,752,721,332,1805,42208
26-11-2017,6,13509,16318,7645,3730,41204,743,808,293,1844,43048
26-11-2017,7,14312,16723,7646,3941,42621,872,803,266,1941,44562
26-11-2017,8,15186,17203,7691,4049,44128,912,801,257,1970,46098
26-11-2017,9,16583,17813,7608,4085,46090,972,811,234,2017,48107
26-11-2017,10,17917,18054,7553,4215,47738,919,828,327,2074,49812
26-11-2017,11,18187,18884,7628,4371,49071,921,835,214,1970,51041
26-11-2017,12,17970,18848,7454,4598,48871,906,807,182,1895,50766
26-11-2017,13,17556,19095,7507,4780,48937,892,802,200,1894,50831
26-11-2017,14,17631,19207,7550,4781,49170,878,803,190,1871,51041
26-11-2017,15,18261,19572,7708,4853,50394,918,841,246,2005,52399
26-11-2017,16,19212,20042,7907,4903,52064,956,808,268,2032,54096
26-11-2017,17,19718,20351,7959,4968,52995,1056,1009,275,2340,55335
26-11-2017,18,19164,20104,7919,5059,52246,1138,985,284,2407,54653
26-11-2017,19,18650,19418,7889,5071,51029,1187,973,296,2456,53485
26-11-2017,20,17255,18663,7817,5084,48818,1191,887,308,2386,51204
26-11-2017,21,16624,18034,7896,5109,47665,1213,775,313,2301,49966
26-11-2017,22,15003,17553,7817,5025,45399,1217,679,269,2165,47564
26-11-2017,23,13550,16806,7811,4872,43040,1217,614,245,2076,45116
27-11-2017,0,12506,16395,7877,4730,41510,1006,273,257,1536,43046
27-11-2017,1,12426,16279,7954,4719,41380,970,271,256,1497,42877
27-11-2017,2,12295,16079,7975,4532,40881,1002,270,267,1539,42420
27-11-2017,3,12404,16185,8020,4337,40947,1005,307,254,1566,42513
27-11-2017,4,13058,16145,8073,4143,41419,1025,474,253,1752,43171
27-11-2017,5,15703,17432,8338,4132,45606,1098,867,251,2216,47822
27-11-2017,6,20803,20214,8662,4244,53922,1200,877,312,2389,56311
27-11-2017,7,24003,21068,9025,4480,58577,1174,1238,378,2790,61367
27-11-2017,8,24717,21784,9112,4346,59961,1173,1263,391,2827,62788
27-11-2017,9,24133,21221,8997,4395,58746,1218,1260,337,2815,61561
27-11-2017,10,23882,20765,8793,4599,58039,1248,1267,313,2828,60867
27-11-2017,11,23502,20576,8546,4998,57621,1239,1273,239,2751,60372
27-11-2017,12,22360,20171,8615,5124,56270,1239,1280,290,2809,59079
27-11-2017,13,22722,20102,8935,5796,57556,1224,1269,304,2797,60353
27-11-2017,14,23751,20399,9047,5518,58716,1230,1273,315,2818,61534
27-11-2017,15,24652,21199,9128,4965,59945,1242,1289,364,2895,62840
27-11-2017,16,24611,21699,9092,4950,60353,1258,1322,623,3203,63556
27-11-2017,17,24590,21847,8883,4768,60088,1256,1315,499,3070,63158
27-11-2017,18,24288,21540,8716,4382,58926,1247,1316,319,2882,61808
27-11-2017,19,24234,20825,8575,3766,57399,1261,1279,259,2799,60198
27-11-2017,20,23135,20216,8291,3569,55211,1257,1247,276,2780,57991
27-11-2017,21,20534,19377,8109,3465,51485,1243,796,263,2302,53787
27-11-2017,22,18339,18375,7834,3271,47821,1227,711,279,2217,50038
27-11-2017,23,16486,17803,7675,3259,45223,1211,516,299,2026,47249
28-11-2017,0,15788,16816,7715,3045,43365,1046,279,327,1652,45017
28-11-2017,1,15176,16467,7611,3013,42267,1015,273,371,1659,43926
28-11-2017,2,14679,16350,7553,3090,41673,1004,299,417,1720,43393
28-11-2017,3,14264,16268,7566,3121,41220,1002,307,427,1736,42956
28-11-2017,4,15216,16824,7663,3282,42985,981,427,429,1837,44822
28-11-2017,5,17311,17724,7836,3180,46051,1046,853,443,2342,48393
28-11-2017,6,21974,20003,8043,3397,53417,1242,1050,449,2741,56158
28-11-2017,7,24626,21982,8297,3660,58566,1297,1385,470,3152,61718
28-11-2017,8,24650,22534,8378,4127,59689,1297,1373,512,3182,62871
28-11-2017,9,24296,22347,8182,4045,58870,1331,1352,512,3195,62065
28-11-2017,10,24275,22389,8010,3862,58535,1343,1245,464,3052,61587
28-11-2017,11,24431,22820,8118,3789,59158,1337,1232,470,3039,62197
28-11-2017,12,24360,22886,8318,3777,59339,1348,1353,458,3159,62498
28-11-2017,13,24657,22903,8586,4041,60186,1353,1370,507,3230,63416
28-11-2017,14,24913,23035,8659,4080,60688,1363,1378,616,3357,64045
28-11-2017,15,25037,23666,8846,4313,61862,1368,1409,733,3510,65372
28-11-2017,16,24976,23671,8871,4305,61823,1342,1570,800,3712,65535
28-11-2017,17,24778,23662,8951,4112,61502,1371,1655,786,3812,65314
28-11-2017,18,24691,23635,8942,3813,61081,1358,1651,748,3757,64838
28-11-2017,19,24894,23453,8677,3286,60310,1352,1561,340,3253,63563
28-11-2017,20,24507,22922,8327,2976,58732,1341,1302,288,2931,61663
28-11-2017,21,23806,21674,8299,2791,56571,1336,1152,302,2790,59361
28-11-2017,22,22786,20572,8204,2499,54063,1288,753,272,2313,56376
28-11-2017,23,21428,19643,8086,2196,51354,1259,548,267,2074,53428
29-11-2017,0,19698,18670,7782,2196,48345,1154,415,251,1820,50165
29-11-2017,1,19095,18180,7649,2062,46986,1144,413,248,1805,48791
29-11-2017,2,18765,18101,7584,1961,46410,1139,414,238,1791,48201
29-11-2017,3,19266,18071,7689,1970,46997,1126,415,220,1761,48758
29-11-2017,4,20230,18373,8004,2025,48632,1126,418,234,1778,50410
29-11-2017,5,21947,19348,8175,2247,51718,1245,942,719,2906,54624
29-11-2017,6,23683,21669,8518,2981,56852,1385,1484,516,3385,60237
29-11-2017,7,25179,23018,8817,3531,60546,1450,1496,716,3662,64208
29-11-2017,8,25732,23297,8874,3821,61725,1274,1576,853,3703,65428
29-11-2017,9,25504,23168,8801,3715,61187,1271,1626,641,3538,64725
29-11-2017,10,25358,23100,8863,3645,60966,1298,1664,594,3556,64522
29-11-2017,11,25008,23031,8838,3657,60533,1296,1659,569,3524,64057
29-11-2017,12,25085,23196,8884,3596,60762,1295,1656,673,3624,64386
29-11-2017,13,24932,23248,8906,3667,60753,1329,1648,966,3943,64696
29-11-2017,14,25145,23149,9022,3689,61007,1338,1660,1009,4007,65014
29-11-2017,15,25570,23317,9112,3807,61807,1350,1761,1065,4176,65983
29-11-2017,16,25589,23542,9213,3929,62273,1373,1795,1069,4237,66510
29-11-2017,17,25519,23534,9303,3892,62249,1439,1792,1052,4283,66532
29-11-2017,18,25506,23355,9273,3685,61819,1439,1656,1025,4120,65939
29-11-2017,19,25244,22664,8903,3396,60208,1416,1578,821,3815,64023
29-11-2017,20,24526,22396,8641,2985,58548,1388,1295,377,3060,61608
29-11-2017,21,24345,21505,8474,2638,56963,1424,1157,291,2872,59835
29-11-2017,22,23387,20515,8354,2276,54533,1308,940,105,2353,56886
29-11-2017,23,22020,19816,8168,2169,52172,1254,489,104,1847,54019
30-11-2017,0,21121,18480,7967,2134,49701,1291,438,105,1834,51535
30-11-2017,1,20376,18023,7908,2100,48408,1300,439,100,1839,50247
30-11-2017,2,20112,17888,7878,2119,47995,1294,439,102,1835,49830
30-11-2017,3,20364,17963,7961,2115,48401,1278,467,114,1859,50260
30-11-2017,4,21200,18438,8036,2152,49827,1259,446,118,1823,51650
30-11-2017,5,22713,19759,8359,2366,53197,1313,1045,137,2495,55692
30-11-2017,6,24796,21652,8831,2843,58120,1352,1476,169,2997,61117
30-11-2017,7,25958,23451,9235,3545,62190,1351,1626,358,3335,65525
30-11-2017,8,25800,23843,9212,3855,62712,1350,1623,591,3564,66276
30-11-2017,9,25350,23324,9045,3678,61399,1354,1696,343,3393,64792
30-11-2017,10,24994,23057,9095,3671,60817,1354,1700,163,3217,64034
30-11-2017,11,24997,23042,9208,3754,61002,1343,1657,250,3250,64252
30-11-2017,12,25258,22926,9099,3837,61120,1343,1648,544,3535,64655
30-11-2017,13,25438,23111,9109,3808,61467,1346,1635,554,3535,65002
30-11-2017,14,25484,23347,9038,3907,61776,1346,1672,566,3584,65360
30-11-2017,15,25577,23677,9130,4027,62412,1340,1706,570,3616,66028
30-11-2017,16,25950,23828,9289,4233,63301,1338,1711,583,3632,66933
30-11-2017,17,25939,23674,9267,4277,63157,1345,1710,599,3654,66811
30-11-2017,18,25688,23485,9233,4166,62572,1340,1676,394,3410,65982
30-11-2017,19,25240,22860,8856,3917,60873,1337,1680,244,3261,64134
30-11-2017,20,24720,22022,8352,3705,58801,1419,1367,265,3051,61852
30-11-2017,21,24511,20932,8165,3496,57105,1440,1200,288,2928,60033
30-11-2017,22,23608,20327,7930,3121,54986,1449,959,301,2709,57695
30-11-2017,23,21642,19397,7787,3079,51906,1373,557,254,2184,54090
01-12-2017,0,21240,18581,7527,2875,50222,1339,411,235,1985,52207
01-12-2017,1,20138,18522,7466,2744,48871,1365,413,219,1997,50868
01-12-2017,2,19678,18591,7485,2726,48480,1383,412,198,1993,50473
01-12-2017,3,19577,18628,7561,2780,48547,1398,411,179,1988,50535
01-12-2017,4,20417,18787,7648,2928,49781,1416,421,167,2004,51785
01-12-2017,5,21845,19940,8043,3066,52895,1433,903,154,2490,55385
01-12-2017,6,24266,21455,8695,3577,57993,1451,1323,196,2970,60963
01-12-2017,7,25761,23305,9163,4016,62245,1454,1474,203,3131,65376
01-12-2017,8,25600,23988,9250,4226,63063,1429,1557,397,3383,66446
01-12-2017,9,25254,23751,9203,4186,62392,1413,1631,588,3632,66024
01-12-2017,10,25233,23490,9231,4055,62009,1401,1582,396,3379,65388
01-12-2017,11,25258,23388,9189,3983,61820,1383,1630,371,3384,65204
01-12-2017,12,25693,23498,9235,3876,62303,1360,1636,359,3355,65658
01-12-2017,13,25704,23577,9139,3813,62234,1351,1639,362,3352,65586
01-12-2017,14,25823,23498,9232,3667,62219,1431,1514,182,3127,65346
01-12-2017,15,26199,23723,9298,3437,62658,1427,1504,166,3097,65755
01-12-2017,16,26183,24048,9362,3658,63251,1420,1549,356,3325,66576
01-12-2017,17,25778,24272,9363,3724,63138,1420,1556,592,3568,66706
01-12-2017,18,25735,23971,9263,3609,62578,1415,1529,424,3368,65946
01-12-2017,19,25538,23002,9075,3408,61023,1336,1529,226,3091,64114
01-12-2017,20,24681,22098,8726,3259,58764,1331,1311,242,2884,61648
01-12-2017,21,24136,21544,8511,3057,57248,1317,1193,260,2770,60018
01-12-2017,22,23080,20879,8282,2798,55038,1304,754,227,2285,57323
01-12-2017,23,21630,19959,8022,2659,52268,1290,523,242,2055,54323
02-12-2017,0,21197,18995,8005,2595,50792,1202,425,245,1872,52664
02-12-2017,1,20281,18729,7919,2677,49607,1206,421,251,1878,51485
02-12-2017,2,19593,18675,7912,2730,48911,1202,423,247,1872,50783
02-12-2017,3,19422,18635,7956,2835,48850,1208,431,226,1865,50715
02-12-2017,4,19280,18636,8152,2906,48974,1208,426,186,1820,50794
02-12-2017,5,19599,18961,8371,3027,49959,1211,475,168,1854,51813
02-12-2017,6,20345,19470,8478,3036,51329,1229,556,164,1949,53278
02-12-2017,7,21131,20282,8675,3137,53224,1200,650,148,1998,55222
02-12-2017,8,21581,21103,8868,3420,54973,1197,742,143,2082,57055
02-12-2017,9,22442,21574,8818,3667,56501,1222,742,158,2122,58623
02-12-2017,10,22721,21792,8723,3913,57148,1247,743,174,2164,59312
02-12-2017,11,22392,21793,8562,4171,56918,1285,750,172,2207,59125
02-12-2017,12,21933,21658,8547,3952,56090,1250,809,142,2201,58291
02-12-2017,13,21409,21623,8466,3738,55236,1273,804,146,2223,57459
02-12-2017,14,21348,21853,8387,3719,55307,1293,857,160,2310,57617
02-12-2017,15,21815,22353,8429,3676,56274,1285,907,166,2358,58632
02-12-2017,16,22220,22723,8546,3777,57266,1307,947,190,2444,59710
02-12-2017,17,22321,22768,8532,3797,57418,1314,856,241,2411,59829
02-12-2017,18,21222,22464,8573,3963,56221,1313,869,218,2400,58621
02-12-2017,19,19710,21906,8667,4072,54354,1298,812,222,2332,56686
02-12-2017,20,18233,21492,8694,4125,52544,1309,820,249,2378,54922
02-12-2017,21,17207,21116,8605,4152,51079,1307,799,205,2311,53390
02-12-2017,22,15908,20718,8515,4204,49346,1312,463,218,1993,51339
02-12-2017,23,14446,20033,8466,4196,47142,1317,386,246,1949,49091
03-12-2017,0,14456,19286,8351,4147,46241,1231,230,266,1727,47968
03-12-2017,1,13903,19107,8225,3990,45225,1209,229,275,1713,46938
03-12-2017,2,13757,18793,8086,3853,44489,1231,229,303,1763,46252
03-12-2017,3,13308,18600,8037,3950,43896,1242,231,313,1786,45682
03-12-2017,4,13717,18525,8013,3857,44111,1247,238,319,1804,45915
03-12-2017,5,14112,18621,8039,3920,44695,1265,251,319,1835,46530
03-12-2017,6,14327,19144,7991,3616,45078,1291,422,342,2055,47133
03-12-2017,7,14061,19413,7875,3849,45199,1239,642,340,2221,47420
03-12-2017,8,16333,20056,7973,3878,48241,1245,651,393,2289,50530
03-12-2017,9,17909,20635,7983,4032,50559,1285,653,377,2315,52874
03-12-2017,10,18893,21098,8041,4046,52079,1279,739,415,2433,54512
03-12-2017,11,19343,21215,8126,4174,52856,1298,767,432,2497,55353
03-12-2017,12,19186,21088,8128,4203,52604,1299,666,406,2371,54975
03-12-2017,13,19055,20838,8231,4260,52386,1303,613,407,2323,54709
03-12-2017,14,19077,21075,8159,4134,52443,1299,647,411,2357,54800
03-12-2017,15,19936,21369,8299,4403,54007,1298,850,407,2555,56562
03-12-2017,16,20621,21878,8378,4568,55446,1297,938,422,2657,58103
03-12-2017,17,21085,22053,8271,4559,55969,1294,941,395,2630,58599
03-12-2017,18,20967,22090,8136,4519,55713,1298,940,410,2648,58361
03-12-2017,19,20340,21930,7998,4483,54750,1273,849,433,2555,57305
03-12-2017,20,19648,21553,7794,4370,53364,1239,661,408,2308,55672
03-12-2017,21,19378,20765,7646,4223,52012,1225,637,372,2234,54246
03-12-2017,22,18253,20073,7510,3834,49671,1175,640,376,2191,51862
03-12-2017,23,15578,19646,7351,3672,46248,1163,213,324,1700,47948
04-12-2017,0,14118,18872,7347,3977,44314,966,189,287,1442,45756
04-12-2017,1,13380,18705,7413,3968,43466,948,189,250,1387,44853
04-12-2017,2,13182,18598,7457,3905,43142,944,189,214,1347,44489
04-12-2017,3,13799,18652,7566,3805,43822,987,193,202,1382,45204
04-12-2017,4,14556,19001,7811,3793,45162,1123,285,177,1585,46747
04-12-2017,5,16742,20222,8097,4030,49092,1233,463,158,1854,50946
04-12-2017,6,21460,21956,8580,4137,56133,1259,875,149,2283,58416
04-12-2017,7,24027,23726,8926,4383,61063,1256,1289,151,2696,63759
04-12-2017,8,24633,24471,9071,4288,62464,1246,1337,329,2912,65376
04-12-2017,9,24625,24441,9056,4142,62265,1237,1385,338,2960,65225
04-12-2017,10,24380,24149,8781,4264,61574,1241,1452,120,2813,64387
04-12-2017,11,24294,24125,8707,4248,61373,1232,1486,283,3001,64374
04-12-2017,12,24233,23725,8562,4222,60742,1235,1491,387,3113,63855
04-12-2017,13,23834,23888,8810,4242,60774,1236,1468,452,3156,63930
04-12-2017,14,23801,24119,8855,4194,60968,1238,1470,570,3278,64246
04-12-2017,15,24310,24669,8858,4202,62039,1246,1488,576,3310,65349
04-12-2017,16,24517,25041,8919,4415,62891,1253,1491,598,3342,66233
04-12-2017,17,24340,25028,8909,4238,62516,1275,1494,604,3373,65889
04-12-2017,18,24212,24873,8940,4076,62103,1268,1449,638,3355,65458
04-12-2017,19,24021,24575,8847,3680,61124,1260,1347,461,3068,64192
04-12-2017,20,23445,23992,8360,3534,59333,1262,1227,386,2875,62208
04-12-2017,21,23138,22756,8179,3293,57366,1256,1081,258,2595,59961
04-12-2017,22,21482,21419,7972,3275,54150,1272,748,304,2324,56474
04-12-2017,23,19188,20293,7736,3246,50465,1270,611,309,2190,52655
05-12-2017,0,17398,19030,7575,3356,47359,1232,411,272,1915,49274
05-12-2017,1,16017,18798,7552,3755,46123,1207,441,238,1886,48009
05-12-2017,2,15215,18669,7558,4111,45554,1202,428,211,1841,47395
05-12-2017,3,15517,18746,7555,4254,46073,1225,428,196,1849,47922
05-12-2017,4,16243,18852,7683,4542,47321,1242,430,194,1866,49187
05-12-2017,5,19084,20097,8122,4666,51969,1265,895,208,2368,54337
05-12-2017,6,20986,22516,8708,5020,57230,1276,1286,225,2787,60017
05-12-2017,7,22847,24172,9195,5380,61594,1313,1409,403,3125,64719
05-12-2017,8,22881,24517,9389,5677,62465,1380,1419,405,3204,65669
05-12-2017,9,22438,24349,9300,6029,62117,1264,1433,552,3249,65366
05-12-2017,10,21833,24311,8951,6017,61113,1246,1425,188,2859,63972
05-12-2017,11,21462,24236,8860,6072,60630,1220,1467,196,2883,63513
05-12-2017,12,21326,24076,9118,5813,60334,1240,1486,436,3162,63496
05-12-2017,13,20921,24295,9168,5937,60321,1278,1477,344,3099,63420
05-12-2017,14,20758,24532,9162,6059,60511,1278,1471,274,3023,63534
05-12-2017,15,20878,24695,9188,6018,60779,1275,1475,343,3093,63872
05-12-2017,16,21928,25029,9212,5781,61950,1264,1473,782,3519,65469
05-12-2017,17,21920,25134,9133,6031,62220,1237,1444,781,3462,65682
05-12-2017,18,21257,24513,8879,5906,60556,1235,1437,690,3362,63918
05-12-2017,19,20471,24026,8411,5992,58900,1245,1080,419,2744,61644
05-12-2017,20,19129,23292,8111,5753,56287,1285,1075,417,2777,59064
05-12-2017,21,17879,21714,7803,5754,53150,1260,1071,460,2791,55941
05-12-2017,22,16051,20834,7667,5374,49926,1287,746,462,2495,52421
05-12-2017,23,14394,20192,7665,5474,47725,1195,646,464,2305,50030
06-12-2017,0,13892,18836,7651,5264,45645,1154,277,461,1892,47537
06-12-2017,1,13568,18645,7614,4759,44586,1093,262,390,1745,46331
06-12-2017,2,13347,18507,7622,4820,44296,1073,262,348,1683,45979
06-12-2017,3,13219,18500,7662,5343,44724,1068,263,271,1602,46326
06-12-2017,4,13975,18521,7778,5356,45631,1154,367,184,1705,47336
06-12-2017,5,15400,19807,7893,5085,48185,1172,547,163,1882,50067
06-12-2017,6,18662,21693,8049,5220,53625,1301,668,140,2109,55734
06-12-2017,7,22021,23167,8396,5325,58909,1340,909,112,2361,61270
06-12-2017,8,22550,23267,8596,5582,59995,1339,1366,110,2815,62810
06-12-2017,9,22251,22970,8685,5680,59585,1351,1372,95,2818,62403
06-12-2017,10,22133,22708,8505,5777,59124,1342,1258,100,2700,61824
06-12-2017,11,22236,22599,8518,5749,59103,1310,1194,124,2628,61731
06-12-2017,12,21914,22700,8746,5712,59073,1228,1377,136,2741,61814
06-12-2017,13,21965,22738,8813,5634,59150,1216,1396,124,2736,61886
06-12-2017,14,22222,22620,8880,5542,59263,1196,1383,118,2697,61960
06-12-2017,15,23160,22623,8944,5556,60283,1202,1402,221,2825,63108
06-12-2017,16,23671,22889,8946,5561,61066,1180,1495,545,3220,64286
06-12-2017,17,23800,22958,8958,5465,61180,1176,1493,539,3208,64388
06-12-2017,18,23388,22584,8651,5438,60061,1165,1465,577,3207,63268
06-12-2017,19,22772,21904,8577,5882,59135,1167,1135,243,2545,61680
06-12-2017,20,21807,21237,8111,5900,57055,1162,1137,130,2429,59484
06-12-2017,21,21105,20587,7901,5512,55104,1146,975,116,2237,57341
06-12-2017,22,18900,19284,7759,5391,51334,1144,808,104,2056,53390
06-12-2017,23,16293,18508,7593,5293,47688,1134,614,110,1858,49546
07-12-2017,0,15530,17519,7475,5079,45603,1034,412,93,1539,47142
07-12-2017,1,14672,17511,7461,4947,44590,994,408,93,1495,46085
07-12-2017,2,14030,17658,7514,4902,44104,1025,409,91,1525,45629
07-12-2017,3,13907,17762,7554,5090,44311,1023,410,117,1550,45861
07-12-2017,4,14732,18056,7708,5499,45995,1042,504,283,1829,47824
07-12-2017,5,15992,19284,8192,5651,49119,1112,954,384,2450,51569
07-12-2017,6,17923,20969,8760,5903,53554,1233,1175,421,2829,56383
07-12-2017,7,19888,22620,9094,5887,57489,1249,1424,417,3090,60579
07-12-2017,8,20315,23038,9134,6273,58762,1243,1450,643,3336,62098
07-12-2017,9,19819,23089,9140,6295,58345,1243,1444,651,3338,61683
07-12-2017,10,19810,23179,8984,6280,58254,1282,1286,476,3044,61298
07-12-2017,11,19408,23482,8912,6266,58068,1309,1476,462,3247,61315
07-12-2017,12,19066,23621,9139,6035,57863,1314,1475,459,3248,61111
07-12-2017,13,18766,23503,9192,6097,57559,1331,1457,538,3326,60885
07-12-2017,14,18905,23464,9415,6154,57939,1356,1455,445,3256,61195
07-12-2017,15,19471,23717,9694,6075,58958,1368,1448,657,3473,62431
07-12-2017,16,20138,24012,9659,5780,59589,1364,1427,616,3407,62996
07-12-2017,17,20449,24384,9621,5299,59754,1354,1500,482,3336,63090
07-12-2017,18,20119,23977,9426,5255,58778,1360,1424,419,3203,61981
07-12-2017,19,18873,23411,9047,5238,56570,1365,1121,413,2899,59469
07-12-2017,20,17141,22285,8958,5308,53692,1350,1089,396,2835,56527
07-12-2017,21,16573,20686,8874,5572,51706,1343,1034,354,2731,54437
07-12-2017,22,14396,20114,8682,5608,48800,1110,847,304,2261,51061
07-12-2017,23,13478,19720,8605,5099,46902,969,653,252,1874,48776
08-12-2017,0,13821,18755,8413,4630,45621,865,658,245,1768,47389
08-12-2017,1,13297,18664,8250,4621,44831,842,569,230,1641,46472
08-12-2017,2,13085,18522,8298,4514,44420,837,567,215,1619,46039
08-12-2017,3,12811,18586,8360,4681,44437,793,561,239,1593,46030
08-12-2017,4,13169,18917,8520,5024,45629,853,582,263,1698,47327
08-12-2017,5,14288,20051,8693,5061,48093,1034,952,290,2276,50369
08-12-2017,6,17765,21932,9015,5120,53832,1122,1152,365,2639,56471
08-12-2017,7,20919,23679,9445,5497,59542,1143,1329,562,3034,62576
08-12-2017,8,21238,24339,9383,5622,60583,1183,1341,762,3286,63869
08-12-2017,9,20846,24312,9299,5737,60194,1192,1399,701,3292,63486
08-12-2017,10,20379,24140,9004,5807,59330,1180,1363,360,2903,62233
08-12-2017,11,20072,23875,9035,5901,58884,1156,1391,362,2909,61793
08-12-2017,12,19693,23674,9145,6005,58517,1171,1439,652,3262,61779
08-12-2017,13,19657,23434,9166,6095,58353,1179,1423,647,3249,61602
08-12-2017,14,19954,23475,9280,5919,58630,1188,1427,549,3164,61794
08-12-2017,15,20584,23826,9531,5601,59543,1170,1349,729,3248,62791
08-12-2017,16,20791,24383,9472,5638,60283,1150,1326,704,3180,63463
08-12-2017,17,20510,24218,9445,5787,59960,1157,1251,635,3043,63003
08-12-2017,18,20207,23701,9392,5777,59078,1167,1272,537,2976,62054
08-12-2017,19,18841,23119,9154,5693,56808,1089,1025,370,2484,59292
08-12-2017,20,17761,22226,9005,5067,54060,1107,1016,330,2453,56513
08-12-2017,21,16808,21318,8782,5204,52111,1133,1009,306,2448,54559
08-12-2017,22,15344,19636,8726,5273,48980,1133,937,301,2371,51351
08-12-2017,23,14243,18585,8530,4968,46325,1083,636,337,2056,48381
09-12-2017,0,14710,17448,8384,5111,45656,791,462,353,1606,47262
09-12-2017,1,13724,17098,8390,4911,44123,748,466,327,1541,45664
09-12-2017,2,13461,16922,8423,4988,43796,749,465,315,1529,45325
09-12-2017,3,13317,16770,8415,4889,43391,787,464,269,1520,44911
09-12-2017,4,13614,16705,8385,4574,43279,755,467,260,1482,44761
09-12-2017,5,14030,16696,8402,4773,43902,769,877,282,1928,45830
09-12-2017,6,14443,17201,8476,4884,45004,770,1020,303,2093,47097
09-12-2017,7,16277,17679,8527,5125,47608,768,1033,347,2148,49756
09-12-2017,8,17286,18172,8538,5064,49061,794,1021,352,2167,51228
09-12-2017,9,17586,19305,8594,5237,50722,766,1032,344,2142,52864
09-12-2017,10,17817,19977,8779,5387,51959,763,1035,339,2137,54096
09-12-2017,11,17833,20048,8813,5385,52081,746,1041,293,2080,54161
09-12-2017,12,17688,19980,8814,5271,51753,741,1036,270,2047,53800
09-12-2017,13,17497,19965,8782,5277,51522,721,1033,241,1995,53517
09-12-2017,14,17683,20073,8919,5129,51804,740,1038,239,2017,53821
09-12-2017,15,18505,20622,8975,5047,53148,742,1028,260,2030,55178
09-12-2017,16,19274,21047,9079,5090,54490,758,1027,288,2073,56563
09-12-2017,17,20939,21283,9200,4927,56350,808,1028,273,2109,58459
09-12-2017,18,19484,21119,9203,4945,54751,817,1029,278,2124,56875
09-12-2017,19,18114,20715,9117,4734,52680,812,968,278,2058,54738
09-12-2017,20,17417,20335,8964,4207,50923,766,968,241,1975,52898
09-12-2017,21,16909,19709,8866,4098,49582,729,937,251,1917,51499
09-12-2017,22,16034,18399,8771,3826,47032,742,1019,209,1970,49002
09-12-2017,23,15576,17246,8681,3592,45095,761,683,232,1676,46771
10-12-2017,0,15083,16639,8555,3501,43777,736,365,207,1308,45085
10-12-2017,1,14630,16444,8568,3382,43026,721,343,210,1274,44300
10-12-2017,2,14357,16280,8537,3289,42462,753,342,199,1294,43756
10-12-2017,3,14303,16280,8545,3259,42387,781,342,190,1313,43700
10-12-2017,4,14162,16234,8556,3280,42232,768,338,182,1288,43520
10-12-2017,5,14694,16346,8651,3218,42910,716,382,177,1275,44185
10-12-2017,6,15124,17038,8693,3179,44036,703,481,205,1389,45425
10-12-2017,7,15798,18035,8735,3094,45662,718,662,229,1609,47271
10-12-2017,8,17201,18969,8737,3057,47965,731,724,313,1768,49733
10-12-2017,9,19061,19568,8852,3229,50710,737,820,313,1870,52580
10-12-2017,10,20363,20398,9001,3368,53131,733,915,292,1940,55071
10-12-2017,11,20760,20571,9057,3468,53855,727,957,290,1974,55829
10-12-2017,12,20679,20885,8773,3345,53681,748,964,262,1974,55655
10-12-2017,13,20683,21041,8776,3289,53790,752,967,240,1959,55749
10-12-2017,14,20696,20998,8630,3217,53541,740,971,264,1975,55516
10-12-2017,15,21062,21354,8613,3303,54332,751,973,247,1971,56303
10-12-2017,16,21918,21980,8594,3624,56116,752,1073,272,2097,58213
10-12-2017,17,21678,22226,8516,3951,56371,767,1018,301,2086,58457
10-12-2017,18,20927,21933,8522,3897,55281,780,977,289,2046,57327
10-12-2017,19,20594,21484,8388,3569,54037,766,863,302,1931,55968
10-12-2017,20,19582,21220,8157,3175,52133,772,775,279,1826,53959
10-12-2017,21,18883,20844,8103,3142,50972,762,713,256,1731,52703
10-12-2017,22,17627,20094,7949,3136,48806,731,700,204,1635,50441
10-12-2017,23,16531,18965,7826,2991,46314,701,607,229,1537,47851
11-12-2017,0,15826,17671,7786,2827,44110,852,349,268,1469,45579
11-12-2017,1,15239,17397,7794,2634,43064,890,347,293,1530,44594
11-12-2017,2,14999,17255,7833,2476,42562,963,306,293,1562,44124
11-12-2017,3,15335,17230,7911,2434,42910,1017,352,290,1659,44569
11-12-2017,4,16848,17531,7882,2351,44611,1068,366,277,1711,46322
11-12-2017,5,19222,19378,8139,2600,49339,1204,578,329,2111,51450
11-12-2017,6,23393,22254,8749,3640,58037,1313,834,324,2471,60508
11-12-2017,7,25296,23953,9247,4076,62573,1318,1448,643,3409,65982
11-12-2017,8,25231,24266,9484,4203,63183,1316,1627,688,3631,66814
11-12-2017,9,24988,23975,9451,4344,62758,1319,1544,671,3534,66292
11-12-2017,10,25239,23842,9225,4210,62515,1317,1472,286,3075,65590
11-12-2017,11,25402,24047,9266,4299,63014,1301,1522,293,3116,66130
11-12-2017,12,25575,24176,9436,4341,63529,1309,1545,427,3281,66810
11-12-2017,13,25599,24233,9470,4597,63899,1226,1630,376,3232,67131
11-12-2017,14,25709,24049,9431,4610,63800,1229,1562,660,3451,67251
11-12-2017,15,25132,23880,9409,4862,63284,1244,1614,644,3502,66786
11-12-2017,16,24777,23748,9303,5143,62971,1246,1606,689,3541,66512
11-12-2017,17,24892,23605,9228,4736,62462,1258,1614,695,3567,66029
11-12-2017,18,25377,23462,9079,4465,62384,1259,1495,697,3451,65835
11-12-2017,19,24799,23352,8848,4480,61480,1242,1390,315,2947,64427
11-12-2017,20,24440,22507,8479,3928,59355,1239,1145,318,2702,62057
11-12-2017,21,23813,22237,8252,3612,57913,1254,1006,323,2583,60496
11-12-2017,22,22090,20734,7983,3967,54774,1254,952,366,2572,57346
11-12-2017,23,18974,19178,7804,4049,50006,1246,822,303,2371,52377
12-12-2017,0,17130,17938,7761,3832,46662,1262,555,313,2130,48792
12-12-2017,1,15811,17607,7729,3912,45059,1270,553,334,2157,47216
12-12-2017,2,15171,17578,7700,4012,44460,1279,556,361,2196,46656
12-12-2017,3,15272,17622,7736,4077,44708,1288,560,359,2207,46915
12-12-2017,4,16165,17863,7852,4144,46023,1317,665,349,2331,48354
12-12-2017,5,18157,19085,8102,4112,49457,1411,708,381,2500,51957
12-12-2017,6,21882,21924,8502,4475,56783,1415,1128,433,2976,59759
12-12-2017,7,24270,23337,8915,4806,61330,1439,1386,416,3241,64571
12-12-2017,8,25530,23812,9017,4955,63315,1438,1389,575,3402,66717
12-12-2017,9,25724,23772,9005,4628,63128,1446,1393,598,3437,66565
12-12-2017,10,25606,23686,8795,4806,62893,1465,1393,432,3290,66183
12-12-2017,11,25644,23696,8850,4775,62965,1468,1402,417,3287,66252
12-12-2017,12,25674,23805,9085,4616,63181,1466,1432,449,3347,66528
12-12-2017,13,25668,23994,9050,4789,63502,1474,1423,473,3370,66872
12-12-2017,14,25605,24278,9169,4868,63920,1487,1440,579,3506,67426
12-12-2017,15,25791,24698,9364,4817,64670,1489,1475,680,3644,68314
12-12-2017,16,25904,24613,9473,4679,64670,1491,1469,867,3827,68497
12-12-2017,17,25826,24603,9461,4630,64520,1503,1459,737,3699,68219
12-12-2017,18,25557,24458,9281,4728,64025,1507,1439,684,3630,67655
12-12-2017,19,25425,23971,8879,4875,63152,1510,1266,527,3303,66455
12-12-2017,20,24660,23712,8506,4783,61662,1457,1172,520,3149,64811
12-12-2017,21,23688,23362,8213,4254,59518,1393,1163,498,3054,62572
12-12-2017,22,21242,22016,7874,4641,55774,1356,1173,438,2967,58741
12-12-2017,23,18850,20535,7801,4287,51473,1346,1048,429,2823,54296
13-12-2017,0,16813,19088,7810,4474,48183,1223,589,417,2229,50412
13-12-2017,1,16354,19145,7890,4544,47932,1201,576,400,2177,50109
13-12-2017,2,16318,19151,7981,4268,47717,1216,578,380,2174,49891
13-12-2017,3,16198,19342,8038,4377,47954,1221,572,356,2149,50103
13-12-2017,4,16128,19850,8136,4601,48714,1201,648,315,2164,50878
13-12-2017,5,17688,21224,8481,4811,52205,1230,905,341,2476,54681
13-12-2017,6,20810,23402,8874,5172,58259,1204,1080,322,2606,60865
13-12-2017,7,23294,25097,9399,5242,63031,1254,1321,337,2912,65943
13-12-2017,8,23461,25352,9468,5685,63965,1274,1340,498,3112,67077
13-12-2017,9,22651,24957,9373,5738,62719,1264,1332,495,3091,65810
13-12-2017,10,22311,24621,9135,5606,61673,1216,1176,427,2819,64492
13-12-2017,11,21492,24538,9124,5694,60848,1193,1166,406,2765,63613
13-12-2017,12,21274,24746,9433,5699,61151,1198,1326,389,2913,64064
13-12-2017,13,21899,24919,9584,5673,62076,1278,1314,363,2955,65031
13-12-2017,14,22864,24930,9795,5630,63219,1287,1357,341,2985,66204
13-12-2017,15,23914,25300,9896,5360,64470,1288,1371,490,3149,67619
13-12-2017,16,24690,25896,9857,4915,65358,1306,1371,456,3133,68491
13-12-2017,17,24851,25573,10054,4856,65334,1325,1357,340,3022,68356
13-12-2017,18,23583,25309,10337,4672,63901,1300,1249,359,2908,66809
13-12-2017,19,22155,24064,9494,4564,60276,1310,1229,338,2877,63153
13-12-2017,20,19753,23315,9009,4686,56764,1315,1185,351,2851,59615
13-12-2017,21,18127,22538,8782,4689,54137,1320,1195,367,2882,57019
13-12-2017,22,16111,21385,8598,4482,50576,1330,1191,326,2847,53423
13-12-2017,23,14998,20175,8491,4072,47735,1324,1074,350,2748,50483
14-12-2017,0,14777,19004,8417,3963,46162,1210,584,346,2140,48302
14-12-2017,1,14568,18336,8355,3526,44784,1058,581,357,1996,46780
14-12-2017,2,14605,18380,8265,3398,44647,1046,576,389,2011,46658
14-12-2017,3,14283,18174,8260,3262,43979,1043,578,402,2023,46002
14-12-2017,4,15275,18326,8364,3267,45232,1169,686,407,2262,47494
14-12-2017,5,17196,19586,8519,3557,48858,1180,821,410,2411,51269
14-12-2017,6,21640,21877,8788,4071,56376,1214,966,487,2667,59043
14-12-2017,7,25144,23488,9304,4279,62215,1266,1248,496,3010,65225
14-12-2017,8,25848,23780,9609,4604,63841,1258,1474,699,3431,67272
14-12-2017,9,25764,23673,9593,4319,63349,1255,1483,534,3272,66621
14-12-2017,10,25400,23242,9255,4381,62279,1188,1472,559,3219,65498
14-12-2017,11,24984,23170,9360,4527,62041,1212,1459,566,3237,65278
14-12-2017,12,24760,22945,9540,4427,61671,1202,1457,478,3137,64808
14-12-2017,13,24680,22840,9645,4506,61672,1195,1460,451,3106,64778
14-12-2017,14,25504,23396,9800,4784,63486,1191,1466,512,3169,66655
14-12-2017,15,26149,23650,9995,4919,64713,1202,1484,527,3213,67926
14-12-2017,16,26225,24179,10060,4791,65256,1267,1485,502,3254,68510
14-12-2017,17,26011,24576,9944,4853,65384,1279,1490,509,3278,68662
14-12-2017,18,25603,24222,9727,4823,64376,1255,1488,487,3230,67606
14-12-2017,19,24800,23589,9508,4650,62548,1255,1117,317,2689,65237
14-12-2017,20,23536,22932,9251,4269,59988,1253,1026,276,2555,62543
14-12-2017,21,22949,22259,9053,3864,58126,1240,1019,232,2491,60617
14-12-2017,22,21592,21305,8898,3684,55480,1238,1003,180,2421,57901
14-12-2017,23,19589,20125,8817,3432,51964,1228,860,214,2302,54266
15-12-2017,0,20237,18925,8631,2895,50688,1199,556,267,2022,52710
15-12-2017,1,19860,18516,8547,2674,49597,1180,551,306,2037,51634
15-12-2017,2,19606,18419,8567,2534,49126,1164,552,326,2042,51168
15-12-2017,3,19879,18404,8619,2401,49304,1161,561,300,2022,51326
15-12-2017,4,20456,19073,8654,2390,50574,1164,645,301,2110,52684
15-12-2017,5,22210,20760,8807,2530,54306,1151,992,273,2416,56722
15-12-2017,6,24656,22977,9214,3046,59892,1177,1221,342,2740,62632
15-12-2017,7,25978,24706,9463,3695,63841,1181,1443,572,3196,67037
15-12-2017,8,26200,24880,9658,3825,64562,1152,1490,760,3402,67964
15-12-2017,9,26211,24862,9656,3868,64597,1179,1479,804,3462,68059
15-12-2017,10,26198,24829,9542,3991,64560,1201,1507,705,3413,67973
15-12-2017,11,26349,24857,9560,4023,64790,1216,1506,514,3236,68026
15-12-2017,12,26189,24806,9555,3893,64444,1227,1487,522,3236,67680
15-12-2017,13,26234,24695,9455,3715,64099,1256,1568,480,3304,67403
15-12-2017,14,26250,24676,9394,3569,63892,1269,1648,477,3394,67286
15-12-2017,15,26479,24670,9364,3559,64071,1269,1662,682,3613,67684
15-12-2017,16,26464,24831,9347,3678,64319,1278,1612,713,3603,67922
15-12-2017,17,26240,24648,9261,3776,63927,1306,1552,673,3531,67458
15-12-2017,18,26178,24037,9176,3578,62969,1314,1487,628,3429,66398
15-12-2017,19,25610,23484,8893,3223,61209,1317,1172,216,2705,63914
15-12-2017,20,24441,22583,8326,3066,58418,1326,1041,172,2539,60957
15-12-2017,21,23744,21892,8042,3094,56772,1306,1022,172,2500,59272
15-12-2017,22,22484,20562,7939,3085,54069,1291,1015,169,2475,56544
15-12-2017,23,21425,19591,7702,3105,51825,1267,788,112,2167,53992
16-12-2017,0,21894,18085,7666,2928,50573,1192,573,79,1844,52417
16-12-2017,1,21093,17541,7645,2842,49120,1140,561,89,1790,50910
16-12-2017,2,20644,17448,7568,2737,48397,1152,562,89,1803,50200
16-12-2017,3,20670,17464,7540,2583,48256,1141,558,77,1776,50032
16-12-2017,4,20983,17612,7621,2531,48749,1057,551,76,1684,50433
16-12-2017,5,21289,18155,7722,2489,49656,1043,806,98,1947,51603
16-12-2017,6,22391,18858,7677,2541,51467,1005,805,110,1920,53387
16-12-2017,7,23673,19705,7830,2633,53842,990,994,177,2161,56003
16-12-2017,8,24313,20955,8088,2682,56039,968,1016,185,2169,58208
16-12-2017,9,25164,22001,8283,2801,58248,949,1003,218,2170,60418
16-12-2017,10,25345,22272,8355,3452,59424,949,1000,180,2129,61553
16-12-2017,11,25168,22304,8306,3594,59372,929,1033,125,2087,61459
16-12-2017,12,24683,22676,8231,3361,58950,928,1128,125,2181,61131
16-12-2017,13,24504,22531,8309,3299,58644,933,1195,112,2240,60884
16-12-2017,14,24817,22587,8305,3152,58860,941,1121,115,2177,61037
16-12-2017,15,25338,22966,8338,3430,60073,939,1164,213,2316,62389
16-12-2017,16,25712,23264,8458,3840,61276,933,1167,310,2410,63686
16-12-2017,17,25536,23336,8463,3969,61304,934,1281,512,2727,64031
16-12-2017,18,25337,23234,8557,3608,60738,958,1099,194,2251,62989
16-12-2017,19,24707,22902,8418,3595,59621,1009,1080,128,2217,61838
16-12-2017,20,23968,22375,8253,3374,57972,1014,984,120,2118,60090
16-12-2017,21,23440,21908,8045,3267,56660,1014,981,193,2188,58848
16-12-2017,22,22649,20662,7878,3095,54285,1008,977,107,2092,56377
16-12-2017,23,21123,19323,7621,3072,51139,1002,748,73,1823,52962
17-12-2017,0,20304,17922,7541,2934,48703,895,397,98,1390,50093
17-12-2017,1,19331,17624,7473,2819,47246,872,386,81,1339,48585
17-12-2017,2,18851,17642,7459,2734,46686,824,385,93,1302,47988
17-12-2017,3,18114,17721,7473,2590,45900,818,385,93,1296,47196
17-12-2017,4,18363,17720,7464,2431,45978,815,384,77,1276,47254
17-12-2017,5,19394,18071,7572,2421,47457,831,385,92,1308,48765
17-12-2017,6,20050,18822,7741,2307,48921,888,503,97,1488,50409
17-12-2017,7,21617,19933,8025,2413,51988,968,584,167,1719,53707
17-12-2017,8,23465,21895,8336,2381,56075,982,674,171,1827,57902
17-12-2017,9,24331,22672,8533,2787,58323,988,692,172,1852,60175
17-12-2017,10,24888,23072,8812,3076,59847,979,949,170,2098,61945
17-12-2017,11,24896,23220,8951,3311,60377,984,1043,159,2186,62563
17-12-2017,12,24774,23237,8896,3302,60209,973,1027,149,2149,62358
17-12-2017,13,24681,23145,8862,3364,60052,972,1026,136,2134,62186
17-12-2017,14,24960,23221,8976,3265,60423,976,1029,131,2136,62559
17-12-2017,15,25275,23705,9040,3413,61434,1010,1116,145,2271,63705
17-12-2017,16,25114,23892,9032,3570,61608,1010,1137,177,2324,63932
17-12-2017,17,24999,23844,8985,3626,61453,988,1138,184,2310,63763
17-12-2017,18,24667,23646,8815,3701,60831,980,1099,183,2262,63093
17-12-2017,19,24272,23263,8708,3771,60013,992,1079,155,2226,62239
17-12-2017,20,23521,22837,8585,3731,58672,1003,844,239,2086,60758
17-12-2017,21,23295,22312,8498,3895,58000,975,713,131,1819,59819
17-12-2017,22,22181,21249,8365,4126,55922,978,649,95,1722,57644
17-12-2017,23,21044,19495,8364,3928,52831,995,682,86,1763,54594
18-12-2017,0,19888,18507,8338,3817,50550,1035,233,84,1352,51902
18-12-2017,1,19069,18243,8391,3838,49539,1076,230,58,1364,50903
18-12-2017,2,18781,18066,8482,3790,49117,1085,231,40,1356,50473
18-12-2017,3,18487,18106,8518,3639,48750,1099,230,32,1361,50111
18-12-2017,4,19371,18432,8574,3509,49886,1133,256,24,1413,51299
18-12-2017,5,22092,20520,9122,3203,54937,1247,514,30,1791,56728
18-12-2017,6,24415,23053,9448,3324,60242,1269,816,103,2188,62430
18-12-2017,7,25760,24711,9656,4096,64224,1274,1173,524,2971,67195
18-12-2017,8,26205,24787,9768,4394,65156,1282,1384,527,3193,68349
18-12-2017,9,26188,24571,9659,4405,64823,1262,1390,528,3180,68003
18-12-2017,10,25766,24361,9493,4191,63811,1243,1376,484,3103,66914
18-12-2017,11,25906,24198,9353,4023,63481,1253,1344,314,2911,66392
18-12-2017,12,25786,24492,9503,4092,63875,1265,1371,483,3119,66994
18-12-2017,13,25840,24310,9563,3935,63648,1239,1395,494,3128,66776
18-12-2017,14,25814,24412,9715,4000,63941,1238,1401,465,3104,67045
18-12-2017,15,25783,24848,9794,4178,64602,1256,1532,435,3223,67825
18-12-2017,16,25812,24672,9611,4445,64540,1284,1547,511,3342,67882
18-12-2017,17,25845,24457,9534,4411,64247,1321,1548,506,3375,67622
18-12-2017,18,25337,24509,9345,4495,63687,1345,1546,502,3393,67080
18-12-2017,19,25142,24178,9098,3955,62374,1310,1394,482,3186,65560
18-12-2017,20,24795,23658,8634,3572,60660,1292,1102,102,2496,63156
18-12-2017,21,24662,22742,8392,3531,59326,1298,1050,103,2451,61777
18-12-2017,22,23796,21606,8061,3425,56887,1316,1048,44,2408,59295
18-12-2017,23,22577,20632,7880,3110,54199,1299,766,33,2098,56297
19-12-2017,0,22709,19034,7733,2770,52247,1293,551,53,1897,54144
19-12-2017,1,21831,18608,7669,2500,50609,1298,542,35,1875,52484
19-12-2017,2,21825,18294,7687,2387,50192,1292,541,36,1869,52061
19-12-2017,3,22299,18135,7769,2342,50547,1272,538,41,1851,52398
19-12-2017,4,23170,18893,7987,2475,52526,1312,550,42,1904,54430
19-12-2017,5,23782,20847,8489,2787,55906,1305,923,117,2345,58251
19-12-2017,6,24907,22560,8935,3337,59739,1297,1276,107,2680,62419
19-12-2017,7,26127,23682,9427,4101,63338,1305,1635,490,3430,66768
19-12-2017,8,26222,23887,9583,4229,63922,1380,1648,574,3602,67524
19-12-2017,9,26023,23664,9651,4187,63525,1396,1643,585,3624,67149
19-12-2017,10,25993,23762,9322,3991,63069,1363,1629,353,3345,66414
19-12-2017,11,25668,23796,9278,4158,62901,1312,1644,279,3235,66136
19-12-2017,12,25510,23734,9324,3999,62568,1352,1609,303,3264,65832
19-12-2017,13,25746,23662,9444,4011,62864,1292,1610,423,3325,66189
19-12-2017,14,25859,23942,9464,3999,63265,1254,1610,323,3187,66452
19-12-2017,15,25994,24029,9709,4001,63734,1361,1609,425,3395,67129
19-12-2017,16,26127,24223,9941,4250,64541,1377,1625,515,3517,68058
19-12-2017,17,25795,24208,10043,4284,64330,1261,1611,513,3385,67715
19-12-2017,18,25470,24165,9729,4229,63594,1261,1444,507,3212,66806
19-12-2017,19,24898,23850,9394,4015,62157,1257,1204,166,2627,64784
19-12-2017,20,24201,22908,9208,3669,59986,1256,1198,159,2613,62599
19-12-2017,21,23740,22124,9068,3370,58303,1253,1201,149,2603,60906
19-12-2017,22,23005,21082,8986,2932,56006,1260,1217,82,2559,58565
19-12-2017,23,21838,20043,8868,2545,53295,1264,987,93,2344,55639
20-12-2017,0,21196,19001,8829,2294,51320,1263,541,114,1918,53238
20-12-2017,1,20296,18572,8735,2257,49861,1264,533,118,1915,51776
20-12-2017,2,19343,18202,8638,2311,48496,1265,534,84,1883,50379
20-12-2017,3,19436,18158,8603,2363,48560,1248,534,74,1856,50416
20-12-2017,4,20332,18751,8729,2464,50277,1245,541,76,1862,52139
20-12-2017,5,21398,20462,8876,2874,53611,1262,854,68,2184,55795
20-12-2017,6,23629,21926,9038,3421,58016,1262,1221,122,2605,60621
20-12-2017,7,25075,23519,9304,3897,61795,1291,1327,135,2753,64548
20-12-2017,8,25475,24051,9409,4086,63023,1302,1371,420,3093,66116
20-12-2017,9,25467,24029,9114,3951,62560,1332,1371,419,3122,65682
20-12-2017,10,25011,23593,8962,4200,61766,1355,1362,320,3037,64803
20-12-2017,11,24855,23412,8910,4291,61468,1329,1320,295,2944,64412
20-12-2017,12,24922,23302,9066,4232,61523,1375,1354,298,3027,64550
20-12-2017,13,24908,23372,9102,4118,61499,1353,1350,300,3003,64502
20-12-2017,14,24793,23522,9100,4219,61634,1406,1448,304,3158,64792
20-12-2017,15,25110,23723,9128,4281,62243,1444,1488,504,3436,65679
20-12-2017,16,25610,23922,9102,4150,62784,1461,1441,528,3430,66214
20-12-2017,17,25439,23891,9036,4144,62510,1535,1373,543,3451,65961
20-12-2017,18,25102,23881,8909,3971,61863,1524,1343,351,3218,65081
20-12-2017,19,24734,23369,8401,3845,60349,1460,1166,229,2855,63204
20-12-2017,20,23855,22370,8010,3776,58012,1473,1126,228,2827,60839
20-12-2017,21,23004,21685,7912,3614,56215,1485,1037,211,2733,58948
20-12-2017,22,21663,20413,7742,3649,53467,1501,1024,164,2689,56156
20-12-2017,23,20003,19392,7554,3454,50404,1503,941,195,2639,53043
21-12-2017,0,19407,18418,7422,3373,48619,1664,583,223,2470,51089
21-12-2017,1,18184,18208,7377,3455,47224,1535,598,237,2370,49594
21-12-2017,2,17964,18185,7437,3363,46948,1487,455,244,2186,49134
21-12-2017,3,17914,18140,7414,3269,46735,1447,452,265,2164,48899
21-12-2017,4,18867,18461,7527,2994,47849,1442,592,276,2310,50159
21-12-2017,5,20277,20542,7975,3048,51844,1416,802,274,2492,54336
21-12-2017,6,22573,22611,8437,3309,56929,1402,841,304,2547,59476
21-12-2017,7,24436,23916,8699,3913,60965,1395,1311,471,3177,64142
21-12-2017,8,25155,24340,8999,4028,62522,1396,1304,632,3332,65854
21-12-2017,9,24904,24426,8988,4213,62532,1382,1304,678,3364,65896
21-12-2017,10,24229,24343,8865,4314,61751,1336,1153,343,2832,64583
21-12-2017,11,24211,24120,8990,4331,61653,1321,1138,236,2695,64348
21-12-2017,12,24219,24082,9288,4165,61754,1320,1185,304,2809,64563
21-12-2017,13,24227,24093,9250,4066,61637,1314,1191,277,2782,64419
21-12-2017,14,24284,24200,9289,4317,62090,1329,1191,363,2883,64973
21-12-2017,15,25180,24495,9315,4203,63192,1339,1234,563,3136,66328
21-12-2017,16,25334,24897,9287,4385,63903,1330,1223,608,3161,67064
21-12-2017,17,24805,24660,9214,4663,63342,1322,1190,570,3082,66424
21-12-2017,18,24614,24465,9197,4417,62693,1332,1150,248,2730,65423
21-12-2017,19,24184,24230,9045,3772,61233,1346,1044,202,2592,63825
21-12-2017,20,23292,23571,8829,3664,59356,1368,1031,124,2523,61879
21-12-2017,21,22287,22618,8567,3592,57065,1336,1045,111,2492,59557
21-12-2017,22,20003,21211,8414,3668,53297,1451,1044,102,2597,55894
21-12-2017,23,18483,20416,8167,3601,50668,1455,949,112,2516,53184
22-12-2017,0,18157,19586,8079,3563,49385,1058,292,85,1435,50820
22-12-2017,1,16742,19426,8081,3632,47881,1102,235,64,1401,49282
22-12-2017,2,16058,19393,8083,3674,47208,1006,238,79,1323,48531
22-12-2017,3,16410,19352,8170,3783,47717,973,237,74,1284,49001
22-12-2017,4,17492,19533,8167,3824,49016,986,240,83,1309,50325
22-12-2017,5,19084,21002,8296,3799,52181,1150,446,96,1692,53873
22-12-2017,6,21345,23002,8763,3851,56960,1270,655,164,2089,59049
22-12-2017,7,23850,24287,9041,3983,61161,1315,952,182,2449,63610
22-12-2017,8,24889,24746,9072,4343,63050,1398,1289,351,3038,66088
22-12-2017,9,24885,24923,8983,4263,63055,1380,1304,507,3191,66246
22-12-2017,10,24931,24953,8751,4304,62939,1357,893,251,2501,65440
22-12-2017,11,24580,24860,8703,4367,62509,1331,980,183,2494,65003
22-12-2017,12,24033,24710,8902,4425,62071,1332,1147,304,2783,64854
22-12-2017,13,23467,24779,8993,4531,61771,1328,1111,236,2675,64446
22-12-2017,14,23240,24577,9056,4540,61414,1312,1212,233,2757,64171
22-12-2017,15,23661,24831,9111,4495,62098,1241,1358,354,2953,65051
22-12-2017,16,24352,25012,9083,4430,62877,1281,1347,439,3067,65944
22-12-2017,17,24709,24865,9054,4359,62989,1312,1312,261,2885,65874
22-12-2017,18,24500,24434,9072,4251,62258,1305,1181,278,2764,65022
22-12-2017,19,23388,23773,8576,3870,59608,1305,989,268,2562,62170
22-12-2017,20,21933,22803,8401,3678,56815,1275,922,237,2434,59249
22-12-2017,21,21180,21963,8123,3738,55003,1114,832,230,2176,57179
22-12-2017,22,19296,20942,7789,4102,52129,994,743,219,1956,54085
22-12-2017,23,16928,19724,7537,4466,48654,919,547,192,1658,50312
23-12-2017,0,14784,18701,7595,4682,45763,881,236,159,1276,47039
23-12-2017,1,12593,18469,7739,4942,43743,908,234,125,1267,45010
23-12-2017,2,12140,18610,7900,4795,43444,783,231,122,1136,44580
23-12-2017,3,11886,18806,7890,4940,43522,709,232,150,1091,44613
23-12-2017,4,11693,18897,7949,5170,43708,678,237,163,1078,44786
23-12-2017,5,11731,19028,8091,4755,43605,692,277,150,1119,44724
23-12-2017,6,12031,19237,8399,4775,44442,715,585,128,1428,45870
23-12-2017,7,12627,19816,8508,4868,45819,738,780,240,1758,47577
23-12-2017,8,13700,20430,8643,4732,47505,823,821,275,1919,49424
23-12-2017,9,14311,21194,8866,4798,49170,917,825,332,2074,51244
23-12-2017,10,14783,21597,8953,4905,50239,893,800,352,2045,52284
23-12-2017,11,15122,21409,8841,4874,50248,909,799,394,2102,52350
23-12-2017,12,15056,21163,8730,5370,50319,905,800,413,2118,52437
23-12-2017,13,14833,21276,8638,5050,49797,930,801,418,2149,51946
23-12-2017,14,14777,21516,8467,5046,49806,936,806,438,2180,51986
23-12-2017,15,14740,22082,8664,5257,50744,1118,811,454,2383,53127
23-12-2017,16,14903,22399,8930,5552,51783,1224,808,444,2476,54259
23-12-2017,17,14935,22120,8943,5816,51814,1210,813,448,2471,54285
23-12-2017,18,14828,21813,8782,5659,51082,1166,825,452,2443,53525
23-12-2017,19,14313,21083,8595,5392,49383,1127,771,450,2348,51731
23-12-2017,20,13852,20224,8600,4878,47555,963,763,470,2196,49751
23-12-2017,21,13603,19505,8531,4248,45888,918,758,425,2101,47989
23-12-2017,22,13641,18901,8461,4113,45117,919,745,426,2090,47207
23-12-2017,23,12981,18192,8226,4123,43522,914,560,429,1903,45425
24-12-2017,0,12651,17928,8265,3205,42049,903,215,430,1548,43597
24-12-2017,1,12043,17526,8245,3027,40840,861,211,434,1506,42346
24-12-2017,2,11685,17376,8155,2971,40188,879,202,420,1501,41689
24-12-2017,3,11640,17155,8116,2765,39677,872,205,363,1440,41117
24-12-2017,4,11834,17011,8067,2549,39463,898,217,335,1450,40913
24-12-2017,5,12124,17043,8082,2812,40062,1005,400,335,1740,41802
24-12-2017,6,12329,17441,8211,3013,40996,1063,762,340,2165,43161
24-12-2017,7,13244,17937,8285,3192,42660,1059,842,337,2238,44898
24-12-2017,8,14214,18412,8299,3602,44527,1148,848,334,2330,46857
24-12-2017,9,15808,18505,8333,3948,46594,1229,847,325,2401,48995
24-12-2017,10,16671,19440,8191,4189,48490,1241,857,321,2419,50909
24-12-2017,11,16538,19824,8139,4495,48996,1172,859,326,2357,51353
24-12-2017,12,15861,19817,8093,4646,48417,1185,1002,260,2447,50864
24-12-2017,13,15843,19703,8098,4971,48615,1186,1021,202,2409,51024
24-12-2017,14,16092,19561,8178,5008,48839,1148,914,192,2254,51093
24-12-2017,15,16712,19785,8183,5153,49834,1116,886,215,2217,52051
24-12-2017,16,17208,19868,8074,5199,50349,1105,880,256,2241,52590
24-12-2017,17,16332,19588,7992,5302,49214,1039,798,232,2069,51283
24-12-2017,18,15207,19179,7868,5225,47479,982,782,205,1969,49448
24-12-2017,19,14358,18905,7938,4868,46069,961,775,199,1935,48004
24-12-2017,20,14338,18473,7743,4346,44900,965,769,198,1932,46832
24-12-2017,21,14863,17777,7619,4053,44312,1000,762,148,1910,46222
24-12-2017,22,14811,17352,7601,4322,44087,982,783,100,1865,45952
24-12-2017,23,14452,16976,7520,4155,43103,990,551,68,1609,44712
25-12-2017,0,14062,16280,7407,3630,41379,974,331,52,1357,42736
25-12-2017,1,13782,16536,7366,3139,40823,971,330,53,1354,42177
25-12-2017,2,12958,16576,7366,3304,40205,971,312,64,1347,41552
25-12-2017,3,12689,16520,7443,3196,39848,971,214,75,1260,41108
25-12-2017,4,12305,16566,7537,3425,39833,979,223,97,1299,41132
25-12-2017,5,12855,16671,7625,3758,40908,979,638,107,1724,42632
25-12-2017,6,13789,17102,7545,3719,42156,955,904,84,1943,44099
25-12-2017,7,14135,17583,7679,4521,43919,951,1047,90,2088,46007
25-12-2017,8,14324,18250,7899,4859,45334,985,1075,95,2155,47489
25-12-2017,9,14507,18511,8063,5115,46198,1065,1062,122,2249,48447
25-12-2017,10,14848,18939,8151,5375,47312,1068,1062,127,2257,49569
25-12-2017,11,14889,19238,8124,5509,47759,1086,1067,147,2300,50059
25-12-2017,12,15080,19448,8052,5554,48135,1099,1088,182,2369,50504
25-12-2017,13,15027,19554,8052,5532,48167,1081,1099,250,2430,50597
25-12-2017,14,15074,19813,8233,5428,48549,1126,1163,388,2677,51226
25-12-2017,15,15684,20152,8126,5421,49384,1151,1207,406,2764,52148
25-12-2017,16,15900,20508,8041,5596,50045,1159,1213,468,2840,52885
25-12-2017,17,15698,20376,7924,5773,49772,1168,1219,469,2856,52628
25-12-2017,18,16642,20041,7758,5759,50200,1159,1269,460,2888,53088
25-12-2017,19,16376,19687,7753,5768,49583,1173,1222,462,2857,52440
25-12-2017,20,15049,19606,7727,5582,47964,1151,1198,458,2807,50771
25-12-2017,21,14468,19539,7603,5447,47057,1142,1106,433,2681,49738
25-12-2017,22,13555,18718,7400,5410,45085,1174,1055,432,2661,47746
25-12-2017,23,13067,17695,7310,5108,43181,1176,762,422,2360,45541
26-12-2017,0,13590,17182,7312,4917,43001,1112,361,416,1889,44890
26-12-2017,1,12703,16593,7265,4863,41425,1088,225,397,1710,43135
26-12-2017,2,11918,16446,7291,4408,40062,1088,223,396,1707,41769
26-12-2017,3,11837,16358,7295,4256,39747,1054,220,351,1625,41372
26-12-2017,4,12636,16365,7310,4267,40578,1048,250,332,1630,42208
26-12-2017,5,13397,16519,7307,4125,41349,1025,661,307,1993,43342
26-12-2017,6,13634,17236,7468,4153,42492,983,984,298,2265,44757
26-12-2017,7,14467,17669,7579,4235,43949,961,1062,335,2358,46307
26-12-2017,8,15267,18005,7644,4829,45745,995,1053,336,2384,48129
26-12-2017,9,16146,18498,7680,5046,47371,1031,1052,335,2418,49789
26-12-2017,10,15945,19250,7704,4965,47864,1088,1051,263,2402,50266
26-12-2017,11,16304,19697,7773,5013,48788,1085,1050,267,2402,51190
26-12-2017,12,16461,20631,7797,5079,49968,1069,1095,284,2448,52416
26-12-2017,13,16444,20964,7783,4939,50131,1065,1026,276,2367,52498
26-12-2017,14,16219,21270,7845,4985,50319,1053,1003,267,2323,52642
26-12-2017,15,16899,21036,7928,5100,50962,1065,1026,296,2387,53349
26-12-2017,16,17752,21458,8050,5061,52322,1061,1108,348,2517,54839
26-12-2017,17,17441,21598,8068,5010,52117,1066,1107,367,2540,54657
26-12-2017,18,17135,21246,8131,5000,51513,1095,1096,347,2538,54051
26-12-2017,19,16430,20907,7955,4928,50221,1116,1012,362,2490,52711
26-12-2017,20,15754,20489,7885,4925,49052,1080,943,366,2389,51441
26-12-2017,21,15188,20115,7832,4833,47967,1035,925,353,2313,50280
26-12-2017,22,14679,19699,7806,4787,46970,1042,827,350,2219,49189
26-12-2017,23,14275,19016,7670,4498,45460,1044,666,314,2024,47484
27-12-2017,0,13876,18369,7488,4277,44009,1083,221,274,1578,45587
27-12-2017,1,12796,18033,7440,4042,42311,974,215,237,1426,43737
27-12-2017,2,12050,17877,7377,3862,41166,983,209,216,1408,42574
27-12-2017,3,11858,17902,7447,3500,40709,982,210,235,1427,42136
27-12-2017,4,12466,18050,7825,3188,41529,1092,223,227,1542,43071
27-12-2017,5,14068,18606,8017,3138,43829,1183,555,278,2016,45845
27-12-2017,6,15950,20521,8095,3297,47864,1193,824,284,2301,50165
27-12-2017,7,19576,21811,8368,3479,53234,1235,891,273,2399,55633
27-12-2017,8,21802,22232,8592,3834,56460,1299,968,262,2529,58989
27-12-2017,9,22795,22400,8305,3933,57433,1287,1208,248,2743,60176
27-12-2017,10,23512,22725,8126,3964,58326,1281,1155,190,2626,60952
27-12-2017,11,24554,23368,8277,3770,59969,1179,1167,173,2519,62488
27-12-2017,12,24650,23647,8291,3741,60330,1278,1249,156,2683,63013
27-12-2017,13,24379,23546,8327,3643,59895,1269,1241,320,2830,62725
27-12-2017,14,24634,23514,8472,3831,60451,1260,1239,384,2883,63334
27-12-2017,15,25215,23593,8782,3976,61565,1273,1353,503,3129,64694
27-12-2017,16,25311,23960,8836,3966,62074,1255,1381,665,3301,65375
27-12-2017,17,25385,23604,8922,4021,61930,1261,1385,569,3215,65145
27-12-2017,18,25184,23306,8611,3775,60877,1239,1339,620,3198,64075
27-12-2017,19,24631,22841,8231,3508,59210,1231,1173,316,2720,61930
27-12-2017,20,23573,21977,8174,3236,56961,1228,926,328,2482,59443
27-12-2017,21,23249,21118,7982,2868,55218,1251,803,339,2393,57611
27-12-2017,22,22077,20348,7745,2758,52928,1240,767,356,2363,55291
27-12-2017,23,20406,19247,7544,2669,49868,1304,631,366,2301,52169
28-12-2017,0,19259,17606,7271,2561,46697,1189,259,378,1826,48523
28-12-2017,1,17747,17028,7130,2411,44316,1118,244,388,1750,46066
28-12-2017,2,16696,16827,7106,2328,42959,993,244,358,1595,44554
28-12-2017,3,15923,16732,7067,2305,42029,983,242,305,1530,43559
28-12-2017,4,17324,16944,6984,2324,43577,1024,340,320,1684,45261
28-12-2017,5,19690,17856,7167,2377,47092,1223,725,357,2305,49397
28-12-2017,6,21830,19074,7552,2523,50980,1268,881,350,2499,53479
28-12-2017,7,23055,20659,7882,2784,54382,1286,1116,348,2750,57132
28-12-2017,8,23649,21198,8205,3207,56260,1290,1312,357,2959,59219
28-12-2017,9,24577,21725,8229,3561,58093,1287,1368,478,3133,61226
28-12-2017,10,25031,22007,8136,3653,58828,1315,1381,338,3034,61862
28-12-2017,11,25150,22190,8286,3532,59158,1248,1358,447,3053,62211
28-12-2017,12,25418,22316,8460,3351,59546,1247,1367,454,3068,62614
28-12-2017,13,25208,22137,8525,2991,58862,1234,1365,444,3043,61905
28-12-2017,14,25013,22205,8695,3082,58997,1203,1344,471,3018,62015
28-12-2017,15,24826,22235,8593,3112,58765,1229,1380,498,3107,61872
28-12-2017,16,24769,22146,8670,3418,59004,1231,1382,520,3133,62137
28-12-2017,17,24767,21790,8685,3762,59003,1294,1382,590,3266,62269
28-12-2017,18,24024,21513,8369,4052,57959,1302,1380,610,3292,61251
28-12-2017,19,22527,20830,7939,3949,55247,1285,1023,366,2674,57921
28-12-2017,20,20663,20241,7615,3915,52435,1262,902,385,2549,54984
28-12-2017,21,19588,19490,7561,3797,50438,1261,885,394,2540,52978
28-12-2017,22,18674,18904,7582,3857,49018,1160,792,364,2316,51334
28-12-2017,23,17220,17801,7397,3928,46348,1163,728,356,2247,48595
29-12-2017,0,15628,16606,7408,4059,43701,1110,642,355,2107,45808
29-12-2017,1,14828,16447,7410,3955,42642,1097,644,309,2050,44692
29-12-2017,2,14230,16596,7471,3903,42199,1154,638,297,2089,44288
29-12-2017,3,14310,16665,7524,3957,42455,1111,630,259,2000,44455
29-12-2017,4,14834,16775,7626,3956,43191,1195,627,223,2045,45236
29-12-2017,5,16077,17043,7806,3950,44877,1180,843,219,2242,47119
29-12-2017,6,17200,18882,8085,3921,48088,1248,932,232,2412,50500
29-12-2017,7,19100,20079,8352,3871,51402,1330,1024,341,2695,54097
29-12-2017,8,20964,21147,8691,3985,54788,1332,1033,462,2827,57615
29-12-2017,9,21570,21194,8722,4177,55664,1352,1163,530,3045,58709
29-12-2017,10,21621,21320,8703,4235,55881,1335,1159,360,2854,58735
29-12-2017,11,22137,21398,8611,3940,56086,1285,1161,395,2841,58927
29-12-2017,12,21922,21425,8751,3915,56014,1273,1163,381,2817,58831
29-12-2017,13,22110,21177,8801,3903,55990,1268,1166,310,2744,58734
29-12-2017,14,22560,21305,9056,3802,56724,1270,1165,326,2761,59485
29-12-2017,15,23061,21522,9253,3826,57663,1260,1181,337,2778,60441
29-12-2017,16,24535,21882,9190,4019,59626,1259,1184,385,2828,62454
29-12-2017,17,25233,22376,9108,3979,60696,1271,1186,397,2854,63550
29-12-2017,18,23958,22135,8871,3999,58963,1259,1175,382,2816,61779
29-12-2017,19,21904,21480,8345,3810,55541,1246,1166,426,2838,58379
29-12-2017,20,20024,20840,8115,3884,52862,1175,1079,443,2697,55559
29-12-2017,21,18848,20074,7984,3709,50616,1149,1040,444,2633,53249
29-12-2017,22,17692,19264,7748,3552,48256,1004,1037,432,2473,50729
29-12-2017,23,16240,18370,7561,3392,45563,1058,799,395,2252,47815
30-12-2017,0,16242,17483,7568,3382,44676,935,849,357,2141,46817
30-12-2017,1,15284,17252,7512,3339,43389,966,848,361,2175,45564
30-12-2017,2,14297,17150,7433,3398,42278,970,851,376,2197,44475
30-12-2017,3,13619,17092,7440,3499,41650,956,899,353,2208,43858
30-12-2017,4,13665,17096,7428,3472,41660,923,964,345,2232,43892
30-12-2017,5,14273,17333,7464,3513,42583,865,1051,409,2325,44908
30-12-2017,6,15123,17682,7564,3661,44030,925,1068,394,2387,46417
30-12-2017,7,15787,19057,7707,3771,46322,908,1159,387,2454,48776
30-12-2017,8,16616,19910,7950,3773,48249,985,1141,389,2515,50764
30-12-2017,9,17517,20294,8144,3858,49813,1032,1138,411,2581,52394
30-12-2017,10,18073,20447,8422,3852,50793,1079,1148,441,2668,53461
30-12-2017,11,18198,20693,8496,3897,51285,1059,1152,440,2651,53936
30-12-2017,12,18002,20987,8499,4007,51496,988,1160,393,2541,54037
30-12-2017,13,18171,21180,8598,3744,51693,990,1158,321,2469,54162
30-12-2017,14,18471,21364,8709,3637,52181,981,1162,374,2517,54698
30-12-2017,15,18977,22087,8756,3668,53489,964,1169,471,2604,56093
30-12-2017,16,19392,22657,8866,3506,54423,1002,1175,535,2712,57135
30-12-2017,17,19550,22912,8888,3489,54838,1008,1181,579,2768,57606
30-12-2017,18,19109,23150,8922,3309,54492,1030,1184,595,2809,57301
30-12-2017,19,18548,22940,8918,2934,53340,1063,1188,604,2855,56195
30-12-2017,20,17155,22417,8816,2687,51075,1065,1192,604,2861,53936
30-12-2017,21,16179,21562,8762,2628,49131,1078,1193,617,2888,52019
30-12-2017,22,15536,20575,8569,2572,47251,1078,1108,572,2758,50009
30-12-2017,23,15310,19305,8292,2424,45330,1076,874,611,2561,47891
31-12-2017,0,14885,16967,8069,2646,42567,1074,832,670,2576,45143
31-12-2017,1,14059,16305,7997,2661,41023,965,826,638,2429,43452
31-12-2017,2,13344,16096,7985,2436,39862,926,821,623,2370,42232
31-12-2017,3,12723,16036,7924,2375,39058,911,812,558,2281,41339
31-12-2017,4,12194,16048,7928,2338,38508,916,818,508,2242,40750
31-12-2017,5,12243,16245,7951,2386,38825,908,905,498,2311,41136
31-12-2017,6,12623,16735,8048,2663,40070,903,995,520,2418,42488
31-12-2017,7,13130,17521,8087,3045,41784,940,1073,466,2479,44263
31-12-2017,8,14436,18341,8165,3209,44151,892,1073,404,2369,46520
31-12-2017,9,16071,18942,8397,3471,46883,871,1070,371,2312,49195
31-12-2017,10,17550,19507,8495,3856,49408,967,1068,364,2399,51807
31-12-2017,11,17835,19697,8525,4278,50335,1029,1071,332,2432,52767
31-12-2017,12,17747,19911,8490,4555,50702,1022,1068,302,2392,53094
31-12-2017,13,17726,20172,8530,4645,51073,1024,1067,281,2372,53445
31-12-2017,14,18173,20422,8532,4556,51684,1039,1063,272,2374,54058
31-12-2017,15,18786,21355,8751,4576,53469,1044,1064,269,2377,55846
31-12-2017,16,19144,22185,8860,4534,54725,1052,1065,271,2388,57113
31-12-2017,17,18682,22437,8917,4759,54795,1060,1066,275,2401,57196
31-12-2017,18,17951,22009,8807,4555,53323,1050,1065,283,2398,55721
31-12-2017,19,16599,21335,8595,4144,50673,969,1064,324,2357,53030
31-12-2017,20,14930,20767,8540,3759,47996,963,1055,379,2397,50393
31-12-2017,21,14435,20246,8413,3585,46680,934,1059,377,2370,49050
31-12-2017,22,14081,19852,8150,3527,45610,965,984,418,2367,47977
31-12-2017,23,13744,18994,8106,3501,44347,923,798,516,2237,46584
01-01-2018,0,14131,18029,8050,3583,43793,944,496,617,2057,45850
01-01-2018,1,14297,16989,7953,3536,42775,959,342,603,1904,44679
01-01-2018,2,13365,16910,7849,3369,41493,1028,342,543,1913,43406
01-01-2018,3,12076,16674,7875,3394,40020,1045,339,502,1886,41906
01-01-2018,4,12083,16539,7850,3389,39862,1050,368,481,1899,41761
01-01-2018,5,12158,16745,7877,3204,39985,1053,598,523,2174,42159
01-01-2018,6,12629,17134,7919,3272,40954,969,688,543,2200,43154
01-01-2018,7,13277,17642,7957,3360,42236,941,777,561,2279,44515
01-01-2018,8,12841,18110,7964,3394,42310,915,841,594,2350,44660
01-01-2018,9,13030,18518,7830,3595,42972,904,915,619,2438,45410
01-01-2018,10,13951,19377,7822,4113,45263,885,925,639,2449,47712
01-01-2018,11,14464,19800,7813,4225,46302,871,994,661,2526,48828
01-01-2018,12,14695,20033,7839,4344,46910,843,1019,618,2480,49390
01-01-2018,13,14664,20101,7902,4591,47260,862,1155,582,2599,49859
01-01-2018,14,14930,20330,8073,4454,47788,883,1226,511,2620,50408
01-01-2018,15,15899,20889,8166,4421,49375,988,1224,465,2677,52052
01-01-2018,16,16703,21333,8263,4409,50707,1041,1226,536,2803,53510
01-01-2018,17,17477,21543,8260,4432,51711,1005,1229,605,2839,54550
01-01-2018,18,17220,21481,8263,4346,51311,1019,1228,597,2844,54155
01-01-2018,19,16376,21341,8146,4244,50108,995,1231,589,2815,52923
01-01-2018,20,15590,21024,7918,3841,48373,1057,1269,545,2871,51244
01-01-2018,21,15061,20886,7896,3752,47594,1121,977,503,2601,50195
01-01-2018,22,13800,20326,7673,3549,45351,1062,797,513,2372,47723
01-01-2018,23,12554,18780,7325,3432,42092,1003,703,522,2228,44320
02-01-2018,0,11647,17302,7074,3295,39318,1072,855,532,2459,41777
02-01-2018,1,11021,16891,6990,3178,38079,1075,765,547,2387,40466
02-01-2018,2,11323,16751,6955,2976,38006,1063,781,514,2358,40364
02-01-2018,3,11411,16693,6970,2848,37922,1182,825,524,2531,40453
02-01-2018,4,12558,17473,7120,2744,39895,1129,1002,509,2640,42535
02-01-2018,5,14566,18042,7209,2740,42558,1422,1009,493,2924,45482
02-01-2018,6,17392,18708,7515,2877,46493,1454,1007,476,2937,49430
02-01-2018,7,21987,21054,7872,3357,54270,1482,1087,486,3055,57325
02-01-2018,8,23603,21830,8129,3996,57557,1529,1096,427,3052,60609
02-01-2018,9,24068,22140,8120,3934,58262,1528,1295,406,3229,61491
02-01-2018,10,24723,22412,8081,3938,59155,1549,1374,386,3309,62464
02-01-2018,11,24969,22422,8097,3775,59263,1551,1376,349,3276,62539
02-01-2018,12,25156,22466,8061,3629,59311,1497,1332,376,3205,62516
02-01-2018,13,25181,22430,8020,3706,59338,1428,1335,401,3164,62502
02-01-2018,14,25193,22363,8074,3818,59449,1449,1324,335,3108,62557
02-01-2018,15,25346,22392,8341,3809,59889,1457,1618,551,3626,63515
02-01-2018,16,25406,22456,8614,3925,60401,1456,1644,796,3896,64297
02-01-2018,17,25450,22664,8677,4085,60875,1424,1646,817,3887,64762
02-01-2018,18,25259,22575,8352,4197,60384,1413,1655,380,3448,63832
02-01-2018,19,24741,22046,8097,3890,58774,1442,1324,343,3109,61883
02-01-2018,20,22795,21107,7883,3587,55374,1466,1163,324,2953,58327
02-01-2018,21,20344,20115,7522,3341,51321,1517,1099,326,2942,54263
02-01-2018,22,18361,18625,7467,3567,48022,1541,1095,316,2952,50974
02-01-2018,23,17364,17283,7463,3716,45827,1498,1009,262,2769,48596
03-01-2018,0,16285,15704,7531,3758,43277,1344,1062,306,2712,45989
03-01-2018,1,14856,15405,7520,3942,41724,1292,1065,306,2663,44387
03-01-2018,2,13760,15385,7495,4064,40704,1199,1050,295,2544,43248
03-01-2018,3,13650,15398,7492,4024,40564,1145,1039,277,2461,43025
03-01-2018,4,13795,15739,7481,4242,41257,1230,1060,276,2566,43823
03-01-2018,5,15541,16391,7748,4589,44269,1244,1221,286,2751,47020
03-01-2018,6,18231,17990,7982,5123,49326,1375,1241,296,2912,52238
03-01-2018,7,20413,19691,8224,5483,53810,1383,1244,375,3002,56812
03-01-2018,8,21097,20803,8363,5573,55838,1355,1262,318,2935,58773
03-01-2018,9,21148,20883,8418,5167,55616,1316,1270,338,2924,58540
03-01-2018,10,22048,21392,8431,4653,56523,1330,1329,349,3008,59531
03-01-2018,11,22330,21544,8537,4061,56472,1318,1262,459,3039,59511
03-01-2018,12,22627,21522,8567,3693,56410,1320,1331,477,3128,59538
03-01-2018,13,23144,21427,8539,3416,56527,1333,1332,526,3191,59718
03-01-2018,14,23803,21912,8530,3146,57391,1343,1351,562,3256,60647
03-01-2018,15,24292,22055,8695,3029,58072,1367,1350,588,3305,61377
03-01-2018,16,24625,22321,8786,2967,58700,1420,1332,538,3290,61990
03-01-2018,17,24704,22405,8785,2850,58745,1426,1331,587,3344,62089
03-01-2018,18,24336,22058,8717,2694,57805,1417,1249,615,3281,61086
03-01-2018,19,23707,21592,8622,2501,56423,1434,1242,621,3297,59720
03-01-2018,20,22574,20618,8352,2506,54050,1429,1246,636,3311,57361
03-01-2018,21,21614,19865,7980,2427,51885,1406,1169,639,3214,55099
03-01-2018,22,20120,18839,7653,2526,49138,1389,1080,632,3101,52239
03-01-2018,23,18255,17845,7475,2571,46146,1212,992,623,2827,48973
04-01-2018,0,16816,16919,7375,2628,43739,1189,1143,603,2935,46674
04-01-2018,1,15689,17051,7390,2634,42764,1246,1156,595,2997,45761
04-01-2018,2,14908,16873,7371,2902,42056,1192,1157,594,2943,44999
04-01-2018,3,14691,16931,7352,3069,42045,1184,1155,581,2920,44965
04-01-2018,4,14822,17029,7370,3114,42334,1194,1157,574,2925,45259
04-01-2018,5,16131,17623,7659,3135,44548,1202,1161,584,2947,47495
04-01-2018,6,19726,19183,8080,3140,50129,1339,1260,615,3214,53343
04-01-2018,7,23184,22308,8299,3311,57103,1400,1277,620,3297,60400
04-01-2018,8,24900,23369,8446,3883,60598,1429,1378,607,3414,64012
04-01-2018,9,25116,23193,8620,4008,60938,1419,1381,580,3380,64318
04-01-2018,10,25376,23515,8704,3887,61482,1460,1445,551,3456,64938
04-01-2018,11,25422,23298,8769,3962,61450,1478,1397,538,3413,64863
04-01-2018,12,25484,23569,8768,3834,61653,1463,1372,738,3573,65226
04-01-2018,13,25588,23712,8819,3798,61918,1473,1372,709,3554,65472
04-01-2018,14,25667,23655,8912,3731,61965,1481,1371,681,3533,65498
04-01-2018,15,25860,23954,8971,3528,62312,1498,1541,870,3909,66221
04-01-2018,16,25864,23978,9053,3394,62289,1457,1537,1022,4016,66305
04-01-2018,17,25562,24013,8961,3300,61837,1459,1526,1020,4005,65842
04-01-2018,18,25515,23555,8823,3249,61143,1472,1362,817,3651,64794
04-01-2018,19,25053,23320,8782,3209,60363,1501,1259,581,3341,63704
04-01-2018,20,23688,23003,8750,2729,58170,1495,1259,558,3312,61482
04-01-2018,21,22583,21957,8542,2252,55334,1419,1174,546,3139,58473
04-01-2018,22,21427,21313,8266,1991,52997,1526,1167,557,3250,56247
04-01-2018,23,18582,19399,8073,1852,47908,1414,1205,515,3134,51042
05-01-2018,0,15914,18012,8115,1678,43720,1203,1218,460,2881,46601
05-01-2018,1,14130,17981,8226,1602,41937,1196,1218,451,2865,44802
05-01-2018,2,13101,17956,8288,1874,41219,1195,1213,481,2889,44108
05-01-2018,3,12985,17853,8335,2165,41336,1176,1211,477,2864,44200
05-01-2018,4,13474,18568,8274,2226,42543,1158,1208,501,2867,45410
05-01-2018,5,14528,18886,8419,2207,44041,1277,1294,547,3118,47159
05-01-2018,6,17884,20133,8863,2302,49183,1470,1314,572,3356,52539
05-01-2018,7,22098,22424,9037,2374,55933,1494,1310,601,3405,59338
05-01-2018,8,23941,23617,8963,2878,59398,1468,1338,589,3395,62793
05-01-2018,9,24674,23728,9004,2898,60304,1436,1392,596,3424,63728
05-01-2018,10,25154,24056,9042,3080,61332,1446,1523,613,3582,64914
05-01-2018,11,24933,24157,9013,3050,61152,1441,1453,608,3502,64654
05-01-2018,12,24758,24174,9020,3243,61194,1465,1454,549,3468,64662
05-01-2018,13,24676,24168,8970,3522,61337,1498,1445,545,3488,64825
05-01-2018,14,24836,24096,8905,3409,61246,1445,1291,611,3347,64593
05-01-2018,15,25335,24260,8870,3407,61874,1461,1378,628,3467,65341
05-01-2018,16,25585,24459,8812,3432,62288,1468,1463,642,3573,65861
05-01-2018,17,25408,24449,8865,3533,62255,1466,1469,639,3574,65829
05-01-2018,18,24932,24310,8798,3455,61497,1404,1334,636,3374,64871
05-01-2018,19,24271,23839,8789,3302,60202,1314,1227,581,3122,63324
05-01-2018,20,23547,22651,8777,2816,57791,1266,1223,528,3017,60808
05-01-2018,21,22798,22223,8412,2592,56025,1300,1146,470,2916,58941
05-01-2018,22,21876,21294,8211,2472,53852,1314,1144,415,2873,56725
05-01-2018,23,20746,20262,7934,2199,51141,1291,1148,446,2885,54026
06-01-2018,0,19623,18775,7784,1847,48029,1097,1004,358,2459,50488
06-01-2018,1,17700,18274,7624,1822,45421,1079,996,402,2477,47898
06-01-2018,2,16007,18135,7557,1825,43524,1077,995,427,2499,46023
06-01-2018,3,15202,18143,7553,1785,42685,1074,993,422,2489,45174
06-01-2018,4,15993,18248,7597,1751,43589,1043,1001,477,2521,46110
06-01-2018,5,17442,18448,7629,1771,45290,998,1081,498,2577,47867
06-01-2018,6,19021,18958,7858,1927,47764,1013,1085,432,2530,50294
06-01-2018,7,20720,19948,8155,2047,50871,989,1163,429,2581,53452
06-01-2018,8,21619,21335,8173,2424,53550,975,1161,386,2522,56072
06-01-2018,9,22440,22167,8236,3109,55952,1033,1163,394,2590,58542
06-01-2018,10,23378,22565,8412,3212,57566,1105,1163,367,2635,60201
06-01-2018,11,23706,22846,8521,3324,58398,1134,1164,378,2676,61074
06-01-2018,12,23348,23068,8633,3304,58353,1146,1165,374,2685,61038
06-01-2018,13,23174,23180,8652,3314,58320,1148,1168,348,2664,60984
06-01-2018,14,23031,23389,8792,3282,58495,1121,1161,355,2637,61132
06-01-2018,15,23759,23578,8958,3179,59474,1082,1307,409,2798,62272
06-01-2018,16,24803,23963,9148,3322,61238,1152,1317,419,2888,64126
06-01-2018,17,24997,23925,9314,3824,62061,1161,1318,388,2867,64928
06-01-2018,18,24519,24079,9408,3772,61779,1149,1247,338,2734,64513
06-01-2018,19,23831,23688,9474,3503,60498,1171,1174,320,2665,63163
06-01-2018,20,22633,23295,9393,3185,58508,1176,1173,374,2723,61231
06-01-2018,21,21837,22765,9466,2924,56991,1156,1167,298,2621,59612
06-01-2018,22,20360,22118,9226,2765,54469,1146,995,286,2427,56896
06-01-2018,23,18724,20629,9008,2559,50919,1182,998,331,2511,53430
07-01-2018,0,16251,19513,8971,2242,46978,1195,1004,340,2539,49517
07-01-2018,1,14830,18965,8976,2027,44797,1140,1005,360,2505,47302
07-01-2018,2,14261,18830,8999,1947,44037,1113,1002,332,2447,46484
07-01-2018,3,13855,18714,9041,2077,43688,1105,993,335,2433,46121
07-01-2018,4,13928,18628,9092,2091,43739,1103,1003,335,2441,46180
07-01-2018,5,14510,18728,9238,2054,44530,1104,1091,327,2522,47052
07-01-2018,6,15107,19246,9315,2064,45733,1112,1095,321,2528,48261
07-01-2018,7,15920,19594,9403,2120,47037,1163,1090,399,2652,49689
07-01-2018,8,17149,20211,9350,2287,48998,1150,1095,404,2649,51647
07-01-2018,9,18318,20908,9461,2501,51188,1139,1181,401,2721,53909
07-01-2018,10,19442,21421,9449,2794,53108,1153,1179,340,2672,55780
07-01-2018,11,19929,21947,9295,2963,54135,1158,1180,301,2639,56774
07-01-2018,12,19758,22368,9249,3015,54389,1163,1187,301,2651,57040
07-01-2018,13,18386,22493,9166,3003,53048,1133,1258,308,2699,55747
07-01-2018,14,18178,22386,9087,2938,52591,1133,1260,305,2698,55289
07-01-2018,15,19644,22695,8955,2845,54139,1134,1255,317,2706,56845
07-01-2018,16,21437,23423,8970,2951,56782,1174,1272,354,2800,59582
07-01-2018,17,23371,24260,9076,3223,59931,1226,1273,401,2900,62831
07-01-2018,18,23827,24702,9086,3411,61028,1242,1265,488,2995,64023
07-01-2018,19,23268,24426,8957,3338,59990,1219,1286,573,3078,63068
07-01-2018,20,21842,24054,8875,3232,58004,1222,1284,631,3137,61141
07-01-2018,21,19841,23128,8688,3121,54780,1251,1288,624,3163,57943
07-01-2018,22,18960,22607,8688,2933,53190,1245,1213,620,3078,56268
07-01-2018,23,15561,21394,8632,2815,48400,1252,1149,621,3022,51422
08-01-2018,0,13047,19929,8439,2779,44196,1183,1321,614,3118,47314
08-01-2018,1,12004,19363,8493,2598,42458,1195,1319,626,3140,45598
08-01-2018,2,11746,19077,8645,2655,42124,1237,1318,598,3153,45277
08-01-2018,3,12127,18922,8728,2496,42274,1286,1316,551,3153,45427
08-01-2018,4,12891,19363,8855,2347,43457,1369,1311,488,3168,46625
08-01-2018,5,15757,19750,9136,2190,46832,1522,1413,433,3368,50200
08-01-2018,6,20940,22437,9564,2492,55434,1707,1460,429,3596,59030
08-01-2018,7,24225,24482,9670,2827,61204,1799,1485,489,3773,64977
08-01-2018,8,25297,24641,9917,3095,62950,1802,1488,789,4079,67029
08-01-2018,9,24873,24408,10031,3251,62564,1798,1489,735,4022,66586
08-01-2018,10,24834,24310,10011,3477,62633,1730,1482,624,3836,66469
08-01-2018,11,24661,24305,9879,3393,62238,1693,1482,646,3821,66059
08-01-2018,12,24522,24145,9882,3478,62027,1687,1476,628,3791,65818
08-01-2018,13,24309,24147,9819,3308,61583,1716,1465,506,3687,65270
08-01-2018,14,24656,24178,9762,3053,61649,1620,1467,470,3557,65206
08-01-2018,15,24985,24411,9899,2894,62191,1660,1458,427,3545,65736
08-01-2018,16,25283,24628,9905,2878,62694,1677,1454,819,3950,66644
08-01-2018,17,25486,24706,9853,3287,63333,1677,1465,781,3923,67256
08-01-2018,18,24820,24622,9728,3735,62905,1659,1485,386,3530,66435
08-01-2018,19,23285,24127,9538,3650,60601,1657,1490,352,3499,64100
08-01-2018,20,21295,22540,9332,3668,56834,1652,1486,395,3533,60367
08-01-2018,21,19823,22103,9158,3708,54793,1644,1397,377,3418,58211
08-01-2018,22,18534,21168,9007,3928,52636,1615,1317,426,3358,55994
08-01-2018,23,16183,20210,8875,3864,49133,1466,1307,483,3256,52389
09-01-2018,0,14828,18925,8763,3830,46347,1279,1303,456,3038,49385
09-01-2018,1,14186,18601,8525,3991,45304,1162,1301,420,2883,48187
09-01-2018,2,14020,18510,8517,4026,45076,1207,1298,369,2874,47950
09-01-2018,3,14282,18526,8516,4080,45404,1253,1297,325,2875,48279
09-01-2018,4,14995,19230,8475,4226,46926,1263,1292,309,2864,49790
09-01-2018,5,17224,19752,8770,4522,50267,1518,1382,280,3180,53447
09-01-2018,6,20289,21756,8897,5094,56037,1651,1457,310,3418,59455
09-01-2018,7,23834,23698,9308,5494,62337,1676,1462,454,3592,65929
09-01-2018,8,24509,24520,9373,5486,63889,1737,1458,478,3673,67562
09-01-2018,9,24338,24431,9310,5103,63181,1644,1458,510,3612,66793
09-01-2018,10,24286,24389,9318,5400,63393,1666,1457,324,3447,66840
09-01-2018,11,24076,24315,9275,5400,63068,1638,1457,315,3410,66478
09-01-2018,12,23724,23855,9289,5655,62524,1645,1459,305,3409,65933
09-01-2018,13,23708,23702,9337,5808,62557,1658,1466,295,3419,65976
09-01-2018,14,23535,23608,9367,5790,62300,1636,1464,287,3387,65687
09-01-2018,15,23979,23892,9407,5803,63081,1640,1464,427,3531,66612
09-01-2018,16,24773,24770,9401,5876,64820,1619,1464,438,3521,68341
09-01-2018,17,25235,25145,9344,5909,65632,1608,1461,497,3566,69198
09-01-2018,18,24921,25133,9139,5960,65154,1596,1458,502,3556,68710
09-01-2018,19,24483,24691,8771,5590,63537,1583,1452,318,3353,66890
09-01-2018,20,23658,23713,8645,5234,61249,1582,1451,322,3355,64604
09-01-2018,21,22890,23154,8564,5360,59969,1585,1384,255,3224,63193
09-01-2018,22,21172,22103,8552,4754,56581,1591,1304,226,3121,59702
09-01-2018,23,19776,21108,8327,4436,53647,1592,1297,297,3186,56833
10-01-2018,0,19320,19869,8203,4167,51559,1584,958,252,2794,54353
10-01-2018,1,17972,19517,8140,4066,49695,1588,984,273,2845,52540
10-01-2018,2,17145,19255,8098,3810,48309,1603,955,316,2874,51183
10-01-2018,3,17112,19155,8219,3592,48078,1619,959,307,2885,50963
10-01-2018,4,18408,19774,8143,3401,49727,1631,1025,357,3013,52740
10-01-2018,5,21812,21016,8348,3515,54692,1580,1046,411,3037,57729
10-01-2018,6,25062,23765,8797,4003,61625,1577,1215,500,3292,64917
10-01-2018,7,26627,25573,9180,4593,65973,1576,1570,703,3849,69822
10-01-2018,8,26309,25645,9256,4903,66115,1565,1595,947,4107,70222
10-01-2018,9,26082,25508,9221,4646,65457,1568,1649,951,4168,69625
10-01-2018,10,26149,25134,9168,4333,64785,1575,1734,894,4203,68988
10-01-2018,11,26027,25154,9209,4355,64746,1591,1739,861,4191,68937
10-01-2018,12,25614,25109,9143,4224,64091,1588,1730,666,3984,68075
10-01-2018,13,25870,24896,9209,4253,64228,1593,1700,668,3961,68189
10-01-2018,14,26385,25230,9273,4226,65114,1610,1702,671,3983,69097
10-01-2018,15,26299,25622,9287,4319,65527,1608,1705,875,4188,69715
10-01-2018,16,25958,25324,9204,4345,64830,1611,1740,914,4265,69095
10-01-2018,17,25653,25054,9201,4541,64450,1610,1711,916,4237,68687
10-01-2018,18,25944,24606,9197,4390,64137,1604,1701,898,4203,68340
10-01-2018,19,26030,24798,9242,4069,64139,1614,1625,859,4098,68237
10-01-2018,20,25456,24074,9010,3742,62283,1619,1608,463,3690,65973
10-01-2018,21,24917,22949,8708,3454,60027,1625,1506,476,3607,63634
10-01-2018,22,24310,21839,8400,2972,57522,1633,1342,443,3418,60940
10-01-2018,23,22828,20885,8172,2662,54546,1677,1439,412,3528,58074
11-01-2018,0,22588,19437,8101,2484,52610,1705,1586,437,3728,56338
11-01-2018,1,21554,19047,8003,2483,51088,1702,1583,444,3729,54817
11-01-2018,2,21121,18709,7998,2455,50283,1707,1581,425,3713,53996
11-01-2018,3,21390,18738,8018,2443,50587,1698,1579,446,3723,54310
11-01-2018,4,22228,19336,8180,2416,52162,1701,1656,410,3767,55929
11-01-2018,5,23243,20683,8531,2787,55244,1701,1747,393,3841,59085
11-01-2018,6,24497,22934,8919,3412,59763,1700,1834,404,3938,63701
11-01-2018,7,25342,24250,9269,3979,62841,1727,1846,556,4129,66970
11-01-2018,8,25905,24427,9458,4033,63823,1696,1845,725,4266,68089
11-01-2018,9,26022,24334,9369,3950,63674,1694,1846,719,4259,67933
11-01-2018,10,26081,24557,9542,4111,64292,1605,1846,717,4168,68460
11-01-2018,11,26176,24618,9487,4293,64573,1606,1847,712,4165,68738
11-01-2018,12,25932,24823,9441,4491,64687,1599,1847,588,4034,68721
11-01-2018,13,25971,24866,9441,4596,64875,1589,1847,470,3906,68781
11-01-2018,14,26153,24838,9457,4500,64947,1601,1849,527,3977,68924
11-01-2018,15,26255,24950,9481,4478,65165,1652,1850,560,4062,69227
11-01-2018,16,25842,24920,9429,4621,64813,1653,1851,653,4157,68970
11-01-2018,17,25715,24998,9459,4611,64783,1685,1852,653,4190,68973
11-01-2018,18,25656,25067,9511,4584,64818,1647,1855,749,4251,69069
11-01-2018,19,25582,24980,9279,4233,64075,1649,1849,351,3849,67924
11-01-2018,20,25485,23759,8797,3691,61732,1657,1840,366,3863,65595
11-01-2018,21,25016,22686,8676,3471,59849,1657,1756,373,3786,63635
11-01-2018,22,23508,21852,8537,3173,57070,1655,1678,372,3705,60775
11-01-2018,23,22345,21038,8305,2846,54535,1594,1677,373,3644,58179
12-01-2018,0,21406,19994,8131,3097,52629,1563,1585,382,3530,56159
12-01-2018,1,20515,19805,8109,2936,51365,1523,1580,364,3467,54832
12-01-2018,2,19998,19548,8120,2985,50653,1522,1580,366,3468,54121
12-01-2018,3,20161,19470,8174,3005,50810,1548,1578,374,3500,54310
12-01-2018,4,20843,20039,8309,3077,52267,1614,1577,368,3559,55826
12-01-2018,5,22935,21198,8725,3390,56248,1579,1667,361,3607,59855
12-01-2018,6,24673,23358,9301,3944,61276,1609,1756,375,3740,65016
12-01-2018,7,26214,25047,9835,4968,66065,1614,1762,646,4022,70087
12-01-2018,8,25778,25319,9701,5417,66215,1653,1843,771,4267,70482
12-01-2018,9,25650,25156,9694,5276,65778,1721,1846,750,4317,70095
12-01-2018,10,26131,25233,9720,5198,66283,1741,1844,744,4329,70612
12-01-2018,11,25933,25220,9829,5602,66584,1615,1845,546,4006,70590
12-01-2018,12,25867,25057,9917,5232,66073,1611,1844,347,3802,69875
12-01-2018,13,25759,24986,9858,5090,65695,1600,1861,351,3812,69507
12-01-2018,14,25592,24767,9836,4982,65177,1570,1866,368,3804,68981
12-01-2018,15,25769,24397,9991,4854,65012,1601,1866,408,3875,68887
12-01-2018,16,25866,24453,10051,5098,65467,1614,1854,570,4038,69505
12-01-2018,17,26068,24603,9936,5225,65832,1613,1869,541,4023,69855
12-01-2018,18,25992,24663,9813,5014,65483,1612,1870,405,3887,69370
12-01-2018,19,25319,23669,9475,4608,63071,1592,1714,359,3665,66736
12-01-2018,20,24294,22225,8939,4165,59623,1619,1706,361,3686,63309
12-01-2018,21,23861,21534,8650,3960,58006,1481,1649,358,3488,61494
12-01-2018,22,22587,20406,8468,3797,55257,1399,1552,354,3305,58562
12-01-2018,23,21352,19813,8367,3635,53166,1391,1546,332,3269,56435
13-01-2018,0,21158,18866,8243,3575,51841,1095,1019,273,2387,54228
13-01-2018,1,20540,18212,8083,3491,50326,1056,1020,289,2365,52691
13-01-2018,2,19627,17896,7979,3508,49011,1058,1020,259,2337,51348
13-01-2018,3,18964,17979,8041,3547,48531,1059,1015,275,2349,50880
13-01-2018,4,18054,17836,7984,3589,47464,1064,1012,277,2353,49817
13-01-2018,5,18900,18047,7938,3707,48591,1067,1008,281,2356,50947
13-01-2018,6,19939,18727,8076,3787,50528,1059,1012,277,2348,52876
13-01-2018,7,22168,20491,8255,3906,54820,1055,1095,318,2468,57288
13-01-2018,8,22992,21864,8566,4128,57551,1063,1199,318,2580,60131
13-01-2018,9,23662,22503,8678,4274,59119,1063,1237,328,2628,61747
13-01-2018,10,24249,22973,8729,4607,60559,1060,1252,322,2634,63193
13-01-2018,11,24245,23095,8786,4898,61024,1042,1178,314,2534,63558
13-01-2018,12,24277,23128,8785,4814,61005,1039,1214,302,2555,63560
13-01-2018,13,23997,23134,8765,4729,60626,1017,1188,307,2512,63138
13-01-2018,14,23634,23044,8849,4657,60183,1015,1239,303,2557,62740
13-01-2018,15,23592,23072,8935,4492,60092,1012,1322,323,2657,62749
13-01-2018,16,24243,23662,9155,4705,61766,1040,1339,358,2737,64503
13-01-2018,17,24710,23852,9071,4797,62431,1043,1362,377,2782,65213
13-01-2018,18,24490,23734,8964,4953,62142,1042,1244,378,2664,64806
13-01-2018,19,23569,23023,8916,4813,60322,1040,1240,364,2644,62966
13-01-2018,20,22020,21529,8772,4697,57018,1039,1110,330,2479,59497
13-01-2018,21,20693,20368,8536,4625,54220,1054,1128,253,2435,56655
13-01-2018,22,19437,19674,8343,4563,52018,1051,1037,255,2343,54361
13-01-2018,23,17281,19174,8231,4437,49123,1044,924,251,2219,51342
14-01-2018,0,15909,18262,8144,3968,46284,933,678,265,1876,48160
14-01-2018,1,15029,18249,8134,3701,45113,929,677,244,1850,46963
14-01-2018,2,14596,18249,8067,3585,44496,847,680,238,1765,46261
14-01-2018,3,14761,18282,8094,3440,44576,855,680,232,1767,46343
14-01-2018,4,14270,18458,8162,3393,44281,866,679,229,1774,46055
14-01-2018,5,14451,18773,8247,3505,44977,844,853,231,1928,46905
14-01-2018,6,14458,19272,8413,3814,45957,869,909,233,2011,47968
14-01-2018,7,15087,19901,8577,3987,47554,908,1044,290,2242,49796
14-01-2018,8,16370,20791,8758,4079,49998,897,1129,293,2319,52317
14-01-2018,9,18726,21824,8851,4266,53667,916,1141,293,2350,56017
14-01-2018,10,19876,22306,9005,4396,55583,901,1131,296,2328,57911
14-01-2018,11,21110,22999,9107,4503,57718,925,1139,292,2356,60074
14-01-2018,12,20687,23226,9063,4347,57323,938,1140,299,2377,59700
14-01-2018,13,19915,23141,9007,4358,56420,944,1141,287,2372,58792
14-01-2018,14,21155,23387,9086,4261,57888,972,1141,292,2405,60293
14-01-2018,15,22482,23969,9226,4191,59868,995,1140,310,2445,62313
14-01-2018,16,23304,24607,9317,4562,61789,1007,1299,336,2642,64431
14-01-2018,17,23093,24849,9366,5030,62338,1020,1368,332,2720,65058
14-01-2018,18,22516,24345,9362,5434,61658,1018,1360,336,2714,64372
14-01-2018,19,21575,24032,9304,5461,60373,1024,1178,335,2537,62910
14-01-2018,20,20516,23045,9071,5583,58215,1033,987,354,2374,60589
14-01-2018,21,19243,22448,9128,5632,56451,1105,809,315,2229,58680
14-01-2018,22,17866,21997,9094,5636,54593,1106,774,339,2219,56812
14-01-2018,23,16151,21021,9047,5448,51667,1076,721,394,2191,53858
15-01-2018,0,14397,20217,9005,5177,48796,1079,401,377,1857,50653
15-01-2018,1,13822,19564,8960,5090,47438,1103,329,380,1812,49250
15-01-2018,2,13938,19668,8924,5086,47616,1110,329,384,1823,49439
15-01-2018,3,13758,19777,8917,5217,47670,1069,327,348,1744,49414
15-01-2018,4,14114,20281,9131,5283,48809,1210,406,373,1989,50798
15-01-2018,5,16200,21749,9362,5497,52809,1386,631,440,2457,55266
15-01-2018,6,19965,24420,9763,5777,59925,1410,931,478,2819,62744
15-01-2018,7,22566,26322,10186,5446,64521,1428,1267,896,3591,68112
15-01-2018,8,23216,26842,10355,5472,65887,1443,1286,874,3603,69490
15-01-2018,9,22778,26989,10285,5456,65508,1456,1344,760,3560,69068
15-01-2018,10,22270,26780,10218,5636,64903,1473,1521,895,3889,68792
15-01-2018,11,21406,26614,10161,6048,64230,1547,1548,738,3833,68063
15-01-2018,12,20115,26627,10170,6299,63211,1483,1549,748,3780,66991
15-01-2018,13,19610,26518,10079,6404,62612,1470,1554,757,3781,66393
15-01-2018,14,19807,26266,10130,6497,62701,1473,1578,775,3826,66527
15-01-2018,15,19921,26393,10316,6370,63001,1477,1597,807,3881,66882
15-01-2018,16,19835,26546,10236,6455,63072,1489,1518,803,3810,66882
15-01-2018,17,20739,26604,10226,6353,63923,1505,1496,817,3818,67741
15-01-2018,18,19585,25825,9924,6438,61771,1520,1484,838,3842,65613
15-01-2018,19,18292,25321,9688,6207,59509,1533,1235,738,3506,63015
15-01-2018,20,17086,24567,9637,6142,57432,1541,1153,662,3356,60788
15-01-2018,21,16592,23621,9434,5916,55563,1547,1176,633,3356,58919
15-01-2018,22,16042,22296,9230,5769,53337,1486,960,624,3070,56407
15-01-2018,23,15105,21183,9129,5149,50568,1392,667,651,2710,53278
16-01-2018,0,14878,20927,9102,4728,49637,1290,471,650,2411,52048
16-01-2018,1,14469,20881,9073,4433,48857,1257,476,653,2386,51243
16-01-2018,2,14212,20471,8904,4735,48322,1265,477,682,2424,50746
16-01-2018,3,13669,20532,8830,4592,47624,1216,480,692,2388,50012
16-01-2018,4,13670,20998,9050,4398,48116,1239,506,773,2518,50634
16-01-2018,5,14541,22241,9386,4160,50330,1442,1003,879,3324,53654
16-01-2018,6,17354,24473,9811,4477,56117,1599,1155,1134,3888,60005
16-01-2018,7,21435,26513,10153,4441,62541,1595,1652,1099,4346,66887
16-01-2018,8,22507,26638,10337,4345,63828,1670,1613,931,4214,68042
16-01-2018,9,22708,26585,10223,4031,63548,1741,1622,933,4296,67844
16-01-2018,10,22909,26530,10259,3970,63670,1744,1473,853,4070,67740
16-01-2018,11,23032,26430,10254,4146,63864,1674,1453,749,3876,67740
16-01-2018,12,22811,25960,10182,4116,63069,1802,1419,746,3967,67036
16-01-2018,13,23179,25830,10168,3591,62769,1810,1373,726,3909,66678
16-01-2018,14,22944,25764,10242,3612,62563,1847,1397,730,3974,66537
16-01-2018,15,23127,25629,10347,3478,62580,1893,1553,721,4167,66747
16-01-2018,16,23646,25688,10528,3826,63688,1936,1700,711,4347,68035
16-01-2018,17,23687,25766,10667,3846,63965,1944,1720,839,4503,68468
16-01-2018,18,23913,25635,10752,4230,64530,1911,1674,706,4291,68821
16-01-2018,19,23179,25514,10420,4154,63269,1775,1467,712,3954,67223
16-01-2018,20,21803,24949,10203,3966,60920,1713,1340,696,3749,64669
16-01-2018,21,20730,23951,9963,3828,58472,1727,1120,622,3469,61941
16-01-2018,22,18914,22674,9893,3621,55102,1749,975,618,3342,58444
16-01-2018,23,15784,21425,9756,3258,50225,1775,590,625,2990,53215
17-01-2018,0,14777,20019,9622,3163,47581,1886,462,631,2979,50560
17-01-2018,1,14057,19394,9475,3238,46164,1884,420,609,2913,49077
17-01-2018,2,13847,19144,9454,2977,45423,1851,416,577,2844,48267
17-01-2018,3,13697,19141,9500,2820,45158,1815,414,547,2776,47934
17-01-2018,4,14412,19363,9667,2932,46375,1890,413,524,2827,49202
17-01-2018,5,17034,20202,10079,2933,50248,1874,828,481,3183,53431
17-01-2018,6,21111,22663,10612,2877,57264,1861,1301,489,3651,60915
17-01-2018,7,24372,24468,10848,3518,63206,1859,1535,444,3838,67044
17-01-2018,8,24543,25044,10838,3780,64206,1853,1538,756,4147,68353
17-01-2018,9,24235,24823,10751,3643,63453,1887,1395,416,3698,67151
17-01-2018,10,24515,24974,10673,3887,64049,1837,1401,399,3637,67686
17-01-2018,11,24378,24669,10515,4107,63670,1821,1375,389,3585,67255
17-01-2018,12,24099,24213,10425,3941,62679,1810,1361,380,3551,66230
17-01-2018,13,23331,23778,10452,3715,61277,1796,1390,370,3556,64833
17-01-2018,14,23398,23773,10541,3938,61652,1790,1439,354,3583,65235
17-01-2018,15,23850,23938,10399,3810,61998,1802,1586,273,3661,65659
17-01-2018,16,24363,24068,10520,3744,62695,1785,1542,466,3793,66488
17-01-2018,17,25233,24641,10622,3950,64446,1783,1539,397,3719,68165
17-01-2018,18,25217,24432,10408,3883,63939,1771,1398,281,3450,67389
17-01-2018,19,24288,24029,10097,3681,62094,1787,1324,266,3377,65471
17-01-2018,20,21966,23206,9786,3280,58238,1860,1222,265,3347,61585
17-01-2018,21,20708,22075,9531,3239,55556,1792,931,334,3057,58613
17-01-2018,22,19221,21267,9394,3298,53181,1769,576,333,2678,55859
17-01-2018,23,17997,19772,9208,3278,50255,1835,536,199,2570,52825
18-01-2018,0,16721,18632,9136,3032,47520,1772,718,199,2689,50209
18-01-2018,1,15671,18102,9068,3089,45930,1781,733,207,2721,48651
18-01-2018,2,15408,17966,9018,3164,45556,1777,739,211,2727,48283
18-01-2018,3,15329,17913,8966,3191,45400,1766,737,210,2713,48113
18-01-2018,4,15916,18349,9144,3125,46534,1764,746,217,2727,49261
18-01-2018,5,18333,19054,9517,3121,50026,1766,986,228,2980,53006
18-01-2018,6,21103,21067,10034,3223,55426,1754,1251,219,3224,58650
18-01-2018,7,24421,23208,10350,3863,61842,1788,1329,431,3548,65390
18-01-2018,8,24706,23449,10264,3805,62224,1770,1326,458,3554,65778
18-01-2018,9,24472,23312,10058,3686,61531,1737,1421,449,3607,65138
18-01-2018,10,24493,23156,9948,3554,61150,1746,1413,463,3622,64772
18-01-2018,11,24581,22950,10008,3490,61030,1747,1411,367,3525,64555
18-01-2018,12,24915,23064,9997,3306,61282,1757,1410,368,3535,64817
18-01-2018,13,24501,22953,9971,3376,60802,1754,1412,284,3450,64252
18-01-2018,14,24327,23029,9974,3491,60821,1762,1408,295,3465,64286
18-01-2018,15,24896,23186,10173,3473,61729,1717,1359,520,3596,65325
18-01-2018,16,25185,23832,10246,3478,62741,1756,1391,544,3691,66432
18-01-2018,17,25733,23855,10111,3649,63349,1764,1324,559,3647,66996
18-01-2018,18,25690,23865,10017,3340,62911,1746,1325,572,3643,66554
18-01-2018,19,25540,23764,9764,3272,62340,1747,1326,393,3466,65806
18-01-2018,20,24998,23226,9537,3047,60810,1740,1276,387,3403,64213
18-01-2018,21,23893,22236,9224,2755,58108,1773,1009,416,3198,61306
18-01-2018,22,22827,20943,9073,2658,55502,1758,843,432,3033,58535
18-01-2018,23,21010,19460,8958,2267,51697,1743,691,452,2886,54583
19-01-2018,0,20927,18387,8807,2409,50531,1713,616,439,2768,53299
19-01-2018,1,20775,18169,8628,2189,49761,1707,612,449,2768,52529
19-01-2018,2,20035,18018,8631,2060,48744,1717,633,458,2808,51552
19-01-2018,3,19758,17975,8623,2037,48393,1718,629,451,2798,51191
19-01-2018,4,20735,18533,8969,2113,50351,1759,653,432,2844,53195
19-01-2018,5,23151,19296,9583,2334,54365,1763,702,402,2867,57232
19-01-2018,6,25143,22488,9976,3053,60661,1767,1183,385,3335,63996
19-01-2018,7,25744,23744,9960,3373,62821,1759,1615,537,3911,66732
19-01-2018,8,25760,23892,9916,3478,63046,1755,1653,539,3947,66993
19-01-2018,9,25709,23876,9799,3597,62984,1732,1725,521,3978,66962
19-01-2018,10,25797,23585,9765,3672,62820,1754,1720,477,3951,66771
19-01-2018,11,25704,23471,9719,3709,62604,1750,1721,447,3918,66522
19-01-2018,12,25941,23497,9858,3696,62991,1738,1721,420,3879,66870
19-01-2018,13,25976,23274,9856,3796,62903,1741,1719,234,3694,66597
19-01-2018,14,25788,23281,9854,3677,62601,1749,1714,238,3701,66302
19-01-2018,15,26550,23087,9923,3663,63224,1713,1869,403,3985,67209
19-01-2018,16,26401,23154,9905,3757,63218,1734,1888,673,4295,67513
19-01-2018,17,25818,23231,9779,3916,62745,1752,1881,621,4254,66999
19-01-2018,18,25747,22995,9719,3963,62425,1749,1788,455,3992,66417
19-01-2018,19,25955,22963,9754,3854,62526,1771,1571,235,3577,66103
19-01-2018,20,25528,22049,9126,3638,60342,1747,1560,226,3533,63875
19-01-2018,21,25113,20901,8863,3309,58186,1720,1386,225,3331,61517
19-01-2018,22,24577,19888,8855,3012,56332,1720,1205,221,3146,59478
19-01-2018,23,23376,18506,8537,2883,53302,1760,1103,215,3078,56380
20-01-2018,0,21946,17761,8332,2651,50689,1583,510,207,2300,52989
20-01-2018,1,20418,17428,8263,2593,48702,1570,467,202,2239,50941
20-01-2018,2,19266,17327,8139,2668,47400,1548,452,199,2199,49599
20-01-2018,3,18295,17233,8172,2666,46366,1491,451,199,2141,48507
20-01-2018,4,18520,17148,8240,2635,46543,1462,537,198,2197,48740
20-01-2018,5,19422,17295,8280,2698,47697,1470,770,193,2433,50130
20-01-2018,6,20486,17679,8482,2905,49552,1471,831,191,2493,52045
20-01-2018,7,22551,18537,8554,2942,52585,1481,976,190,2647,55232
20-01-2018,8,24111,19965,8914,3304,56294,1514,1011,189,2714,59008
20-01-2018,9,24695,21663,9143,3673,59175,1499,1212,186,2897,62072
20-01-2018,10,24901,22293,9119,3969,60282,1513,1200,184,2897,63179
20-01-2018,11,24815,22226,9111,3917,60070,1596,1277,184,3057,63127
20-01-2018,12,24663,22157,9055,4005,59880,1610,1197,186,2993,62873
20-01-2018,13,24547,22194,8950,3876,59566,1609,1194,183,2986,62552
20-01-2018,14,24421,22211,8953,3783,59368,1606,1202,183,2991,62359
20-01-2018,15,24740,22354,9169,3620,59885,1611,1186,188,2985,62870
20-01-2018,16,25052,22816,9427,3584,60881,1664,1077,379,3120,64001
20-01-2018,17,25233,22947,9483,3755,61418,1678,1078,390,3146,64564
20-01-2018,18,25165,23105,9454,3808,61534,1674,1077,401,3152,64686
20-01-2018,19,24675,22710,9313,3791,60490,1670,1067,221,2958,63448
20-01-2018,20,24251,21962,9111,3398,58722,1666,1010,220,2896,61618
20-01-2018,21,24195,21378,8804,3028,57406,1666,766,220,2652,60058
20-01-2018,22,23861,20431,8589,2968,55848,1637,554,236,2427,58275
20-01-2018,23,23360,19331,8570,2646,53908,1641,452,230,2323,56231
21-01-2018,0,22370,17878,8465,2266,50980,1449,404,220,2073,53053
21-01-2018,1,21563,17230,8420,2270,49485,1218,405,226,1849,51334
21-01-2018,2,19734,16680,8331,2264,47010,1152,406,223,1781,48791
21-01-2018,3,18643,16437,8277,2185,45542,1157,431,214,1802,47344
21-01-2018,4,18837,16386,8369,2181,45774,1135,491,209,1835,47609
21-01-2018,5,19491,16355,8516,2126,46488,1145,698,206,2049,48537
21-01-2018,6,20203,16546,8686,2199,47635,1163,741,204,2108,49743
21-01-2018,7,22065,17629,8878,2293,50864,1196,952,203,2351,53215
21-01-2018,8,23112,19499,9078,2450,54141,1293,955,198,2446,56587
21-01-2018,9,24208,21093,9210,2884,57395,1295,963,193,2451,59846
21-01-2018,10,24315,21958,9162,3099,58533,1285,1034,203,2522,61055
21-01-2018,11,24317,22173,9231,3228,58949,1284,1055,185,2524,61473
21-01-2018,12,24132,22171,9242,3232,58777,1286,1043,184,2513,61290
21-01-2018,13,24113,21696,9318,3098,58227,1277,952,181,2410,60637
21-01-2018,14,24087,21575,9410,3035,58108,1256,954,181,2391,60499
21-01-2018,15,24370,21673,9688,3055,58787,1289,960,181,2430,61217
21-01-2018,16,24932,22442,9796,3199,60369,1287,1108,193,2588,62957
21-01-2018,17,25079,22856,10019,3529,61483,1304,1159,182,2645,64128
21-01-2018,18,24860,22764,10066,3580,61271,1299,1168,182,2649,63920
21-01-2018,19,25002,22529,9902,3609,61041,1317,1168,191,2676,63717
21-01-2018,20,25112,21845,9624,3308,59888,1297,1058,278,2633,62521
21-01-2018,21,24285,20465,9166,2869,56787,1280,621,283,2184,58971
21-01-2018,22,23885,19647,9012,2966,55510,1279,483,193,1955,57465
21-01-2018,23,22542,17933,8835,2926,52236,1250,514,196,1960,54196
22-01-2018,0,20191,17185,8736,2955,49066,1124,956,219,2299,51365
22-01-2018,1,18192,16971,8745,3106,47015,1166,984,240,2390,49405
22-01-2018,2,17980,16966,8747,3139,46832,1200,999,217,2416,49248
22-01-2018,3,17983,17027,8750,3268,47028,1187,1193,210,2590,49618
22-01-2018,4,18750,17486,9292,3374,48903,1284,1229,241,2754,51657
22-01-2018,5,20718,18066,10045,3583,52412,1510,1340,253,3103,55515
22-01-2018,6,23735,19953,10329,4301,58317,1532,1714,643,3889,62206
22-01-2018,7,25974,22347,10432,4818,63572,1605,1992,699,4296,67868
22-01-2018,8,26064,22881,10409,5319,64672,1579,1997,728,4304,68976
22-01-2018,9,26071,22783,10385,5385,64625,1526,1921,691,4138,68763
22-01-2018,10,26487,22839,10426,5307,65060,1543,1889,677,4109,69169
22-01-2018,11,26421,22969,10261,5118,64771,1553,1888,668,4109,68880
22-01-2018,12,26289,22868,10201,5192,64549,1499,1888,684,4071,68620
22-01-2018,13,26477,22862,10198,5125,64663,1529,1976,496,4001,68664
22-01-2018,14,26435,22777,10163,4910,64285,1513,1895,650,4058,68343
22-01-2018,15,26504,22786,10339,4756,64387,1539,1891,685,4115,68502
22-01-2018,16,26368,22937,10353,4903,64562,1629,1921,707,4257,68819
22-01-2018,17,26542,23114,10350,4899,64905,1539,1830,706,4075,68980
22-01-2018,18,26397,23177,10380,4745,64698,1557,1744,658,3959,68657
22-01-2018,19,26441,23067,10044,4605,64158,1429,1748,597,3774,67932
22-01-2018,20,26314,22851,9833,4545,63543,1437,1746,282,3465,67008
22-01-2018,21,25874,22500,9702,4074,62149,1436,1197,254,2887,65036
22-01-2018,22,24891,21416,9478,3443,59229,1432,1127,192,2751,61980
22-01-2018,23,24514,19947,9328,3094,56881,1440,997,198,2635,59516
23-01-2018,0,24146,18538,9116,2615,54415,1391,1004,190,2585,57000
23-01-2018,1,23509,18048,9155,2401,53114,1366,1025,208,2599,55713
23-01-2018,2,22985,17960,9188,2362,52494,1373,923,188,2484,54978
23-01-2018,3,22617,18037,9379,2415,52449,1384,924,188,2496,54945
23-01-2018,4,23042,19003,9760,2582,54387,1400,1055,187,2642,57029
23-01-2018,5,23871,20095,10264,3091,57320,1423,1494,256,3173,60493
23-01-2018,6,25518,22034,10656,3895,62103,1467,1590,630,3687,65790
23-01-2018,7,26282,23638,10680,4415,65016,1546,1803,675,4024,69040
23-01-2018,8,26090,24043,10662,4879,65674,1484,1836,675,3995,69669
23-01-2018,9,26363,24403,10671,4757,66195,1456,1843,677,3976,70171
23-01-2018,10,26079,24511,10573,5046,66209,1443,1840,683,3966,70175
23-01-2018,11,25740,24275,10589,4886,65491,1433,1781,683,3897,69388
23-01-2018,12,26152,24373,10640,5008,66175,1435,1776,457,3668,69843
23-01-2018,13,25978,24514,10546,5049,66088,1450,1793,271,3514,69602
23-01-2018,14,25616,24923,10498,5360,66399,1431,1804,209,3444,69843
23-01-2018,15,25133,24938,10502,5130,65702,1445,1814,437,3696,69398
23-01-2018,16,25961,24638,10664,5298,66562,1511,1823,309,3643,70205
23-01-2018,17,25614,25275,10661,5756,67306,1514,1845,352,3711,71017
23-01-2018,18,24847,24632,10562,5829,65870,1509,1846,282,3637,69507
23-01-2018,19,23816,23704,10313,6192,64025,1533,1755,303,3591,67616
23-01-2018,20,22537,22810,9865,6270,61484,1548,1580,343,3471,64955
23-01-2018,21,20740,21983,9619,6272,58614,1575,966,371,2912,61526
23-01-2018,22,18465,21240,9230,5934,54870,1524,893,406,2823,57693
23-01-2018,23,16894,20822,8835,5636,52187,1480,672,472,2624,54811
24-01-2018,0,14816,20279,8942,5673,49711,1071,613,460,2144,51855
24-01-2018,1,14112,20091,8965,5254,48423,994,617,458,2069,50492
24-01-2018,2,13507,19951,9006,4794,47259,993,618,463,2074,49333
24-01-2018,3,13098,19904,9039,4461,46502,1000,628,483,2111,48613
24-01-2018,4,13394,20290,9201,4689,47574,997,721,500,2218,49792
24-01-2018,5,15124,20599,9567,4807,50096,1168,1003,502,2673,52769
24-01-2018,6,18827,22159,10141,4837,55964,1393,1047,536,2976,58940
24-01-2018,7,23030,24364,10444,5141,62980,1467,1448,718,3633,66613
24-01-2018,8,23518,24280,10568,5365,63731,1408,1498,796,3702,67433
24-01-2018,9,23286,23452,10619,5405,62762,1403,1544,753,3700,66462
24-01-2018,10,22297,23118,10639,5830,61885,1405,1550,702,3657,65542
24-01-2018,11,21460,22796,10673,6092,61022,1410,1511,514,3435,64457
24-01-2018,12,20572,22428,10628,6252,59880,1413,1574,498,3485,63365
24-01-2018,13,20033,22109,10505,6680,59327,1406,1568,501,3475,62802
24-01-2018,14,20123,22520,10394,6475,59512,1397,1564,486,3447,62959
24-01-2018,15,19919,22829,10419,6538,59705,1398,1512,679,3589,63294
24-01-2018,16,20180,23324,10484,6609,60596,1392,1449,862,3703,64299
24-01-2018,17,20698,23659,10384,6239,60981,1397,1392,901,3690,64671
24-01-2018,18,19774,23610,10354,5944,59682,1363,1393,814,3570,63252
24-01-2018,19,18375,22912,9965,5778,57032,1342,1199,522,3063,60095
24-01-2018,20,17547,22647,9320,5544,55060,1049,1139,576,2764,57824
24-01-2018,21,16382,22195,8952,5446,52975,1064,911,554,2529,55504
24-01-2018,22,15516,21195,8593,5280,50585,1054,808,561,2423,53008
24-01-2018,23,14864,20568,8178,5301,48912,993,724,586,2303,51215
25-01-2018,0,14080,20148,8163,5255,47647,958,619,582,2159,49806
25-01-2018,1,13596,19863,8222,5107,46789,980,616,601,2197,48986
25-01-2018,2,12950,19757,8268,5048,46022,975,616,610,2201,48223
25-01-2018,3,12184,19703,8347,4877,45111,966,619,611,2196,47307
25-01-2018,4,12010,20093,8487,4748,45337,972,716,624,2312,47649
25-01-2018,5,13209,21101,8994,5054,48359,1068,883,615,2566,50925
25-01-2018,6,16313,22982,9374,5384,54054,1187,997,606,2790,56844
25-01-2018,7,20801,24139,9809,5804,60553,1287,1267,568,3122,63675
25-01-2018,8,21738,24557,9923,5236,61454,1379,1290,575,3244,64698
25-01-2018,9,21604,24426,9912,4423,60366,1368,1291,571,3230,63596
25-01-2018,10,21350,24330,9841,4657,60178,1358,1290,578,3226,63404
25-01-2018,11,21093,24156,9750,5025,60025,1356,1292,567,3215,63240
25-01-2018,12,21103,23921,9767,5128,59918,1358,1272,503,3133,63051
25-01-2018,13,21098,23878,9803,5203,59983,1378,1291,463,3132,63115
25-01-2018,14,21393,23970,10046,4690,60101,1381,1285,412,3078,63179
25-01-2018,15,21891,24204,10117,4416,60627,1387,1225,397,3009,63636
25-01-2018,16,23078,24900,10087,4018,62081,1384,1205,546,3135,65216
25-01-2018,17,23665,25366,10164,4574,63769,1382,1214,793,3389,67158
25-01-2018,18,23288,25382,9987,4431,63088,1366,1220,602,3188,66276
25-01-2018,19,22822,24948,9699,4200,61671,1334,1068,407,2809,64480
25-01-2018,20,22210,24090,9269,3920,59490,1182,946,377,2505,61995
25-01-2018,21,21701,23305,8937,3632,57577,1132,883,349,2364,59941
25-01-2018,22,20002,22336,8734,3392,54463,1066,778,326,2170,56633
25-01-2018,23,18803,21597,8624,3140,52163,1128,690,275,2093,54256
26-01-2018,0,18953,20572,8512,2998,51036,1117,588,252,1957,52993
26-01-2018,1,18726,20121,8311,2928,50085,1028,583,245,1856,51941
26-01-2018,2,18669,19820,8256,2750,49495,1015,581,244,1840,51335
26-01-2018,3,19065,19830,8262,2696,49852,973,575,223,1771,51623
26-01-2018,4,19910,20407,8403,2646,51366,1079,668,224,1971,53337
26-01-2018,5,21020,21259,8989,2927,54195,1113,841,218,2172,56367
26-01-2018,6,22793,22803,9439,3272,58306,1185,1006,270,2461,60767
26-01-2018,7,24616,24125,9635,3066,61441,1205,1280,657,3142,64583
26-01-2018,8,24971,24406,9726,3295,62401,1262,1305,672,3239,65640
26-01-2018,9,24671,24235,9744,3363,62013,1266,1390,688,3344,65357
26-01-2018,10,24808,24052,9695,3353,61908,1265,1393,684,3342,65250
26-01-2018,11,24481,24088,9604,3297,61471,1269,1303,684,3256,64727
26-01-2018,12,24100,23861,9493,3224,60679,1252,1317,671,3240,63919
26-01-2018,13,23924,23572,9494,3205,60196,1239,1321,664,3224,63420
26-01-2018,14,24148,23353,9470,3113,60084,1235,1279,654,3168,63252
26-01-2018,15,24251,23290,9527,3193,60261,1236,1263,636,3135,63396
26-01-2018,16,24797,23501,9611,3257,61168,1232,1353,659,3244,64412
26-01-2018,17,25442,23978,9673,4006,63100,1230,1368,661,3259,66359
26-01-2018,18,24891,23955,9564,4176,62587,1235,1308,645,3188,65775
26-01-2018,19,24493,23699,9235,3740,61168,1122,1120,249,2491,63659
26-01-2018,20,23543,22911,8529,3248,58231,1110,1115,200,2425,60656
26-01-2018,21,22960,22371,8235,2819,56385,1095,785,194,2074,58459
26-01-2018,22,22274,21585,7972,2655,54486,1078,641,193,1912,56398
26-01-2018,23,21404,20635,7720,2675,52434,1044,491,191,1726,54160
27-01-2018,0,21602,19024,7640,2629,50894,844,392,190,1426,52320
27-01-2018,1,20864,18495,7555,2617,49531,822,392,196,1410,50941
27-01-2018,2,20374,18371,7514,2587,48846,800,392,198,1390,50236
27-01-2018,3,20379,18387,7510,2598,48873,793,392,201,1386,50259
27-01-2018,4,20815,18370,7530,2625,49339,846,391,205,1442,50781
27-01-2018,5,21547,18719,7709,2484,50460,838,395,203,1436,51896
27-01-2018,6,21829,20525,7918,2485,52757,827,510,231,1568,54325
27-01-2018,7,22332,21419,8210,2702,54663,831,811,236,1878,56541
27-01-2018,8,23172,22005,8360,3180,56717,850,849,254,1953,58670
27-01-2018,9,23946,22402,8403,3592,58343,860,975,266,2101,60444
27-01-2018,10,24602,22489,8319,3683,59094,864,984,319,2167,61261
27-01-2018,11,24439,22526,8172,3702,58838,845,894,395,2134,60972
27-01-2018,12,24013,21984,8202,3817,58017,821,891,424,2136,60153
27-01-2018,13,23518,21400,8137,4221,57276,790,894,424,2108,59384
27-01-2018,14,22941,21102,8125,4585,56754,766,889,447,2102,58856
27-01-2018,15,23054,21115,8225,4845,57240,776,941,420,2137,59377
27-01-2018,16,23710,21710,8543,5375,59339,813,1012,433,2258,61597
27-01-2018,17,24136,22424,8592,5626,60776,814,1016,436,2266,63042
27-01-2018,18,23018,22009,8605,5906,59540,839,924,413,2176,61716
27-01-2018,19,21755,21124,8284,6016,57180,821,869,393,2083,59263
27-01-2018,20,19802,20028,8001,6314,54146,824,635,402,1861,56007
27-01-2018,21,18027,19860,7826,5956,51668,720,340,418,1478,53146
27-01-2018,22,16784,19487,7616,5909,49797,688,344,396,1428,51225
27-01-2018,23,15906,19246,7528,5326,48006,694,339,415,1448,49454
28-01-2018,0,15671,19050,7431,4492,46644,719,195,426,1340,47984
28-01-2018,1,14786,18616,7288,3957,44647,714,193,412,1319,45966
28-01-2018,2,13618,18394,7280,3769,43061,711,198,425,1334,44395
28-01-2018,3,13666,18319,7267,3880,43131,704,201,449,1354,44485
28-01-2018,4,13320,18278,7356,3962,42916,693,206,500,1399,44315
28-01-2018,5,13691,18350,7483,4524,44050,693,299,522,1514,45564
28-01-2018,6,14351,18772,7624,4404,45151,701,430,584,1715,46866
28-01-2018,7,14817,19031,7835,4862,46544,676,487,604,1767,48311
28-01-2018,8,15742,19645,7948,5085,48419,690,526,626,1842,50261
28-01-2018,9,16205,20303,8083,5190,49781,742,535,649,1926,51707
28-01-2018,10,17045,20873,8163,5321,51404,759,534,642,1935,53339
28-01-2018,11,17359,21270,8165,5327,52121,752,523,707,1982,54103
28-01-2018,12,17242,21363,8193,5289,52087,746,524,634,1904,53991
28-01-2018,13,16872,21408,8288,5357,51924,727,524,654,1905,53829
28-01-2018,14,16600,21446,8330,5325,51702,712,587,651,1950,53652
28-01-2018,15,17029,21414,8304,5034,51783,684,650,661,1995,53778
28-01-2018,16,18020,21754,8339,5110,53224,777,883,696,2356,55580
28-01-2018,17,18955,22022,8384,5306,54667,783,913,700,2396,57063
28-01-2018,18,19098,22043,8395,4981,54518,768,911,697,2376,56894
28-01-2018,19,18525,22018,8376,4453,53373,769,825,707,2301,55674
28-01-2018,20,17772,21294,8247,4266,51578,706,727,685,2118,53696
28-01-2018,21,17041,20892,8107,4084,50124,686,591,663,1940,52064
28-01-2018,22,15903,20476,8031,3821,48233,682,256,662,1600,49833
28-01-2018,23,14703,19673,7826,3749,45952,683,226,661,1570,47522
29-01-2018,0,13890,18777,7656,3613,43937,737,216,658,1611,45548
29-01-2018,1,12935,18135,7617,3728,42415,764,211,657,1632,44047
29-01-2018,2,12327,17933,7660,3822,41742,790,216,654,1660,43402
29-01-2018,3,12947,17762,7811,4037,42557,822,211,653,1686,44243
29-01-2018,4,13666,18491,8038,4320,44516,833,351,632,1816,46332
29-01-2018,5,15651,19089,8575,4616,47931,1119,490,658,2267,50198
29-01-2018,6,18271,20503,9082,5245,53102,1290,710,656,2656,55758
29-01-2018,7,21417,21891,9346,6126,58779,1304,1206,755,3265,62044
29-01-2018,8,21770,22468,9404,6167,59809,1304,1248,824,3376,63185
29-01-2018,9,21403,22667,9439,6233,59742,1305,1394,689,3388,63130
29-01-2018,10,21277,22783,9411,6377,59851,1275,1511,598,3384,63235
29-01-2018,11,21082,22894,9455,6385,59816,1277,1512,559,3348,63164
29-01-2018,12,20716,22580,9329,6201,58826,1289,1504,538,3331,62157
29-01-2018,13,20632,22492,9275,6216,58615,1287,1339,495,3121,61736
29-01-2018,14,20627,22489,9249,6451,58816,1284,1364,495,3143,61959
29-01-2018,15,21132,22700,9262,6342,59437,1272,1321,610,3203,62640
29-01-2018,16,21377,22905,9444,5945,59672,1242,1245,889,3376,63048
29-01-2018,17,22594,23353,9480,5983,61409,1237,1242,1032,3511,64920
29-01-2018,18,23509,23626,9236,5913,62283,1237,1199,931,3367,65650
29-01-2018,19,21207,22824,9004,5846,58881,1252,1188,688,3128,62009
29-01-2018,20,19277,21541,8630,6192,55641,1174,1119,695,2988,58629
29-01-2018,21,18546,21099,8325,5669,53639,1123,559,706,2388,56027
29-01-2018,22,16960,20351,8196,5552,51060,1060,496,644,2200,53260
29-01-2018,23,15887,19448,8200,5428,48963,1026,510,643,2179,51142
30-01-2018,0,15774,18586,8210,5635,48206,941,805,653,2399,50605
30-01-2018,1,15169,18279,8222,5633,47303,908,810,639,2357,49660
30-01-2018,2,14529,18449,8255,5737,46971,919,815,644,2378,49349
30-01-2018,3,14656,18612,8318,5611,47197,943,809,641,2393,49590
30-01-2018,4,15656,18959,8401,5727,48743,999,926,618,2543,51286
30-01-2018,5,18147,19538,8743,5556,51985,1272,1052,613,2937,54922
30-01-2018,6,21869,21788,9024,5861,58542,1365,1148,612,3125,61667
30-01-2018,7,24086,23417,9286,6024,62813,1356,1469,708,3533,66346
30-01-2018,8,24539,23534,9544,5761,63380,1348,1520,696,3564,66944
30-01-2018,9,24616,23482,9429,5642,63170,1347,1543,791,3681,66851
30-01-2018,10,24430,23395,9443,5634,62901,1325,1523,749,3597,66498
30-01-2018,11,24028,23513,9228,5448,62216,1312,1525,755,3592,65808
30-01-2018,12,23648,23244,9204,5248,61342,1298,1521,669,3488,64830
30-01-2018,13,23443,22972,9188,5099,60704,1284,1525,700,3509,64213
30-01-2018,14,23306,22942,9284,4816,60348,1289,1535,812,3636,63984
30-01-2018,15,23807,22997,9445,4665,60915,1307,1536,857,3700,64615
30-01-2018,16,24555,23748,9545,4490,62339,1312,1539,947,3798,66137
30-01-2018,17,25467,24680,9538,5124,64810,1318,1556,946,3820,68630
30-01-2018,18,25213,24732,9434,4906,64286,1315,1562,889,3766,68052
30-01-2018,19,24885,24108,9196,4998,63186,1312,1445,691,3448,66634
30-01-2018,20,24246,23544,8779,4630,61198,1310,1157,491,2958,64156
30-01-2018,21,23300,22714,8562,4467,59043,1310,889,458,2657,61700
30-01-2018,22,21612,21283,8390,4334,55620,1295,829,412,2536,58156
30-01-2018,23,19845,19709,8235,4660,52449,1295,772,353,2420,54869
31-01-2018,0,17863,18711,8089,4641,49305,1158,839,310,2307,51612
31-01-2018,1,17154,18497,8041,4723,48415,1142,838,287,2267,50682
31-01-2018,2,15355,18435,7965,4648,46403,1019,837,297,2153,48556
31-01-2018,3,14828,18419,7922,4826,45994,1022,836,291,2149,48143
31-01-2018,4,14501,19084,8206,4921,46712,1250,891,266,2407,49119
31-01-2018,5,15762,19604,8955,4949,49270,1393,1040,263,2696,51966
31-01-2018,6,19742,21489,9359,5281,55870,1409,1352,498,3259,59129
31-01-2018,7,22589,23609,9593,5629,61418,1399,1381,698,3478,64896
31-01-2018,8,22924,23837,9710,5841,62310,1401,1426,470,3297,65607
31-01-2018,9,21977,23654,9666,5742,61041,1394,1389,642,3425,64466
31-01-2018,10,22081,23508,9644,5660,60895,1401,1397,497,3295,64190
31-01-2018,11,21042,23490,9642,6075,60251,1398,1451,524,3373,63624
31-01-2018,12,20417,23055,9720,5848,59040,1398,1444,496,3338,62378
31-01-2018,13,20100,23431,9749,5550,58830,1408,1357,353,3118,61948
31-01-2018,14,20406,23596,9734,5672,59408,1380,1347,409,3136,62544
31-01-2018,15,20843,24196,9882,5161,60084,1356,1259,448,3063,63147
31-01-2018,16,21731,24719,9929,5071,61450,1383,1249,499,3131,64581
31-01-2018,17,23176,24858,9927,5730,63691,1445,1261,759,3465,67156
31-01-2018,18,23820,24875,9836,5635,64167,1451,1232,658,3341,67508
31-01-2018,19,22890,24543,9550,5278,62261,1407,1216,679,3302,65563
31-01-2018,20,20734,23769,9412,5048,58964,1324,1015,664,3003,61967
31-01-2018,21,18471,22635,9363,4833,55302,1252,743,645,2640,57942
31-01-2018,22,16600,21464,9202,4951,52218,1214,664,620,2498,54716
31-01-2018,23,14828,20438,9165,4887,49320,1164,664,623,2451,51771
01-02-2018,0,13886,19617,9161,5033,47696,1106,576,577,2259,49955
01-02-2018,1,13485,19224,9082,5244,47035,1119,581,569,2269,49304
01-02-2018,2,12908,18964,9067,5307,46245,1129,578,573,2280,48525
01-02-2018,3,12571,18946,9124,5042,45684,1117,578,576,2271,47955
01-02-2018,4,12920,19612,9367,5355,47254,1160,629,566,2355,49609
01-02-2018,5,15355,20616,9665,5540,51177,1320,829,614,2763,53940
01-02-2018,6,19618,22555,10005,5391,57570,1463,1152,600,3215,60785
01-02-2018,7,22695,24302,10245,5225,62468,1538,1459,395,3392,65860
01-02-2018,8,23102,24745,10313,5138,63299,1539,1541,382,3462,66761
01-02-2018,9,22808,24703,10384,5290,63186,1512,1434,497,3443,66629
01-02-2018,10,22921,24663,10464,5504,63552,1491,1437,495,3423,66975
01-02-2018,11,22208,24632,10104,5784,62727,1480,1421,400,3301,66028
01-02-2018,12,21494,25071,9876,5905,62346,1471,1414,311,3196,65542
01-02-2018,13,21475,24687,9941,5447,61549,1448,1418,292,3158,64707
01-02-2018,14,21737,24567,10386,5380,62070,1440,1439,292,3171,65241
01-02-2018,15,21678,24786,10582,5307,62354,1432,1435,346,3213,65567
01-02-2018,16,22340,25092,10632,5445,63510,1427,1436,525,3388,66898
01-02-2018,17,23566,25317,10614,5399,64897,1439,1429,528,3396,68293
01-02-2018,18,23787,25440,10423,5099,64749,1425,1448,499,3372,68121
01-02-2018,19,22888,25190,10046,4659,62782,1416,1361,267,3044,65826
01-02-2018,20,21701,24187,9796,4112,59796,1386,1354,254,2994,62790
01-02-2018,21,21071,23157,9716,3959,57903,1395,745,234,2374,60277
01-02-2018,22,19853,22460,9440,3759,55513,1420,711,238,2369,57882
01-02-2018,23,17166,21058,9264,4450,51940,1388,694,226,2308,54248
02-02-2018,0,16997,19867,9218,4238,50320,1386,525,213,2124,52444
02-02-2018,1,16433,19429,9205,4386,49453,1377,523,213,2113,51566
02-02-2018,2,16237,19303,9192,4465,49197,1382,523,223,2128,51325
02-02-2018,3,16467,19505,9209,4418,49600,1372,525,212,2109,51709
02-02-2018,4,17279,20110,9198,4442,51028,1339,582,215,2136,53164
02-02-2018,5,19970,21493,9473,4555,55492,1383,776,223,2382,57874
02-02-2018,6,23027,23399,9749,5004,61178,1367,1228,372,2967,64145
02-02-2018,7,24890,24421,10145,5233,64688,1359,1471,423,3253,67941
02-02-2018,8,25451,25049,10291,5455,66245,1380,1491,437,3308,69553
02-02-2018,9,25450,25253,10284,5485,66474,1371,1523,454,3348,69822
02-02-2018,10,25657,25452,10152,5452,66713,1368,1499,319,3186,69899
02-02-2018,11,25358,25196,9916,5228,65700,1338,1471,454,3263,68963
02-02-2018,12,24816,24905,9706,5026,64453,1342,1468,330,3140,67593
02-02-2018,13,24779,24775,9765,4770,64088,1374,1432,265,3071,67159
02-02-2018,14,24650,24752,9872,4637,63910,1385,1401,272,3058,66968
02-02-2018,15,24093,24907,10072,4619,63690,1359,1389,293,3041,66731
02-02-2018,16,24491,24748,10315,4671,64227,1360,1357,484,3201,67428
02-02-2018,17,25282,25291,10435,4885,65892,1382,1489,695,3566,69458
02-02-2018,18,25626,25369,10391,4780,66166,1381,1447,724,3552,69718
02-02-2018,19,25296,25163,10230,4336,65026,1361,1197,497,3055,68081
02-02-2018,20,24284,24405,9919,3949,62558,1270,1073,308,2651,65209
02-02-2018,21,23674,23926,9679,3653,60931,1247,566,300,2113,63044
02-02-2018,22,23042,22693,9511,3539,58784,1240,535,285,2060,60844
02-02-2018,23,21379,21474,9365,3374,55593,1228,503,277,2008,57601
03-02-2018,0,21200,20896,9278,3375,54749,1116,444,265,1825,56574
03-02-2018,1,20660,20630,9211,3104,53606,1101,349,278,1728,55334
03-02-2018,2,20485,20609,9149,2976,53221,1097,348,269,1714,54935
03-02-2018,3,20504,20627,9168,2947,53246,1094,346,264,1704,54950
03-02-2018,4,20560,20614,9216,2975,53365,1092,436,253,1781,55146
03-02-2018,5,21010,20642,9322,3180,54156,1086,606,271,1963,56119
03-02-2018,6,21757,21289,9455,3164,55665,1091,684,258,2033,57698
03-02-2018,7,22635,22620,9646,3229,58130,1079,723,271,2073,60203
03-02-2018,8,23637,23998,9873,3397,60904,1068,725,274,2067,62971
03-02-2018,9,24463,24508,10070,3749,62791,1081,788,276,2145,64936
03-02-2018,10,24681,25108,10062,3934,63786,1111,808,282,2201,65987
03-02-2018,11,24518,25105,9963,3955,63542,1187,802,280,2269,65811
03-02-2018,12,24161,25010,9804,4095,63070,1203,772,287,2262,65332
03-02-2018,13,23660,24719,9823,4100,62305,1122,723,362,2207,64512
03-02-2018,14,23406,24518,9953,4122,61999,1129,732,292,2153,64152
03-02-2018,15,23412,24486,10073,4180,62153,1134,964,289,2387,64540
03-02-2018,16,24119,24959,10320,4387,63786,1122,1087,303,2512,66298
03-02-2018,17,24561,25310,10544,4569,64984,1146,1197,517,2860,67844
03-02-2018,18,24418,25178,10476,4731,64802,1147,1196,526,2869,67671
03-02-2018,19,23966,24860,10128,4824,63778,1147,1051,334,2532,66310
03-02-2018,20,23015,24400,9803,4880,62099,1159,767,346,2272,64371
03-02-2018,21,22495,23688,9653,4981,60817,1167,707,308,2182,62999
03-02-2018,22,21827,22518,9545,5090,58981,1176,594,291,2061,61042
03-02-2018,23,21165,21313,9407,5169,57055,1179,436,280,1895,58950
04-02-2018,0,20174,20160,9426,5173,54933,1002,355,289,1646,56579
04-02-2018,1,18617,19694,9289,5078,52677,995,351,277,1623,54300
04-02-2018,2,18014,19416,9208,5005,51644,983,349,302,1634,53278
04-02-2018,3,18103,19282,9188,5064,51638,1001,357,309,1667,53305
04-02-2018,4,17665,19416,9208,5016,51304,984,448,302,1734,53038
04-02-2018,5,17622,19516,9323,5001,51462,1001,700,310,2011,53473
04-02-2018,6,17640,19812,9424,4960,51836,1058,759,396,2213,54049
04-02-2018,7,18354,20115,9394,5270,53133,1066,732,443,2241,55374
04-02-2018,8,19678,20921,9502,5565,55667,1055,743,410,2208,57875
04-02-2018,9,21082,22047,9649,5760,58538,1080,748,342,2170,60708
04-02-2018,10,21504,22685,9597,5694,59482,1113,767,330,2210,61692
04-02-2018,11,22283,22968,9544,5317,60112,1193,887,331,2411,62523
04-02-2018,12,21641,22745,9427,5272,59085,1198,830,368,2396,61481
04-02-2018,13,20616,22475,9275,5075,57442,1192,824,392,2408,59850
04-02-2018,14,20362,22376,9288,4907,56934,1175,830,428,2433,59367
04-02-2018,15,21221,22640,9307,4864,58033,1150,827,475,2452,60485
04-02-2018,16,22778,23197,9458,4935,60370,1141,931,526,2598,62968
04-02-2018,17,24347,24505,9656,4966,63474,1256,1233,550,3039,66513
04-02-2018,18,24656,25140,9724,4968,64488,1256,1252,555,3063,67551
04-02-2018,19,24567,25154,9669,4827,64217,1288,1245,512,3045,67262
04-02-2018,20,24205,24653,9539,4552,62949,1271,1142,429,2842,65791
04-02-2018,21,23933,23600,9306,4335,61174,1282,1041,335,2658,63832
04-02-2018,22,23422,22753,9216,4211,59601,1276,732,301,2309,61910
04-02-2018,23,22364,21469,9124,4003,56961,1282,465,313,2060,59021
05-02-2018,0,20682,20235,8943,3387,53247,1355,359,336,2050,55297
05-02-2018,1,19245,19855,8887,3308,51296,1345,377,294,2016,53312
05-02-2018,2,18610,19754,8938,3144,50444,1360,489,303,2152,52596
05-02-2018,3,18707,19676,9046,2969,50399,1340,518,305,2163,52562
05-02-2018,4,19389,20192,9260,3074,51915,1372,536,310,2218,54133
05-02-2018,5,22120,21639,9856,3145,56761,1440,859,459,2758,59519
05-02-2018,6,24563,23822,10248,3514,62147,1475,1450,600,3525,65672
05-02-2018,7,25490,25052,10406,4169,65117,1501,1941,605,4047,69164
05-02-2018,8,25562,25186,10371,4265,65385,1490,1997,609,4096,69481
05-02-2018,9,25666,25028,10325,4122,65142,1480,1978,612,4070,69212
05-02-2018,10,25755,24871,10267,4254,65148,1468,1946,605,4019,69167
05-02-2018,11,25208,24633,10142,4214,64198,1471,1884,607,3962,68160
05-02-2018,12,25278,24340,10146,4117,63883,1482,1887,424,3793,67676
05-02-2018,13,25237,24252,10127,4178,63795,1455,1888,597,3940,67735
05-02-2018,14,25509,24225,10184,3985,63901,1447,1885,419,3751,67652
05-02-2018,15,25559,24548,10181,3977,64265,1447,1829,583,3859,68124
05-02-2018,16,25309,24378,10240,3902,63828,1476,1917,567,3960,67788
05-02-2018,17,25410,24408,10609,3866,64293,1483,1954,621,4058,68351
05-02-2018,18,25535,24532,10744,3933,64743,1477,1956,605,4038,68781
05-02-2018,19,25378,24724,10724,3932,64759,1418,1809,624,3851,68610
05-02-2018,20,25070,24484,10449,3743,63745,1406,1803,407,3616,67361
05-02-2018,21,24851,23673,10284,3640,62450,1397,1197,479,3073,65523
05-02-2018,22,24136,23080,10151,3486,60853,1384,1077,353,2814,63667
05-02-2018,23,23718,21423,10029,3218,58389,1273,820,278,2371,60760
06-02-2018,0,22468,19554,9852,3207,55081,1259,896,262,2417,57498
06-02-2018,1,22184,19185,9890,2994,54252,1256,899,272,2427,56679
06-02-2018,2,22077,19039,9993,2963,54072,1235,895,291,2421,56493
06-02-2018,3,22084,19092,10040,3016,54233,1239,893,287,2419,56652
06-02-2018,4,22652,19830,10145,3014,55642,1262,897,279,2438,58080
06-02-2018,5,23824,21059,10385,3385,58653,1354,1080,296,2730,61383
06-02-2018,6,24960,23343,11055,3678,63038,1335,1292,378,3005,66043
06-02-2018,7,25376,24355,11353,4052,65136,1336,1382,520,3238,68374
06-02-2018,8,25259,24476,11249,4179,65165,1329,1358,523,3210,68375
06-02-2018,9,25390,24465,11210,4171,65236,1336,1405,545,3286,68522
06-02-2018,10,25478,24583,11219,4268,65549,1333,1376,606,3315,68864
06-02-2018,11,25348,24713,11024,4296,65380,1312,1283,377,2972,68352
06-02-2018,12,25100,24769,10842,4353,65063,1306,1287,414,3007,68070
06-02-2018,13,25289,24589,10715,4334,64927,1300,1276,469,3045,67972
06-02-2018,14,25653,24640,10647,4187,65128,1304,1278,511,3093,68221
06-02-2018,15,25725,24661,10628,4161,65175,1266,1270,532,3068,68243
06-02-2018,16,25761,24590,10646,4180,65178,1315,1263,698,3276,68454
06-02-2018,17,26001,24752,10798,4230,65781,1344,1374,692,3410,69191
06-02-2018,18,25776,24660,10649,4363,65448,1333,1376,686,3395,68843
06-02-2018,19,25349,24492,10516,4401,64759,1340,1373,646,3359,68118
06-02-2018,20,25437,23960,10273,4131,63801,1307,971,515,2793,66594
06-02-2018,21,24870,23556,10086,3809,62321,1256,910,501,2667,64988
06-02-2018,22,23703,22328,9768,3464,59262,1250,907,524,2681,61943
06-02-2018,23,22653,20808,9563,3436,56461,1316,890,486,2692,59153
07-02-2018,0,22842,19177,9484,3463,54966,1311,608,463,2382,57348
07-02-2018,1,22458,18934,9454,3421,54269,1311,594,484,2389,56658
07-02-2018,2,22306,19012,9455,3367,54141,1314,599,422,2335,56476
07-02-2018,3,22509,19073,9523,3467,54571,1292,600,379,2271,56842
07-02-2018,4,22838,20019,9694,3470,56022,1338,604,384,2326,58348
07-02-2018,5,23610,21128,9946,3685,58370,1382,714,438,2534,60904
07-02-2018,6,25213,23767,10387,4309,63675,1448,1038,458,2944,66619
07-02-2018,7,25786,24739,10768,4765,66060,1471,1321,639,3431,69491
07-02-2018,8,26001,24914,10888,4747,66551,1467,1339,628,3434,69985
07-02-2018,9,26379,25047,10853,4819,67098,1472,1333,598,3403,70501
07-02-2018,10,26309,25074,10576,5041,67000,1553,1324,585,3462,70462
07-02-2018,11,26257,24820,10230,5158,66466,1557,1229,561,3347,69813
07-02-2018,12,25564,24405,10128,5135,65231,1558,1239,532,3329,68560
07-02-2018,13,25749,24516,10120,4982,65366,1576,1325,337,3238,68604
07-02-2018,14,25632,24605,10280,4969,65488,1598,1240,458,3296,68784
07-02-2018,15,25574,24503,10334,4947,65359,1572,1225,488,3285,68644
07-02-2018,16,25662,24527,10685,4923,65798,1582,1329,499,3410,69208
07-02-2018,17,25887,25132,10797,5418,67234,1597,1431,523,3551,70785
07-02-2018,18,25883,25251,10785,5354,67272,1608,1535,569,3712,70984
07-02-2018,19,25639,25085,10547,5227,66498,1657,1210,610,3477,69975
07-02-2018,20,25549,24668,10126,4994,65337,1629,1142,434,3205,68542
07-02-2018,21,25157,24091,10193,4411,63853,1631,829,404,2864,66717
07-02-2018,22,24574,22821,9645,3857,60897,1659,749,375,2783,63680
07-02-2018,23,23745,21141,9167,3522,57575,1762,743,309,2814,60389
08-02-2018,0,23341,20273,8929,3349,55893,1785,541,331,2657,58550
08-02-2018,1,22914,20300,8861,3583,55658,1763,538,339,2640,58298
08-02-2018,2,22419,19946,8912,3545,54823,1763,538,329,2630,57453
08-02-2018,3,22302,19953,8942,3562,54759,1808,449,306,2563,57322
08-02-2018,4,22764,20628,9130,3696,56217,1793,543,303,2639,58856
08-02-2018,5,23361,21866,9724,3963,58913,1800,712,286,2798,61711
08-02-2018,6,24633,24028,10276,4300,63237,1817,1056,272,3145,66382
08-02-2018,7,25615,25231,10471,4854,66170,1821,1312,465,3598,69768
08-02-2018,8,25695,25255,10469,4882,66301,1861,1387,473,3721,70022
08-02-2018,9,25850,25003,10513,4719,66085,1849,1412,471,3732,69817
08-02-2018,10,25724,25138,10463,4832,66160,1842,1334,463,3639,69799
08-02-2018,11,25583,24547,10078,4932,65140,1791,1273,338,3402,68542
08-02-2018,12,25159,24191,9858,5043,64253,1788,1202,263,3253,67506
08-02-2018,13,25147,24165,10034,5074,64420,1804,1216,261,3281,67701
08-02-2018,14,25024,24028,10273,5198,64523,1794,1211,259,3264,67787
08-02-2018,15,24974,24040,10315,4899,64230,1779,1211,256,3246,67476
08-02-2018,16,25369,24419,10469,4668,64926,1805,1213,270,3288,68214
08-02-2018,17,26055,25418,10499,4491,66464,1817,1287,467,3571,70035
08-02-2018,18,25865,25219,10421,5417,66923,1770,1284,457,3511,70434
08-02-2018,19,25134,24705,10154,5286,65277,1647,1233,465,3345,68622
08-02-2018,20,24093,23987,9825,5198,63104,1612,1127,271,3010,66114
08-02-2018,21,23620,23418,9673,4895,61606,1607,808,307,2722,64328
08-02-2018,22,22398,22434,9602,4936,59370,1553,614,254,2421,61791
08-02-2018,23,20988,21343,9571,4968,56871,1500,528,187,2215,59086
09-02-2018,0,20306,20689,9421,4780,55196,1461,510,254,2225,57421
09-02-2018,1,19629,20301,9367,4656,53953,1482,508,206,2196,56149
09-02-2018,2,18816,20393,9368,4657,53235,1488,507,208,2203,55438
09-02-2018,3,18858,20561,9379,4684,53481,1500,506,208,2214,55695
09-02-2018,4,19553,21003,9473,4616,54647,1500,508,254,2262,56909
09-02-2018,5,21139,21836,9722,4745,57444,1556,668,304,2528,59972
09-02-2018,6,22898,23774,10159,5155,61987,1701,1092,319,3112,65099
09-02-2018,7,24680,24604,10527,5261,65074,1742,1214,453,3409,68483
09-02-2018,8,25260,24884,10688,5396,66229,1769,1237,468,3474,69703
09-02-2018,9,25169,24801,10626,5513,66109,1770,1238,472,3480,69589
09-02-2018,10,25083,24696,10542,5543,65863,1772,1230,473,3475,69338
09-02-2018,11,24168,24468,10279,5562,64479,1778,1181,274,3233,67712
09-02-2018,12,23454,24182,10097,5468,63202,1777,1178,267,3222,66424
09-02-2018,13,23430,24069,10187,5296,62981,1781,1178,266,3225,66206
09-02-2018,14,23722,24008,10300,5079,63110,1772,1183,260,3215,66325
09-02-2018,15,23678,24213,10352,4932,63175,1774,1182,259,3215,66390
09-02-2018,16,24262,24607,10471,4723,64062,1777,1174,294,3245,67307
09-02-2018,17,25306,24941,10647,5303,66198,1774,1200,475,3449,69647
09-02-2018,18,25163,25256,10517,5319,66254,1774,1175,482,3431,69685
09-02-2018,19,23806,24805,10141,5220,63971,1711,1131,277,3119,67090
09-02-2018,20,22609,23990,9536,4920,61053,1706,1081,355,3142,64195
09-02-2018,21,22143,23048,9373,4628,59192,1710,772,316,2798,61990
09-02-2018,22,21562,22163,9122,4158,57004,1599,617,315,2531,59535
09-02-2018,23,20985,21250,9016,3889,55142,1465,453,265,2183,57325
10-02-2018,0,20799,20648,8799,3609,53855,1297,284,324,1905,55760
10-02-2018,1,20303,20213,8751,3642,52909,1291,284,330,1905,54814
10-02-2018,2,19748,20022,8819,3575,52165,1283,282,234,1799,53964
10-02-2018,3,19921,19821,8748,3420,51911,1282,282,233,1797,53708
10-02-2018,4,20276,19870,8762,3305,52212,1285,285,346,1916,54128
10-02-2018,5,20807,20271,8832,3475,53385,1288,332,347,1967,55352
10-02-2018,6,20657,21587,8909,3696,54850,1290,514,299,2103,56953
10-02-2018,7,20877,22692,9034,3737,56340,1302,712,283,2297,58637
10-02-2018,8,21987,23293,9093,3935,58308,1276,892,251,2419,60727
10-02-2018,9,22766,23817,9145,4215,59943,1298,938,260,2496,62439
10-02-2018,10,23258,23888,9041,4417,60604,1300,896,262,2458,63062
10-02-2018,11,23230,23754,8900,4546,60429,1304,849,261,2414,62843
10-02-2018,12,23146,23569,8915,4355,59986,1304,849,263,2416,62402
10-02-2018,13,22804,23649,8911,4247,59613,1303,848,260,2411,62024
10-02-2018,14,22571,23570,8966,4230,59337,1307,763,257,2327,61664
10-02-2018,15,22905,23569,8964,4266,59704,1288,772,256,2316,62020
10-02-2018,16,23657,23664,9075,4236,60632,1309,822,257,2388,63020
10-02-2018,17,24338,24084,9255,4448,62127,1306,829,354,2489,64616
10-02-2018,18,23967,23990,9216,4495,61670,1280,962,336,2578,64248
10-02-2018,19,23026,23655,8956,4462,60099,1244,848,256,2348,62447
10-02-2018,20,21803,22991,8732,4510,58037,1224,715,300,2239,60276
10-02-2018,21,20994,22068,8549,4622,56233,1231,389,233,1853,58086
10-02-2018,22,20216,20832,8363,4559,53970,1220,301,232,1753,55723
10-02-2018,23,17523,19875,8197,4395,49992,1217,281,206,1704,51696
11-02-2018,0,16303,19046,8195,4434,47978,1205,280,207,1692,49670
11-02-2018,1,15450,18660,8176,4673,46960,1149,280,207,1636,48596
11-02-2018,2,14996,18561,8091,4673,46322,1038,280,228,1546,47868
11-02-2018,3,14962,18449,8085,4420,45916,990,278,234,1502,47418
11-02-2018,4,15088,18815,8050,4518,46471,1022,278,234,1534,48005
11-02-2018,5,14659,18878,8061,4773,46371,960,281,231,1472,47843
11-02-2018,6,15026,18956,8187,4742,46911,1042,531,232,1805,48716
11-02-2018,7,15426,19486,8327,4932,48172,1105,533,238,1876,50048
11-02-2018,8,15974,20217,8470,5365,50027,1170,547,292,2009,52036
11-02-2018,9,17076,21140,8615,5571,52404,1210,605,323,2138,54542
11-02-2018,10,17565,22011,8577,5579,53733,1233,742,286,2261,55994
11-02-2018,11,17880,22515,8507,5957,54858,1231,748,279,2258,57116
11-02-2018,12,17584,22744,8545,6022,54895,1249,763,254,2266,57161
11-02-2018,13,17266,22827,8540,5927,54561,1240,750,272,2262,56823
11-02-2018,14,17276,22900,8596,5922,54695,1227,749,277,2253,56948
11-02-2018,15,17798,23005,8683,5974,55460,1222,800,261,2283,57743
11-02-2018,16,18404,23099,8774,6022,56298,1231,801,343,2375,58673
11-02-2018,17,19741,23521,8943,6150,58358,1229,840,374,2443,60801
11-02-2018,18,20744,24173,9004,6569,60490,1191,808,440,2439,62929
11-02-2018,19,19829,24225,8952,6618,59625,1168,857,434,2459,62084
11-02-2018,20,18106,23513,8731,6419,56771,1151,798,358,2307,59078
11-02-2018,21,17009,22896,8572,5884,54359,1133,542,357,2032,56391
11-02-2018,22,16574,22203,8486,5612,52875,1133,404,382,1919,54794
11-02-2018,23,15492,21091,8419,5679,50681,1006,350,390,1746,52427
12-02-2018,0,14791,19995,8394,5915,49095,990,288,399,1677,50772
12-02-2018,1,14428,19860,8364,5933,48584,960,289,395,1644,50228
12-02-2018,2,14445,19891,8297,5769,48403,984,318,389,1691,50094
12-02-2018,3,14502,20354,8334,5806,48997,1020,325,384,1729,50726
12-02-2018,4,14870,21074,8545,5802,50291,1151,379,395,1925,52216
12-02-2018,5,16116,21957,8948,5974,52996,1389,628,379,2396,55392
12-02-2018,6,18666,23703,9313,6010,57691,1546,1197,436,3179,60870
12-02-2018,7,22025,24913,9588,6475,63001,1645,1208,641,3494,66495
12-02-2018,8,22646,25147,9578,6235,63607,1674,1293,626,3593,67200
12-02-2018,9,22906,25224,9638,6346,64112,1680,1258,635,3573,67685
12-02-2018,10,22795,25493,9573,6423,64285,1684,1257,639,3580,67865
12-02-2018,11,22534,25512,9406,6420,63872,1719,1267,502,3488,67360
12-02-2018,12,22056,25529,9304,6511,63401,1704,1217,354,3275,66676
12-02-2018,13,22069,25513,9504,6256,63342,1716,1271,519,3506,66848
12-02-2018,14,21801,25431,9751,6253,63236,1719,1280,570,3569,66805
12-02-2018,15,22262,25421,9788,5592,63062,1707,1304,465,3476,66538
12-02-2018,16,22744,25660,9711,5317,63432,1732,1374,535,3641,67073
12-02-2018,17,24335,25713,9838,5140,65027,1728,1428,567,3723,68750
12-02-2018,18,24604,25498,9782,4944,64828,1739,1431,581,3751,68579
12-02-2018,19,23905,25152,9484,4703,63244,1821,1181,375,3377,66621
12-02-2018,20,22501,24669,9171,4406,60747,1822,1048,330,3200,63947
12-02-2018,21,21788,24254,8954,4181,59178,1823,601,339,2763,61941
12-02-2018,22,20274,23205,8841,4265,56585,1816,593,353,2762,59347
12-02-2018,23,19014,21416,8795,3773,52998,1754,455,333,2542,55540
13-02-2018,0,18750,20304,8653,4096,51803,1658,500,309,2467,54270
13-02-2018,1,18257,19802,8662,3934,50654,1617,501,289,2407,53061
13-02-2018,2,18052,19528,8697,3755,50033,1650,494,292,2436,52469
13-02-2018,3,18691,19495,8795,3447,50428,1643,492,276,2411,52839
13-02-2018,4,19570,20169,8824,3285,51850,1639,492,263,2394,54244
13-02-2018,5,21738,21126,9244,3543,55649,1712,733,255,2700,58349
13-02-2018,6,23983,23318,9833,3505,60639,1771,1021,430,3222,63861
13-02-2018,7,24710,24891,9977,3818,63398,1775,1338,521,3634,67032
13-02-2018,8,24534,24990,10232,4228,63984,1767,1362,511,3640,67624
13-02-2018,9,24587,25031,10148,4150,63918,1768,1363,501,3632,67550
13-02-2018,10,24712,24783,10008,4334,63834,1763,1272,481,3516,67350
13-02-2018,11,24243,23975,9701,4376,62296,1720,1275,281,3276,65572
13-02-2018,12,23834,23349,9552,4171,60906,1658,1268,275,3201,64107
13-02-2018,13,23865,23140,9585,4133,60723,1649,1256,273,3178,63901
13-02-2018,14,24237,23488,9839,4088,61651,1661,1316,269,3246,64897
13-02-2018,15,24510,23320,9920,4013,61763,1705,1296,271,3272,65035
13-02-2018,16,24794,23326,10130,4161,62412,1735,1382,400,3517,65929
13-02-2018,17,25215,24298,10237,4469,64220,1739,1410,460,3609,67829
13-02-2018,18,25263,24550,10161,4596,64571,1728,1420,475,3623,68194
13-02-2018,19,24927,23987,10024,4439,63377,1681,1284,278,3243,66620
13-02-2018,20,23871,23519,9710,4178,61279,1687,1172,273,3132,64411
13-02-2018,21,23592,22768,9522,4163,60045,1658,683,203,2544,62589
13-02-2018,22,22521,21418,9318,4096,57353,1618,494,198,2310,59663
13-02-2018,23,20870,20312,9123,3892,54196,1646,480,206,2332,56528
14-02-2018,0,20641,19286,9002,3578,52507,1642,524,209,2375,54882
14-02-2018,1,19961,19109,8949,3582,51600,1602,529,211,2342,53942
14-02-2018,2,19498,19207,8899,3467,51071,1624,527,207,2358,53429
14-02-2018,3,19827,19226,8932,3390,51375,1617,526,210,2353,53728
14-02-2018,4,21208,19847,9118,3339,53513,1627,524,231,2382,55895
14-02-2018,5,22550,21010,9414,3474,56448,1624,701,234,2559,59007
14-02-2018,6,23757,23075,9613,3872,60316,1631,1075,309,3015,63331
14-02-2018,7,24965,24255,9797,4389,63407,1631,1332,454,3417,66824
14-02-2018,8,24760,24140,9888,4308,63096,1616,1522,491,3629,66725
14-02-2018,9,24567,23269,9727,4291,61854,1608,1443,477,3528,65382
14-02-2018,10,24368,23267,9670,4441,61747,1617,1359,282,3258,65005
14-02-2018,11,23735,23582,9370,4543,61230,1568,1337,274,3179,64409
14-02-2018,12,23011,23256,9240,4872,60379,1570,1322,279,3171,63550
14-02-2018,13,22067,23184,9341,5091,59682,1595,1262,267,3124,62806
14-02-2018,14,21856,22774,9709,5277,59615,1590,1258,269,3117,62732
14-02-2018,15,22219,22602,9744,5152,59717,1563,1274,271,3108,62825
14-02-2018,16,22826,23018,9787,4916,60547,1516,1258,277,3051,63598
14-02-2018,17,23568,23708,9924,5143,62345,1594,1274,458,3326,65671
14-02-2018,18,23253,24268,9966,5897,63384,1605,1262,501,3368,66752
14-02-2018,19,22297,23760,9571,5919,61548,1585,1092,306,2983,64531
14-02-2018,20,20775,23306,9455,5950,59485,1542,1012,285,2839,62324
14-02-2018,21,19980,21915,9271,5793,56958,1555,605,220,2380,59338
14-02-2018,22,17876,20847,9102,5789,53615,1581,532,223,2336,55951
14-02-2018,23,14799,19889,8946,5946,49580,1605,539,203,2347,51927
15-02-2018,0,14022,19836,8862,5892,48612,1421,537,207,2165,50777
15-02-2018,1,13988,19873,8849,5841,48552,1400,535,209,2144,50696
15-02-2018,2,13922,20116,8820,5480,48338,1393,481,225,2099,50437
15-02-2018,3,13468,20078,8881,5498,47925,1395,480,232,2107,50032
15-02-2018,4,13932,20547,9121,5648,49248,1412,531,244,2187,51435
15-02-2018,5,15385,21168,9499,5899,51950,1559,642,255,2456,54406
15-02-2018,6,17419,23622,9984,6214,57239,1615,1181,266,3062,60301
15-02-2018,7,19812,25695,10245,6447,62201,1623,1361,359,3343,65544
15-02-2018,8,21220,25753,10227,6296,63497,1627,1420,400,3447,66944
15-02-2018,9,20644,25701,10191,6539,63076,1624,1423,409,3456,66532
15-02-2018,10,19893,25621,10072,6934,62520,1619,1400,433,3452,65972
15-02-2018,11,19566,25488,9829,6495,61380,1616,1327,286,3229,64609
15-02-2018,12,19758,25409,9799,6171,61136,1606,1330,289,3225,64361
15-02-2018,13,19841,25371,9847,6087,61145,1609,1330,292,3231,64376
15-02-2018,14,20214,25418,9947,6018,61598,1613,1378,286,3277,64875
15-02-2018,15,20341,25180,10125,5848,61495,1604,1344,286,3234,64729
15-02-2018,16,20694,25441,10285,5529,61951,1636,1385,300,3321,65272
15-02-2018,17,21911,25681,10425,5403,63423,1628,1403,525,3556,66979
15-02-2018,18,22258,26085,10368,5783,64494,1631,1355,492,3478,67972
15-02-2018,19,21708,26017,9910,5397,63032,1617,1200,354,3171,66203
15-02-2018,20,21225,25408,9644,4855,61131,1585,989,293,2867,63998
15-02-2018,21,20903,24481,9358,4512,59254,1588,729,297,2614,61868
15-02-2018,22,19874,23256,9154,4467,56751,1597,671,293,2561,59312
15-02-2018,23,17943,22014,8936,4427,53321,1616,605,284,2505,55826
16-02-2018,0,17157,21081,8778,3790,50806,1623,572,302,2497,53303
16-02-2018,1,16758,20586,8588,3735,49667,1635,517,303,2455,52122
16-02-2018,2,16635,20291,8541,3741,49207,1617,520,309,2446,51653
16-02-2018,3,16360,20034,8588,4119,49101,1619,569,321,2509,51610
16-02-2018,4,17120,20882,8686,4166,50854,1632,569,307,2508,53362
16-02-2018,5,19565,22197,9062,4094,54916,1634,578,279,2491,57407
16-02-2018,6,22486,23458,9345,4370,59660,1639,1037,441,3117,62777
16-02-2018,7,24101,24090,9604,4860,62655,1635,1321,568,3524,66179
16-02-2018,8,24575,24066,9740,5141,63521,1597,1342,562,3501,67022
16-02-2018,9,24799,23924,9690,5144,63558,1570,1376,546,3492,67050
16-02-2018,10,24972,23883,9629,5492,63976,1557,1361,539,3457,67433
16-02-2018,11,24384,23729,9414,5798,63324,1553,1303,489,3345,66669
16-02-2018,12,23320,23467,9382,5599,61768,1573,1302,363,3238,65006
16-02-2018,13,22549,23502,9416,5557,61025,1595,1305,398,3298,64323
16-02-2018,14,22236,23453,9540,4941,60168,1621,1298,393,3312,63480
16-02-2018,15,22735,23321,9709,4740,60506,1609,1296,269,3174,63680
16-02-2018,16,23425,23567,9770,4317,61080,1586,1337,446,3369,64449
16-02-2018,17,24819,23824,9926,4524,63096,1586,1342,478,3406,66502
16-02-2018,18,24719,23861,9849,4750,63181,1576,1473,480,3529,66710
16-02-2018,19,24327,23637,9617,4308,61890,1574,1163,287,3024,64914
16-02-2018,20,23203,23281,9354,3436,59274,1540,927,213,2680,61954
16-02-2018,21,22486,22582,8995,3235,57299,1556,622,210,2388,59687
16-02-2018,22,21030,21603,8809,3076,54519,1455,608,217,2280,56799
16-02-2018,23,19853,20261,8644,3240,51996,1437,571,240,2248,54244
17-02-2018,0,20612,18211,8454,3012,50290,1306,506,232,2044,52334
17-02-2018,1,20164,17922,8429,3140,49655,1267,507,248,2022,51677
17-02-2018,2,20189,17971,8424,2985,49570,1265,507,226,1998,51568
17-02-2018,3,19750,17981,8454,2760,48945,1264,507,226,1997,50942
17-02-2018,4,19773,18208,8429,2767,49177,1269,507,230,2006,51183
17-02-2018,5,20206,18532,8448,2742,49929,1276,605,211,2092,52021
17-02-2018,6,21072,19959,8659,2690,52381,1278,845,213,2336,54717
17-02-2018,7,22356,20910,8913,2892,55072,1285,945,223,2453,57525
17-02-2018,8,23435,21689,9077,3074,57275,1286,1130,313,2729,60004
17-02-2018,9,24007,21987,9415,3452,58862,1277,1171,326,2774,61636
17-02-2018,10,23942,22062,9456,3551,59012,1271,1174,288,2733,61745
17-02-2018,11,23822,22161,9309,3553,58844,1283,1176,278,2737,61581
17-02-2018,12,23560,21959,9200,3465,58183,1285,1181,282,2748,60931
17-02-2018,13,23317,21534,9084,3356,57293,1266,1181,277,2724,60017
17-02-2018,14,23123,21432,9018,3362,56935,1271,1171,269,2711,59646
17-02-2018,15,23283,21537,9082,3299,57201,1272,1175,280,2727,59928
17-02-2018,16,23976,21966,9350,3235,58528,1275,1164,290,2729,61257
17-02-2018,17,24642,22670,9694,3589,60596,1298,1165,302,2765,63361
17-02-2018,18,24518,22854,9715,3703,60789,1301,1179,493,2973,63762
17-02-2018,19,24027,22197,9573,3469,59265,1309,1180,284,2773,62038
17-02-2018,20,23438,21609,9431,3223,57701,1318,1183,280,2781,60482
17-02-2018,21,23053,20835,9051,3083,56022,1303,1111,268,2682,58704
17-02-2018,22,22386,20064,8834,2995,54279,1309,1091,253,2653,56932
17-02-2018,23,21132,19260,8777,2980,52150,1294,915,252,2461,54611
18-02-2018,0,19512,18492,8628,2962,49594,1206,510,240,1956,51550
18-02-2018,1,19421,18128,8546,3070,49165,1193,510,250,1953,51118
18-02-2018,2,18804,17921,8569,3261,48557,1191,510,250,1951,50508
18-02-2018,3,18287,17968,8522,3219,47997,1183,509,252,1944,49941
18-02-2018,4,18009,17987,8631,3241,47870,1184,519,245,1948,49818
18-02-2018,5,18135,18137,8732,3298,48303,1176,680,284,2140,50443
18-02-2018,6,17638,18571,8807,3286,48303,1178,889,277,2344,50647
18-02-2018,7,17844,19036,8889,3327,49095,1154,882,274,2310,51405
18-02-2018,8,19672,19897,8872,3681,52123,1164,878,269,2311,54434
18-02-2018,9,21440,20906,8931,4002,55279,1172,934,239,2345,57624
18-02-2018,10,21712,21178,8909,4284,56084,1145,941,214,2300,58384
18-02-2018,11,21154,20963,8808,4360,55285,1129,990,219,2338,57623
18-02-2018,12,20226,20800,8833,4512,54371,1117,998,222,2337,56708
18-02-2018,13,20657,20781,8834,4612,54884,1117,1001,234,2352,57236
18-02-2018,14,20348,20704,8916,4506,54474,1119,1079,270,2468,56942
18-02-2018,15,20956,20791,8987,4356,55091,1116,1086,319,2521,57612
18-02-2018,16,21735,21316,8998,4299,56348,1099,1168,344,2611,58959
18-02-2018,17,23098,22800,9409,4546,59854,1075,1250,415,2740,62594
18-02-2018,18,23458,23166,9622,4532,60779,1075,1261,433,2769,63548
18-02-2018,19,23162,22947,9444,4396,59950,1070,1261,406,2737,62687
18-02-2018,20,22802,22501,9036,4077,58416,1074,1258,338,2670,61086
18-02-2018,21,21604,21121,8913,3925,55563,1142,1158,290,2590,58153
18-02-2018,22,20631,20503,8794,3678,53606,1139,938,245,2322,55928
18-02-2018,23,18814,19191,8638,3426,50067,1176,787,217,2180,52247
19-02-2018,0,18351,18630,8501,3267,48750,1267,634,221,2122,50872
19-02-2018,1,17988,18441,8491,3167,48089,1270,633,244,2147,50236
19-02-2018,2,18466,18411,8537,3001,48417,1270,631,259,2160,50577
19-02-2018,3,19164,18441,8679,2982,49266,1259,632,254,2145,51411
19-02-2018,4,20174,19225,8945,3094,51439,1263,722,241,2226,53665
19-02-2018,5,22078,19868,9840,3294,55081,1264,974,272,2510,57591
19-02-2018,6,23993,22554,10292,3903,60742,1266,1280,399,2945,63687
19-02-2018,7,25006,23771,10276,4279,63333,1265,1606,489,3360,66693
19-02-2018,8,25419,24132,10361,4191,64103,1284,1794,497,3575,67678
19-02-2018,9,25547,24238,10312,4185,64283,1275,1817,508,3600,67883
19-02-2018,10,25431,24302,10201,4232,64166,1279,1832,499,3610,67776
19-02-2018,11,25258,24271,9898,4126,63553,1283,1642,482,3407,66960
19-02-2018,12,24960,24304,9759,4269,63292,1278,1607,482,3367,66659
19-02-2018,13,24828,24210,9767,4176,62981,1278,1614,480,3372,66353
19-02-2018,14,24746,24254,9836,4159,62995,1275,1650,473,3398,66393
19-02-2018,15,24665,24102,9896,4202,62867,1275,1586,475,3336,66203
19-02-2018,16,24838,24024,10079,4262,63204,1239,1651,475,3365,66569
19-02-2018,17,25404,24504,10429,4476,64813,1278,1797,484,3559,68372
19-02-2018,18,25622,24686,10499,4797,65604,1295,1805,485,3585,69189
19-02-2018,19,25259,24538,10308,4651,64756,1294,1617,463,3374,68130
19-02-2018,20,25208,23855,10009,4248,63320,1277,1532,256,3065,66385
19-02-2018,21,24812,23096,9734,4047,61688,1278,977,256,2511,64199
19-02-2018,22,23942,21898,9520,3715,59074,1277,743,184,2204,61278
19-02-2018,23,23020,20648,9134,3695,56499,1272,733,191,2196,58695
20-02-2018,0,22116,19503,8874,3811,54305,1273,733,214,2220,56525
20-02-2018,1,21624,19234,8832,3760,53449,1273,733,204,2210,55659
20-02-2018,2,21397,19094,8837,3578,52906,1276,733,200,2209,55115
20-02-2018,3,21165,19176,8884,3699,52924,1263,731,225,2219,55143
20-02-2018,4,21781,19918,9282,3816,54797,1362,740,209,2311,57108
20-02-2018,5,22805,20881,10003,3944,57634,1368,781,353,2502,60136
20-02-2018,6,23942,22743,10237,4458,61380,1371,1346,503,3220,64600
20-02-2018,7,25014,24134,10173,4947,64268,1374,1749,495,3618,67886
20-02-2018,8,25169,24054,10302,4962,64487,1369,1770,474,3613,68100
20-02-2018,9,25276,23976,10258,4999,64511,1365,1810,494,3669,68180
20-02-2018,10,25637,24032,10157,5015,64842,1360,1731,506,3597,68439
20-02-2018,11,25055,23820,9836,4694,63405,1367,1721,494,3582,66987
20-02-2018,12,24573,23617,9753,4510,62453,1356,1509,475,3340,65793
20-02-2018,13,24895,23384,9714,4667,62660,1381,1477,474,3332,65992
20-02-2018,14,24869,23497,9839,4571,62777,1388,1353,472,3213,65990
20-02-2018,15,25160,23596,9913,4531,63202,1389,1361,465,3215,66417
20-02-2018,16,24846,23617,9904,4573,62939,1388,1571,452,3411,66350
20-02-2018,17,25211,23768,10177,4573,63729,1389,1694,476,3559,67288
20-02-2018,18,25199,23843,10241,4612,63896,1392,1711,476,3579,67475
20-02-2018,19,25117,23697,10110,4540,63465,1388,1484,448,3320,66785
20-02-2018,20,24901,23339,9834,4096,62169,1379,1324,319,3022,65191
20-02-2018,21,24592,21797,9433,3529,59351,1381,774,255,2410,61761
20-02-2018,22,24126,20559,9183,3463,57332,1372,735,326,2433,59765
20-02-2018,23,22855,19509,8865,3330,54558,1364,732,293,2389,56947
21-02-2018,0,20282,18248,8901,3157,50589,1452,732,212,2396,52985
21-02-2018,1,20009,17835,8946,3014,49804,1448,730,234,2412,52216
21-02-2018,2,19856,17754,8888,2899,49397,1447,729,209,2385,51782
21-02-2018,3,19940,17847,8959,2858,49604,1471,729,233,2433,52037
21-02-2018,4,20111,18360,9276,2943,50692,1473,732,210,2415,53107
21-02-2018,5,21751,19470,10119,3192,54532,1474,920,236,2630,57162
21-02-2018,6,24130,22419,10424,3610,60584,1488,1502,420,3410,63994
21-02-2018,7,25187,23828,10444,4135,63594,1527,1847,436,3810,67404
21-02-2018,8,25633,23688,10528,4248,64097,1597,1820,427,3844,67941
21-02-2018,9,25324,23794,10454,4343,63916,1301,1914,439,3654,67570
21-02-2018,10,25130,23810,10322,4211,63473,1333,1799,437,3569,67042
21-02-2018,11,24608,23625,10221,4361,62815,1281,1601,418,3300,66115
21-02-2018,12,24293,23295,9921,4227,61735,1287,1407,224,2918,64653
21-02-2018,13,24124,23176,10035,4178,61513,1429,1373,223,3025,64538
21-02-2018,14,23987,23005,10094,4141,61227,1469,1372,332,3173,64400
21-02-2018,15,24270,22912,10213,4334,61728,1455,1132,226,2813,64541
21-02-2018,16,24289,23566,10372,4190,62417,1596,1383,369,3348,65765
21-02-2018,17,24555,23980,10453,4256,63246,1604,1499,505,3608,66854
21-02-2018,18,24646,24221,10537,4354,63758,1600,1630,513,3743,67501
21-02-2018,19,24684,23935,10426,4285,63331,1599,1514,523,3636,66967
21-02-2018,20,24572,23694,10127,4063,62458,1517,1335,356,3208,65666
21-02-2018,21,24081,22703,9866,3745,60397,1507,950,362,2819,63216
21-02-2018,22,23293,21271,9637,3519,57721,1511,944,359,2814,60535
21-02-2018,23,21651,19797,9529,3425,54402,1481,941,358,2780,57182
22-02-2018,0,20738,18630,9352,3090,51812,1503,914,355,2772,54584
22-02-2018,1,20421,18343,9267,3027,51058,1511,907,340,2758,53816
22-02-2018,2,20276,18260,9177,2975,50689,1506,907,319,2732,53421
22-02-2018,3,20366,18278,9282,2973,50900,1496,914,311,2721,53621
22-02-2018,4,20691,18831,9603,3023,52150,1501,1016,301,2818,54968
22-02-2018,5,22367,19734,10288,3452,55841,1522,1203,303,3028,58869
22-02-2018,6,23925,22672,10497,3891,60985,1517,1653,528,3698,64683
22-02-2018,7,24838,23459,10716,4335,63349,1524,1842,524,3890,67239
22-02-2018,8,25427,23587,10723,4466,64204,1626,1771,532,3929,68133
22-02-2018,9,25157,23603,10678,4540,63978,1523,1893,362,3778,67756
22-02-2018,10,24863,23483,10495,4528,63369,1532,1801,277,3610,66979
22-02-2018,11,24046,23156,10236,4509,61948,1505,1522,264,3291,65239
22-02-2018,12,23805,22553,10115,4407,60879,1471,1207,255,2933,63812
22-02-2018,13,23692,22133,10021,4218,60063,1461,1195,254,2910,62973
22-02-2018,14,23794,21838,10037,4272,59941,1405,1177,247,2829,62770
22-02-2018,15,24315,22075,10172,4182,60744,1254,1205,345,2804,63548
22-02-2018,16,24426,22175,10236,4257,61093,1237,1517,478,3232,64325
22-02-2018,17,24673,22592,10380,4233,61879,1249,1675,512,3436,65315
22-02-2018,18,24952,22956,10560,4319,62787,1248,1677,497,3422,66209
22-02-2018,19,25046,23065,10333,4174,62619,1254,1378,366,2998,65617
22-02-2018,20,24339,22805,10049,3977,61172,1257,1372,312,2941,64113
22-02-2018,21,23900,21660,9611,3799,58971,1254,1074,281,2609,61580
22-02-2018,22,23148,20450,9370,3653,56622,1265,912,275,2452,59074
22-02-2018,23,21154,19240,9146,3323,52864,1194,915,244,2353,55217
23-02-2018,0,20348,18484,9077,3165,51075,1186,1008,166,2360,53435
23-02-2018,1,19794,18293,9101,3095,50284,1190,1009,154,2353,52637
23-02-2018,2,19467,18341,9051,3207,50066,1205,1008,141,2354,52420
23-02-2018,3,19338,18249,9181,3171,49940,1197,1006,139,2342,52282
23-02-2018,4,19879,19142,9366,3102,51490,1210,1016,138,2364,53854
23-02-2018,5,21665,20880,9727,3393,55665,1200,1125,244,2569,58234
23-02-2018,6,23877,23033,10174,3732,60816,1187,1598,409,3194,64010
23-02-2018,7,24780,23595,10404,4137,62916,1181,1814,431,3426,66342
23-02-2018,8,25033,23802,10549,4233,63618,1177,1835,484,3496,67114
23-02-2018,9,25164,23711,10363,4262,63499,1171,1827,318,3316,66815
23-02-2018,10,25266,23662,10095,4299,63322,1183,1752,298,3233,66555
23-02-2018,11,24860,23129,9827,4351,62167,1163,1711,307,3181,65348
23-02-2018,12,24624,22917,9669,4224,61434,1145,1394,318,2857,64291
23-02-2018,13,24003,22631,9549,4062,60247,1085,1290,334,2709,62956
23-02-2018,14,23419,22531,9489,3966,59406,1048,1280,336,2664,62070
23-02-2018,15,23303,22360,9578,3833,59075,1080,1291,347,2718,61793
23-02-2018,16,23855,22687,9945,3900,60387,1135,1205,332,2672,63059
23-02-2018,17,24471,23198,10402,3887,61959,1213,1222,344,2779,64738
23-02-2018,18,24441,24415,10567,3897,63319,1244,1183,358,2785,66104
23-02-2018,19,24389,24286,10521,3927,63123,1255,1141,326,2722,65845
23-02-2018,20,23811,23536,10272,3925,61546,1238,1129,367,2734,64280
23-02-2018,21,22039,22437,9701,3703,57880,1185,1041,345,2571,60451
23-02-2018,22,20922,21558,9463,3431,55374,1186,1033,382,2601,57975
23-02-2018,23,18756,20410,9225,3587,51979,1171,1008,462,2641,54620
24-02-2018,0,17992,18725,8941,3621,49280,999,949,556,2504,51784
24-02-2018,1,17844,18259,8880,3640,48622,926,943,587,2456,51078
24-02-2018,2,17857,18249,8861,3470,48438,921,942,545,2408,50846
24-02-2018,3,17572,18326,8852,3550,48299,909,942,501,2352,50651
24-02-2018,4,17950,18281,8920,3781,48933,906,936,484,2326,51259
24-02-2018,5,18585,18782,8934,3879,50180,921,935,461,2317,52497
24-02-2018,6,19214,19397,9101,4242,51954,923,971,428,2322,54276
24-02-2018,7,19882,20219,9259,4538,53898,897,1127,402,2426,56324
24-02-2018,8,20182,21510,9421,4394,55508,880,1171,369,2420,57928
24-02-2018,9,20760,22407,9565,4450,57182,859,1340,327,2526,59708
24-02-2018,10,20631,22453,9303,4557,56945,865,1364,341,2570,59515
24-02-2018,11,19920,21878,9167,4440,55405,867,1371,371,2609,58014
24-02-2018,12,19668,21393,9137,4287,54484,860,1361,372,2593,57077
24-02-2018,13,18719,21422,9031,4301,53473,810,1382,355,2547,56020
24-02-2018,14,18340,21287,9054,4331,53013,801,1379,334,2514,55527
24-02-2018,15,18333,21306,9260,4091,52989,836,1369,333,2538,55527
24-02-2018,16,19752,21449,9573,4045,54819,838,1366,312,2516,57335
24-02-2018,17,22198,22049,10027,4175,58450,872,1368,279,2519,60969
24-02-2018,18,22694,22564,10241,4167,59666,908,1378,310,2596,62262
24-02-2018,19,21987,22149,10140,3934,58210,907,1292,344,2543,60753
24-02-2018,20,20690,21870,9850,3726,56138,899,1265,376,2540,58678
24-02-2018,21,19364,21169,9700,3484,53718,915,930,368,2213,55931
24-02-2018,22,18851,20361,9626,3287,52124,897,930,323,2150,54274
24-02-2018,23,18001,19475,9544,2995,50014,897,935,284,2116,52130
25-02-2018,0,17815,18303,9768,2857,48742,876,828,269,1973,50715
25-02-2018,1,17684,18112,9814,2970,48579,834,698,262,1794,50373
25-02-2018,2,17597,18052,9892,2927,48468,835,689,240,1764,50232
25-02-2018,3,17172,18037,9837,2842,47888,858,689,243,1790,49678
25-02-2018,4,16882,18141,9939,2932,47894,869,687,260,1816,49710
25-02-2018,5,17489,18362,9946,2959,48756,969,685,279,1933,50689
25-02-2018,6,18082,18770,9969,3140,49962,964,768,299,2031,51993
25-02-2018,7,18705,19317,9985,3359,51366,913,941,408,2262,53628
25-02-2018,8,19591,20081,10016,3615,53305,908,946,407,2261,55566
25-02-2018,9,20404,21650,9941,3940,55934,881,1011,359,2251,58185
25-02-2018,10,20585,22239,9877,4114,56816,869,1026,315,2210,59026
25-02-2018,11,19636,22350,9762,4167,55915,862,1027,239,2128,58043
25-02-2018,12,18948,22132,9666,4227,54973,862,1024,234,2120,57093
25-02-2018,13,18104,21844,9617,4288,53853,853,790,228,1871,55724
25-02-2018,14,17198,21709,9634,4345,52888,938,779,226,1943,54831
25-02-2018,15,17243,21688,9738,4512,53182,933,773,234,1940,55122
25-02-2018,16,18072,22318,10021,4833,55244,893,864,255,2012,57256
25-02-2018,17,20501,22929,10387,5198,59015,935,1200,311,2446,61461
25-02-2018,18,22820,24000,10375,5203,62398,992,1287,323,2602,65000
25-02-2018,19,22631,24002,10288,5172,62094,980,1297,269,2546,64640
25-02-2018,20,21415,23677,10079,4892,60064,968,1206,281,2455,62519
25-02-2018,21,19602,23158,9828,4734,57322,971,1045,270,2286,59608
25-02-2018,22,18788,22546,9603,4776,55712,964,1021,342,2327,58039
25-02-2018,23,17049,21762,9428,4754,52994,965,742,224,1931,54925
26-02-2018,0,16362,20435,9352,4702,50852,1080,689,206,1975,52827
26-02-2018,1,16698,20282,9343,4761,51084,1080,687,197,1964,53048
26-02-2018,2,16717,20258,9351,4698,51027,1008,688,184,1880,52907
26-02-2018,3,16716,20329,9424,4639,51108,1053,745,183,1981,53089
26-02-2018,4,17772,21011,9557,4416,52758,1118,708,187,2013,54771
26-02-2018,5,20116,22262,10100,4407,56886,1224,1104,235,2563,59449
26-02-2018,6,23588,24956,10715,4962,64223,1273,1347,263,2883,67106
26-02-2018,7,24738,25961,11025,5432,67155,1301,1816,779,3896,71051
26-02-2018,8,24957,25967,11124,5527,67574,1366,1812,955,4133,71707
26-02-2018,9,24530,25646,10970,5689,66836,1367,1763,851,3981,70817
26-02-2018,10,24107,25216,10844,6001,66169,1393,1594,825,3812,69981
26-02-2018,11,23978,24694,10664,6060,65396,1316,1405,295,3016,68412
26-02-2018,12,23207,24511,10675,5697,64090,1331,1338,269,2938,67028
26-02-2018,13,22520,24453,10660,5513,63149,1331,1365,263,2959,66108
26-02-2018,14,22569,24668,10824,5546,63607,1337,1374,226,2937,66544
26-02-2018,15,22627,24679,10818,5683,63807,1362,1383,255,3000,66807
26-02-2018,16,23261,24913,10881,5366,64420,1374,1382,270,3026,67446
26-02-2018,17,23948,25736,11108,5777,66569,1431,1449,470,3350,69919
26-02-2018,18,24630,26106,11382,5103,67221,1421,1778,570,3769,70990
26-02-2018,19,24244,26144,11216,5343,66947,1398,1528,571,3497,70444
26-02-2018,20,24142,25325,11002,5228,65697,1387,1145,363,2895,68592
26-02-2018,21,23251,24882,10680,4957,63771,1264,1043,344,2651,66422
26-02-2018,22,22019,24321,10346,4646,61331,1266,944,341,2551,63882
26-02-2018,23,21046,22676,10038,4903,58665,1285,940,272,2497,61162
27-02-2018,0,20595,21539,9892,5167,57194,1291,939,269,2499,59693
27-02-2018,1,19368,21347,9839,5267,55821,1287,935,258,2480,58301
27-02-2018,2,18638,21417,9745,5117,54917,1279,838,247,2364,57281
27-02-2018,3,18697,21626,9828,5153,55303,1279,844,256,2379,57682
27-02-2018,4,19764,22248,10153,5419,57585,1268,1027,268,2563,60148
27-02-2018,5,21637,23581,10614,5806,61638,1385,1144,329,2858,64496
27-02-2018,6,23474,26238,10985,6355,67054,1387,1411,464,3262,70316
27-02-2018,7,24987,27289,11080,6865,70222,1416,1730,625,3771,73993
27-02-2018,8,24925,27335,10778,6941,69981,1435,1747,646,3828,73809
27-02-2018,9,24719,27125,10497,7181,69522,1454,1814,615,3883,73405
27-02-2018,10,24693,26854,10326,7540,69414,1491,1855,573,3919,73333
27-02-2018,11,24102,26639,10059,7557,68355,1460,1531,561,3552,71907
27-02-2018,12,24061,26203,10000,7197,67462,1449,1564,680,3693,71155
27-02-2018,13,23845,26239,9990,7300,67375,1421,1556,653,3630,71005
27-02-2018,14,23658,25975,9955,7282,66870,1422,1461,606,3489,70359
27-02-2018,15,23796,26339,9986,7369,67490,1396,1357,707,3460,70950
27-02-2018,16,24097,26638,10191,6899,67826,1433,1366,670,3469,71295
27-02-2018,17,25020,27135,10586,6977,69717,1479,1682,734,3895,73612
27-02-2018,18,25242,27107,10663,7365,70378,1484,1704,784,3972,74350
27-02-2018,19,24747,27041,10342,7790,69920,1467,1318,751,3536,73456
27-02-2018,20,24457,26412,10158,7482,68511,1423,981,542,2946,71457
27-02-2018,21,23389,25682,9664,7370,66105,1334,968,567,2869,68974
27-02-2018,22,22375,24440,9434,6683,62932,1344,941,560,2845,65777
27-02-2018,23,20978,23210,9334,6705,60229,1367,703,537,2607,62836
28-02-2018,0,21169,21452,9230,6408,58260,1399,961,537,2897,61157
28-02-2018,1,21394,21108,9175,6477,58154,1386,719,518,2623,60777
28-02-2018,2,21105,21323,9103,6339,57869,1399,705,493,2597,60466
28-02-2018,3,21189,21389,9108,6229,57916,1401,730,456,2587,60503
28-02-2018,4,21332,21795,9403,6335,58864,1413,973,442,2828,61692
28-02-2018,5,21995,23369,10121,6190,61676,1455,1188,447,3090,64766
28-02-2018,6,24662,25683,10452,7018,67816,1547,1674,652,3873,71689
28-02-2018,7,25774,26264,10579,7261,69877,1745,1813,850,4408,74285
28-02-2018,8,25892,26256,10602,7493,70244,1783,1831,854,4468,74712
28-02-2018,9,25604,26094,10496,7551,69744,1734,1747,605,4086,73830
28-02-2018,10,25021,26088,10406,6628,68144,1693,1744,684,4121,72265
28-02-2018,11,24490,25708,10204,6247,66649,1653,1740,662,4055,70704
28-02-2018,12,23524,25111,10060,6313,65009,1658,1513,667,3838,68847
28-02-2018,13,23539,24826,10140,6545,65051,1520,1595,669,3784,68835
28-02-2018,14,23467,24715,10215,6576,64974,1545,1642,687,3874,68848
28-02-2018,15,23358,24692,10341,6521,64913,1510,1369,684,3563,68476
28-02-2018,16,23413,24983,10417,6478,65291,1546,1343,658,3547,68838
28-02-2018,17,24053,25856,10695,6711,67315,1624,1565,904,4093,71408
28-02-2018,18,24892,25966,10794,6663,68316,1650,1580,894,4124,72440
28-02-2018,19,24642,25748,10698,6460,67546,1626,1480,680,3786,71332
28-02-2018,20,24189,25091,10244,6491,66014,1606,1181,464,3251,69265
28-02-2018,21,23522,24425,9959,5964,63869,1507,1139,456,3102,66971
28-02-2018,22,22416,23671,9541,5846,61475,1437,1127,430,2994,64469
28-02-2018,23,21075,22510,9414,5947,58946,1391,933,390,2714,61660
01-03-2018,0,20800,20539,9542,6220,57102,1528,929,370,2827,59929
01-03-2018,1,20788,20002,9553,5959,56305,1548,969,370,2887,59192
01-03-2018,2,20319,20147,9603,5453,55523,1627,928,479,3034,58557
01-03-2018,3,20274,20085,9657,5474,55490,1639,927,484,3050,58540
01-03-2018,4,20571,20773,9861,5743,56950,1699,939,321,2959,59909
01-03-2018,5,22090,21604,10431,5948,60074,1763,1104,332,3199,63273
01-03-2018,6,23128,24010,10600,6084,63823,1766,1687,580,4033,67856
01-03-2018,7,24333,25345,10521,6625,66824,1761,1816,601,4178,71002
01-03-2018,8,24876,25597,10541,7046,68061,1755,1863,603,4221,72282
01-03-2018,9,24538,25691,10498,6996,67723,1728,1945,696,4369,72092
01-03-2018,10,24239,25225,10255,6643,66362,1697,1874,707,4278,70640
01-03-2018,11,24114,25113,10124,6429,65782,1628,1866,678,4172,69954
01-03-2018,12,23872,24901,10019,6242,65035,1636,1780,699,4115,69150
01-03-2018,13,23467,24529,9876,6099,63971,1565,1794,687,4046,68017
01-03-2018,14,23036,24280,9844,5854,63015,1580,1802,700,4082,67097
01-03-2018,15,22553,24329,9845,5688,62416,1593,1803,644,4040,66456
01-03-2018,16,22508,24395,9842,5778,62523,1604,1797,634,4035,66558
01-03-2018,17,22909,24773,9926,6216,63825,1600,1787,764,4151,67976
01-03-2018,18,23912,25060,9887,6124,64981,1676,1766,791,4233,69214
01-03-2018,19,23702,25130,9754,6223,64810,1671,1719,770,4160,68970
01-03-2018,20,23181,24489,9474,5900,63045,1627,1316,566,3509,66554
01-03-2018,21,22652,23349,9151,5889,61040,1560,1203,528,3291,64331
01-03-2018,22,21905,21896,8822,5622,58245,1540,1103,488,3131,61376
01-03-2018,23,20683,20817,8641,5818,55958,1527,998,472,2997,58955
02-03-2018,0,20425,19892,8659,5686,54662,1653,1061,454,3168,57830
02-03-2018,1,20430,19528,8625,5774,54358,1683,1029,453,3165,57523
02-03-2018,2,20251,19456,8571,5793,54071,1679,1020,452,3151,57222
02-03-2018,3,20271,19568,8720,5715,54275,1655,1017,444,3116,57391
02-03-2018,4,20580,20363,9139,5721,55804,1679,1016,453,3148,58952
02-03-2018,5,21736,21744,9924,5668,59071,1666,1056,468,3190,62261
02-03-2018,6,23679,23787,10186,5905,63558,1661,1501,671,3833,67391
02-03-2018,7,24856,25258,10297,6041,66453,1671,1730,744,4145,70598
02-03-2018,8,25265,25324,10283,6208,67081,1710,1674,709,4093,71174
02-03-2018,9,25016,25306,10250,6554,67127,1757,1652,724,4133,71260
02-03-2018,10,24550,25212,10081,6179,66023,1743,1643,699,4085,70108
02-03-2018,11,23889,25036,9935,5869,64731,1716,1638,650,4004,68735
02-03-2018,12,23590,24825,9784,5734,63935,1704,1617,651,3972,67907
02-03-2018,13,23577,24585,9733,5699,63595,1622,1409,657,3688,67283
02-03-2018,14,23380,24040,9736,5647,62802,1641,1142,463,3246,66048
02-03-2018,15,23152,23797,9517,5626,62093,1606,1140,459,3205,65298
02-03-2018,16,23332,23981,9653,5771,62737,1618,1251,466,3335,66072
02-03-2018,17,24349,24585,9802,5542,64277,1603,1570,668,3841,68118
02-03-2018,18,25129,25075,10127,5710,66041,1462,1603,714,3779,69820
02-03-2018,19,24502,24767,9827,5765,64860,1408,1394,685,3487,68347
02-03-2018,20,24048,23960,9222,5110,62339,1359,943,509,2811,65150
02-03-2018,21,23390,22973,8793,5007,60165,1322,925,526,2773,62938
02-03-2018,22,22397,22041,8475,4870,57783,1316,1027,507,2850,60633
02-03-2018,23,20815,20826,8209,5034,54883,1276,1013,338,2627,57510
03-03-2018,0,20515,18912,8220,4903,52551,1231,925,323,2479,55030
03-03-2018,1,19828,18386,8266,4818,51298,1206,922,357,2485,53783
03-03-2018,2,19459,18146,8331,4316,50253,1206,921,368,2495,52748
03-03-2018,3,19756,18142,8322,4099,50320,1202,918,359,2479,52799
03-03-2018,4,20036,18135,8371,3891,50434,1208,919,361,2488,52922
03-03-2018,5,20527,18382,8515,3976,51401,1204,919,398,2521,53922
03-03-2018,6,21269,19338,8628,4104,53339,1216,918,351,2485,55824
03-03-2018,7,22039,20172,8922,4180,55314,1217,920,354,2491,57805
03-03-2018,8,22894,21813,9253,4348,58308,1221,1000,273,2494,60802
03-03-2018,9,23177,22815,9484,4573,60050,1239,1108,224,2571,62621
03-03-2018,10,23358,22636,9412,4576,59983,1237,1059,223,2519,62502
03-03-2018,11,23063,22333,9059,4672,59127,1234,1289,231,2754,61881
03-03-2018,12,22589,21861,8834,4706,57989,1218,1235,249,2702,60691
03-03-2018,13,22171,21519,8700,4606,56996,1220,1098,260,2578,59574
03-03-2018,14,21673,21258,8557,4590,56077,1180,1082,276,2538,58615
03-03-2018,15,21583,21323,8592,4523,56022,1170,1132,272,2574,58596
03-03-2018,16,22017,21477,8882,4467,56844,1164,1182,261,2607,59451
03-03-2018,17,22990,22190,9328,4533,59043,1199,1278,240,2717,61760
03-03-2018,18,23336,22907,9662,4612,60518,1261,1387,247,2895,63413
03-03-2018,19,22972,22367,9556,4667,59562,1280,1234,287,2801,62363
03-03-2018,20,21989,21598,9178,4794,57560,1323,1028,292,2643,60203
03-03-2018,21,21311,20458,8836,4711,55317,1324,931,287,2542,57859
03-03-2018,22,20108,19994,8692,4751,53546,1363,929,291,2583,56129
03-03-2018,23,19014,18813,8565,4601,50993,1433,912,259,2604,53597
04-03-2018,0,19243,17708,8509,4198,49658,1218,931,274,2423,52081
04-03-2018,1,18865,17213,8548,4091,48717,1212,929,300,2441,51158
04-03-2018,2,18570,17092,8556,3949,48167,1118,926,323,2367,50534
04-03-2018,3,18725,17069,8546,3882,48222,1095,922,362,2379,50601
04-03-2018,4,18692,17125,8557,3970,48343,1133,923,373,2429,50772
04-03-2018,5,18748,17316,8688,4063,48815,1142,925,376,2443,51258
04-03-2018,6,19048,17764,8797,4192,49801,1215,1011,342,2568,52369
04-03-2018,7,18990,18622,8972,4368,50952,1220,1011,329,2560,53512
04-03-2018,8,20866,19225,8986,4621,53699,1279,1011,272,2562,56261
04-03-2018,9,21404,20246,8941,5151,55742,1205,1011,203,2419,58161
04-03-2018,10,21289,20512,8893,5354,56048,1191,1011,186,2388,58436
04-03-2018,11,20958,20513,8857,5573,55903,1184,1010,184,2378,58281
04-03-2018,12,20539,20079,8713,5496,54826,1241,1001,185,2427,57253
04-03-2018,13,19973,20229,8685,5502,54390,1221,1012,187,2420,56810
04-03-2018,14,19622,20308,8719,5386,54035,1215,1024,182,2421,56456
04-03-2018,15,19348,20557,8854,5294,54053,1212,1018,180,2410,56463
04-03-2018,16,19735,20738,8985,5465,54923,1236,1120,171,2527,57450
04-03-2018,17,21112,21357,9308,5264,57040,1269,1177,174,2620,59660
04-03-2018,18,21998,21792,9734,5312,58836,1281,1180,179,2640,61476
04-03-2018,19,21677,21813,9676,5158,58322,1278,1184,180,2642,60964
04-03-2018,20,20873,21422,9384,5000,56681,1268,1132,181,2581,59262
04-03-2018,21,19900,20815,9105,4874,54694,1191,915,170,2276,56970
04-03-2018,22,18968,20028,8963,4871,52829,1176,915,163,2254,55083
04-03-2018,23,17816,18999,8785,4700,50301,1258,919,164,2341,52642
05-03-2018,0,17253,18509,8720,4665,49148,1378,919,163,2460,51608
05-03-2018,1,16681,18359,8602,4723,48363,1408,922,164,2494,50857
05-03-2018,2,16630,18235,8567,4989,48422,1423,920,169,2512,50934
05-03-2018,3,17066,18451,8618,5133,49269,1421,920,174,2515,51784
05-03-2018,4,17566,19357,8929,5590,51444,1465,925,175,2565,54009
05-03-2018,5,18527,21040,9602,5761,54932,1768,1061,175,3004,57936
05-03-2018,6,22137,23324,9857,6412,61729,1780,1427,205,3412,65141
05-03-2018,7,24509,24429,10236,6574,65749,1794,1570,440,3804,69553
05-03-2018,8,24758,24641,10218,6613,66230,1801,1782,463,4046,70276
05-03-2018,9,24719,24731,10031,6089,65569,1799,1788,408,3995,69564
05-03-2018,10,24682,24736,9952,5940,65312,1762,1798,427,3987,69299
05-03-2018,11,24439,24814,9879,5872,65003,1735,1764,250,3749,68752
05-03-2018,12,24060,24655,9830,5652,64196,1662,1652,273,3587,67783
05-03-2018,13,23862,24317,9792,5440,63411,1650,1563,296,3509,66920
05-03-2018,14,24050,24539,9829,5764,64183,1637,1567,289,3493,67676
05-03-2018,15,24081,24442,9987,5767,64278,1651,1632,292,3575,67853
05-03-2018,16,24587,24556,10195,5745,65083,1663,1637,319,3619,68702
05-03-2018,17,24709,24907,10412,5928,65955,1675,1818,626,4119,70074
05-03-2018,18,24810,24946,10704,5851,66312,1716,1855,722,4293,70605
05-03-2018,19,24476,24834,10610,5646,65567,1735,1843,683,4261,69828
05-03-2018,20,24136,23898,10497,5080,63610,1712,1723,394,3829,67439
05-03-2018,21,23562,22981,10459,4490,61491,1797,1088,369,3254,64745
05-03-2018,22,22405,22066,10066,4078,58615,1813,899,363,3075,61690
05-03-2018,23,20798,20655,9543,3800,54795,1794,892,375,3061,57856
06-03-2018,0,19946,19344,9342,3749,52381,1841,714,367,2922,55303
06-03-2018,1,19057,19129,9251,3561,50999,1841,714,335,2890,53889
06-03-2018,2,17565,18950,9296,3363,49174,1840,709,288,2837,52011
06-03-2018,3,16811,18879,9314,3245,48249,1852,706,270,2828,51077
06-03-2018,4,17631,19432,9428,3144,49637,1855,713,283,2851,52488
06-03-2018,5,20310,21034,9847,3228,54419,1862,827,287,2976,57395
06-03-2018,6,23472,23460,10259,3487,60679,1875,1004,271,3150,63829
06-03-2018,7,24800,24533,10519,3900,63752,1852,1304,479,3635,67387
06-03-2018,8,24759,24538,10625,3960,63882,1852,1279,476,3607,67489
06-03-2018,9,24607,24472,10533,4112,63725,1849,1292,458,3599,67324
06-03-2018,10,24478,23890,10356,4131,62856,1842,1294,438,3574,66430
06-03-2018,11,24660,24045,10380,4434,63521,1644,1113,399,3156,66677
06-03-2018,12,24883,23956,10538,4643,64018,1642,1051,207,2900,66918
06-03-2018,13,24363,23862,10523,4661,63409,1559,926,206,2691,66100
06-03-2018,14,24202,23979,10311,4685,63176,1535,834,211,2580,65756
06-03-2018,15,24276,24001,10313,4700,63288,1539,838,253,2630,65918
06-03-2018,16,24022,23999,10400,4789,63210,1576,855,299,2730,65940
06-03-2018,17,24348,24128,10675,4884,64034,1692,1035,390,3117,67151
06-03-2018,18,24843,24509,11100,4947,65398,1651,1252,671,3574,68972
06-03-2018,19,24719,24868,10965,4963,65517,1525,1091,412,3028,68545
06-03-2018,20,24061,24230,10684,4770,63746,1419,912,369,2700,66446
06-03-2018,21,22784,23326,10426,4655,61191,1518,732,347,2597,63788
06-03-2018,22,21538,22230,9819,4625,58213,1511,711,330,2552,60765
06-03-2018,23,19668,20613,9438,4335,54054,1496,712,321,2529,56583
07-03-2018,0,19144,19048,9458,4391,52043,1529,748,318,2595,54638
07-03-2018,1,18297,18945,9528,4261,51032,1504,720,455,2679,53711
07-03-2018,2,17329,18824,9560,4213,49926,1547,717,340,2604,52530
07-03-2018,3,16908,18923,9648,4355,49833,1580,717,357,2654,52487
07-03-2018,4,18188,19608,9848,4337,51982,1610,716,366,2692,54674
07-03-2018,5,20584,21235,10327,4472,56621,1634,726,422,2782,59403
07-03-2018,6,23367,23497,10945,4722,62530,1672,743,382,2797,65327
07-03-2018,7,24609,24898,11263,4939,65709,1637,917,382,2936,68645
07-03-2018,8,25061,25094,11081,5024,66260,1642,1301,637,3580,69840
07-03-2018,9,24800,25218,10768,4806,65592,1645,1329,602,3576,69168
07-03-2018,10,24731,25168,10643,4740,65284,1646,1077,608,3331,68615
07-03-2018,11,24636,24553,10432,4694,64315,1735,945,428,3108,67423
07-03-2018,12,24402,24029,10238,4522,63192,1751,922,459,3132,66324
07-03-2018,13,24122,24042,10050,4347,62561,1642,910,505,3057,65618
07-03-2018,14,24266,24141,10062,4376,62846,1615,915,354,2884,65730
07-03-2018,15,24451,24156,10138,4228,62974,1683,854,383,2920,65894
07-03-2018,16,24531,24418,10210,4115,63276,1696,835,403,2934,66210
07-03-2018,17,24828,24648,10665,4266,64409,1748,1188,652,3588,67997
07-03-2018,18,24278,24933,10913,4422,64546,1764,1337,652,3753,68299
07-03-2018,19,24470,24971,10938,4322,64701,1768,1244,599,3611,68312
07-03-2018,20,23402,24180,10721,4037,62341,1695,662,492,2849,65190
07-03-2018,21,22548,23248,10351,3808,59955,1690,662,414,2766,62721
07-03-2018,22,21054,22020,9889,3584,56547,1710,661,320,2691,59238
07-03-2018,23,18388,20484,9423,3100,51396,1717,649,323,2689,54085
08-03-2018,0,18055,19148,9297,2929,49429,1614,633,316,2563,51992
08-03-2018,1,16430,18689,9304,2810,47232,1590,623,288,2501,49733
08-03-2018,2,16084,18453,9283,2751,46572,1587,627,289,2503,49075
08-03-2018,3,16027,18361,9289,2798,46474,1575,622,259,2456,48930
08-03-2018,4,16669,18453,9372,2905,47398,1572,622,285,2479,49877
08-03-2018,5,18161,19394,9469,2923,49946,1576,811,314,2701,52647
08-03-2018,6,22099,21338,10110,3608,57155,1672,912,287,2871,60026
08-03-2018,7,24045,22821,10755,3813,61435,1681,899,364,2944,64379
08-03-2018,8,24258,23302,10648,3793,62003,1603,909,370,2882,64885
08-03-2018,9,24156,23423,10351,3855,61784,1602,1004,296,2902,64686
08-03-2018,10,23862,23345,10089,3895,61191,1599,1060,267,2926,64117
08-03-2018,11,23626,23239,9714,3871,60451,1601,1098,236,2935,63386
08-03-2018,12,23176,23090,9547,3798,59611,1598,1073,254,2925,62536
08-03-2018,13,23316,23062,9414,3780,59574,1548,1071,231,2850,62424
08-03-2018,14,22414,22695,9350,3899,58356,1520,1079,228,2827,61183
08-03-2018,15,22365,22574,9353,3854,58146,1524,988,232,2744,60890
08-03-2018,16,22843,22631,9710,3750,58934,1531,967,225,2723,61657
08-03-2018,17,23629,22626,10139,3955,60351,1541,961,234,2736,63087
08-03-2018,18,24290,22883,10344,4105,61622,1549,959,297,2805,64427
08-03-2018,19,23554,23512,10349,4309,61726,1562,985,245,2792,64518
08-03-2018,20,21330,22800,9737,3784,57653,1498,941,250,2689,60342
08-03-2018,21,20091,21988,9334,3624,55037,1516,797,230,2543,57580
08-03-2018,22,17928,20974,9170,3510,51582,1525,709,235,2469,54051
08-03-2018,23,16224,19920,9019,3380,48543,1556,470,260,2286,50829
09-03-2018,0,15584,18599,8828,3283,46296,1466,468,277,2211,48507
09-03-2018,1,15152,18298,8819,3424,45693,1465,469,274,2208,47901
09-03-2018,2,14530,18377,8843,3449,45197,1473,469,245,2187,47384
09-03-2018,3,14507,18250,8939,3399,45096,1459,470,255,2184,47280
09-03-2018,4,15166,18500,9047,3403,46117,1479,472,282,2233,48350
09-03-2018,5,16806,19567,9092,3551,49017,1618,582,273,2473,51490
09-03-2018,6,20039,21522,9466,3634,54661,1690,897,302,2889,57550
09-03-2018,7,22828,23019,9842,3914,59603,1712,974,317,3003,62606
09-03-2018,8,23549,23452,9946,4119,61067,1717,875,549,3141,64208
09-03-2018,9,23214,23387,9859,4099,60559,1713,1036,599,3348,63907
09-03-2018,10,22542,23199,9585,4048,59372,1703,918,623,3244,62616
09-03-2018,11,21985,22985,9282,4078,58329,1691,978,624,3293,61622
09-03-2018,12,21286,22893,9228,4148,57556,1697,1005,627,3329,60885
09-03-2018,13,22042,22838,9299,4111,58290,1610,937,525,3072,61362
09-03-2018,14,22819,22753,9411,4007,58991,1595,964,570,3129,62120
09-03-2018,15,23372,23041,9615,3997,60025,1609,986,456,3051,63076
09-03-2018,16,23624,23139,9925,3948,60636,1641,1007,425,3073,63709
09-03-2018,17,23994,23413,10143,4089,61639,1627,1165,494,3286,64925
09-03-2018,18,24677,23715,10299,4096,62788,1664,1191,504,3359,66147
09-03-2018,19,24255,23496,10300,3944,61996,1667,995,452,3114,65110
09-03-2018,20,23675,23034,10065,3816,60590,1604,681,461,2746,63336
09-03-2018,21,22833,22544,9742,3643,58762,1609,581,238,2428,61190
09-03-2018,22,21742,21396,9294,3499,55930,1597,602,206,2405,58335
09-03-2018,23,20065,20300,8973,3471,52808,1588,578,197,2363,55171
10-03-2018,0,17919,17981,8633,3238,47772,1379,492,195,2066,49838
10-03-2018,1,16500,17294,8541,2811,45147,1361,486,195,2042,47189
10-03-2018,2,15436,17089,8524,2768,43817,1354,486,190,2030,45847
10-03-2018,3,15004,17056,8591,3011,43661,1370,486,182,2038,45699
10-03-2018,4,15366,17132,8579,3134,44213,1270,488,184,1942,46155
10-03-2018,5,15907,17644,8622,3464,45638,1255,488,191,1934,47572
10-03-2018,6,16379,18474,8844,3717,47414,1240,489,197,1926,49340
10-03-2018,7,17856,19316,8957,3956,50086,1220,537,235,1992,52078
10-03-2018,8,18678,20484,9072,4218,52454,1336,576,233,2145,54599
10-03-2018,9,19268,21217,9074,4609,54168,1333,662,242,2237,56405
10-03-2018,10,18881,21189,8950,4850,53870,1313,664,249,2226,56096
10-03-2018,11,18460,21124,8895,4944,53424,1315,755,250,2320,55744
10-03-2018,12,17944,20687,8818,4924,52375,1315,754,259,2328,54703
10-03-2018,13,17444,20597,8849,4940,51831,1310,754,253,2317,54148
10-03-2018,14,17111,20624,8828,5109,51672,1281,768,243,2292,53964
10-03-2018,15,16954,20618,8836,5235,51643,1264,771,245,2280,53923
10-03-2018,16,17707,20578,8965,5750,53001,1264,822,217,2303,55304
10-03-2018,17,19516,21193,9164,6079,55952,1269,860,231,2360,58312
10-03-2018,18,21304,21694,9427,6641,59066,1280,921,208,2409,61475
10-03-2018,19,21214,22065,9428,6710,59417,1272,865,203,2340,61757
10-03-2018,20,19513,21494,9045,6307,56358,1266,802,220,2288,58646
10-03-2018,21,17436,20647,8651,5695,52430,1279,546,240,2065,54495
10-03-2018,22,16594,19552,8470,5246,49861,1288,497,242,2027,51888
10-03-2018,23,15749,18986,8380,4902,48017,1287,483,248,2018,50035
11-03-2018,0,15224,17663,8319,4782,45987,1353,301,252,1906,47893
11-03-2018,1,14590,17370,8229,4637,44828,1371,300,256,1927,46755
11-03-2018,2,14401,17470,8129,4605,44606,1328,301,266,1895,46501
11-03-2018,3,14407,17520,8106,4538,44571,1359,301,281,1941,46512
11-03-2018,4,14215,17696,8083,4356,44350,1346,301,301,1948,46298
11-03-2018,5,14566,17853,8101,4327,44847,1329,303,309,1941,46788
11-03-2018,6,14914,18485,8285,4192,45876,1303,306,310,1919,47795
11-03-2018,7,15177,18996,8345,4180,46699,1317,356,314,1987,48686
11-03-2018,8,15891,20226,8532,4245,48894,1323,391,333,2047,50941
11-03-2018,9,16237,21172,8543,4539,50493,1342,391,328,2061,52554
11-03-2018,10,16740,21452,8502,4564,51259,1322,395,368,2085,53344
11-03-2018,11,16760,21559,8564,4624,51508,1294,392,384,2070,53578
11-03-2018,12,16525,21513,8485,4534,51057,1281,392,373,2046,53103
11-03-2018,13,16336,21618,8521,4527,51001,1309,481,340,2130,53131
11-03-2018,14,15631,21581,8486,4614,50312,1289,484,359,2132,52444
11-03-2018,15,15374,21661,8529,4664,50230,1276,490,394,2160,52390
11-03-2018,16,15639,21962,8585,4794,50978,1309,579,407,2295,53273
11-03-2018,17,17017,22293,8708,5089,53107,1308,688,406,2402,55509
11-03-2018,18,18438,22622,8794,5510,55364,1316,824,425,2565,57929
11-03-2018,19,19044,22788,8759,5733,56325,1298,808,473,2579,58904
11-03-2018,20,17078,22289,8623,5443,53432,1341,675,417,2433,55865
11-03-2018,21,16639,21684,8515,5575,52412,1321,429,335,2085,54497
11-03-2018,22,15965,20644,8325,5611,50545,1333,405,322,2060,52605
11-03-2018,23,14984,19326,8148,5415,47872,1361,319,341,2021,49893
12-03-2018,0,14205,19079,8030,4570,45885,1386,318,337,2041,47926
12-03-2018,1,14011,18674,7938,4145,44768,1343,316,327,1986,46754
12-03-2018,2,14388,18537,8013,3697,44637,1368,320,326,2014,46651
12-03-2018,3,14526,18653,8131,3295,44607,1392,315,336,2043,46650
12-03-2018,4,14780,19076,8251,3553,45660,1471,341,390,2202,47862
12-03-2018,5,17575,19836,8706,3762,49879,1500,413,432,2345,52224
12-03-2018,6,21272,22599,9370,4065,57306,1474,833,511,2818,60124
12-03-2018,7,23617,24239,9802,4290,61949,1437,1004,510,2951,64900
12-03-2018,8,24012,24246,9849,4360,62466,1451,1121,715,3287,65753
12-03-2018,9,23713,24249,9792,4344,62098,1447,1104,736,3287,65385
12-03-2018,10,23661,23959,9787,4390,61796,1445,1036,754,3235,65031
12-03-2018,11,23501,23663,9682,4494,61340,1436,1003,777,3216,64556
12-03-2018,12,23188,23355,9516,4256,60315,1434,1017,791,3242,63557
12-03-2018,13,22841,23088,9500,4463,59893,1442,974,794,3210,63103
12-03-2018,14,22409,22764,9661,4033,58869,1443,965,799,3207,62076
12-03-2018,15,22409,22623,9913,3980,58926,1455,996,739,3190,62116
12-03-2018,16,22761,22806,9644,3982,59194,1474,967,798,3239,62433
12-03-2018,17,23274,23113,9771,4290,60448,1484,985,836,3305,63753
12-03-2018,18,23794,23584,9958,4404,61742,1482,1075,817,3374,65116
12-03-2018,19,23414,23560,9956,4565,61496,1467,976,794,3237,64733
12-03-2018,20,21950,23071,9562,3976,58560,1498,875,577,2950,61510
12-03-2018,21,19982,21952,9060,3603,54598,1506,559,555,2620,57218
12-03-2018,22,17114,20750,8602,3384,49850,1498,504,509,2511,52361
12-03-2018,23,15452,19205,8276,3196,46129,1494,498,522,2514,48643
13-03-2018,0,14937,17893,8054,3095,43980,1517,497,534,2548,46528
13-03-2018,1,14526,17704,8012,3195,43438,1505,499,535,2539,45977
13-03-2018,2,13831,17788,7989,3119,42728,1508,500,542,2550,45278
13-03-2018,3,13823,17844,7923,3168,42758,1500,499,544,2543,45301
13-03-2018,4,14505,18582,8010,3393,44491,1476,498,540,2514,47005
13-03-2018,5,16591,19379,8206,3633,47808,1427,520,607,2554,50362
13-03-2018,6,19551,21605,8635,4088,53877,1418,666,578,2662,56539
13-03-2018,7,22139,23250,9306,4481,59177,1425,878,560,2863,62040
13-03-2018,8,22352,23815,9483,4505,60156,1429,1095,553,3077,63233
13-03-2018,9,22017,23535,9431,4556,59540,1424,1258,537,3219,62759
13-03-2018,10,21610,23371,9446,4930,59357,1445,1105,541,3091,62448
13-03-2018,11,21500,23590,9392,4629,59110,1499,1125,518,3142,62252
13-03-2018,12,21288,23379,9319,4792,58778,1506,1172,492,3170,61948
13-03-2018,13,21064,23284,9356,4794,58498,1485,1058,566,3109,61607
13-03-2018,14,20901,23203,9343,4796,58244,1466,1084,589,3139,61383
13-03-2018,15,21442,23180,9516,4878,59016,1465,1150,528,3143,62159
13-03-2018,16,21442,23316,9533,4800,59092,1415,1167,540,3122,62214
13-03-2018,17,22303,23750,9737,4777,60567,1436,1230,536,3202,63769
13-03-2018,18,22749,24146,10052,4704,61651,1436,1360,667,3463,65114
13-03-2018,19,22726,24326,10086,4624,61762,1431,1141,673,3245,65007
13-03-2018,20,21645,23702,9850,4412,59608,1348,805,538,2691,62299
13-03-2018,21,21006,22726,9584,4181,57496,1333,522,503,2358,59854
13-03-2018,22,18908,21941,9042,3858,53750,1356,495,433,2284,56034
13-03-2018,23,16290,20240,8660,3475,48665,1326,516,417,2259,50924
14-03-2018,0,14761,19012,8623,3250,45647,1353,591,373,2317,47964
14-03-2018,1,14077,18872,8630,3165,44744,1455,599,346,2400,47144
14-03-2018,2,14066,18782,8658,3157,44663,1457,600,320,2377,47040
14-03-2018,3,13857,18875,8759,3107,44599,1473,601,295,2369,46968
14-03-2018,4,15006,19248,8758,3063,46075,1480,604,290,2374,48449
14-03-2018,5,17655,20567,9089,3208,50519,1445,620,280,2345,52864
14-03-2018,6,21047,23197,9794,3819,57858,1466,710,266,2442,60300
14-03-2018,7,22984,24639,10317,4288,62230,1501,1176,533,3210,65440
14-03-2018,8,23278,24387,10499,4387,62550,1534,1233,538,3305,65855
14-03-2018,9,23232,24215,10526,4461,62435,1523,1235,538,3296,65731
14-03-2018,10,23214,23921,10498,4480,62114,1495,1153,550,3198,65312
14-03-2018,11,23121,23537,10230,4355,61243,1484,1114,533,3131,64374
14-03-2018,12,22624,22953,10175,4039,59792,1497,1173,360,3030,62822
14-03-2018,13,22955,22529,10106,3902,59493,1500,1151,363,3014,62507
14-03-2018,14,22848,22632,9979,3725,59185,1477,1156,358,2991,62176
14-03-2018,15,22696,22529,9974,3869,59068,1452,1152,368,2972,62040
14-03-2018,16,22871,22487,10118,3867,59344,1441,1139,359,2939,62283
14-03-2018,17,22993,22700,10203,4089,59985,1470,1321,470,3261,63246
14-03-2018,18,23203,22907,10292,4382,60783,1463,1410,554,3427,64210
14-03-2018,19,23073,23106,10330,4572,61081,1467,1319,567,3353,64434
14-03-2018,20,21993,22768,10100,4357,59218,1459,1095,393,2947,62165
14-03-2018,21,20252,22177,9567,3554,55549,1433,661,311,2405,57954
14-03-2018,22,17882,20722,9207,3538,51348,1402,599,293,2294,53642
14-03-2018,23,16427,19113,9140,3584,48265,1408,597,280,2285,50550
15-03-2018,0,15495,18283,9084,3623,46485,1454,690,268,2412,48897
15-03-2018,1,15133,17960,9094,3769,45956,1441,689,280,2410,48366
15-03-2018,2,14937,17778,9170,3856,45743,1426,689,264,2379,48122
15-03-2018,3,15252,17844,9049,4096,46242,1394,691,264,2349,48591
15-03-2018,4,15604,18532,9224,4660,48021,1403,691,291,2385,50406
15-03-2018,5,17055,19627,9638,5178,51499,1432,754,340,2526,54025
15-03-2018,6,19145,22133,10220,5605,57104,1428,1166,354,2948,60052
15-03-2018,7,20834,23981,10385,6124,61324,1429,1384,501,3314,64638
15-03-2018,8,20769,23395,10368,6071,60601,1452,1586,577,3615,64216
15-03-2018,9,20327,23482,10168,6440,60418,1442,1691,530,3663,64081
15-03-2018,10,20047,23397,9955,6401,59801,1438,1684,516,3638,63439
15-03-2018,11,19641,23329,9781,6418,59169,1441,1607,547,3595,62764
15-03-2018,12,19330,23159,9872,6252,58614,1451,1515,339,3305,61919
15-03-2018,13,19084,23110,9724,6237,58156,1423,1462,327,3212,61368
15-03-2018,14,19129,22745,9759,6152,57786,1415,1377,324,3116,60902
15-03-2018,15,19059,23088,9820,6232,58200,1426,1214,329,2969,61169
15-03-2018,16,19299,23267,9873,6195,58634,1429,1205,343,2977,61611
15-03-2018,17,19990,23041,10291,6322,59644,1456,1194,359,3009,62653
15-03-2018,18,20622,23105,10699,6439,60866,1483,1184,422,3089,63955
15-03-2018,19,20359,23273,10510,6353,60494,1488,1194,447,3129,63623
15-03-2018,20,19555,22824,10246,6088,58712,1488,1153,366,3007,61719
15-03-2018,21,19181,22310,10007,5972,57469,1447,766,435,2648,60117
15-03-2018,22,17927,20757,9823,5934,54441,1438,701,357,2496,56937
15-03-2018,23,16651,19758,9629,6022,52059,1421,703,423,2547,54606
16-03-2018,0,16003,18748,9339,5994,50084,1403,722,352,2477,52561
16-03-2018,1,15833,18611,9328,5583,49356,1405,718,368,2491,51847
16-03-2018,2,15840,18761,9305,5505,49410,1417,720,387,2524,51934
16-03-2018,3,15900,19187,9397,5823,50306,1413,723,425,2561,52867
16-03-2018,4,17004,19713,9558,6045,52322,1403,877,450,2730,55052
16-03-2018,5,18596,20671,9976,6140,55382,1400,1064,460,2924,58306
16-03-2018,6,20388,23394,10417,6576,60775,1376,1312,462,3150,63925
16-03-2018,7,22412,24875,10774,6737,64798,1346,1559,518,3423,68221
16-03-2018,8,22874,25038,10548,7019,65480,1323,1586,741,3650,69130
16-03-2018,9,22533,25023,10288,7031,64875,1295,1579,820,3694,68569
16-03-2018,10,21942,24614,10043,7061,63661,1305,1748,820,3873,67534
16-03-2018,11,21640,24258,9984,6996,62879,1335,1574,807,3716,66595
16-03-2018,12,21134,24086,9960,6803,61982,1424,1565,605,3594,65576
16-03-2018,13,20429,23965,9883,6672,60948,1395,1524,587,3506,64454
16-03-2018,14,20028,23630,9808,6743,60208,1380,1487,604,3471,63679
16-03-2018,15,19568,23306,9780,6736,59390,1392,1492,599,3483,62873
16-03-2018,16,19496,22916,9932,6766,59111,1494,1431,620,3545,62656
16-03-2018,17,20520,23382,10259,6853,61016,1442,1417,672,3531,64547
16-03-2018,18,21752,23907,10658,6881,63199,1454,1368,733,3555,66754
16-03-2018,19,21558,23882,10553,6821,62815,1470,1346,527,3343,66158
16-03-2018,20,19926,23054,10243,6580,59802,1469,1162,459,3090,62892
16-03-2018,21,18187,22339,9693,6265,56484,1474,941,460,2875,59359
16-03-2018,22,17256,20955,9521,6107,53839,1463,739,489,2691,56530
16-03-2018,23,16848,19800,9278,6028,51954,1443,739,528,2710,54664
17-03-2018,0,17380,18741,9048,5669,50839,1266,726,560,2552,53391
17-03-2018,1,17496,18602,8945,5457,50501,1201,712,572,2485,52986
17-03-2018,2,17253,18606,8790,5303,49953,1195,714,564,2473,52426
17-03-2018,3,16735,18573,8746,5428,49483,1185,760,522,2467,51950
17-03-2018,4,16861,18863,8675,5333,49732,1207,1046,490,2743,52475
17-03-2018,5,16853,19156,8731,5349,50088,1295,1376,466,3137,53225
17-03-2018,6,17153,20449,9042,5274,51918,1294,1373,471,3138,55056
17-03-2018,7,17429,21412,9187,5478,53506,1283,1368,542,3193,56699
17-03-2018,8,17729,22031,9169,5635,54564,1287,1379,603,3269,57833
17-03-2018,9,17819,22111,8987,5813,54730,1254,1381,658,3293,58023
17-03-2018,10,17901,21997,8928,5977,54802,1220,1374,683,3277,58079
17-03-2018,11,17740,22101,9042,6039,54922,1236,1358,674,3268,58190
17-03-2018,12,16869,21857,9021,5975,53722,1300,1313,588,3201,56923
17-03-2018,13,16325,21647,9044,5833,52851,1269,1228,614,3111,55962
17-03-2018,14,15661,21319,8917,5751,51649,1263,1229,583,3075,54724
17-03-2018,15,15332,21224,8950,5888,51395,1244,1218,524,2986,54381
17-03-2018,16,15808,21610,9190,5897,52506,1246,1212,530,2988,55494
17-03-2018,17,16610,21641,9435,6030,53715,1261,1200,471,2932,56647
17-03-2018,18,18501,22703,9766,5938,56909,1295,1209,456,2960,59869
17-03-2018,19,17703,22556,9732,5769,55760,1333,1216,332,2881,58641
17-03-2018,20,16354,21917,9674,5361,53307,1347,1165,343,2855,56162
17-03-2018,21,15905,21430,9584,4952,51871,1355,915,352,2622,54493
17-03-2018,22,15907,20676,9567,5557,51706,1367,841,422,2630,54336
17-03-2018,23,15505,20288,9505,4900,50200,1396,706,418,2520,52720
18-03-2018,0,15673,19332,9464,4446,48916,1328,726,411,2465,51381
18-03-2018,1,15434,19184,9524,4295,48437,1366,727,351,2444,50881
18-03-2018,2,15100,19199,9514,4303,48117,1358,727,397,2482,50599
18-03-2018,3,15131,19182,9506,4011,47829,1388,730,357,2475,50304
18-03-2018,4,15262,19246,9648,4043,48200,1431,730,351,2512,50712
18-03-2018,5,14837,19507,9622,4015,47982,1577,1008,308,2893,50875
18-03-2018,6,14970,19685,9716,4401,48772,1570,960,216,2746,51518
18-03-2018,7,15610,20204,9730,4376,49921,1562,1072,209,2843,52764
18-03-2018,8,15610,20783,9550,4955,50899,1545,1132,236,2913,53812
18-03-2018,9,16164,20893,9504,4837,51400,1536,856,244,2636,54036
18-03-2018,10,15725,20826,9503,4925,50981,1493,838,279,2610,53591
18-03-2018,11,15624,20683,9563,4903,50772,1520,796,286,2602,53374
18-03-2018,12,14906,20466,9401,5088,49861,1515,730,255,2500,52361
18-03-2018,13,14161,20322,9323,5065,48871,1581,712,266,2559,51430
18-03-2018,14,13745,20404,9284,5023,48454,1568,715,266,2549,51003
18-03-2018,15,13521,20426,9327,4913,48187,1515,714,242,2471,50658
18-03-2018,16,13967,20635,9366,4829,48798,1488,705,258,2451,51249
18-03-2018,17,15339,21412,9441,4491,50684,1512,1019,285,2816,53500
18-03-2018,18,18272,23020,9767,4116,55174,1602,1089,321,3012,58186
18-03-2018,19,18934,23457,9898,4048,56337,1582,1127,323,3032,59369
18-03-2018,20,17764,23094,9713,3724,54294,1538,1142,310,2990,57284
18-03-2018,21,16663,22237,9598,3280,51778,1551,834,272,2657,54435
18-03-2018,22,16283,21734,9467,3268,50754,1580,732,257,2569,53323
18-03-2018,23,14737,20833,9369,2983,47924,1581,693,258,2532,50456
19-03-2018,0,14103,19693,9174,3179,46149,1666,447,270,2383,48532
19-03-2018,1,13709,19270,9100,2951,45030,1645,442,267,2354,47384
19-03-2018,2,13558,19242,9119,2862,44782,1701,437,281,2419,47201
19-03-2018,3,13763,19251,9114,2857,44984,1681,459,301,2441,47425
19-03-2018,4,14615,20077,9182,2949,46824,1644,757,325,2726,49550
19-03-2018,5,17650,21263,9826,3164,51904,1729,1365,370,3464,55368
19-03-2018,6,20853,24263,10335,3855,59308,1718,1385,462,3565,62873
19-03-2018,7,22448,25770,10611,4405,63233,1712,1467,676,3855,67088
19-03-2018,8,22475,25450,10520,4702,63148,1730,1568,645,3943,67091
19-03-2018,9,22337,25503,10280,4807,62928,1742,1379,653,3774,66702
19-03-2018,10,22020,25216,10013,5129,62377,1729,1346,682,3757,66134
19-03-2018,11,21715,25219,9654,5199,61788,1710,1328,704,3742,65530
19-03-2018,12,21118,24930,9441,5282,60774,1697,1371,699,3767,64541
19-03-2018,13,21022,24721,9519,5254,60515,1694,1275,518,3487,64002
19-03-2018,14,20710,24511,9448,5190,59859,1642,1270,498,3410,63269
19-03-2018,15,20681,24510,9370,5276,59837,1702,1268,483,3453,63290
19-03-2018,16,20480,24567,9403,5438,59889,1714,1258,434,3406,63295
19-03-2018,17,20990,24670,9620,5617,60897,1733,1340,403,3476,64373
19-03-2018,18,21715,24695,9955,5486,61851,1790,1384,435,3609,65460
19-03-2018,19,20928,24614,10027,5836,61404,1770,1345,389,3504,64908
19-03-2018,20,19606,23941,9934,5828,59310,1727,1258,396,3381,62691
19-03-2018,21,18689,22753,9877,5550,56870,1705,884,461,3050,59920
19-03-2018,22,17584,21589,9737,5333,54244,1701,806,391,2898,57142
19-03-2018,23,15422,20190,9514,5446,50572,1685,786,353,2824,53396
20-03-2018,0,14975,18879,9348,5190,48391,1678,684,414,2776,51167
20-03-2018,1,14131,18646,9376,4607,46760,1683,681,409,2773,49533
20-03-2018,2,14140,18537,9372,4708,46757,1683,679,419,2781,49538
20-03-2018,3,14218,18519,9337,4693,46769,1671,675,417,2763,49532
20-03-2018,4,14543,19172,9457,5019,48190,1675,854,383,2912,51102
20-03-2018,5,16411,20330,9807,5038,51585,1652,1090,353,3095,54680
20-03-2018,6,19288,22413,10146,5040,56889,1581,1221,341,3143,60032
20-03-2018,7,21779,23441,10338,5128,60686,1620,1238,323,3181,63867
20-03-2018,8,21955,23541,10216,5646,61359,1728,1256,361,3345,64704
20-03-2018,9,20633,22901,10136,5989,59661,1626,1184,431,3241,62902
20-03-2018,10,19971,22380,9923,5729,58004,1607,1175,397,3179,61183
20-03-2018,11,19441,21932,9829,5612,56813,1590,1178,326,3094,59907
20-03-2018,12,18920,21438,9675,5375,55408,1569,1179,348,3096,58504
20-03-2018,13,18652,20904,9616,5082,54256,1615,1172,385,3172,57428
20-03-2018,14,18975,21094,9582,4813,54463,1622,1162,424,3208,57671
20-03-2018,15,19248,20961,9693,4637,54540,1659,1167,447,3273,57813
20-03-2018,16,19767,21325,9677,4343,55112,1640,1204,497,3341,58453
20-03-2018,17,20799,22100,9860,4205,56963,1727,1192,537,3456,60419
20-03-2018,18,21806,22591,10194,4112,58704,1833,1193,721,3747,62451
20-03-2018,19,22109,23192,10101,4277,59679,1872,1314,702,3888,63567
20-03-2018,20,21075,22909,10222,3992,58198,1818,1181,563,3562,61760
20-03-2018,21,20229,22718,10181,3695,56822,1826,780,461,3067,59889
20-03-2018,22,18336,21475,9964,3726,53503,1777,695,499,2971,56474
20-03-2018,23,16912,20531,9904,3251,50597,1811,684,488,2983,53580
21-03-2018,0,16325,19736,9887,3522,49472,1832,614,499,2945,52417
21-03-2018,1,16181,19251,9963,3413,48808,1836,610,488,2934,51742
21-03-2018,2,15918,19194,9962,3432,48505,1823,608,466,2897,51402
21-03-2018,3,15877,19196,10095,3550,48718,1812,608,492,2912,51630
21-03-2018,4,16506,19881,10280,3713,50381,1795,610,452,2857,53238
21-03-2018,5,17827,21319,10389,4347,53883,1779,856,454,3089,56972
21-03-2018,6,20005,23364,10899,4835,59103,1745,1088,436,3269,62372
21-03-2018,7,21753,24330,11300,5125,62510,1780,1184,429,3393,65903
21-03-2018,8,21824,24009,11173,5212,62219,1877,1261,603,3741,65960
21-03-2018,9,21398,23443,11007,5266,61115,1748,1181,605,3534,64649
21-03-2018,10,20897,23008,10675,5538,60118,1760,1177,415,3352,63470
21-03-2018,11,20460,22856,10197,5767,59279,1792,1164,378,3334,62613
21-03-2018,12,19993,22320,9988,5992,58293,1770,1177,395,3342,61635
21-03-2018,13,19448,21980,9801,6178,57407,1706,1194,412,3312,60719
21-03-2018,14,19381,21768,9714,6040,56903,1696,1092,431,3219,60122
21-03-2018,15,19863,21688,9737,5969,57255,1728,1102,474,3304,60559
21-03-2018,16,20099,21999,9837,5828,57765,1735,1096,446,3277,61042
21-03-2018,17,20972,22472,9872,5870,59187,1748,1099,419,3266,62453
21-03-2018,18,21274,23030,10073,5917,60294,1815,1103,441,3359,63653
21-03-2018,19,20523,22882,9965,5915,59286,1833,1095,417,3345,62631
21-03-2018,20,18946,22300,9613,5974,56833,1834,967,424,3225,60058
21-03-2018,21,17986,21521,9325,5640,54471,1832,710,450,2992,57463
21-03-2018,22,16060,20880,8896,5417,51253,1796,613,477,2886,54139
21-03-2018,23,14510,19264,8528,5329,47630,1741,601,493,2835,50465
22-03-2018,0,14295,18242,8386,4777,45700,1770,568,498,2836,48536
22-03-2018,1,14205,18055,8329,4627,45218,1792,566,492,2850,48068
22-03-2018,2,13865,17860,8231,4508,44464,1789,565,465,2819,47283
22-03-2018,3,13917,17865,8263,4512,44558,1795,560,447,2802,47360
22-03-2018,4,13961,18579,8387,4221,45147,1799,563,446,2808,47955
22-03-2018,5,14855,19956,8575,3963,47350,1804,711,456,2971,50321
22-03-2018,6,16995,21753,9030,3961,51739,1810,794,461,3065,54804
22-03-2018,7,19651,22540,9396,4127,55715,1796,1052,518,3366,59081
22-03-2018,8,20795,22562,9487,4402,57245,1801,1155,533,3489,60734
22-03-2018,9,20386,22551,9467,4221,56627,1806,1158,569,3533,60160
22-03-2018,10,19776,22362,9505,4092,55736,1799,1168,474,3441,59177
22-03-2018,11,19242,21922,9484,3878,54528,1811,1163,498,3472,58000
22-03-2018,12,18883,21652,9593,3762,53891,1847,1174,508,3529,57420
22-03-2018,13,18781,21552,9706,3767,53806,1808,1258,500,3566,57372
22-03-2018,14,19473,21818,9925,3787,55003,1818,1255,456,3529,58532
22-03-2018,15,20123,21883,9976,4119,56101,1843,1251,415,3509,59610
22-03-2018,16,20387,22244,10036,4014,56683,1780,1242,391,3413,60096
22-03-2018,17,20583,22472,10098,3999,57152,1801,1318,428,3547,60699
22-03-2018,18,21267,22556,10323,4069,58214,1769,1448,597,3814,62028
22-03-2018,19,21681,22577,10213,4231,58703,1840,1248,474,3562,62265
22-03-2018,20,21100,22056,10014,4096,57268,1820,1059,358,3237,60505
22-03-2018,21,20504,21550,9809,3718,55581,1771,965,357,3093,58674
22-03-2018,22,19476,20402,9498,3464,52840,1758,899,342,2999,55839
22-03-2018,23,18651,18962,9249,3301,50164,1777,672,332,2781,52945
23-03-2018,0,17653,17189,9070,3207,47118,1784,698,368,2850,49968
23-03-2018,1,17317,16535,8927,3160,45939,1777,692,351,2820,48759
23-03-2018,2,17348,16361,8916,3261,45885,1756,690,359,2805,48690
23-03-2018,3,17131,16598,8978,3359,46065,1766,690,350,2806,48871
23-03-2018,4,17414,17508,9281,3503,47706,1758,778,277,2813,50519
23-03-2018,5,19567,18885,9861,3780,52092,1736,918,273,2927,55019
23-03-2018,6,21645,20626,10313,4174,56757,1699,1150,357,3206,59963
23-03-2018,7,22916,22157,10309,4539,59921,1670,1320,487,3477,63398
23-03-2018,8,23041,22407,9989,4525,59961,1650,1323,492,3465,63426
23-03-2018,9,23285,22558,9668,4662,60174,1663,1336,485,3484,63658
23-03-2018,10,23079,22592,9552,5053,60278,1653,1322,481,3456,63734
23-03-2018,11,22811,22602,9535,5101,60048,1641,1244,414,3299,63347
23-03-2018,12,22295,22249,9509,5135,59189,1641,1205,283,3129,62318
23-03-2018,13,21915,21889,9296,5163,58265,1596,1155,293,3044,61309
23-03-2018,14,21454,21769,9113,5052,57389,1555,1145,275,2975,60364
23-03-2018,15,21117,21801,9028,4991,56938,1539,1143,271,2953,59891
23-03-2018,16,21081,21941,9057,4940,57020,1534,1141,264,2939,59959
23-03-2018,17,21483,22187,9270,5136,58076,1600,1127,265,2992,61068
23-03-2018,18,22082,22404,9683,5168,59337,1661,1130,364,3155,62492
23-03-2018,19,21337,22434,9482,5089,58341,1635,1019,351,3005,61346
23-03-2018,20,19624,22006,9022,5004,55657,1617,903,297,2817,58474
23-03-2018,21,18106,21452,8914,4831,53303,1608,922,288,2818,56121
23-03-2018,22,17030,20726,8708,4510,50976,1632,793,280,2705,53681
23-03-2018,23,15975,19474,8649,4432,48530,1662,556,278,2496,51026
24-03-2018,0,15136,17803,8744,4225,45909,1381,510,321,2212,48121
24-03-2018,1,13525,17624,8816,4313,44279,1382,510,280,2172,46451
24-03-2018,2,12610,17483,8896,4259,43249,1397,511,286,2194,45443
24-03-2018,3,12291,17413,8879,4271,42856,1406,512,288,2206,45062
24-03-2018,4,12495,17477,8847,4257,43077,1415,514,302,2231,45308
24-03-2018,5,12709,18189,8950,4255,44105,1425,520,311,2256,46361
24-03-2018,6,13136,18246,9185,4192,44759,1391,566,322,2279,47038
24-03-2018,7,15461,18959,9425,4249,48094,1400,592,355,2347,50441
24-03-2018,8,17266,19734,9612,4217,50830,1432,801,372,2605,53435
24-03-2018,9,17284,19664,9473,4287,50709,1452,816,297,2565,53274
24-03-2018,10,16527,19594,9289,4254,49662,1468,815,307,2590,52252
24-03-2018,11,16201,19560,9137,4360,49259,1461,830,326,2617,51876
24-03-2018,12,15503,19382,9064,4323,48272,1515,890,349,2754,51026
24-03-2018,13,14736,19390,9089,4132,47347,1518,897,370,2785,50132
24-03-2018,14,14427,19366,9085,3775,46654,1537,897,359,2793,49447
24-03-2018,15,15170,19598,9146,3553,47467,1556,893,340,2789,50256
24-03-2018,16,16347,20032,9339,3762,49480,1585,891,329,2805,52285
24-03-2018,17,17897,20848,9333,4040,52120,1708,978,330,3016,55136
24-03-2018,18,19527,21089,9459,4008,54082,1723,981,316,3020,57102
24-03-2018,19,19354,21243,9399,3980,53976,1765,972,328,3065,57041
24-03-2018,20,17633,20817,9033,3932,51414,1767,960,345,3072,54486
24-03-2018,21,16505,20165,8839,3938,49447,1765,824,370,2959,52406
24-03-2018,22,15112,19260,8422,3761,46555,1748,676,392,2816,49371
24-03-2018,23,13066,18381,8201,3349,42997,1703,525,409,2637,45634
25-03-2018,0,12601,16861,8133,3311,40905,1555,487,380,2422,43327
25-03-2018,1,12415,16614,8164,2965,40160,1528,491,384,2403,42563
25-03-2018,2,,,,,,1397,,,,
25-03-2018,3,12537,16725,8255,2663,40180,1512,495,373,2380,42560
25-03-2018,4,12360,16669,8263,2715,40008,1509,493,362,2364,42372
25-03-2018,5,12646,16884,8250,2667,40446,1470,499,374,2343,42789
25-03-2018,6,12592,16989,8391,2909,40881,1437,584,379,2400,43281
25-03-2018,7,13059,17785,8532,2955,42332,1419,622,391,2432,44764
25-03-2018,8,14031,17986,8429,3105,43551,1405,617,391,2413,45964
25-03-2018,9,15317,18263,8494,3263,45335,1458,691,373,2522,47857
25-03-2018,10,15467,18902,8470,3399,46238,1511,709,361,2581,48819
25-03-2018,11,14935,18684,8482,3394,45497,1534,711,391,2636,48133
25-03-2018,12,14579,18509,8470,3124,44682,1539,792,415,2746,47428
25-03-2018,13,14393,18332,8482,3045,44252,1546,800,414,2760,47012
25-03-2018,14,13631,18266,8454,3111,43464,1557,785,404,2746,46210
25-03-2018,15,12976,18170,8510,3030,42687,1557,858,371,2786,45473
25-03-2018,16,13010,18312,8535,2867,42724,1542,936,324,2802,45526
25-03-2018,17,13732,18590,8613,2948,43886,1540,976,291,2807,46693
25-03-2018,18,15268,19836,8889,3305,47298,1526,1002,295,2823,50121
25-03-2018,19,17521,20359,9648,3624,51153,1496,1071,295,2862,54015
25-03-2018,20,17778,20812,9946,3800,52336,1432,1095,298,2825,55161
25-03-2018,21,17006,20425,9812,3723,50966,1404,1093,313,2810,53776
25-03-2018,22,15683,19751,9467,3597,48498,1387,1089,322,2798,51296
25-03-2018,23,14207,18543,9233,3496,45479,1363,692,300,2355,47834
26-03-2018,0,13798,17248,9173,3005,43225,1551,477,323,2351,45576
26-03-2018,1,13096,17014,9173,2782,42065,1543,474,339,2356,44421
26-03-2018,2,12215,16885,9048,2929,41077,1540,472,337,2349,43426
26-03-2018,3,11982,16885,9020,3064,40953,1585,472,304,2361,43314
26-03-2018,4,12849,17621,9160,3171,42801,1616,471,334,2421,45222
26-03-2018,5,15489,19096,9529,3407,47521,1718,489,389,2596,50117
26-03-2018,6,19371,21592,10083,4070,55116,1722,709,358,2789,57905
26-03-2018,7,21259,22652,10390,4351,58653,1727,1109,333,3169,61822
26-03-2018,8,22484,23684,10283,4632,61083,1720,1319,537,3576,64659
26-03-2018,9,22657,23691,10061,4762,61171,1730,1348,525,3603,64774
26-03-2018,10,22390,23790,9825,4790,60794,1729,1352,502,3583,64377
26-03-2018,11,21960,23377,9757,5042,60137,1727,1372,492,3591,63728
26-03-2018,12,21592,22804,9712,4874,58982,1674,1268,309,3251,62233
26-03-2018,13,21184,22011,9586,4782,57564,1642,1160,344,3146,60710
26-03-2018,14,21308,21864,9607,4779,57558,1645,1025,364,3034,60592
26-03-2018,15,20631,21763,9534,4682,56610,1499,1040,364,2903,59513
26-03-2018,16,19855,21705,9369,4538,55467,1609,1015,354,2978,58445
26-03-2018,17,20551,21741,9442,4508,56242,1608,1045,367,3020,59262
26-03-2018,18,21245,22065,9676,4424,57409,1575,1248,356,3179,60588
26-03-2018,19,22081,22406,10129,4229,58846,1566,1241,438,3245,62091
26-03-2018,20,21820,22678,9976,4139,58614,1606,940,469,3015,61629
26-03-2018,21,20958,21796,9908,4012,56675,1629,724,432,2785,59460
26-03-2018,22,19560,21006,9581,3835,53981,1542,725,379,2646,56627
26-03-2018,23,18103,19671,9252,3781,50807,1514,633,383,2530,53337
27-03-2018,0,17262,18191,9158,3752,48364,1524,589,416,2529,50893
27-03-2018,1,15461,17845,8940,3617,45864,1526,593,414,2533,48397
27-03-2018,2,14896,17831,8961,3541,45229,1482,595,308,2385,47614
27-03-2018,3,14439,18302,8903,3468,45114,1479,593,331,2403,47517
27-03-2018,4,15016,19117,8984,3464,46582,1479,595,339,2413,48995
27-03-2018,5,17715,20517,9506,3666,51403,1494,692,378,2564,53967
27-03-2018,6,21503,23112,10045,4165,58825,1574,883,423,2880,61705
27-03-2018,7,23304,23431,10356,4759,61850,1539,1337,593,3469,65319
27-03-2018,8,23258,23521,10150,5058,61986,1546,1515,779,3840,65826
27-03-2018,9,23199,23281,9984,4872,61337,1557,1501,590,3648,64985
27-03-2018,10,22882,22988,9843,4798,60513,1559,1357,585,3501,64014
27-03-2018,11,22506,22511,9576,4725,59319,1535,1335,510,3380,62699
27-03-2018,12,21732,21799,9543,4604,57678,1555,1244,549,3348,61026
27-03-2018,13,20778,21407,9346,4741,56271,1553,1248,541,3342,59613
27-03-2018,14,20415,21265,9270,4631,55581,1562,1250,333,3145,58726
27-03-2018,15,19947,21191,9201,4805,55144,1544,1242,325,3111,58255
27-03-2018,16,19563,21403,9208,4863,55037,1460,1191,321,2972,58009
27-03-2018,17,19939,21472,9314,4757,55482,1529,1192,313,3034,58516
27-03-2018,18,20214,21799,9545,5030,56588,1523,1233,294,3050,59638
27-03-2018,19,20640,22197,9689,4996,57521,1525,1193,307,3025,60546
27-03-2018,20,20142,22361,9767,5343,57614,1555,1012,326,2893,60507
27-03-2018,21,18293,21684,9748,5231,54956,1583,709,334,2626,57582
27-03-2018,22,16478,20780,9358,5161,51779,1591,625,326,2542,54321
27-03-2018,23,15309,19295,8962,5121,48688,1600,601,318,2519,51207
28-03-2018,0,14959,17595,8783,5065,46403,1602,713,328,2643,49046
28-03-2018,1,15058,17059,8768,5065,45951,1598,703,319,2620,48571
28-03-2018,2,14983,16962,8785,5456,46186,1586,708,318,2612,48798
28-03-2018,3,15156,16931,8765,5550,46401,1578,712,295,2585,48986
28-03-2018,4,15347,17639,8941,5960,47888,1567,707,311,2585,50473
28-03-2018,5,16727,19321,9112,6224,51385,1546,762,246,2554,53939
28-03-2018,6,19061,21489,9657,6319,56525,1573,1107,350,3030,59555
28-03-2018,7,20864,23100,10059,5968,59992,1579,1226,519,3324,63316
28-03-2018,8,21465,23332,9982,5690,60469,1593,1444,512,3549,64018
28-03-2018,9,21207,23169,9745,5983,60105,1524,1484,511,3519,63624
28-03-2018,10,20572,22694,9443,6108,58817,1516,1382,309,3207,62024
28-03-2018,11,19785,21993,9237,6411,57427,1532,1333,302,3167,60594
28-03-2018,12,18649,21547,9200,6438,55833,1558,1263,301,3122,58955
28-03-2018,13,18047,21251,9073,6476,54847,1625,1245,300,3170,58017
28-03-2018,14,17613,21151,9033,6535,54334,1615,1156,298,3069,57403
28-03-2018,15,17073,20958,8976,6580,53588,1561,1127,290,2978,56566
28-03-2018,16,16826,20796,8893,6515,53029,1527,1127,277,2931,55960
28-03-2018,17,17027,20743,8946,6331,53048,1524,1109,269,2902,55950
28-03-2018,18,17261,20835,9264,6366,53727,1509,1069,285,2863,56590
28-03-2018,19,18448,20971,9380,6326,55126,1560,1170,350,3080,58206
28-03-2018,20,18664,20680,9253,6468,55065,1618,1114,389,3121,58186
28-03-2018,21,16769,19673,9082,6483,52008,1604,710,401,2715,54723
28-03-2018,22,15471,18746,8814,6092,49123,1600,721,351,2672,51795
28-03-2018,23,14394,17896,8840,5733,46862,1602,721,375,2698,49560
29-03-2018,0,13803,17339,8906,5570,45619,1604,721,424,2749,48368
29-03-2018,1,13388,17390,8872,5551,45199,1596,727,455,2778,47977
29-03-2018,2,13115,17427,8963,5604,45110,1570,715,490,2775,47885
29-03-2018,3,13198,17573,9030,5517,45319,1568,726,465,2759,48078
29-03-2018,4,13594,18207,9134,5530,46465,1565,748,463,2776,49241
29-03-2018,5,14666,19979,9266,5671,49581,1573,803,507,2883,52464
29-03-2018,6,16255,21891,9630,6059,53835,1601,1121,509,3231,57066
29-03-2018,7,18994,23189,9947,6310,58440,1603,1200,579,3382,61822
29-03-2018,8,19723,23523,9923,6422,59592,1606,1278,559,3443,63035
29-03-2018,9,19251,23484,9701,6725,59161,1615,1256,599,3470,62631
29-03-2018,10,18082,23106,9322,6643,57153,1621,1299,569,3489,60642
29-03-2018,11,17163,22573,9093,6411,55240,1593,1316,645,3554,58794
29-03-2018,12,16421,22292,9092,5998,53804,1573,1074,687,3334,57138
29-03-2018,13,15671,21887,9020,5661,52241,1534,1045,714,3293,55534
29-03-2018,14,15198,21599,9021,5463,51282,1528,961,715,3204,54486
29-03-2018,15,14927,21307,8987,5412,50634,1534,1040,693,3267,53901
29-03-2018,16,15514,21196,9123,5133,50965,1533,1045,679,3257,54222
29-03-2018,17,16828,21704,9221,5422,53175,1547,1099,651,3297,56472
29-03-2018,18,17669,22237,9330,5206,54442,1567,1222,640,3429,57871
29-03-2018,19,18607,22526,9465,4923,55522,1595,1230,614,3439,58961
29-03-2018,20,18409,22373,9558,4745,55086,1611,1135,608,3354,58440
29-03-2018,21,17564,21767,9477,4438,53245,1608,959,613,3180,56425
29-03-2018,22,17270,20843,9219,4194,51525,1612,849,563,3024,54549
29-03-2018,23,15590,19018,8986,3781,47375,1614,839,505,2958,50333
30-03-2018,0,14604,17516,9042,3459,44620,1286,661,488,2435,47055
30-03-2018,1,13819,17255,8884,3521,43479,1231,648,449,2328,45807
30-03-2018,2,13217,17180,8860,3602,42860,1231,654,425,2310,45170
30-03-2018,3,13274,17265,8876,3707,43124,1159,657,416,2232,45356
30-03-2018,4,13637,17766,8899,3557,43860,1161,676,407,2244,46104
30-03-2018,5,14725,18326,8884,3685,45621,1171,666,402,2239,47860
30-03-2018,6,16072,19923,9039,3656,48690,1174,851,407,2432,51122
30-03-2018,7,17617,21217,9341,3917,52092,1175,1075,479,2729,54821
30-03-2018,8,18677,21654,9231,4039,53602,1170,1441,389,3000,56602
30-03-2018,9,18441,21448,8998,4081,52969,1177,1451,408,3036,56005
30-03-2018,10,17678,21163,8902,4195,51937,1192,1346,427,2965,54902
30-03-2018,11,17127,20501,8689,4313,50631,1216,1355,364,2935,53566
30-03-2018,12,16272,19965,8627,4257,49120,1293,1359,394,3046,52166
30-03-2018,13,15490,19500,8486,4299,47774,1297,1385,331,3013,50787
30-03-2018,14,15462,19049,8263,4280,47054,1305,1303,333,2941,49995
30-03-2018,15,15308,19079,8236,4148,46771,1292,1273,308,2873,49644
30-03-2018,16,15384,19080,8211,4203,46878,1273,1185,305,2763,49641
30-03-2018,17,15617,19291,8275,4420,47606,1288,1166,284,2738,50344
30-03-2018,18,15829,19373,8477,4534,48213,1276,1108,292,2676,50889
30-03-2018,19,16396,19479,8798,4530,49204,1265,1051,318,2634,51838
30-03-2018,20,16542,19495,8963,4543,49543,1252,890,323,2465,52008
30-03-2018,21,16264,18889,8943,4508,48603,1224,727,333,2284,50887
30-03-2018,22,15295,18078,8885,4484,46742,1196,654,316,2166,48908
30-03-2018,23,13976,17241,8705,4516,44439,1205,632,304,2141,46580
31-03-2018,0,13468,16414,8783,4667,43334,1024,538,236,1798,45132
31-03-2018,1,13554,15696,8804,4451,42506,992,538,208,1738,44244
31-03-2018,2,13567,15689,8769,4184,42210,980,537,195,1712,43922
31-03-2018,3,13779,15650,8840,4078,42347,996,541,186,1723,44070
31-03-2018,4,14056,15807,8870,4018,42749,993,678,184,1855,44604
31-03-2018,5,14149,16232,8842,4577,43801,1002,687,205,1894,45695
31-03-2018,6,13879,17427,8919,4917,45143,1000,912,198,2110,47253
31-03-2018,7,14509,18092,9013,5137,46752,1005,988,236,2229,48981
31-03-2018,8,15507,18882,8780,5551,48720,999,1106,273,2378,51098
31-03-2018,9,15725,19044,8633,5951,49354,995,1144,282,2421,51775
31-03-2018,10,15505,19065,8432,5894,48895,997,1148,296,2441,51336
31-03-2018,11,14784,18768,8335,5653,47540,996,1090,306,2392,49932
31-03-2018,12,14507,18516,8333,5411,46769,999,859,307,2165,48934
31-03-2018,13,14138,18294,8297,5139,45868,1012,847,313,2172,48040
31-03-2018,14,13631,18217,8211,4781,44841,1040,772,320,2132,46973
31-03-2018,15,13282,18180,8153,4578,44194,1040,758,353,2151,46345
31-03-2018,16,13115,18154,8110,4478,43858,1132,766,378,2276,46134
31-03-2018,17,13300,18425,8060,4646,44432,1264,774,424,2462,46894
31-03-2018,18,13906,18709,8153,4864,45633,1241,695,492,2428,48061
31-03-2018,19,14929,18888,8381,4640,46840,1239,787,548,2574,49414
31-03-2018,20,15214,18970,8535,4370,47089,1196,772,563,2531,49620
31-03-2018,21,14633,18930,8580,4174,46317,1242,549,587,2378,48695
31-03-2018,22,14058,18261,8530,4000,44850,1248,535,586,2369,47219
31-03-2018,23,13508,16944,8553,3826,42831,1197,549,519,2265,45096
01-04-2018,0,13559,16185,8413,3366,41522,1122,536,516,2174,43696
01-04-2018,1,13212,16156,8256,3244,40868,1108,542,547,2197,43065
01-04-2018,2,13028,15816,8270,3175,40289,1147,542,582,2271,42560
01-04-2018,3,13173,15835,8288,3138,40435,1133,542,583,2258,42693
01-04-2018,4,13285,15965,8289,3247,40787,1155,592,605,2352,43139
01-04-2018,5,13245,16450,8269,3464,41428,1137,621,605,2363,43791
01-04-2018,6,13519,17016,8253,3535,42322,1150,830,612,2592,44914
01-04-2018,7,13585,18003,8241,3629,43458,1126,972,635,2733,46191
01-04-2018,8,14501,18846,8196,3872,45416,1173,830,705,2708,48124
01-04-2018,9,14466,19090,8127,4342,46024,1129,823,711,2663,48687
01-04-2018,10,14130,19233,8052,4868,46285,1130,826,697,2653,48938
01-04-2018,11,13671,19055,8046,4987,45761,1106,788,664,2558,48319
01-04-2018,12,13171,18714,8047,5008,44939,1065,784,670,2519,47458
01-04-2018,13,12671,18418,8048,5045,44184,1029,796,649,2474,46658
01-04-2018,14,12207,18166,8015,5145,43534,1021,797,616,2434,45968
01-04-2018,15,11810,17904,7895,4750,42361,1122,817,540,2479,44840
01-04-2018,16,11908,17847,7853,4654,42264,1233,812,520,2565,44829
01-04-2018,17,12285,18001,7905,4796,42987,1146,813,474,2433,45420
01-04-2018,18,12872,18555,7944,4725,44096,1111,888,437,2436,46532
01-04-2018,19,13869,18670,8160,4292,44991,1195,943,410,2548,47539
01-04-2018,20,14850,19002,8322,3888,46063,1222,790,371,2383,48446
01-04-2018,21,14614,19026,8408,3606,45654,1185,557,313,2055,47709
01-04-2018,22,14103,18059,8429,3647,44238,1164,517,284,1965,46203
01-04-2018,23,13439,17212,8265,3443,42360,1242,463,261,1966,44326
02-04-2018,0,13011,16664,8164,3886,41727,1340,370,245,1955,43682
02-04-2018,1,12707,16573,8185,3732,41198,1344,361,227,1932,43130
02-04-2018,2,12630,16375,8218,3658,40881,1363,358,219,1940,42821
02-04-2018,3,12551,16909,8190,3271,40922,1371,355,230,1956,42878
02-04-2018,4,12783,17308,8187,3348,41626,1461,360,281,2102,43728
02-04-2018,5,13343,17755,8343,3520,42961,1460,378,410,2248,45209
02-04-2018,6,14049,18598,8602,3434,44683,1445,615,480,2540,47223
02-04-2018,7,14293,19302,8948,3514,46058,1449,786,555,2790,48848
02-04-2018,8,15054,19611,8925,3590,47180,1461,918,620,2999,50179
02-04-2018,9,15437,20044,8921,3894,48296,1423,940,676,3039,51335
02-04-2018,10,15281,20118,8886,4172,48457,1425,956,701,3082,51539
02-04-2018,11,14780,19825,8764,4033,47402,1531,983,708,3222,50624
02-04-2018,12,14209,19249,8881,3946,46285,1374,994,714,3082,49367
02-04-2018,13,13491,19066,8937,3852,45346,1391,967,708,3066,48412
02-04-2018,14,12850,18864,9013,3666,44393,1407,969,712,3088,47481
02-04-2018,15,12526,18816,8934,3465,43741,1411,982,701,3094,46835
02-04-2018,16,12942,18917,8992,3184,44035,1383,1117,686,3186,47221
02-04-2018,17,13725,19180,9054,3031,44991,1342,1206,667,3215,48206
02-04-2018,18,14276,19583,9143,2971,45971,1334,1196,628,3158,49129
02-04-2018,19,15078,19732,9263,3003,47074,1409,1190,571,3170,50244
02-04-2018,20,15741,19710,9293,3005,47750,1451,1165,536,3152,50902
02-04-2018,21,15306,19525,9248,2927,47006,1357,941,523,2821,49827
02-04-2018,22,13935,19050,9109,3131,45224,1324,784,529,2637,47861
02-04-2018,23,12965,17988,8952,3317,43224,1309,781,514,2604,45828
03-04-2018,0,12724,16652,8780,3560,41715,1277,556,472,2305,44020
03-04-2018,1,12305,16474,8841,3538,41158,1339,552,434,2325,43483
03-04-2018,2,12234,16416,8852,3671,41173,1350,547,380,2277,43450
03-04-2018,3,12267,16477,8919,3984,41647,1330,545,364,2239,43886
03-04-2018,4,12628,17388,8988,3999,43004,1345,545,364,2254,45258
03-04-2018,5,14315,18481,9212,4390,46398,1413,573,344,2330,48728
03-04-2018,6,16846,20847,9521,5169,52384,1408,926,321,2655,55039
03-04-2018,7,19355,22180,9819,5508,56863,1376,1121,319,2816,59679
03-04-2018,8,20060,22933,9794,5645,58432,1385,1286,309,2980,61412
03-04-2018,9,20078,23176,9904,5345,58502,1380,1420,312,3112,61614
03-04-2018,10,19704,23005,9978,4735,57421,1359,1597,321,3277,60698
03-04-2018,11,19326,22008,9881,4745,55961,1314,1549,334,3197,59158
03-04-2018,12,18783,21289,9779,4478,54329,1295,1527,332,3154,57483
03-04-2018,13,18510,20755,9739,4371,53374,1323,1446,346,3115,56489
03-04-2018,14,18296,20830,9518,4369,53013,1350,1156,322,2828,55841
03-04-2018,15,18167,20600,9320,4265,52351,1349,1168,340,2857,55208
03-04-2018,16,18615,20631,9399,4399,53044,1300,1253,389,2942,55986
03-04-2018,17,19789,20802,9486,4717,54795,1252,1266,454,2972,57767
03-04-2018,18,20608,21181,9786,4991,56567,1231,1159,486,2876,59443
03-04-2018,19,20646,21481,9948,5042,57117,1234,1245,453,2932,60049
03-04-2018,20,20083,21144,9720,4847,55796,1242,1141,399,2782,58578
03-04-2018,21,18503,20639,9469,4613,53224,1268,878,362,2508,55732
03-04-2018,22,16199,19204,9187,4320,48910,1287,828,338,2453,51363
03-04-2018,23,14120,17954,8760,4312,45147,1279,626,325,2230,47377
04-04-2018,0,14018,16605,8578,3788,42989,1285,689,319,2293,45282
04-04-2018,1,13352,16432,8454,3965,42203,1314,729,309,2352,44555
04-04-2018,2,13267,16453,8398,3800,41918,1326,692,287,2305,44223
04-04-2018,3,13366,16689,8432,3376,41864,1337,693,271,2301,44165
04-04-2018,4,13289,17553,8449,3501,42792,1342,694,264,2300,45092
04-04-2018,5,14004,18949,8715,3722,45392,1353,704,273,2330,47722
04-04-2018,6,16773,20960,9147,4629,51509,1365,1211,293,2869,54378
04-04-2018,7,19315,22636,9479,5157,56586,1371,1393,347,3111,59697
04-04-2018,8,19768,23069,9436,5455,57730,1368,1487,561,3416,61146
04-04-2018,9,19809,22766,9318,5196,57090,1350,1481,559,3390,60480
04-04-2018,10,19720,23025,9080,4923,56748,1364,1416,383,3163,59911
04-04-2018,11,19086,22733,8851,4733,55404,1382,1447,540,3369,58773
04-04-2018,12,18566,22248,8828,4339,53982,1397,1368,527,3292,57274
04-04-2018,13,18795,22245,8904,3956,53900,1416,1321,578,3315,57215
04-04-2018,14,18253,21887,8894,3771,52805,1391,1317,450,3158,55963
04-04-2018,15,17797,21515,8954,3584,51852,1391,1219,447,3057,54909
04-04-2018,16,17510,21303,9206,3632,51651,1455,1201,566,3222,54873
04-04-2018,17,17474,21046,9354,3629,51503,1483,1206,559,3248,54751
04-04-2018,18,18012,20934,9709,3548,52204,1472,1204,583,3259,55463
04-04-2018,19,18249,20842,9862,3399,52353,1475,1281,601,3357,55710
04-04-2018,20,18806,20654,9675,3514,52650,1490,1223,442,3155,55805
04-04-2018,21,17767,20041,9497,3669,50974,1470,977,410,2857,53831
04-04-2018,22,15703,18978,8993,3753,47426,1455,789,388,2632,50058
04-04-2018,23,13905,17138,8566,3583,43194,1374,702,374,2450,45644
05-04-2018,0,13026,15472,8211,3404,40114,1373,598,368,2339,42453
05-04-2018,1,12716,15100,8050,3189,39054,1360,594,365,2319,41373
05-04-2018,2,12358,15079,7837,3295,38569,1354,593,370,2317,40886
05-04-2018,3,12242,15180,7718,3480,38620,1376,595,384,2355,40975
05-04-2018,4,12301,16226,7733,3362,39623,1402,601,399,2402,42025
05-04-2018,5,13745,17066,7969,3812,42592,1441,660,403,2504,45096
05-04-2018,6,16652,18737,8201,3994,47583,1495,953,481,2929,50512
05-04-2018,7,18991,20135,8727,4082,51936,1567,1224,461,3252,55188
05-04-2018,8,19841,20885,8792,4012,53532,1569,1242,394,3205,56737
05-04-2018,9,19879,21041,8788,4046,53755,1584,1236,346,3166,56921
05-04-2018,10,19818,20995,8740,4095,53648,1619,1330,333,3282,56930
05-04-2018,11,19373,20851,8676,4154,53054,1664,1366,342,3372,56426
05-04-2018,12,18579,20613,8595,4508,52295,1681,1350,336,3367,55662
05-04-2018,13,18179,20582,8490,4707,51957,1710,1266,338,3314,55271
05-04-2018,14,17453,20386,8445,4865,51148,1706,1173,335,3214,54362
05-04-2018,15,17134,20325,8411,5352,51222,1720,1156,352,3228,54450
05-04-2018,16,17066,20431,8412,5929,51840,1681,1093,302,3076,54916
05-04-2018,17,16781,20561,8448,6407,52197,1700,1084,289,3073,55270
05-04-2018,18,16942,20560,8445,6293,52241,1707,1070,283,3060,55301
05-04-2018,19,17320,20633,8535,6771,53260,1724,1064,280,3068,56328
05-04-2018,20,16982,20462,8473,7055,52973,1741,1075,294,3110,56083
05-04-2018,21,15944,20295,8410,6801,51451,1730,920,300,2950,54401
05-04-2018,22,14410,19506,8161,6640,48719,1706,744,252,2702,51421
05-04-2018,23,13401,18116,8057,6097,45671,1717,740,238,2695,48366
06-04-2018,0,13133,17185,7878,5894,44090,1409,883,282,2574,46664
06-04-2018,1,12893,17093,7816,5850,43652,1303,889,322,2514,46166
06-04-2018,2,12371,17091,7703,5673,42838,1296,903,467,2666,45504
06-04-2018,3,12444,17114,7651,5584,42793,1321,914,544,2779,45572
06-04-2018,4,12479,17784,7637,5406,43304,1387,1017,613,3017,46321
06-04-2018,5,13140,19104,7844,5738,45826,1682,1073,616,3371,49197
06-04-2018,6,15959,21634,8273,5986,51853,1763,1260,692,3715,55568
06-04-2018,7,18513,23338,8828,6031,56710,1817,1281,710,3808,60518
06-04-2018,8,19134,23806,9007,5718,57665,1866,1284,723,3873,61538
06-04-2018,9,18111,23805,8771,5562,56250,1911,1304,747,3962,60212
06-04-2018,10,17230,23342,8513,5312,54396,1906,1400,760,4066,58462
06-04-2018,11,16058,23020,8335,4952,52365,1857,1388,762,4007,56372
06-04-2018,12,15070,22581,8292,4625,50568,1785,1310,762,3857,54425
06-04-2018,13,14242,22548,8274,4474,49539,1745,1312,758,3815,53354
06-04-2018,14,13430,21970,8376,4019,47797,1724,1301,750,3775,51572
06-04-2018,15,13518,21096,8492,3663,46771,1693,1310,752,3755,50526
06-04-2018,16,13728,21608,8709,3371,47416,1708,1318,740,3766,51182
06-04-2018,17,14329,21432,8866,3027,47655,1714,1301,720,3735,51390
06-04-2018,18,14552,21223,8891,2798,47466,1721,1262,693,3676,51142
06-04-2018,19,15669,20885,8978,2720,48253,1734,1307,639,3680,51933
06-04-2018,20,15998,20640,8843,2923,48404,1785,1283,589,3657,52061
06-04-2018,21,14716,19472,8751,3172,46112,1746,1189,550,3485,49597
06-04-2018,22,13594,18605,8725,3478,44403,1732,1089,457,3278,47681
06-04-2018,23,12366,17439,8506,3287,41599,1732,1090,358,3180,44779
07-04-2018,0,12285,15828,8483,3528,40123,1557,959,350,2866,42989
07-04-2018,1,11541,15500,8308,3837,39188,1550,918,320,2788,41976
07-04-2018,2,11358,15454,8289,3848,38950,1547,908,301,2756,41706
07-04-2018,3,11428,15520,8267,3832,39048,1499,907,280,2686,41734
07-04-2018,4,11535,15894,8277,4150,39856,1471,907,273,2651,42507
07-04-2018,5,11600,16188,8150,4328,40265,1452,907,265,2624,42889
07-04-2018,6,11439,16557,7927,4316,40239,1415,1015,269,2699,42938
07-04-2018,7,12551,17378,7862,4323,42114,1398,1148,277,2823,44937
07-04-2018,8,14569,18017,7833,4254,44674,1412,1237,286,2935,47609
07-04-2018,9,15231,18394,8007,4219,45850,1347,1236,293,2876,48726
07-04-2018,10,15307,18329,8050,4109,45797,1341,1232,312,2885,48682
07-04-2018,11,15063,18140,8156,3891,45250,1307,1231,326,2864,48114
07-04-2018,12,14565,17969,8171,3858,44564,1288,1215,331,2834,47398
07-04-2018,13,14235,17637,8143,3738,43754,1322,1215,340,2877,46631
07-04-2018,14,13235,17360,8003,3507,42105,1353,1290,351,2994,45099
07-04-2018,15,12959,17319,7996,3399,41673,1301,1269,368,2938,44611
07-04-2018,16,12966,17603,8007,3073,41650,1271,1262,365,2898,44548
07-04-2018,17,13526,18126,8135,3317,43104,1253,1222,387,2862,45966
07-04-2018,18,14132,18287,8109,3301,43828,1311,1225,384,2920,46748
07-04-2018,19,15014,18396,8341,3304,45053,1370,1229,452,3051,48104
07-04-2018,20,14923,18237,8247,3275,44682,1389,1173,549,3111,47793
07-04-2018,21,13384,17706,7986,3313,42389,1402,1123,572,3097,45486
07-04-2018,22,12467,16982,7820,3086,40355,1423,1129,596,3148,43503
07-04-2018,23,12205,16049,7664,2933,38853,1453,1096,522,3071,41924
08-04-2018,0,11940,15424,7594,2520,37479,1366,1021,521,2908,40387
08-04-2018,1,11557,15121,7417,2288,36384,1358,1036,503,2897,39281
08-04-2018,2,11531,14933,7344,2293,36101,1354,1047,471,2872,38973
08-04-2018,3,11821,14835,7238,2359,36253,1354,1048,424,2826,39079
08-04-2018,4,12036,14764,7234,2524,36556,1350,1103,437,2890,39446
08-04-2018,5,12153,14848,7272,2655,36929,1324,1102,425,2851,39780
08-04-2018,6,11899,15396,7275,2793,37364,1300,1186,459,2945,40309
08-04-2018,7,12495,15990,7283,2790,38558,1293,1269,453,3015,41573
08-04-2018,8,13758,16262,7212,2918,40150,1288,1258,392,2938,43088
08-04-2018,9,14635,16400,7225,2851,41109,1297,1253,352,2902,44011
08-04-2018,10,15026,16470,7153,2952,41601,1288,1252,328,2868,44469
08-04-2018,11,14728,16423,7167,2950,41269,1257,1250,330,2837,44106
08-04-2018,12,14002,16409,7148,2978,40539,1209,1234,341,2784,43323
08-04-2018,13,13456,16406,7223,2845,39929,1200,1212,357,2769,42698
08-04-2018,14,13034,16314,7226,2911,39488,1157,1217,365,2739,42227
08-04-2018,15,12907,16351,7166,3044,39470,1160,1228,325,2713,42183
08-04-2018,16,12948,16687,7187,2949,39771,1180,1231,318,2729,42500
08-04-2018,17,13341,17266,7230,2914,40751,1210,1239,354,2803,43554
08-04-2018,18,14028,17634,7230,2911,41802,1213,1238,353,2804,44606
08-04-2018,19,15667,17997,7562,2915,44140,1298,1237,383,2918,47058
08-04-2018,20,16884,18539,7742,3069,46235,1346,1256,471,3073,49308
08-04-2018,21,16140,18358,7806,2984,45288,1351,1132,548,3031,48319
08-04-2018,22,14289,17689,7583,2730,42290,1328,1041,558,2927,45217
08-04-2018,23,12219,16622,7488,2299,38629,1323,1060,528,2911,41540
09-04-2018,0,10903,15668,7475,2029,36077,1371,1009,560,2940,39017
09-04-2018,1,10598,15430,7470,2093,35591,1470,1012,541,3023,38614
09-04-2018,2,10527,15353,7533,2023,35437,1500,1009,509,3018,38455
09-04-2018,3,10790,15542,7567,1878,35776,1506,1021,427,2954,38730
09-04-2018,4,11566,16197,7546,1911,37220,1512,1073,428,3013,40233
09-04-2018,5,13983,17179,7621,2114,40897,1644,1142,440,3226,44123
09-04-2018,6,17705,19829,8015,2828,48377,1659,1230,477,3366,51743
09-04-2018,7,19851,21556,8328,3206,52941,1596,1417,557,3570,56511
09-04-2018,8,20216,21507,8587,3409,53718,1597,1452,609,3658,57376
09-04-2018,9,20149,21129,8614,3446,53338,1593,1404,418,3415,56753
09-04-2018,10,19656,20907,8515,3514,52593,1546,1416,343,3305,55898
09-04-2018,11,19721,20997,8524,3541,52784,1515,1410,343,3268,56052
09-04-2018,12,19141,20654,8573,3408,51776,1564,1359,350,3273,55049
09-04-2018,13,18364,20227,8428,3401,50419,1560,1306,394,3260,53679
09-04-2018,14,17949,19911,8450,3431,49742,1565,1248,446,3259,53001
09-04-2018,15,17658,19790,8458,3488,49394,1558,1222,419,3199,52593
09-04-2018,16,18505,19905,8583,3504,50498,1550,1218,454,3222,53720
09-04-2018,17,19038,20480,8687,3645,51850,1545,1222,369,3136,54986
09-04-2018,18,19443,20675,8843,3704,52664,1540,1221,326,3087,55751
09-04-2018,19,19211,20774,8905,3696,52587,1535,1228,279,3042,55629
09-04-2018,20,18612,20655,8817,3605,51691,1560,1160,265,2985,54676
09-04-2018,21,16787,19999,8825,3179,48791,1565,1074,265,2904,51695
09-04-2018,22,14760,18989,8488,3185,45424,1530,1051,274,2855,48279
09-04-2018,23,12471,17445,8158,2859,40934,1525,1067,271,2863,43797
10-04-2018,0,11297,16007,8049,3017,38371,1425,1017,266,2708,41079
10-04-2018,1,10660,15863,8023,2974,37520,1470,991,286,2747,40267
10-04-2018,2,10513,15888,8046,3254,37703,1505,997,312,2814,40517
10-04-2018,3,10989,15686,7967,3505,38146,1510,1009,321,2840,40986
10-04-2018,4,11313,16180,7954,3890,39338,1520,1052,294,2866,42204
10-04-2018,5,13289,17265,8178,4438,43172,1550,1045,300,2895,46067
10-04-2018,6,16550,19225,8522,5317,49612,1560,1247,310,3117,52729
10-04-2018,7,19203,21155,8654,5717,54729,1545,1473,323,3341,58070
10-04-2018,8,19585,21604,8439,5192,54821,1530,1473,321,3324,58145
10-04-2018,9,18593,21264,8232,4750,52842,1503,1496,313,3312,56154
10-04-2018,10,17704,20687,8030,4767,51187,1444,1501,345,3290,54477
10-04-2018,11,16740,20318,7853,4556,49467,1410,1561,397,3368,52835
10-04-2018,12,16863,19940,7759,5433,49995,1418,1562,412,3392,53387
10-04-2018,13,16007,19715,7708,5694,49125,1440,1560,426,3426,52551
10-04-2018,14,15320,19201,7549,5417,47487,1427,1566,462,3455,50942
10-04-2018,15,15140,19317,7519,5410,47387,1423,1530,505,3458,50845
10-04-2018,16,15085,19340,7506,5755,47686,1414,1500,538,3452,51138
10-04-2018,17,15283,19575,7423,5997,48277,1409,1509,575,3493,51770
10-04-2018,18,15572,20015,7527,6050,49164,1400,1342,601,3343,52507
10-04-2018,19,15993,20122,7732,5860,49708,1409,1253,621,3283,52991
10-04-2018,20,15751,20091,7785,5660,49288,1450,1274,649,3373,52661
10-04-2018,21,15003,19819,7786,5337,47946,1444,1246,657,3347,51293
10-04-2018,22,13786,18682,7537,5038,45044,1425,1202,638,3265,48309
10-04-2018,23,11940,17896,7429,4865,42130,1422,1122,667,3211,45341
11-04-2018,0,11525,16891,7390,4895,40702,1380,1111,643,3134,43836
11-04-2018,1,11136,16598,7411,4914,40058,1374,1107,640,3121,43179
11-04-2018,2,11069,16588,7409,5060,40127,1418,1103,623,3144,43271
11-04-2018,3,11414,16617,7494,4905,40431,1424,1108,605,3137,43568
11-04-2018,4,11648,17123,7703,4944,41418,1447,1108,622,3177,44595
11-04-2018,5,13219,18140,7882,5027,44268,1480,1105,608,3193,47461
11-04-2018,6,15706,20221,8218,5344,49491,1471,1291,643,3405,52896
11-04-2018,7,18155,21999,8446,5785,54385,1474,1503,662,3639,58024
11-04-2018,8,18936,22266,8298,5826,55327,1435,1565,652,3652,58979
11-04-2018,9,17540,21940,8189,5949,53618,1379,1570,681,3630,57248
11-04-2018,10,16507,21090,7931,6063,51593,1366,1561,721,3648,55241
11-04-2018,11,15745,20299,7778,5851,49675,1385,1566,719,3670,53345
11-04-2018,12,15823,19892,7748,5541,49002,1379,1563,697,3639,52641
11-04-2018,13,15339,19650,7741,5703,48432,1410,1561,674,3645,52077
11-04-2018,14,14907,19284,7658,5574,47423,1407,1545,688,3640,51063
11-04-2018,15,14489,19155,7602,5457,46703,1409,1540,677,3626,50329
11-04-2018,16,14483,19146,7656,5553,46838,1403,1522,656,3581,50419
11-04-2018,17,14891,19254,7669,5628,47442,1405,1520,639,3564,51006
11-04-2018,18,15151,19505,7627,5349,47631,1397,1526,587,3510,51141
11-04-2018,19,15840,19595,7648,5192,48276,1408,1539,568,3515,51791
11-04-2018,20,16331,19563,7712,5166,48774,1458,1465,592,3515,52289
11-04-2018,21,15998,18908,7662,5282,47851,1459,1466,636,3561,51412
11-04-2018,22,14381,17690,7400,4938,44408,1425,1468,607,3500,47908
11-04-2018,23,13014,16855,7189,4613,41671,1422,1155,582,3159,44830
12-04-2018,0,13067,15802,7191,4361,40421,1282,1218,553,3053,43474
12-04-2018,1,12897,15701,7367,4359,40323,1273,1245,538,3056,43379
12-04-2018,2,12821,15727,7364,4466,40378,1268,1239,528,3035,43413
12-04-2018,3,12917,15692,7381,4557,40548,1260,1237,533,3030,43578
12-04-2018,4,13220,16204,7446,4534,41404,1242,1238,539,3019,44423
12-04-2018,5,13801,17438,7554,4746,43539,1369,1494,573,3436,46975
12-04-2018,6,16491,19751,7859,5265,49366,1470,1506,635,3611,52977
12-04-2018,7,18641,21002,8192,5392,53226,1463,1550,579,3592,56818
12-04-2018,8,18933,21347,8266,5727,54273,1463,1583,452,3498,57771
12-04-2018,9,17805,21147,8085,5638,52675,1463,1558,432,3453,56128
12-04-2018,10,16943,20653,7676,5723,50996,1470,1550,488,3508,54504
12-04-2018,11,16215,20221,7507,5851,49795,1429,1530,576,3535,53330
12-04-2018,12,15567,19812,7428,5919,48727,1418,1482,595,3495,52222
12-04-2018,13,15110,19330,7297,5999,47736,1436,1498,560,3494,51230
12-04-2018,14,14249,19023,7193,6065,46530,1436,1461,560,3457,49987
12-04-2018,15,14560,19277,7285,6075,47197,1441,1505,567,3513,50710
12-04-2018,16,14697,19468,7202,6037,47405,1437,1495,556,3488,50893
12-04-2018,17,14797,19507,7227,6054,47584,1443,1419,574,3436,51020
12-04-2018,18,14780,19554,7282,6090,47705,1416,1426,552,3394,51099
12-04-2018,19,15225,19573,7363,5550,47711,1397,1445,552,3394,51105
12-04-2018,20,14974,19465,7472,5598,47508,1439,1448,597,3484,50992
12-04-2018,21,14185,18739,7370,5982,46276,1479,1455,620,3554,49830
12-04-2018,22,13263,17966,7153,5853,44237,1466,1445,555,3466,47703
12-04-2018,23,11688,17371,6963,5515,41538,1457,1238,564,3259,44797
13-04-2018,0,11088,16381,7039,5365,39874,1200,1321,502,3023,42897
13-04-2018,1,10830,16208,7077,5267,39383,1179,1339,513,3031,42414
13-04-2018,2,10814,16066,7065,5207,39153,1177,1341,547,3065,42218
13-04-2018,3,11066,15917,7108,5347,39438,1163,1353,533,3049,42487
13-04-2018,4,11528,16362,7302,5481,40673,1159,1346,511,3016,43689
13-04-2018,5,13053,17191,7492,5719,43456,1373,1472,557,3402,46858
13-04-2018,6,16193,19281,7721,6126,49323,1480,1595,565,3640,52963
13-04-2018,7,18395,21008,8013,6362,53779,1478,1566,526,3570,57349
13-04-2018,8,18180,21097,8006,6358,53641,1477,1528,481,3486,57127
13-04-2018,9,17425,20753,7782,6378,52339,1476,1570,491,3537,55876
13-04-2018,10,17241,20436,7567,6392,51636,1478,1548,540,3566,55202
13-04-2018,11,16350,20110,7472,6316,50247,1472,1533,564,3569,53816
13-04-2018,12,15425,20010,7483,6299,49216,1482,1526,599,3607,52823
13-04-2018,13,14596,20210,7414,6130,48350,1518,1495,607,3620,51970
13-04-2018,14,13350,19936,7410,5982,46680,1501,1551,634,3686,50366
13-04-2018,15,12968,19448,7287,5866,45571,1481,1456,648,3585,49156
13-04-2018,16,13502,19388,7244,5640,45775,1465,1461,653,3579,49354
13-04-2018,17,14365,19247,7186,5262,46061,1490,1456,619,3565,49626
13-04-2018,18,14644,19514,7205,4972,46337,1493,1455,590,3538,49875
13-04-2018,19,14597,19654,7260,4705,46215,1467,1464,613,3544,49759
13-04-2018,20,13721,19479,7334,4570,45103,1529,1437,644,3610,48713
13-04-2018,21,12944,19324,7348,4466,44082,1445,1507,648,3600,47682
13-04-2018,22,11824,18606,7476,4216,42122,1326,1425,610,3361,45483
13-04-2018,23,10373,17603,7401,3731,39109,1273,1301,604,3178,42287
14-04-2018,0,10291,16670,7476,3041,37477,1043,1248,544,2835,40312
14-04-2018,1,10138,16317,7343,2801,36599,979,1244,519,2742,39341
14-04-2018,2,10065,16053,7308,2714,36141,981,1238,513,2732,38873
14-04-2018,3,9991,15938,7301,2802,36032,1029,1264,513,2806,38838
14-04-2018,4,10059,15852,7289,2718,35920,1002,1338,494,2834,38754
14-04-2018,5,10488,15850,7405,2620,36363,1000,1337,478,2815,39178
14-04-2018,6,10956,15959,7413,2713,37042,947,1423,537,2907,39949
14-04-2018,7,12338,15644,7271,3091,38344,942,1468,556,2966,41310
14-04-2018,8,15090,15884,7242,3204,41419,915,1456,507,2878,44297
14-04-2018,9,15605,15977,7186,3310,42078,917,1482,489,2888,44966
14-04-2018,10,15372,15611,7048,3341,41373,920,1486,342,2748,44121
14-04-2018,11,14859,15287,7046,3220,40413,908,1463,426,2797,43210
14-04-2018,12,14218,14972,7083,3019,39293,849,1449,504,2802,42095
14-04-2018,13,13474,14718,7035,2982,38209,855,1430,383,2668,40877
14-04-2018,14,13070,14759,7040,2780,37651,859,1427,365,2651,40302
14-04-2018,15,13169,14604,6883,2609,37266,855,1381,338,2574,39840
14-04-2018,16,13416,14669,6810,2560,37456,844,1412,330,2586,40042
14-04-2018,17,14086,15261,6804,2325,38477,822,1409,307,2538,41015
14-04-2018,18,15387,15949,6953,2878,41167,821,1385,328,2534,43701
14-04-2018,19,16314,16608,7147,2987,43057,792,1390,388,2570,45627
14-04-2018,20,16355,16685,7304,2883,43228,785,1382,383,2550,45778
14-04-2018,21,16482,16361,7186,2984,43012,825,1329,305,2459,45471
14-04-2018,22,15922,15590,6947,2661,41120,860,1306,279,2445,43565
14-04-2018,23,14617,14530,6628,2633,38408,897,1311,271,2479,40887
15-04-2018,0,12755,14330,6373,2134,35594,891,1288,253,2432,38026
15-04-2018,1,11388,14037,6330,2020,33774,898,1288,232,2418,36192
15-04-2018,2,10396,13961,6299,2029,32684,894,1307,218,2419,35103
15-04-2018,3,10297,13846,6286,2054,32482,885,1294,215,2394,34876
15-04-2018,4,10513,13829,6286,1975,32601,880,1287,222,2389,34990
15-04-2018,5,10468,13804,6307,2052,32631,897,1404,247,2548,35179
15-04-2018,6,10511,13853,6439,2160,32963,896,1518,309,2723,35686
15-04-2018,7,12250,13600,6522,2282,34653,878,1532,325,2735,37388
15-04-2018,8,13756,13782,6574,2343,36456,878,1538,299,2715,39171
15-04-2018,9,15102,14112,6451,2399,38065,890,1247,298,2435,40500
15-04-2018,10,16124,14413,6601,2446,39585,871,1180,294,2345,41930
15-04-2018,11,15725,14427,6542,2541,39236,857,1142,304,2303,41539
15-04-2018,12,15116,14428,6596,2555,38696,869,1105,294,2268,40964
15-04-2018,13,14255,14473,6591,2579,37898,876,1228,276,2380,40278
15-04-2018,14,13981,14444,6556,2444,37425,877,1217,279,2373,39798
15-04-2018,15,13865,14444,6522,2559,37389,868,1265,284,2417,39806
15-04-2018,16,13969,14782,6551,2714,38018,857,1200,276,2333,40351
15-04-2018,17,14497,15060,6570,2659,38787,839,1217,272,2328,41115
15-04-2018,18,15135,15667,6648,2556,40006,847,1279,305,2431,42437
15-04-2018,19,16837,16381,6969,2833,43020,839,1277,347,2463,45483
15-04-2018,20,17746,16660,7125,2912,44443,856,1295,423,2574,47017
15-04-2018,21,16988,16116,6899,2634,42637,879,1304,459,2642,45279
15-04-2018,22,15442,15211,6672,2361,39685,901,1257,487,2645,42330
15-04-2018,23,12669,14236,6526,2156,35589,984,1106,438,2528,38117
16-04-2018,0,11382,13639,6446,2035,33503,1012,888,429,2329,35832
16-04-2018,1,10998,13534,6482,1928,32942,1051,877,413,2341,35283
16-04-2018,2,10898,13491,6427,1857,32674,1088,848,399,2335,35009
16-04-2018,3,10991,13563,6433,1968,32954,1139,822,403,2364,35318
16-04-2018,4,11398,14357,6431,1927,34113,1187,793,396,2376,36489
16-04-2018,5,13013,15244,6751,2089,37098,1328,939,378,2645,39743
16-04-2018,6,17060,16659,7193,2902,43815,1439,1291,401,3131,46946
16-04-2018,7,20510,17893,7430,3376,49209,1506,1364,584,3454,52663
16-04-2018,8,21170,18771,7505,3690,51136,1541,1443,561,3545,54681
16-04-2018,9,20833,18458,7666,3515,50472,1504,1488,535,3527,53999
16-04-2018,10,20211,18567,7425,3659,49863,1478,1384,508,3370,53233
16-04-2018,11,19941,18089,7452,3740,49222,1479,1370,486,3335,52557
16-04-2018,12,19674,17447,7395,3642,48159,1486,1352,461,3299,51458
16-04-2018,13,19747,16848,7332,3597,47525,1477,1365,274,3116,50641
16-04-2018,14,19510,16416,7225,3357,46507,1457,1372,268,3097,49604
16-04-2018,15,19460,16369,7216,3359,46406,1456,1287,256,2999,49405
16-04-2018,16,19428,16344,7275,3093,46140,1451,1238,250,2939,49079
16-04-2018,17,19498,17055,7372,3063,46989,1450,1172,249,2871,49860
16-04-2018,18,19464,17092,7428,2993,46977,1441,1172,253,2866,49843
16-04-2018,19,19570,17111,7479,2907,47067,1445,1166,475,3086,50153
16-04-2018,20,19901,17444,7548,2818,47712,1452,1137,367,2956,50668
16-04-2018,21,19083,17331,7415,2753,46582,1451,1143,310,2904,49486
16-04-2018,22,18513,15944,7218,2588,44263,1536,1098,231,2865,47128
16-04-2018,23,16777,14844,6680,2439,40741,1536,907,191,2634,43375
17-04-2018,0,14720,13204,6411,1974,36308,1538,1190,210,2938,39246
17-04-2018,1,13779,12810,6368,1897,34855,1538,1257,209,3004,37859
17-04-2018,2,12832,12842,6345,1919,33938,1536,1254,211,3001,36939
17-04-2018,3,12216,12976,6388,1872,33451,1535,1263,213,3011,36462
17-04-2018,4,12253,13583,6470,1760,34065,1537,1285,233,3055,37120
17-04-2018,5,13550,14662,6596,1848,36656,1537,1295,279,3111,39767
17-04-2018,6,17977,16437,7078,2391,43884,1541,1406,444,3391,47275
17-04-2018,7,20257,17661,7429,2605,47953,1531,1444,556,3531,51484
17-04-2018,8,20605,17748,7620,2726,48700,1532,1454,578,3564,52264
17-04-2018,9,20314,17723,7544,2932,48513,1537,1429,593,3559,52072
17-04-2018,10,19940,17458,7545,3004,47947,1551,1411,450,3412,51359
17-04-2018,11,19166,17290,7544,3234,47235,1554,1408,450,3412,50647
17-04-2018,12,18317,16928,7460,3254,45960,1560,1408,485,3453,49413
17-04-2018,13,17797,16675,7242,3568,45283,1566,1449,418,3433,48716
17-04-2018,14,16661,16547,7100,3476,43785,1562,1411,439,3412,47197
17-04-2018,15,16252,16482,7032,3529,43295,1565,1412,455,3432,46727
17-04-2018,16,17130,16542,7115,3371,44159,1576,1410,471,3457,47616
17-04-2018,17,18510,16870,7152,3404,45936,1562,1403,436,3401,49337
17-04-2018,18,19159,17284,7350,3457,47250,1559,1399,427,3385,50635
17-04-2018,19,19194,17573,7528,3340,47636,1579,1375,583,3537,51173
17-04-2018,20,18788,17531,7517,3283,47121,1594,1395,449,3438,50559
17-04-2018,21,18352,17205,7274,3368,46199,1597,1310,370,3277,49476
17-04-2018,22,16992,16049,6810,3562,43413,1621,1230,335,3186,46599
17-04-2018,23,14584,15093,6411,3502,39591,1601,1245,309,3155,42746
18-04-2018,0,13069,14006,6280,3308,36662,1602,1100,296,2998,39660
18-04-2018,1,12245,13771,6225,3277,35517,1596,1088,294,2978,38495
18-04-2018,2,11337,13857,6185,3470,34850,1575,1086,299,2960,37810
18-04-2018,3,10777,14048,6072,3766,34664,1594,1087,302,2983,37647
18-04-2018,4,10490,14557,6156,3533,34736,1634,1071,306,3011,37747
18-04-2018,5,11719,15782,6479,3454,37434,1714,1058,300,3072,40506
18-04-2018,6,16446,17679,6986,3808,44920,1708,1326,338,3372,48292
18-04-2018,7,19365,18529,7067,3877,48838,1676,1426,517,3619,52457
18-04-2018,8,19588,18843,7120,3959,49512,1682,1468,544,3694,53206
18-04-2018,9,19295,18714,7112,3640,48760,1643,1411,541,3595,52355
18-04-2018,10,18544,18316,7053,3554,47467,1634,1390,474,3498,50965
18-04-2018,11,17549,17909,6780,3554,45793,1601,1378,482,3461,49254
18-04-2018,12,17119,17707,6674,3475,44974,1578,1388,479,3445,48419
18-04-2018,13,16572,17590,6611,3636,44409,1567,1385,498,3450,47859
18-04-2018,14,15363,17399,6461,3696,42920,1555,1371,491,3417,46337
18-04-2018,15,15102,17556,6436,3154,42249,1536,1352,472,3360,45609
18-04-2018,16,15827,17596,6549,2865,42836,1525,1352,440,3317,46153
18-04-2018,17,16740,17783,6765,3205,44493,1530,1309,424,3263,47756
18-04-2018,18,18103,18416,6913,2922,46355,1577,1293,382,3252,49607
18-04-2018,19,18509,18739,6975,2555,46779,1573,1301,354,3228,50007
18-04-2018,20,17843,18302,7055,2324,45525,1580,1300,336,3216,48741
18-04-2018,21,17270,18188,6897,2199,44555,1587,1167,321,3075,47630
18-04-2018,22,16366,17205,6770,2070,42411,1589,1141,329,3059,45470
18-04-2018,23,12561,16322,6607,1489,36979,1596,1157,342,3095,40074
19-04-2018,0,11113,15462,6504,1115,34193,1600,1157,334,3091,37284
19-04-2018,1,10290,14997,6348,1009,32645,1610,1155,339,3104,35749
19-04-2018,2,10148,15126,6378,1046,32698,1606,1161,339,3106,35804
19-04-2018,3,10386,15183,6383,1032,32985,1619,1167,310,3096,36081
19-04-2018,4,10408,15500,6529,1009,33445,1629,1175,299,3103,36548
19-04-2018,5,11885,16476,6800,1114,36275,1656,1167,372,3195,39470
19-04-2018,6,16115,17960,7247,1775,43098,1634,1415,387,3436,46534
19-04-2018,7,19363,18685,7510,2008,47568,1622,1475,544,3641,51209
19-04-2018,8,19950,18865,7565,2206,48587,1620,1473,556,3649,52236
19-04-2018,9,19510,18157,7369,2472,47509,1604,1460,387,3451,50960
19-04-2018,10,18441,17483,7264,2750,45935,1592,1478,497,3567,49502
19-04-2018,11,18392,17108,7176,2939,45615,1554,1477,576,3607,49222
19-04-2018,12,17385,16485,7008,3077,43955,1557,1473,638,3668,47623
19-04-2018,13,16817,16361,6994,2994,43167,1565,1365,604,3534,46701
19-04-2018,14,15987,15989,6960,3128,42065,1569,1398,607,3574,45639
19-04-2018,15,16023,15987,6839,2839,41687,1585,1307,615,3507,45194
19-04-2018,16,16809,16015,6883,2951,42659,1613,1226,589,3428,46087
19-04-2018,17,18236,16127,6981,2998,44344,1629,1243,520,3392,47736
19-04-2018,18,18556,16735,7056,2931,45278,1613,1241,470,3324,48602
19-04-2018,19,18924,17023,7168,2855,45970,1577,1224,432,3233,49203
19-04-2018,20,18481,17132,7030,2805,45449,1599,1186,359,3144,48593
19-04-2018,21,17312,17214,6953,3118,44598,1598,1178,296,3072,47670
19-04-2018,22,15004,16368,6736,3277,41386,1585,1161,275,3021,44407
19-04-2018,23,11766,15752,6515,2776,36811,1567,1147,267,2981,39792
20-04-2018,0,11253,14929,6485,2514,35182,1339,1032,261,2632,37814
20-04-2018,1,10595,14725,6427,2454,34201,1297,1016,225,2538,36739
20-04-2018,2,10305,14549,6522,2431,33807,1291,1017,232,2540,36347
20-04-2018,3,10380,14716,6652,2435,34184,1294,1016,213,2523,36707
20-04-2018,4,10578,15292,6840,2443,35153,1293,1019,204,2516,37669
20-04-2018,5,11847,16504,7181,2549,38082,1442,1026,241,2709,40791
20-04-2018,6,15207,17977,7598,3246,44028,1477,1305,294,3076,47104
20-04-2018,7,17813,19004,7858,3601,48277,1483,1333,343,3159,51436
20-04-2018,8,18257,19256,7792,3706,49012,1501,1344,489,3334,52346
20-04-2018,9,18185,19358,7676,3937,49157,1487,1333,338,3158,52315
20-04-2018,10,17956,18980,7519,3988,48445,1475,1315,388,3178,51623
20-04-2018,11,17037,18725,7303,3822,46886,1496,1282,424,3202,50088
20-04-2018,12,15620,18178,7187,3706,44691,1477,1329,417,3223,47914
20-04-2018,13,14585,17996,7051,3295,42927,1490,1319,422,3231,46158
20-04-2018,14,13523,17819,6850,3353,41546,1495,1268,406,3169,44715
20-04-2018,15,12937,17697,6704,3596,40936,1556,1255,401,3212,44148
20-04-2018,16,13325,17847,6736,3687,41595,1579,1257,371,3207,44802
20-04-2018,17,14508,17940,6764,3874,43086,1596,1274,336,3206,46292
20-04-2018,18,15776,18418,6871,3825,44889,1588,1217,287,3092,47981
20-04-2018,19,15661,18624,6875,3608,44768,1566,1214,293,3073,47841
20-04-2018,20,14855,18312,6742,3511,43421,1480,1143,359,2982,46403
20-04-2018,21,14439,18172,6607,3498,42717,1471,1142,507,3120,45837
20-04-2018,22,13266,17699,6491,3155,40611,1433,1047,526,3006,43617
20-04-2018,23,11709,17027,6306,2870,37912,1347,1040,583,2970,40882
21-04-2018,0,11359,16182,6268,2656,36465,1048,1044,598,2690,39155
21-04-2018,1,10611,15634,6272,2531,35048,977,1049,605,2631,37679
21-04-2018,2,10385,15479,6378,2519,34760,957,1027,570,2554,37314
21-04-2018,3,10221,15396,6394,2386,34397,1006,1025,554,2585,36982
21-04-2018,4,10306,15403,6399,2345,34453,1017,1042,532,2591,37044
21-04-2018,5,10283,15287,6540,2319,34431,1030,1049,522,2601,37032
21-04-2018,6,10693,15736,6708,2319,35457,1136,1069,506,2711,38168
21-04-2018,7,12113,16192,6684,2219,37207,1145,1070,545,2760,39967
21-04-2018,8,13122,17265,6776,2338,39501,1174,1058,601,2833,42334
21-04-2018,9,12658,17336,6832,2481,39307,1169,1069,627,2865,42172
21-04-2018,10,12575,17248,6783,2826,39433,1147,1152,615,2914,42347
21-04-2018,11,12173,17071,6674,2938,38856,1144,1154,602,2900,41756
21-04-2018,12,11267,17443,6587,3088,38385,1163,1155,583,2901,41286
21-04-2018,13,10977,17200,6519,3246,37943,1120,1151,561,2832,40775
21-04-2018,14,10782,17031,6458,3204,37476,1084,1147,498,2729,40205
21-04-2018,15,10707,17053,6474,3105,37340,1107,1163,467,2737,40077
21-04-2018,16,10767,17037,6441,2993,37238,1083,1162,480,2725,39963
21-04-2018,17,11526,17314,6549,2833,38224,1113,1377,412,2902,41126
21-04-2018,18,13006,18137,6694,2800,40637,1079,1403,364,2846,43483
21-04-2018,19,14017,18610,6980,2459,42066,1114,1402,310,2826,44892
21-04-2018,20,14498,18478,7095,2250,42322,1129,1402,313,2844,45166
21-04-2018,21,14435,18401,7209,2203,42250,1088,1393,320,2801,45051
21-04-2018,22,13462,17604,7049,1993,40110,1081,1386,278,2745,42855
21-04-2018,23,12743,16307,6770,1730,37549,1069,1365,272,2706,40255
22-04-2018,0,11449,15089,6610,1502,34653,1069,838,279,2186,36839
22-04-2018,1,10297,14677,6413,1455,32844,1060,829,277,2166,35010
22-04-2018,2,9652,14463,6276,1403,31794,1039,825,253,2117,33911
22-04-2018,3,9829,14349,6291,1365,31834,1067,830,265,2162,33996
22-04-2018,4,10186,14199,6295,1275,31955,1065,829,249,2143,34098
22-04-2018,5,10460,13994,6366,1150,31969,1067,868,235,2170,34139
22-04-2018,6,11038,14285,6480,1160,32965,1039,873,256,2168,35133
22-04-2018,7,12680,14362,6617,1211,34871,1032,882,250,2164,37035
22-04-2018,8,13555,15506,6675,1331,37067,1043,889,315,2247,39314
22-04-2018,9,14142,15725,6772,1531,38170,1029,1005,299,2333,40503
22-04-2018,10,14307,15714,6771,1666,38457,1004,1167,330,2501,40958
22-04-2018,11,14350,15583,6722,1824,38479,990,1185,364,2539,41018
22-04-2018,12,13972,15486,6736,1844,38038,956,1185,418,2559,40597
22-04-2018,13,13683,15366,6685,1905,37637,929,1183,459,2571,40208
22-04-2018,14,13382,15216,6664,1948,37210,937,1181,463,2581,39791
22-04-2018,15,13616,15347,6479,2007,37447,952,1182,404,2538,39985
22-04-2018,16,14278,15572,6067,2100,38017,937,1160,369,2466,40483
22-04-2018,17,14783,15858,5957,2100,38699,989,1163,348,2500,41199
22-04-2018,18,14917,16044,6096,2152,39209,973,1166,332,2471,41680
22-04-2018,19,14839,16409,6137,2280,39665,966,1165,276,2407,42072
22-04-2018,20,15038,16547,6227,2484,40296,981,997,246,2224,42520
22-04-2018,21,14538,16664,6242,2763,40208,995,876,270,2141,42349
22-04-2018,22,13106,16346,6092,3056,38600,964,865,250,2079,40679
22-04-2018,23,12023,15247,5843,3134,36249,939,833,238,2010,38259
23-04-2018,0,10257,14783,5647,3238,,959,926,232,2117,
23-04-2018,1,9675,14765,5625,3010,33077,937,928,226,2091,35168
23-04-2018,2,10061,15159,5742,2640,33602,1005,933,260,2198,35800
23-04-2018,3,10675,15458,5912,2247,34291,1030,945,283,2258,36549
23-04-2018,4,10527,16039,6062,2176,34805,1142,955,284,2381,37186
23-04-2018,5,11095,16675,6397,2571,36738,1449,1006,302,2757,39495
23-04-2018,6,13923,18333,7010,3326,42592,1480,1101,384,2965,45557
23-04-2018,7,16565,19605,7244,4123,47537,1554,1231,538,3323,50860
23-04-2018,8,18201,19870,7299,4138,49508,1705,1246,491,3442,52950
23-04-2018,9,17524,19810,7183,4262,48777,1694,1233,497,3424,52201
23-04-2018,10,16914,20009,7233,4566,48722,1696,1208,516,3420,52142
23-04-2018,11,15652,20176,7361,5156,48345,1711,1131,531,3373,51718
23-04-2018,12,14645,19949,7455,5441,47491,1725,1114,546,3385,50876
23-04-2018,13,13972,19916,7219,5261,46369,1678,1101,565,3344,49713
23-04-2018,14,13578,19747,6819,5401,45544,1690,1107,407,3204,48748
23-04-2018,15,13426,19667,6686,5164,44944,1703,1110,381,3194,48138
23-04-2018,16,13381,19967,6705,5255,45310,1733,1104,520,3357,48667
23-04-2018,17,13805,19881,6621,5772,46081,1738,1108,522,3368,49449
23-04-2018,18,14637,20132,6607,5725,47102,1733,1127,514,3374,50476
23-04-2018,19,15202,20144,6731,5229,47307,1701,1162,476,3339,50646
23-04-2018,20,15039,19765,6792,4695,46292,1703,1193,463,3359,49651
23-04-2018,21,14683,19447,6982,4497,45609,1775,1035,408,3218,48827
23-04-2018,22,13740,18826,7023,4278,43867,1796,940,344,3080,46947
23-04-2018,23,12775,17260,6600,3978,40613,1778,929,245,2952,43565
24-04-2018,0,11709,16483,6444,3292,37928,1462,981,257,2700,40628
24-04-2018,1,11091,16313,6504,2901,36809,1368,990,235,2593,39402
24-04-2018,2,10583,16070,6560,2892,36105,1352,991,220,2563,38668
24-04-2018,3,10545,15962,6478,2965,35951,1303,990,207,2500,38451
24-04-2018,4,10588,16467,6494,2981,36530,1285,1043,254,2582,39112
24-04-2018,5,11340,17242,6663,3371,38616,1526,1136,319,2981,41597
24-04-2018,6,14030,18554,7059,3606,43249,1695,1176,358,3229,46478
24-04-2018,7,16160,19670,7295,4084,47209,1791,1206,544,3541,50750
24-04-2018,8,16309,19546,7604,4700,48158,1855,1234,560,3649,51807
24-04-2018,9,15980,19526,7689,4746,47940,1791,1096,670,3557,51497
24-04-2018,10,15227,19903,7561,4898,47590,1758,1103,746,3607,51197
24-04-2018,11,14991,19801,7498,5285,47577,1757,1096,724,3577,51154
24-04-2018,12,14554,19545,7480,5555,47133,1765,1098,670,3533,50666
24-04-2018,13,14606,19612,7422,5745,47384,1737,1084,650,3471,50855
24-04-2018,14,13804,19430,7195,5868,46296,1732,1073,549,3354,49650
24-04-2018,15,13642,19639,7112,5788,46182,1761,1075,550,3386,49568
24-04-2018,16,13832,19656,7141,5590,46220,1795,1194,430,3419,49639
24-04-2018,17,14322,19746,7097,5293,46458,1816,1208,352,3376,49834
24-04-2018,18,14786,20028,7098,5090,47002,1788,1214,406,3408,50410
24-04-2018,19,15596,20219,6929,4705,47449,1784,1229,389,3402,50851
24-04-2018,20,15368,20143,6874,4308,46694,1737,1146,461,3344,50038
24-04-2018,21,15327,20270,6776,3897,46270,1466,1122,559,3147,49417
24-04-2018,22,14561,19355,6634,3568,44118,1351,1053,586,2990,47108
24-04-2018,23,13249,18062,6391,3002,40705,1343,1042,614,2999,43704
25-04-2018,0,12662,16244,6182,2655,37742,1636,939,585,3160,40902
25-04-2018,1,11523,15826,6072,2268,35689,1675,809,552,3036,38725
25-04-2018,2,10910,15408,5957,2075,34350,1641,803,524,2968,37318
25-04-2018,3,11153,15628,5897,1785,34464,1618,800,516,2934,37398
25-04-2018,4,11495,16226,6089,1617,35426,1613,799,485,2897,38323
25-04-2018,5,12453,16978,6397,1630,37458,1754,859,465,3078,40536
25-04-2018,6,15452,18171,6743,1926,42293,1808,1012,627,3447,45740
25-04-2018,7,18113,18968,7028,2447,46557,1844,1174,625,3643,50200
25-04-2018,8,18524,18921,7150,2893,47489,1943,1189,714,3846,51335
25-04-2018,9,18268,18821,7118,3045,47253,1839,1194,718,3751,51004
25-04-2018,10,18040,18766,7087,3069,46962,1840,1188,640,3668,50630
25-04-2018,11,17440,18400,7069,3332,46241,1859,1180,597,3636,49877
25-04-2018,12,16531,18197,7028,3772,45529,1862,1179,579,3620,49149
25-04-2018,13,15776,18119,6986,3978,44862,1844,1214,581,3639,48501
25-04-2018,14,15033,17705,6569,3987,43294,1787,1261,514,3562,46856
25-04-2018,15,14804,17764,6558,3889,43015,1786,1245,403,3434,46449
25-04-2018,16,14474,18065,6600,4016,43155,1819,1220,411,3450,46605
25-04-2018,17,14659,18281,6738,3701,43379,1828,1165,428,3421,46800
25-04-2018,18,14672,18242,6866,3913,43694,1775,1068,418,3261,46955
25-04-2018,19,15338,17914,6871,4181,44304,1783,1128,506,3417,47721
25-04-2018,20,15944,17953,6651,3855,44405,1730,1067,618,3415,47820
25-04-2018,21,15678,17673,6442,3486,43279,1765,1016,491,3272,46551
25-04-2018,22,13969,17218,6267,2938,40394,1800,866,492,3158,43552
25-04-2018,23,11737,16734,6062,2758,37293,1611,808,536,2955,40248
26-04-2018,0,11079,16049,5791,2698,35618,1278,974,482,2734,38352
26-04-2018,1,10632,15992,5573,2519,34718,1247,979,401,2627,37345
26-04-2018,2,10548,15816,5517,2415,34296,1234,977,398,2609,36905
26-04-2018,3,10714,16020,5643,2310,34688,1289,978,363,2630,37318
26-04-2018,4,10734,16300,5901,2122,35057,1354,987,394,2735,37792
26-04-2018,5,11584,17317,6342,2113,37357,1670,984,410,3064,40421
26-04-2018,6,14752,18839,6753,2399,42744,1786,1075,468,3329,46073
26-04-2018,7,18051,19335,6951,2907,47245,1778,1202,671,3651,50896
26-04-2018,8,19147,19173,7007,3106,48434,1790,1248,709,3747,52181
26-04-2018,9,17981,18976,6975,3216,47148,1787,1172,694,3653,50801
26-04-2018,10,16899,18612,7063,3183,45757,1808,1085,704,3597,49354
26-04-2018,11,15945,18361,7024,3343,44673,1810,1092,716,3618,48291
26-04-2018,12,15324,18077,6905,3697,44003,1814,1100,758,3672,47675
26-04-2018,13,14668,18270,6838,3998,43775,1810,1141,760,3711,47486
26-04-2018,14,14310,18318,6527,4106,43261,1819,1094,594,3507,46768
26-04-2018,15,14113,18335,6394,4380,43220,1822,1096,569,3487,46707
26-04-2018,16,13781,18421,6580,4545,43327,1798,1194,528,3520,46847
26-04-2018,17,13607,18450,6622,4446,43125,1799,1193,659,3651,46776
26-04-2018,18,14772,18588,6726,4343,44431,1808,1111,604,3523,47954
26-04-2018,19,15893,18529,6808,4935,46167,1789,1045,554,3388,49555
26-04-2018,20,16116,18520,6432,4699,45767,1776,1020,370,3166,48933
26-04-2018,21,17120,18519,6318,4339,46296,1805,960,335,3100,49396
26-04-2018,22,15701,17988,6203,4097,43989,1762,938,314,3014,47003
26-04-2018,23,13045,17435,6163,3619,40262,1710,936,336,2982,43244
27-04-2018,0,11714,16522,6010,3503,37750,1389,931,364,2684,40434
27-04-2018,1,10865,16186,5873,3588,36512,1368,783,357,2508,39020
27-04-2018,2,10588,15822,5721,3468,35598,1361,731,374,2466,38064
27-04-2018,3,10990,15906,5797,3419,36112,1341,728,362,2431,38543
27-04-2018,4,11095,16389,6036,3294,36813,1383,771,347,2501,39314
27-04-2018,5,12299,17207,6343,3262,39113,1686,911,348,2945,42058
27-04-2018,6,16110,18736,6967,3600,45412,1778,1086,377,3241,48653
27-04-2018,7,18780,19813,7173,3541,49306,1765,1193,478,3436,52742
27-04-2018,8,19285,19733,7211,3725,49953,1782,1224,594,3600,53553
27-04-2018,9,19091,19683,7113,3800,49688,1795,1104,616,3515,53203
27-04-2018,10,18427,19477,6972,3691,48566,1803,1094,627,3524,52090
27-04-2018,11,16934,19145,6857,3607,46544,1815,1098,696,3609,50153
27-04-2018,12,15552,18845,6903,3247,44546,1844,1051,747,3642,48188
27-04-2018,13,14548,19007,6821,2936,43312,1846,1074,648,3568,46880
27-04-2018,14,14304,18984,6457,2863,42607,1817,1132,526,3475,46082
27-04-2018,15,14602,19005,6378,2657,42641,1770,1049,470,3289,45930
27-04-2018,16,15566,19249,6690,2482,43987,1756,1174,451,3381,47368
27-04-2018,17,16368,19418,6743,2325,44854,1750,1148,424,3322,48176
27-04-2018,18,16992,19506,6775,2288,45561,1743,1127,380,3250,48811
27-04-2018,19,17060,19351,6671,2206,45289,1775,1075,332,3182,48471
27-04-2018,20,16777,19200,6365,2041,44382,1730,1112,299,3141,47523
27-04-2018,21,17163,19256,6278,2036,44732,1709,951,262,2922,47654
27-04-2018,22,16703,18780,6391,1698,43571,1492,792,261,2545,46116
27-04-2018,23,14197,17726,6253,1114,39290,1313,738,253,2304,41594
28-04-2018,0,13061,16762,6115,1213,37150,978,689,264,1931,39081
28-04-2018,1,11188,16196,5935,1188,34506,917,686,306,1909,36415
28-04-2018,2,10849,16193,5901,1237,34180,904,687,321,1912,36092
28-04-2018,3,10809,16257,5968,1229,34263,899,685,341,1925,36188
28-04-2018,4,10708,16201,6003,1143,34055,889,690,355,1934,35989
28-04-2018,5,10740,16384,6022,1195,34342,847,693,348,1888,36230
28-04-2018,6,12230,16661,6214,1192,36297,878,687,362,1927,38224
28-04-2018,7,13959,17132,6475,1288,38855,899,823,351,2073,40928
28-04-2018,8,15113,17425,6725,1538,40800,950,972,384,2306,43106
28-04-2018,9,15652,17716,6881,1805,42055,938,986,342,2266,44321
28-04-2018,10,15572,17782,6900,1852,42106,949,986,325,2260,44366
28-04-2018,11,14993,17810,6965,1873,41642,964,991,277,2232,43874
28-04-2018,12,14215,17855,6839,1921,40830,973,1008,268,2249,43079
28-04-2018,13,13601,17708,6751,2025,40085,947,1020,274,2241,42326
28-04-2018,14,13158,17609,6340,2038,39146,868,941,220,2029,41175
28-04-2018,15,13232,17373,6227,2131,38964,869,930,232,2031,40995
28-04-2018,16,13654,17442,6386,2165,39650,924,938,268,2130,41780
28-04-2018,17,14891,17605,6406,2155,41057,895,932,284,2111,43168
28-04-2018,18,15910,17681,6589,2365,42547,883,934,313,2130,44677
28-04-2018,19,16468,17934,6520,2702,43625,887,929,370,2186,45811
28-04-2018,20,17035,17891,6530,2582,44038,894,861,408,2163,46201
28-04-2018,21,16690,17844,6698,2502,43735,874,872,398,2144,45879
28-04-2018,22,15744,17774,6670,2333,42522,821,861,374,2056,44578
28-04-2018,23,14313,17385,6543,1977,40219,794,787,316,1897,42116
29-04-2018,0,13376,16136,6321,1512,37345,783,679,299,1761,39106
29-04-2018,1,11569,15801,6207,1393,34970,780,681,301,1762,36732
29-04-2018,2,11328,15910,6269,1281,34789,788,686,287,1761,36550
29-04-2018,3,11014,15887,6255,1262,34418,786,687,258,1731,36149
29-04-2018,4,10921,15831,6218,1194,34165,771,775,244,1790,35955
29-04-2018,5,10546,15869,6190,1088,33693,782,778,236,1796,35489
29-04-2018,6,10968,16170,6157,1099,34394,779,780,256,1815,36209
29-04-2018,7,12124,16351,6090,1191,35758,804,783,265,1852,37610
29-04-2018,8,13613,16699,6203,1337,37853,851,910,280,2041,39894
29-04-2018,9,14254,16934,6277,1511,38977,831,1065,281,2177,41154
29-04-2018,10,14376,17211,6291,1628,39505,822,1067,304,2193,41698
29-04-2018,11,14309,17276,6292,1784,39661,827,1048,327,2202,41863
29-04-2018,12,14014,17338,6255,1886,39494,827,968,368,2163,41657
29-04-2018,13,13658,17354,6111,1900,39022,845,973,288,2106,41128
29-04-2018,14,13113,17304,5993,1903,38312,850,983,280,2113,40425
29-04-2018,15,12753,17246,6028,1860,37887,846,983,279,2108,39995
29-04-2018,16,12656,17197,6051,1849,37752,865,979,245,2089,39841
29-04-2018,17,13560,17382,6290,1777,39012,858,988,279,2125,41137
29-04-2018,18,13709,17242,6242,1827,39020,858,990,271,2119,41139
29-04-2018,19,13059,17539,6278,1874,38749,825,939,267,2031,40780
29-04-2018,20,13012,17598,6359,1867,38837,835,938,282,2055,40892
29-04-2018,21,13925,17743,6345,1922,39933,857,937,254,2048,41981
29-04-2018,22,13329,17603,6291,2081,39304,856,759,236,1851,41155
29-04-2018,23,11572,16855,6032,1970,36430,901,683,236,1820,38250
30-04-2018,0,10229,16188,5986,1997,34401,883,682,250,1815,36216
30-04-2018,1,9527,16109,5790,2157,33584,829,683,271,1783,35367
30-04-2018,2,9113,16223,5712,2444,33492,797,773,306,1876,35368
30-04-2018,3,9017,16364,5687,2578,33647,772,779,347,1898,35545
30-04-2018,4,9167,16289,5785,3003,34244,785,790,318,1893,36137
30-04-2018,5,10119,16841,6056,3380,36398,771,793,312,1876,38274
30-04-2018,6,12432,18515,6245,3809,41001,793,904,343,2040,43041
30-04-2018,7,13918,19752,6437,4272,44380,852,1005,354,2211,46591
30-04-2018,8,14532,19972,6458,4676,45637,915,1095,385,2395,48032
30-04-2018,9,13863,20042,6571,4826,45302,900,1125,346,2371,47673
30-04-2018,10,13928,19967,6327,4821,45043,911,1130,369,2410,47453
30-04-2018,11,13877,20046,6228,4935,45086,891,1085,380,2356,47442
30-04-2018,12,13296,19836,6272,4888,44293,916,1114,367,2397,46690
30-04-2018,13,12681,19742,6098,4773,43294,899,1032,352,2283,45577
30-04-2018,14,12598,19964,6160,4199,42922,901,1002,363,2266,45188
30-04-2018,15,12639,19756,6130,3602,42128,894,998,339,2231,44359
30-04-2018,16,12677,19755,6014,3509,41957,886,1000,347,2233,44190
30-04-2018,17,12711,19754,6215,3254,41934,895,1001,367,2263,44197
30-04-2018,18,12662,19889,6201,2837,41587,890,1002,376,2268,43855
30-04-2018,19,12412,20161,6277,2656,41508,895,902,448,2245,43753
30-04-2018,20,12197,19843,6281,2474,40795,929,836,479,2244,43039
30-04-2018,21,12162,19636,6308,2312,40417,937,835,501,2273,42690
30-04-2018,22,11789,18853,6293,2343,39278,928,759,388,2075,41353
30-04-2018,23,10980,17942,6275,2278,37474,973,697,268,1938,39412
01-05-2018,0,10911,17399,6193,2130,36632,875,679,314,1868,38500
01-05-2018,1,10395,17029,6136,1920,35480,824,690,368,1882,37362
01-05-2018,2,9679,16506,6132,1830,34148,791,695,324,1810,35958
01-05-2018,3,9576,16276,6132,1755,33738,778,696,308,1782,35520
01-05-2018,4,9678,15970,6068,1999,33716,803,691,318,1812,35528
01-05-2018,5,9820,16395,6109,2022,34347,794,533,310,1637,35984
01-05-2018,6,10969,17014,6197,2146,36327,786,795,275,1856,38183
01-05-2018,7,11748,18504,6414,2422,39089,855,803,249,1907,40996
01-05-2018,8,12623,18877,6519,2524,40543,892,786,256,1934,42477
01-05-2018,9,13801,18796,6675,2662,41936,909,810,304,2023,43959
01-05-2018,10,14003,18882,6805,2911,42602,873,821,308,2002,44604
01-05-2018,11,13858,19085,6880,3066,42888,853,817,300,1970,44858
01-05-2018,12,13788,19299,6850,3044,42982,876,807,251,1934,44916
01-05-2018,13,13185,19208,6858,3013,42263,883,887,243,2013,44276
01-05-2018,14,12591,19246,6950,3012,41797,861,902,237,2000,43797
01-05-2018,15,12305,19258,7154,3145,41862,836,955,254,2045,43907
01-05-2018,16,12262,19482,7160,3398,42302,810,952,238,2000,44302
01-05-2018,17,12497,19395,7179,3586,42657,773,939,223,1935,44592
01-05-2018,18,12487,19353,7191,3806,42836,801,924,223,1948,44784
01-05-2018,19,12313,19040,7097,3952,42403,825,1020,230,2075,44478
01-05-2018,20,11922,18913,7212,3835,41882,854,1037,255,2146,44028
01-05-2018,21,11741,18872,7267,3840,41720,843,1053,268,2164,43884
01-05-2018,22,11596,18522,7202,3894,41215,830,1035,261,2126,43341
01-05-2018,23,10855,17867,7178,3711,39611,827,940,343,2110,41721
02-05-2018,0,10530,16800,7059,3368,37757,787,702,363,1852,39609
02-05-2018,1,9503,16518,7117,3146,36284,768,689,366,1823,38107
02-05-2018,2,8865,16251,7061,2843,35021,751,705,323,1779,36800
02-05-2018,3,9080,16377,7080,2664,35204,770,747,271,1788,36992
02-05-2018,4,9717,16625,7204,2494,36040,846,755,300,1901,37941
02-05-2018,5,11750,17035,7284,2487,38556,853,851,335,2039,40595
02-05-2018,6,16009,18824,7465,2935,45234,905,1001,371,2277,47511
02-05-2018,7,18753,20086,7462,3151,49452,993,966,591,2550,52002
02-05-2018,8,19154,19998,7516,3457,50126,954,969,616,2539,52665
02-05-2018,9,18482,19787,7305,3799,49374,1011,844,640,2495,51869
02-05-2018,10,18085,19636,7133,4187,49042,1007,682,834,2523,51565
02-05-2018,11,17902,19317,7000,4603,48822,1017,730,752,2499,51321
02-05-2018,12,17316,18976,7000,4657,47948,983,855,611,2449,50397
02-05-2018,13,16057,18639,6879,4726,46301,956,1043,539,2538,48839
02-05-2018,14,15483,18625,6783,4609,45500,973,1035,513,2521,48021
02-05-2018,15,16033,18554,6773,3993,45353,960,1048,483,2491,47844
02-05-2018,16,16764,18632,6901,3882,46179,949,1047,368,2364,48543
02-05-2018,17,17393,18596,6824,3686,46499,929,1117,266,2312,48811
02-05-2018,18,17572,18430,6767,4025,46793,915,1078,374,2367,49160
02-05-2018,19,17448,18429,6726,3647,46249,901,1035,408,2344,48593
02-05-2018,20,17702,18454,6685,3299,46142,930,940,415,2285,48427
02-05-2018,21,17981,18635,6637,3302,46557,963,840,241,2044,48601
02-05-2018,22,16991,18320,6507,3626,45446,928,685,333,1946,47392
02-05-2018,23,14238,17631,6342,3760,41971,952,672,260,1884,43855
03-05-2018,0,12707,17303,6362,3637,40009,982,569,265,1816,41825
03-05-2018,1,11878,17081,6268,3418,38646,906,567,310,1783,40429
03-05-2018,2,11418,16999,6276,3066,37758,913,568,354,1835,39593
03-05-2018,3,10696,16906,6378,2795,36775,979,575,380,1934,38709
03-05-2018,4,11188,16922,6439,2597,37146,1060,663,414,2137,39283
03-05-2018,5,12289,17480,6591,2718,39078,1130,782,505,2417,41495
03-05-2018,6,15304,19166,6844,3223,44535,1243,939,560,2742,47277
03-05-2018,7,17690,20195,7097,3749,48731,1434,984,665,3083,51814
03-05-2018,8,18500,20212,7080,3888,49681,1466,1021,678,3165,52846
03-05-2018,9,18226,20276,7121,3649,49272,1435,795,685,2915,52187
03-05-2018,10,17814,20341,7017,3843,49016,1438,766,666,2870,51886
03-05-2018,11,17191,20154,6981,3896,48222,1447,757,655,2859,51081
03-05-2018,12,16778,20153,6974,4125,48030,1456,761,674,2891,50921
03-05-2018,13,16647,20119,7024,4687,48477,1449,773,620,2842,51319
03-05-2018,14,16086,19768,6939,4663,47456,1474,799,399,2672,50128
03-05-2018,15,15426,19504,6885,4499,46313,1465,984,374,2823,49136
03-05-2018,16,15236,19666,6923,3969,45795,1422,973,414,2809,48604
03-05-2018,17,16553,19820,6940,3649,46961,1445,972,424,2841,49802
03-05-2018,18,17451,19760,7067,3674,47952,1445,968,564,2977,50929
03-05-2018,19,17100,19596,7257,3643,47596,1480,942,572,2994,50590
03-05-2018,20,16550,19486,7208,3163,46407,1504,861,438,2803,49210
03-05-2018,21,16238,19468,7326,2915,45947,1552,812,297,2661,48608
03-05-2018,22,15846,18156,7421,2532,43955,1552,693,227,2472,46427
03-05-2018,23,13618,17646,7534,1861,40660,1544,698,214,2456,43116
04-05-2018,0,12084,17008,7485,1710,38287,1242,625,239,2106,40393
04-05-2018,1,11483,16957,7418,1620,37478,1146,624,246,2016,39494
04-05-2018,2,11587,17062,7402,1557,37609,1117,628,259,2004,39613
04-05-2018,3,11913,17044,7435,1450,37843,1075,623,245,1943,39786
04-05-2018,4,12367,17107,7495,1531,38500,1139,623,243,2005,40505
04-05-2018,5,13720,17420,7660,1677,40477,1265,627,255,2147,42624
04-05-2018,6,16707,19021,7818,2190,45737,1326,680,260,2266,48003
04-05-2018,7,18995,19754,8005,2630,49385,1327,697,456,2480,51865
04-05-2018,8,19540,19658,7965,2627,49791,1314,868,465,2647,52438
04-05-2018,9,19350,19589,7895,2721,49556,1282,941,478,2701,52257
04-05-2018,10,19195,19550,7798,2806,49350,1288,881,492,2661,52011
04-05-2018,11,18720,19101,7789,2582,48193,1273,926,489,2688,50881
04-05-2018,12,18061,18807,7656,2550,47074,1294,1049,503,2846,49920
04-05-2018,13,16952,18281,7544,2649,45426,1272,1036,452,2760,48186
04-05-2018,14,15628,18214,7321,2553,43715,1259,839,411,2509,46224
04-05-2018,15,15165,18202,7037,2484,42888,1247,764,412,2423,45311
04-05-2018,16,15877,18283,7089,2395,43643,1251,768,412,2431,46074
04-05-2018,17,17156,18333,7099,2330,44919,1238,784,353,2375,47294
04-05-2018,18,17391,18204,7257,2623,45477,1246,867,311,2424,47901
04-05-2018,19,17256,18114,7218,2456,45046,1288,884,353,2525,47571
04-05-2018,20,16559,17931,7025,2218,43734,1264,749,323,2336,46070
04-05-2018,21,16237,17561,6892,2150,42840,1254,678,319,2251,45091
04-05-2018,22,16033,17660,6823,2081,42597,1245,628,314,2187,44784
04-05-2018,23,13163,17206,6694,1638,38702,1216,629,375,2220,40922
05-05-2018,0,11768,17320,6581,1392,37063,1002,627,299,1928,38991
05-05-2018,1,10422,17071,6430,1196,35119,887,623,286,1796,36915
05-05-2018,2,9664,17124,6376,1215,34380,790,618,250,1658,36038
05-05-2018,3,9458,17158,6350,1211,34178,800,616,239,1655,35833
05-05-2018,4,9467,17236,6345,1214,34262,822,617,234,1673,35935
05-05-2018,5,9474,16949,6326,1179,33928,817,606,228,1651,35579
05-05-2018,6,10246,16912,6396,1192,34745,800,603,227,1630,36375
05-05-2018,7,12322,17129,6314,1325,37090,846,830,216,1892,38982
05-05-2018,8,14349,17470,6347,1515,39681,878,934,270,2082,41763
05-05-2018,9,14879,17546,6371,1612,40408,889,944,294,2127,42535
05-05-2018,10,14301,17330,6325,1701,39657,878,948,287,2113,41770
05-05-2018,11,12894,17217,6242,1848,38201,804,895,290,1989,40190
05-05-2018,12,12116,17262,6268,1864,37511,801,816,331,1948,39459
05-05-2018,13,11435,17196,6299,1858,36786,793,820,308,1921,38707
05-05-2018,14,10978,17014,6334,1784,36111,771,750,288,1809,37920
05-05-2018,15,10489,17029,6360,1785,35662,764,743,289,1796,37458
05-05-2018,16,10856,17136,6377,1736,36106,765,670,334,1769,37875
05-05-2018,17,11920,17293,6423,1622,37257,779,661,340,1780,39037
05-05-2018,18,13206,17667,6572,1463,38907,821,654,371,1846,40753
05-05-2018,19,13417,17922,6709,1290,39337,873,655,339,1867,41204
05-05-2018,20,12691,17891,6819,1179,38580,837,657,329,1823,40403
05-05-2018,21,12210,17886,6873,1162,38131,841,658,349,1848,39979
05-05-2018,22,11255,17923,6874,1220,37271,833,620,301,1754,39025
05-05-2018,23,10127,17812,6770,1130,35840,679,619,279,1577,37417
06-05-2018,0,9217,17309,6729,1104,34361,717,617,296,1630,35991
06-05-2018,1,8894,17374,6692,1123,34084,798,618,292,1708,35792
06-05-2018,2,9200,17399,6771,1161,34533,649,600,265,1514,36047
06-05-2018,3,9169,17345,6800,1153,34468,623,600,225,1448,35916
06-05-2018,4,9055,17307,6822,1163,34347,629,601,202,1432,35779
06-05-2018,5,8681,16961,6658,987,33288,631,650,195,1476,34764
06-05-2018,6,8983,16967,6460,983,33394,639,651,191,1481,34875
06-05-2018,7,9520,17291,6427,1093,34332,658,664,189,1511,35843
06-05-2018,8,10222,17729,6556,1206,35715,761,675,195,1631,37346
06-05-2018,9,10380,17799,6736,1391,36308,765,677,204,1646,37954
06-05-2018,10,10329,17892,6858,1534,36613,733,687,215,1635,38248
06-05-2018,11,10052,17891,7098,1659,36699,711,673,248,1632,38331
06-05-2018,12,9903,17662,7207,1759,36532,663,657,253,1573,38105
06-05-2018,13,9913,17543,7034,1738,36229,659,674,234,1567,37796
06-05-2018,14,9880,17511,7082,1701,36175,668,756,249,1673,37848
06-05-2018,15,9994,17630,6962,1686,36273,674,763,248,1685,37958
06-05-2018,16,10073,17558,6951,1678,36260,680,766,252,1698,37958
06-05-2018,17,10584,17574,6892,1676,36726,714,836,254,1804,38530
06-05-2018,18,11714,17540,6968,1515,37736,730,897,238,1865,39601
06-05-2018,19,12347,17591,7129,1464,38531,740,965,251,1956,40487
06-05-2018,20,12550,17394,7308,1383,38635,725,969,249,1943,40578
06-05-2018,21,12070,17402,7405,1443,38320,748,967,209,1924,40244
06-05-2018,22,10773,17192,7462,1566,36993,756,896,203,1855,38848
06-05-2018,23,10105,16568,7316,1801,35789,665,751,195,1611,37400
07-05-2018,0,9604,15706,7264,1967,34542,658,607,190,1455,35997
07-05-2018,1,9518,15577,7228,2076,34400,664,531,190,1385,35785
07-05-2018,2,9461,15786,7173,2029,34449,648,526,195,1369,35818
07-05-2018,3,9339,16009,7074,2129,34551,640,525,189,1354,35905
07-05-2018,4,9639,16558,7097,2289,35582,656,467,174,1297,36879
07-05-2018,5,10038,17434,7282,2438,37192,744,611,225,1580,38772
07-05-2018,6,13086,19614,7535,2607,42843,826,673,249,1748,44591
07-05-2018,7,15895,19938,7471,2623,45927,840,953,428,2221,48148
07-05-2018,8,17126,20031,7567,2796,47522,827,988,472,2287,49809
07-05-2018,9,16444,20061,7619,2731,46855,818,983,453,2254,49109
07-05-2018,10,15793,20160,7650,2726,46331,738,952,438,2128,48459
07-05-2018,11,14796,20281,7746,2301,45124,712,962,438,2112,47236
07-05-2018,12,14159,20011,7733,2263,44168,728,964,414,2106,46274
07-05-2018,13,13861,19826,7821,2274,43783,743,935,376,2054,45837
07-05-2018,14,13408,19146,7870,2221,42645,724,781,427,1932,44577
07-05-2018,15,13295,18838,7837,2173,42144,719,777,383,1879,44023
07-05-2018,16,13758,19005,7654,2185,42603,688,778,328,1794,44397
07-05-2018,17,14844,19177,7513,2286,43821,725,786,294,1805,45626
07-05-2018,18,14199,19737,7602,2641,44180,701,788,385,1874,46054
07-05-2018,19,13840,19725,7870,2556,43993,674,780,462,1916,45909
07-05-2018,20,13517,18576,7990,2265,42347,692,672,377,1741,44088
07-05-2018,21,13436,18473,8086,1842,41838,822,634,264,1720,43558
07-05-2018,22,13147,17263,7985,1588,39983,776,607,238,1621,41604
07-05-2018,23,11766,16374,7819,1536,37496,684,487,247,1418,38914
08-05-2018,0,11355,16278,7813,1661,37107,673,383,259,1315,38422
08-05-2018,1,11204,16171,7805,1667,36847,648,412,253,1313,38160
08-05-2018,2,10930,16145,7702,1669,36447,640,412,254,1306,37753
08-05-2018,3,10926,16226,7589,1790,36532,630,412,244,1286,37818
08-05-2018,4,10665,16154,7437,1681,35938,643,398,238,1279,37217
08-05-2018,5,11224,16453,7399,1812,36889,746,573,237,1556,38445
08-05-2018,6,13144,17742,7435,1781,40102,780,628,337,1745,41847
08-05-2018,7,16029,18195,7670,1867,43763,656,900,444,2000,45763
08-05-2018,8,16398,18318,7724,1815,44255,662,1004,503,2169,46424
08-05-2018,9,15555,17966,7740,1962,43225,658,1006,493,2157,45382
08-05-2018,10,15192,18156,7661,2151,43159,716,996,524,2236,45395
08-05-2018,11,14666,18371,7621,2429,43088,739,923,484,2146,45234
08-05-2018,12,13728,18266,7632,2716,42343,646,886,516,2048,44391
08-05-2018,13,13165,18034,7678,3055,41933,658,786,576,2020,43953
08-05-2018,14,12748,17811,7640,3444,41643,682,962,370,2014,43657
08-05-2018,15,12622,18006,7607,3603,41840,703,903,287,1893,43733
08-05-2018,16,13115,18403,7293,3765,42575,716,809,392,1917,44492
08-05-2018,17,12999,18646,7244,3694,42581,741,832,301,1874,44455
08-05-2018,18,13501,18235,6757,3613,42108,822,837,443,2102,44210
08-05-2018,19,13858,18480,6721,3116,42174,815,719,451,1985,44159
08-05-2018,20,13686,18695,6636,2927,41945,671,662,506,1839,43784
08-05-2018,21,13854,18426,6799,2899,41980,678,488,486,1652,43632
08-05-2018,22,12908,18182,6712,3025,40828,699,463,390,1552,42380
08-05-2018,23,12284,16905,6662,2856,38709,636,184,425,1245,39954
09-05-2018,0,11391,15811,6615,2626,36444,518,174,438,1130,37574
09-05-2018,1,11389,16044,6488,2128,36050,505,167,425,1097,37147
09-05-2018,2,11217,15787,6775,2040,35820,518,167,433,1118,36938
09-05-2018,3,11310,15414,6914,1915,35552,520,166,445,1131,36683
09-05-2018,4,11427,15675,6846,1947,35896,502,163,429,1094,36990
09-05-2018,5,11643,16370,7087,2191,37292,501,183,419,1103,38395
09-05-2018,6,13422,18275,7256,2248,41202,494,711,343,1548,42750
09-05-2018,7,15252,19553,7289,2396,44491,481,751,460,1692,46183
09-05-2018,8,16051,19350,7531,2565,45497,487,861,479,1827,47324
09-05-2018,9,15578,19306,7495,2983,45364,493,866,520,1879,47243
09-05-2018,10,15410,19232,7572,2949,45165,510,855,565,1930,47095
09-05-2018,11,14612,19721,7443,3120,44895,531,856,554,1941,46836
09-05-2018,12,13813,19808,7321,3325,44269,535,862,528,1925,46194
09-05-2018,13,13402,19592,7341,3610,43944,552,932,560,2044,45988
09-05-2018,14,12868,18874,7293,4298,43334,561,840,453,1854,45188
09-05-2018,15,12319,19057,7353,4649,43378,561,780,345,1686,45064
09-05-2018,16,12407,19149,7263,4700,43518,551,845,280,1676,45194
09-05-2018,17,12680,19245,7227,4411,43563,548,685,310,1543,45106
09-05-2018,18,12720,19286,7129,3970,43106,544,673,301,1518,44624
09-05-2018,19,13363,19300,7080,3637,43382,530,681,360,1571,44953
09-05-2018,20,12650,19135,7075,3137,41997,539,679,432,1650,43647
09-05-2018,21,12270,19022,7221,2869,41383,556,595,484,1635,43018
09-05-2018,22,11547,18890,7198,2924,40560,554,588,507,1649,42209
09-05-2018,23,10798,18264,7150,2858,39071,555,191,503,1249,40320
10-05-2018,0,9771,17633,7247,2923,37574,558,169,512,1239,38813
10-05-2018,1,9373,16622,7434,2494,35926,563,166,491,1220,37146
10-05-2018,2,9454,16770,7617,2161,36002,553,161,468,1182,37184
10-05-2018,3,9418,16718,7733,2190,36060,549,163,466,1178,37238
10-05-2018,4,9575,16609,7726,2244,36154,560,159,451,1170,37324
10-05-2018,5,9984,16971,7528,2250,36733,540,179,419,1138,37871
10-05-2018,6,11007,17641,7147,2069,37864,518,647,354,1519,39383
10-05-2018,7,12418,18973,6957,1898,40245,456,670,359,1485,41730
10-05-2018,8,12931,18748,6940,1889,40509,485,1020,570,2075,42584
10-05-2018,9,13153,18580,6937,1903,40573,495,1032,651,2178,42751
10-05-2018,10,12956,18643,7040,1914,40554,494,940,596,2030,42584
10-05-2018,11,12321,18662,7096,1963,40042,509,752,519,1780,41822
10-05-2018,12,12103,18692,7134,1998,39928,513,762,570,1845,41773
10-05-2018,13,12164,19064,6983,2096,40307,505,670,762,1937,42244
10-05-2018,14,11951,19287,6949,2427,40616,515,665,463,1643,42259
10-05-2018,15,11819,19375,6940,2264,40399,545,672,380,1597,41996
10-05-2018,16,12142,19421,6885,2520,40968,547,667,403,1617,42585
10-05-2018,17,12240,19420,6894,2569,41124,570,664,547,1781,42905
10-05-2018,18,12369,19724,6851,2740,41683,564,663,473,1700,43383
10-05-2018,19,12967,19724,6911,2311,41913,571,664,377,1612,43525
10-05-2018,20,12900,19246,7008,2018,41173,589,668,395,1652,42825
10-05-2018,21,12521,18820,7286,2050,40677,630,675,467,1772,42449
10-05-2018,22,11887,18337,7405,2047,39676,643,627,452,1722,41398
10-05-2018,23,10930,17724,7386,2070,38110,643,305,439,1387,39497
11-05-2018,0,10188,17244,7475,1986,36893,661,169,457,1287,38180
11-05-2018,1,9695,16593,7455,1909,35652,658,164,450,1272,36924
11-05-2018,2,9735,16286,7405,1922,35347,648,157,434,1239,36586
11-05-2018,3,9866,16225,7484,1923,35499,643,158,415,1216,36715
11-05-2018,4,10183,16479,7547,1727,35935,622,159,389,1170,37105
11-05-2018,5,11363,17083,7356,1631,37436,610,412,381,1403,38839
11-05-2018,6,13717,17779,7085,1893,40475,710,620,352,1682,42157
11-05-2018,7,16103,17871,6929,1816,42718,803,803,532,2138,44856
11-05-2018,8,17295,18447,6923,1913,44579,846,953,569,2368,46947
11-05-2018,9,17665,18327,6948,2172,45114,860,969,551,2380,47494
11-05-2018,10,17571,18067,6888,2253,44781,891,964,557,2412,47193
11-05-2018,11,17470,17948,6909,2217,44544,871,958,550,2379,46923
11-05-2018,12,17092,18037,6876,2234,44238,840,1051,625,2516,46754
11-05-2018,13,17122,17631,6818,2054,43625,815,1059,636,2510,46135
11-05-2018,14,16864,17677,6858,2006,43405,805,839,571,2215,45620
11-05-2018,15,16491,17651,6871,1857,42870,795,721,518,2034,44904
11-05-2018,16,16333,17689,6840,1808,42671,822,612,497,1931,44602
11-05-2018,17,16265,17682,6802,1818,42569,813,613,507,1933,44502
11-05-2018,18,16253,17568,6751,1694,42265,819,614,502,1935,44200
11-05-2018,19,16177,17544,6708,1541,41968,763,615,356,1734,43702
11-05-2018,20,15844,17588,6617,1470,41520,799,618,316,1733,43253
11-05-2018,21,15607,17706,6629,1356,41298,815,535,464,1814,43112
11-05-2018,22,15147,17253,6532,1322,40254,836,532,465,1833,42087
11-05-2018,23,13929,16923,6554,1148,38555,726,316,398,1440,39995
12-05-2018,0,13340,16421,6603,1068,37431,743,155,432,1330,38761
12-05-2018,1,12648,16103,6575,1023,36349,791,153,328,1272,37621
12-05-2018,2,12093,16199,6621,915,35827,783,161,326,1270,37097
12-05-2018,3,11774,16164,6665,927,35532,769,159,315,1243,36775
12-05-2018,4,11556,15848,6660,924,34989,761,153,282,1196,36185
12-05-2018,5,11250,15976,6594,901,34721,750,329,283,1362,36083
12-05-2018,6,11420,16476,6499,969,35365,700,515,273,1488,36853
12-05-2018,7,12891,16403,6355,1106,36756,667,805,239,1711,38467
12-05-2018,8,14564,16591,6273,1255,38683,720,807,260,1787,40470
12-05-2018,9,15612,16691,6340,1353,39999,726,798,312,1836,41835
12-05-2018,10,15212,16615,6334,1250,39412,729,801,358,1888,41300
12-05-2018,11,14418,16515,6297,1344,38574,703,891,359,1953,40527
12-05-2018,12,13644,16785,6273,1431,38134,709,893,330,1932,40066
12-05-2018,13,13360,16726,6238,1497,37821,735,726,288,1749,39570
12-05-2018,14,12853,16657,6191,1467,37168,748,614,240,1602,38770
12-05-2018,15,12688,16712,6132,1383,36915,698,677,242,1617,38532
12-05-2018,16,12447,16743,6106,1360,36657,726,673,232,1631,38288
12-05-2018,17,13849,16866,6151,1340,38208,747,531,219,1497,39705
12-05-2018,18,15744,16768,6257,1409,40178,740,501,248,1489,41667
12-05-2018,19,15438,16881,6233,1341,39891,737,490,253,1480,41371
12-05-2018,20,14740,16789,6233,1168,38931,746,494,206,1446,40377
12-05-2018,21,14760,17008,6236,1011,39015,746,497,223,1466,40481
12-05-2018,22,13520,17065,6239,1344,38169,714,507,313,1534,39703
12-05-2018,23,11388,16772,6148,1388,35696,637,297,295,1229,36925
13-05-2018,0,10727,16685,6145,1307,34863,627,146,338,1111,35974
13-05-2018,1,10859,16571,6160,1141,34730,596,143,337,1076,35806
13-05-2018,2,10228,16358,6113,1065,33763,607,144,334,1085,34848
13-05-2018,3,9983,16422,6148,993,33546,594,141,357,1092,34638
13-05-2018,4,9861,16279,6111,1070,33319,593,227,342,1162,34481
13-05-2018,5,9541,15927,6048,1157,32674,579,332,327,1238,33912
13-05-2018,6,9660,15956,6041,1196,32853,574,443,318,1335,34188
13-05-2018,7,10073,15928,5996,1375,33372,565,456,282,1303,34675
13-05-2018,8,10722,16513,6000,1539,34776,569,469,260,1298,36074
13-05-2018,9,11402,16830,6060,1712,36005,643,568,306,1517,37522
13-05-2018,10,11505,16849,5990,1920,36264,678,570,358,1606,37870
13-05-2018,11,11377,16925,5990,2185,36478,663,568,381,1612,38090
13-05-2018,12,11200,17052,6028,2379,36660,555,480,364,1399,38059
13-05-2018,13,10886,16878,6030,2608,36402,553,497,360,1410,37812
13-05-2018,14,10547,16725,5910,2887,36068,572,477,363,1412,37480
13-05-2018,15,10466,16794,5642,3063,35965,572,521,348,1441,37406
13-05-2018,16,10524,16804,5303,3261,35893,565,527,321,1413,37306
13-05-2018,17,10772,16909,5181,3448,36312,570,436,310,1316,37628
13-05-2018,18,11343,16829,5190,3342,36704,641,579,279,1499,38203
13-05-2018,19,11641,17360,5230,3092,37324,682,786,301,1769,39093
13-05-2018,20,11859,17477,5303,2878,37518,706,795,332,1833,39351
13-05-2018,21,11799,17671,5299,2687,37457,721,638,357,1716,39173
13-05-2018,22,12216,17714,5299,2656,37887,732,645,363,1740,39627
13-05-2018,23,10532,17429,5297,2575,35835,719,616,344,1679,37514
14-05-2018,0,9869,16685,5356,2495,34126,776,311,331,1418,35544
14-05-2018,1,9915,16783,5387,1886,33970,766,298,266,1330,35300
14-05-2018,2,9930,16772,5410,1876,33987,784,311,249,1344,35331
14-05-2018,3,9841,16571,5406,1990,33807,782,307,236,1325,35132
14-05-2018,4,9946,16423,5316,1900,33305,788,305,221,1314,34619
14-05-2018,5,10654,16484,5371,2124,34353,903,434,200,1537,35890
14-05-2018,6,14410,17434,5661,1601,38827,1014,501,450,1965,40792
14-05-2018,7,17511,17514,5780,1725,,1074,849,463,2386,
14-05-2018,8,18511,17713,5815,2020,44059,1081,1030,497,2608,46667
14-05-2018,9,18218,17488,5828,2468,44002,1067,922,482,2471,46473
14-05-2018,10,18059,17331,5847,2647,43884,1077,861,530,2468,46352
14-05-2018,11,17890,17130,5916,2653,43590,1079,762,547,2388,45978
14-05-2018,12,17488,16914,5936,2471,42810,1085,695,562,2342,45152
14-05-2018,13,17622,16761,5956,2534,42872,1083,635,576,2294,45166
14-05-2018,14,17534,16607,5890,2557,42588,1087,506,411,2004,44592
14-05-2018,15,17335,16600,5887,2546,42369,1090,495,432,2017,44386
14-05-2018,16,17228,16730,5785,2425,42168,1096,498,304,1898,44066
14-05-2018,17,16754,16570,5755,2151,41231,1083,487,507,2077,43308
14-05-2018,18,17190,16678,5890,1999,41757,1059,499,497,2055,43812
14-05-2018,19,17154,16997,5905,1762,41817,1073,443,498,2014,43831
14-05-2018,20,16485,16583,5753,1379,40202,1067,431,476,1974,42176
14-05-2018,21,16518,16656,5846,1197,40217,1059,427,427,1913,42130
14-05-2018,22,15996,16276,5736,1305,39312,1054,437,320,1811,41123
14-05-2018,23,13730,15907,5647,1591,36876,1021,426,350,1797,38673
15-05-2018,0,13021,15627,5663,1152,35464,849,186,335,1370,36834
15-05-2018,1,12029,15529,5599,1313,34469,854,181,301,1336,35805
15-05-2018,2,11383,15337,5482,1337,33537,878,181,258,1317,34854
15-05-2018,3,11087,15318,5452,1278,33135,882,181,241,1304,34439
15-05-2018,4,11671,15460,5557,1170,33858,899,236,230,1365,35223
15-05-2018,5,12988,15701,5666,1046,35401,1034,410,239,1683,37084
15-05-2018,6,15807,16133,5825,1347,39112,1083,817,450,2350,41462
15-05-2018,7,17812,16600,5944,1920,42277,1062,1072,506,2640,44917
15-05-2018,8,17337,17067,5938,2150,42493,1064,1184,518,2766,45259
15-05-2018,9,17339,17146,5949,2319,42754,1063,1290,510,2863,45617
15-05-2018,10,17157,17255,5952,2499,42863,1050,1300,501,2851,45714
15-05-2018,11,16589,17365,6006,2576,42536,1065,1287,502,2854,45390
15-05-2018,12,16670,17152,6005,2599,42426,1081,1144,516,2741,45167
15-05-2018,13,16522,17086,6066,2452,42125,1090,1128,497,2715,44840
15-05-2018,14,16686,16703,5959,2322,41670,1090,972,482,2544,44214
15-05-2018,15,16655,16546,5989,2157,41348,1087,948,410,2445,43793
15-05-2018,16,16530,16456,5980,2070,41035,1080,898,390,2368,43403
15-05-2018,17,16460,16391,5971,2192,41013,1077,873,381,2331,43344
15-05-2018,18,16248,16495,6044,2159,40945,1065,878,365,2308,43253
15-05-2018,19,16099,16346,6057,2025,40527,1069,883,361,2313,42840
15-05-2018,20,15446,16494,5906,1678,39524,1083,835,395,2313,41837
15-05-2018,21,15444,16441,5816,1553,39255,1014,831,417,2262,41517
15-05-2018,22,15113,16205,5766,1626,38710,993,834,225,2052,40762
15-05-2018,23,13843,15978,5740,1490,37051,969,828,218,2015,39066
16-05-2018,0,12669,15375,5724,1421,35189,876,365,229,1470,36659
16-05-2018,1,11885,15374,5702,1364,34325,876,342,223,1441,35766
16-05-2018,2,11351,15271,5757,1314,33693,881,339,206,1426,35119
16-05-2018,3,11107,15210,5756,1339,33411,869,338,197,1404,34815
16-05-2018,4,11017,14943,5790,1434,33185,917,342,193,1452,34637
16-05-2018,5,11877,15404,5907,1634,34823,972,351,190,1513,36336
16-05-2018,6,14851,16062,6047,2094,39054,1064,839,187,2090,41144
16-05-2018,7,17213,16633,6123,2135,42104,1060,888,456,2404,44508
16-05-2018,8,17143,17507,6336,2579,43565,1065,929,476,2470,46035
16-05-2018,9,17237,16935,6348,2341,42862,1064,1029,480,2573,45435
16-05-2018,10,17479,17452,6330,2374,43636,1059,873,462,2394,46030
16-05-2018,11,17396,17110,6408,2525,43441,1057,868,482,2407,45848
16-05-2018,12,17213,16728,6341,3051,43335,1054,915,483,2452,45787
16-05-2018,13,16956,16535,6312,3087,42890,1050,784,489,2323,45213
16-05-2018,14,15833,16478,6030,3250,41591,1040,777,444,2261,43852
16-05-2018,15,14369,16914,5895,3470,40650,1042,697,419,2158,42808
16-05-2018,16,14281,17252,5837,3699,41071,1040,730,390,2160,43231
16-05-2018,17,14829,17524,5902,3423,41680,1084,733,408,2225,43905
16-05-2018,18,15517,17555,5953,2838,41863,1062,733,414,2209,44072
16-05-2018,19,14910,17811,5915,2550,41186,1017,740,445,2202,43388
16-05-2018,20,13565,17937,5834,2282,39616,883,723,267,1873,41489
16-05-2018,21,12958,18179,5658,2232,39028,808,739,326,1873,40901
16-05-2018,22,12561,17906,5667,1999,38134,808,766,360,1934,40068
16-05-2018,23,11061,17575,5801,1835,36273,693,737,304,1734,38007
17-05-2018,0,10285,17703,5822,1691,35501,581,362,276,1219,36720
17-05-2018,1,9704,17421,5855,1487,34466,556,301,314,1171,35637
17-05-2018,2,9442,17233,6015,1343,34034,562,285,322,1169,35203
17-05-2018,3,9230,16935,6155,1423,33743,558,287,309,1154,34897
17-05-2018,4,9314,16651,6146,1321,33433,570,312,322,1204,34637
17-05-2018,5,10028,17371,6186,1290,34875,673,382,333,1388,36263
17-05-2018,6,11638,18385,6503,1616,38142,794,326,301,1421,39563
17-05-2018,7,13556,18549,6599,2336,41040,813,448,551,1812,42852
17-05-2018,8,15244,18662,6612,2605,43125,817,625,542,1984,45109
17-05-2018,9,15820,18410,6666,2887,43783,814,638,523,1975,45758
17-05-2018,10,15569,18174,6644,3089,43477,826,810,494,2130,45607
17-05-2018,11,15339,17944,6607,2962,42852,833,773,512,2118,44970
17-05-2018,12,14998,17752,6546,3260,42555,835,781,378,1994,44549
17-05-2018,13,14543,17636,6548,3234,41962,845,677,432,1954,43916
17-05-2018,14,13566,17395,6404,3369,40733,797,601,454,1852,42585
17-05-2018,15,12926,17347,6360,3355,39987,783,528,436,1747,41734
17-05-2018,16,12687,17236,6257,3264,39445,760,499,430,1689,41134
17-05-2018,17,13910,17611,6266,3299,41085,819,385,416,1620,42705
17-05-2018,18,14638,18009,6316,2958,41920,848,337,379,1564,43484
17-05-2018,19,15030,17998,6268,2601,41897,840,337,399,1576,43473
17-05-2018,20,14367,17992,6155,2312,40826,783,344,382,1509,42335
17-05-2018,21,14054,17933,6118,2094,40200,818,353,356,1527,41727
17-05-2018,22,13151,17878,6172,2036,39237,820,332,238,1390,40627
17-05-2018,23,11381,17817,6118,1699,37017,783,310,234,1327,38344
18-05-2018,0,10512,17219,6135,1642,35507,635,228,209,1072,36579
18-05-2018,1,10304,17207,6057,1604,35173,576,226,190,992,36165
18-05-2018,2,10011,17333,5962,1661,34967,568,218,173,959,35926
18-05-2018,3,10072,17393,5968,1637,35070,562,252,172,986,36056
18-05-2018,4,10367,17833,5993,1642,35836,606,298,176,1080,36916
18-05-2018,5,11289,18021,6038,2042,37390,790,386,181,1357,38747
18-05-2018,6,13656,19113,6233,2164,41166,852,401,185,1438,42604
18-05-2018,7,15650,19387,6307,2520,43866,835,697,436,1968,45834
18-05-2018,8,16095,19180,6378,2922,44576,829,1021,452,2302,46878
18-05-2018,9,16226,19116,6396,2887,44625,810,1030,471,2311,46936
18-05-2018,10,16515,18979,6470,2920,44885,821,1028,462,2311,47196
18-05-2018,11,16298,18754,6552,2857,44462,824,895,485,2204,46666
18-05-2018,12,15687,18514,6629,2509,43338,833,792,521,2146,45484
18-05-2018,13,15501,18304,6575,2429,42809,857,588,482,1927,44736
18-05-2018,14,14690,18203,6273,2361,41526,824,501,530,1855,43381
18-05-2018,15,13996,18001,6162,2401,40561,865,526,515,1906,42467
18-05-2018,16,14543,17949,6127,2360,40978,877,558,508,1943,42921
18-05-2018,17,15241,17951,6145,2441,41777,853,542,544,1939,43716
18-05-2018,18,15375,17897,6274,2369,41915,835,591,517,1943,43858
18-05-2018,19,15251,17720,6218,2571,41761,807,631,322,1760,43521
18-05-2018,20,14459,17427,5978,2503,40367,816,522,360,1698,42065
18-05-2018,21,14135,17341,5934,2291,39702,803,383,341,1527,41229
18-05-2018,22,14128,17154,5930,2055,39267,805,374,371,1550,40817
18-05-2018,23,12813,16828,5757,1793,37191,801,325,349,1475,38666
19-05-2018,0,12574,15854,5682,1446,35555,851,254,342,1447,37002
19-05-2018,1,11881,15862,5631,1181,34556,896,251,336,1483,36039
19-05-2018,2,11388,15571,5597,1128,33684,889,247,344,1480,35164
19-05-2018,3,11244,15526,5535,1179,33483,856,247,349,1452,34935
19-05-2018,4,10943,15476,5419,1152,32990,811,249,342,1402,34392
19-05-2018,5,11184,15433,5336,1148,33102,803,246,312,1361,34463
19-05-2018,6,11965,15625,5272,1129,33990,841,446,269,1556,35546
19-05-2018,7,12690,16182,5275,1404,35550,818,531,289,1638,37188
19-05-2018,8,13878,16574,5309,1462,37223,825,615,316,1756,38979
19-05-2018,9,13859,16735,5391,1458,37443,804,623,345,1772,39215
19-05-2018,10,13794,16859,5439,1534,37626,820,627,380,1827,39453
19-05-2018,11,13548,16671,5453,1689,37359,796,717,384,1897,39256
19-05-2018,12,12747,16700,5447,2040,36933,776,654,318,1748,38681
19-05-2018,13,12149,16752,5447,2053,36401,792,565,300,1657,38058
19-05-2018,14,11530,16843,5453,2216,36042,799,537,320,1656,37698
19-05-2018,15,11292,16915,5455,2243,35905,792,576,333,1701,37606
19-05-2018,16,11350,16959,5484,2194,35987,780,576,343,1699,37686
19-05-2018,17,12349,17036,5544,1830,36759,835,448,327,1610,38369
19-05-2018,18,13488,17303,5599,1671,38062,789,439,295,1523,39585
19-05-2018,19,13271,17265,5694,1642,37874,806,484,295,1585,39459
19-05-2018,20,12858,17089,5757,1324,37029,789,474,278,1541,38570
19-05-2018,21,12979,17051,5806,1189,37026,773,424,270,1467,38493
19-05-2018,22,12592,16984,5883,1158,36615,806,369,264,1439,38054
19-05-2018,23,10260,16424,5798,1164,33646,759,358,284,1401,35047
20-05-2018,0,8933,15893,5769,1221,31816,793,205,257,1255,33071
20-05-2018,1,8543,15837,5598,1195,31173,774,203,247,1224,32397
20-05-2018,2,8356,15814,5609,1132,30911,760,203,238,1201,32112
20-05-2018,3,8247,15745,5541,1085,30619,662,205,243,1110,31729
20-05-2018,4,8152,15634,5389,1000,30175,560,272,259,1091,31266
20-05-2018,5,8106,15414,5174,1066,29760,565,272,294,1131,30891
20-05-2018,6,8763,15748,5106,1145,30763,636,298,250,1184,31947
20-05-2018,7,9553,15911,5113,1277,31853,708,365,197,1270,33123
20-05-2018,8,10638,16181,5171,1446,33437,730,363,204,1297,34734
20-05-2018,9,11260,16413,5266,1686,34626,731,537,220,1488,36114
20-05-2018,10,11307,16392,5390,1869,34958,723,636,238,1597,36555
20-05-2018,11,10980,16475,5506,1897,34858,692,688,241,1621,36479
20-05-2018,12,10591,16537,5627,1998,34752,531,691,348,1570,36322
20-05-2018,13,10120,16553,5705,1969,34347,498,633,383,1514,35861
20-05-2018,14,10019,16809,5644,2011,34483,587,549,250,1386,35869
20-05-2018,15,9990,16766,5609,1967,34333,620,525,252,1397,35730
20-05-2018,16,10326,16809,5591,1973,34699,590,521,257,1368,36067
20-05-2018,17,10683,17308,5668,1991,35650,659,448,257,1364,37014
20-05-2018,18,10819,17321,5819,1939,35898,677,369,239,1285,37183
20-05-2018,19,10737,17585,5891,1847,36060,707,406,235,1348,37408
20-05-2018,20,10447,17528,6058,1698,35731,707,413,256,1376,37107
20-05-2018,21,10123,17345,6112,1648,35229,734,364,288,1386,36615
20-05-2018,22,9571,17234,6140,1725,34669,733,311,296,1340,36009
20-05-2018,23,9235,16680,6171,1695,33782,677,291,286,1254,35036
21-05-2018,0,8471,16326,6155,1689,32641,690,135,222,1047,33688
21-05-2018,1,8131,15878,6063,1774,31847,695,130,216,1041,32888
21-05-2018,2,8041,15726,5994,1809,31571,722,128,254,1104,32675
21-05-2018,3,8012,15739,5896,1700,31345,737,131,281,1149,32494
21-05-2018,4,7963,15814,5777,1725,31279,779,219,288,1286,32565
21-05-2018,5,8526,16403,5856,1772,32557,930,257,302,1489,34046
21-05-2018,6,10460,16833,5862,1856,35012,1158,370,260,1788,36800
21-05-2018,7,12311,17088,6021,1904,37325,1216,478,446,2140,39465
21-05-2018,8,13002,17092,6015,1953,38064,1211,747,435,2393,40457
21-05-2018,9,13423,17344,6178,2119,39064,1233,831,450,2514,41578
21-05-2018,10,14007,17403,6176,2351,39937,1215,831,472,2518,42455
21-05-2018,11,13868,17571,6223,2608,40270,1234,831,491,2556,42826
21-05-2018,12,13568,17270,6299,2823,39961,1287,681,480,2448,42409
21-05-2018,13,13274,17201,6221,3091,39787,1286,605,496,2387,42174
21-05-2018,14,13124,17250,6054,3313,39741,1190,601,529,2320,42061
21-05-2018,15,13089,17322,5946,3277,39635,1141,607,516,2264,41899
21-05-2018,16,12881,17367,5883,3126,39257,1126,389,517,2032,41289
21-05-2018,17,13155,17381,5867,3160,39563,1150,371,531,2052,41615
21-05-2018,18,13212,17485,5914,3069,39682,1154,368,525,2047,41729
21-05-2018,19,13233,17291,5843,2979,39346,1141,372,502,2015,41361
21-05-2018,20,12636,16959,5674,2728,37997,956,431,486,1873,39870
21-05-2018,21,12472,16794,5671,2382,37318,961,428,287,1676,38994
21-05-2018,22,11983,16273,5781,2223,36260,965,380,302,1647,37907
21-05-2018,23,10741,16046,5666,2070,34523,979,381,278,1638,36161
22-05-2018,0,9985,15384,5563,2060,32991,1058,198,252,1508,34499
22-05-2018,1,9264,15325,5478,2055,32123,1066,194,230,1490,33613
22-05-2018,2,9264,15333,5481,1962,32041,1046,193,204,1443,33484
22-05-2018,3,9290,15454,5457,1965,32167,1033,186,215,1434,33601
22-05-2018,4,9716,15184,5528,1962,32390,1059,189,244,1492,33882
22-05-2018,5,11402,15356,5633,1935,34326,1270,307,298,1875,36201
22-05-2018,6,14687,16526,5698,2171,39082,1296,411,395,2102,41184
22-05-2018,7,16291,17110,5801,2213,41415,1341,921,453,2715,44130
22-05-2018,8,17034,17375,5983,2595,42989,1418,1028,434,2880,45869
22-05-2018,9,17151,17399,6050,2721,43322,1313,1172,454,2939,46261
22-05-2018,10,17022,17215,6023,2757,43019,1315,1249,464,3028,46047
22-05-2018,11,16955,17206,5966,2726,42854,1315,1171,473,2959,45813
22-05-2018,12,16880,17041,5968,2667,42557,1323,1268,448,3039,45596
22-05-2018,13,17140,17173,6036,2563,42913,1321,1173,452,2946,45859
22-05-2018,14,16821,17095,5889,2493,42298,1318,947,440,2705,45003
22-05-2018,15,16180,16903,5822,2438,41344,1318,864,409,2591,43935
22-05-2018,16,15809,17215,5735,2268,41028,1314,835,408,2557,43585
22-05-2018,17,15959,17295,5963,2484,41700,1314,827,410,2551,44251
22-05-2018,18,16814,17419,6052,2375,42659,1316,827,410,2553,45212
22-05-2018,19,16382,17500,6155,2540,42578,1326,900,241,2467,45045
22-05-2018,20,15509,17625,5896,2291,41322,1217,900,340,2457,43779
22-05-2018,21,15124,17488,5737,2064,40414,1226,448,238,1912,42326
22-05-2018,22,14666,17167,5719,1571,39123,1288,377,208,1873,40996
22-05-2018,23,12907,16870,5656,1489,36923,1289,335,192,1816,38739
23-05-2018,0,12654,16661,5640,1173,36129,1190,192,188,1570,37699
23-05-2018,1,11653,16371,5826,1171,35023,1146,190,179,1515,36538
23-05-2018,2,11089,16411,6020,1027,34549,1101,188,177,1466,36015
23-05-2018,3,10636,16160,6250,922,33968,1128,188,176,1492,35460
23-05-2018,4,10548,16180,6360,912,33999,1128,193,169,1490,35489
23-05-2018,5,12126,16704,6420,1007,36256,1105,297,180,1582,37838
23-05-2018,6,14829,17452,6522,1382,40185,1185,372,197,1754,41939
23-05-2018,7,16524,17440,6667,2085,42718,1198,498,425,2121,44839
23-05-2018,8,17149,17422,6835,2254,43661,1192,678,463,2333,45994
23-05-2018,9,17257,17390,6735,2422,43804,1195,712,465,2372,46176
23-05-2018,10,17366,17321,6761,2366,43815,1194,755,477,2426,46241
23-05-2018,11,17426,17433,6740,2470,44071,1202,752,464,2418,46489
23-05-2018,12,17127,17054,6677,2292,43151,1203,656,471,2330,45481
23-05-2018,13,17300,17088,6633,2306,43327,1223,567,501,2291,45618
23-05-2018,14,16588,16832,6432,2276,42128,1238,427,470,2135,44263
23-05-2018,15,16006,16901,6330,2260,41498,1250,376,464,2090,43588
23-05-2018,16,15801,17016,6268,2228,41311,1254,369,476,2099,43410
23-05-2018,17,16214,16929,6171,2154,41469,1261,368,365,1994,43463
23-05-2018,18,17323,16993,6265,2251,42833,1257,391,256,1904,44737
23-05-2018,19,17249,17006,6292,2146,42693,1240,417,251,1908,44601
23-05-2018,20,16684,16903,6086,1863,41536,1240,421,276,1937,43473
23-05-2018,21,16013,16566,6050,1490,40120,1258,372,278,1908,42028
23-05-2018,22,14760,16274,6088,1373,38494,1290,373,282,1945,40439
23-05-2018,23,12122,15741,6072,1313,35249,1235,365,287,1887,37136
24-05-2018,0,10969,15062,6025,1373,33430,1123,178,286,1587,35017
24-05-2018,1,9543,15012,5902,1461,31919,1043,173,262,1478,33397
24-05-2018,2,9301,15024,5882,1379,31586,1075,173,259,1507,33093
24-05-2018,3,9165,14928,5745,1370,31208,1104,174,288,1566,32774
24-05-2018,4,9304,15170,5753,1369,31596,1127,174,322,1623,33219
24-05-2018,5,10907,15647,5792,1394,33740,1255,180,334,1769,35509
24-05-2018,6,14108,16821,5968,1632,38530,1392,233,284,1909,40439
24-05-2018,7,16084,17265,6088,2397,41834,1453,475,469,2397,44231
24-05-2018,8,16956,17384,6233,2564,43137,1449,708,494,2651,45788
24-05-2018,9,16881,17038,6231,2616,42766,1455,851,490,2796,45562
24-05-2018,10,16633,16674,6247,3067,42622,1458,855,511,2824,45446
24-05-2018,11,16551,16658,6284,3062,42554,1464,762,499,2725,45279
24-05-2018,12,16559,16505,6252,3359,42676,1472,575,510,2557,45233
24-05-2018,13,16412,16287,6307,3630,42637,1363,578,506,2447,45084
24-05-2018,14,16082,16101,6104,3836,42124,1208,491,505,2204,44328
24-05-2018,15,15390,16082,6097,3807,41376,1206,515,495,2216,43592
24-05-2018,16,15357,16243,6040,3744,41383,1215,449,274,1938,43321
24-05-2018,17,15175,16169,6009,3382,40735,1232,390,272,1894,42629
24-05-2018,18,15808,16216,5980,2904,40908,1301,303,308,1912,42820
24-05-2018,19,16378,16577,6026,2463,41445,1387,244,336,1967,43412
24-05-2018,20,16339,16161,5878,2188,40567,1455,234,274,1963,42530
24-05-2018,21,15323,16099,5780,2055,39257,1454,241,328,2023,41280
24-05-2018,22,13614,15798,5778,2021,37212,1470,249,347,2066,39278
24-05-2018,23,10947,15484,5701,2211,34345,1436,247,346,2029,36374
25-05-2018,0,9931,15277,5504,2260,32972,1232,197,305,1734,34706
25-05-2018,1,9428,14975,5449,2339,32191,1211,192,254,1657,33848
25-05-2018,2,9089,14790,5477,2344,31701,1204,192,257,1653,33354
25-05-2018,3,8715,14772,5524,2293,31303,1200,194,293,1687,32990
25-05-2018,4,9232,14765,5631,2262,31890,1203,191,353,1747,33637
25-05-2018,5,11035,14909,5796,2169,33909,1310,300,366,1976,35885
25-05-2018,6,14488,16224,5933,2066,38712,1404,374,295,2073,40785
25-05-2018,7,16600,17612,6096,2118,42427,1450,400,483,2333,44760
25-05-2018,8,16975,17574,6309,2382,43240,1452,632,500,2584,45824
25-05-2018,9,17005,17532,6315,2465,43317,1449,704,505,2658,45975
25-05-2018,10,16818,17521,6289,2607,43235,1441,711,555,2707,45942
25-05-2018,11,16480,17106,6222,2654,42463,1456,805,596,2857,45320
25-05-2018,12,16305,16942,6258,2764,42269,1463,779,647,2889,45158
25-05-2018,13,16235,16621,6298,2831,41985,1465,609,637,2711,44696
25-05-2018,14,15538,16654,6113,2727,41031,1394,480,614,2488,43519
25-05-2018,15,14982,16607,6113,2669,40369,1264,388,614,2266,42635
25-05-2018,16,15140,16669,6183,2492,40485,1221,376,422,2019,42504
25-05-2018,17,16149,16323,6186,2387,41045,1257,384,385,2026,43071
25-05-2018,18,16978,16521,6292,2148,41941,1244,397,336,1977,43918
25-05-2018,19,16625,16504,6264,1844,41238,1246,401,328,1975,43213
25-05-2018,20,15607,16745,6217,1444,40014,1219,400,332,1951,41965
25-05-2018,21,15193,16583,6177,1379,39334,986,387,374,1747,41081
25-05-2018,22,14290,16288,6160,1386,38124,971,390,433,1794,39918
25-05-2018,23,12721,16124,6041,1131,36018,845,385,463,1693,37711
26-05-2018,0,11917,15695,5906,1075,34593,793,154,442,1389,35982
26-05-2018,1,10882,15489,5765,913,33051,751,155,386,1292,34343
26-05-2018,2,9563,15138,5689,913,31303,765,146,372,1283,32586
26-05-2018,3,9226,15127,5513,922,30789,756,143,327,1226,32015
26-05-2018,4,9208,15160,5422,940,30730,746,148,305,1199,31929
26-05-2018,5,9178,14834,5327,1017,30357,737,159,237,1133,31490
26-05-2018,6,10746,15016,5294,1110,32166,753,226,222,1201,33367
26-05-2018,7,13010,15535,5330,1227,35101,749,230,214,1193,36294
26-05-2018,8,14734,15795,5506,1312,37348,749,390,270,1409,38757
26-05-2018,9,14245,15519,5598,1482,36844,743,648,235,1626,38470
26-05-2018,10,13441,15520,5645,1505,36110,745,667,212,1624,37734
26-05-2018,11,13354,15807,5612,1945,36718,750,552,226,1528,38246
26-05-2018,12,12653,15750,5572,1974,35950,753,552,234,1539,37489
26-05-2018,13,12037,15570,5473,2029,35111,729,487,249,1465,36576
26-05-2018,14,11862,15684,5418,1979,34945,756,491,262,1509,36454
26-05-2018,15,11853,15657,5368,1864,34743,731,564,348,1643,36386
26-05-2018,16,12010,15705,5399,1753,34868,613,568,353,1534,36402
26-05-2018,17,12841,15905,5398,1714,35859,676,518,323,1517,37376
26-05-2018,18,14612,16039,5425,1657,37734,724,462,261,1447,39181
26-05-2018,19,15300,16237,5485,1534,38556,725,517,228,1470,40026
26-05-2018,20,15273,16150,5553,1517,38494,730,275,200,1205,39699
26-05-2018,21,14989,15934,5684,1388,37996,734,264,204,1202,39198
26-05-2018,22,14171,15683,5682,1311,36850,738,230,316,1284,38134
26-05-2018,23,12326,15365,5697,986,34374,726,189,225,1140,35514
27-05-2018,0,10799,14485,5656,790,31731,741,143,199,1083,32814
27-05-2018,1,9357,14018,5421,820,29615,676,142,182,1000,30615
27-05-2018,2,8798,13872,5370,895,28935,685,137,174,996,29931
27-05-2018,3,8375,13859,5261,837,28330,688,137,182,1007,29337
27-05-2018,4,8097,13873,5184,918,28075,678,139,173,990,29065
27-05-2018,5,8443,13920,5031,953,28347,675,141,175,991,29338
27-05-2018,6,8989,13923,4955,1005,28874,673,188,175,1036,29910
27-05-2018,7,9588,14235,4908,987,29719,669,279,178,1126,30845
27-05-2018,8,11044,14613,5010,1150,31817,743,316,187,1246,33063
27-05-2018,9,11750,14958,5083,1372,33164,764,474,194,1432,34596
27-05-2018,10,11975,15080,5176,1692,33924,777,556,207,1540,35464
27-05-2018,11,11833,15028,5226,1983,34071,764,577,213,1554,35625
27-05-2018,12,11365,14957,5292,2209,33823,618,568,204,1390,35213
27-05-2018,13,10884,15021,5378,2376,33658,671,572,205,1448,35106
27-05-2018,14,10543,14998,5257,2760,33559,701,508,202,1411,34970
27-05-2018,15,10650,15076,5193,3014,33935,695,502,198,1395,35330
27-05-2018,16,10926,15277,5151,3163,34517,688,431,196,1315,35832
27-05-2018,17,12194,15551,5145,3070,35960,678,494,192,1364,37324
27-05-2018,18,13520,15942,5258,2761,37481,657,492,195,1344,38825
27-05-2018,19,14755,16385,5353,2300,38793,665,435,267,1367,40160
27-05-2018,20,14818,16647,5233,2070,38770,752,436,245,1433,40203
27-05-2018,21,14382,16480,5184,2044,38091,778,330,227,1335,39426
27-05-2018,22,13269,16285,5131,2236,36921,830,325,237,1392,38313
27-05-2018,23,11070,15436,4953,2248,33707,876,241,234,1351,35058
28-05-2018,0,9745,14960,4748,2386,31840,857,152,279,1288,33128
28-05-2018,1,8825,14734,4768,2389,30716,825,156,350,1331,32047
28-05-2018,2,8270,14590,4705,2405,29970,786,159,345,1290,31260
28-05-2018,3,7944,14446,4976,2372,29739,764,157,345,1266,31005
28-05-2018,4,8222,14514,5161,2438,30336,784,177,343,1304,31640
28-05-2018,5,9757,15042,5445,2249,32493,993,236,332,1561,34054
28-05-2018,6,13662,16765,5994,2475,38896,1096,331,265,1692,40588
28-05-2018,7,16227,18491,6285,2397,43398,1099,790,451,2340,45738
28-05-2018,8,16735,18491,6476,2511,44214,1104,871,437,2412,46626
28-05-2018,9,16519,17709,6536,2544,43309,1107,892,437,2436,45745
28-05-2018,10,16861,17614,6481,2501,43457,1107,950,456,2513,45970
28-05-2018,11,16831,18137,6494,2362,43824,1128,932,468,2528,46352
28-05-2018,12,16678,17813,6501,2410,43402,1139,934,471,2544,45946
28-05-2018,13,16439,17495,6439,2363,42739,1148,850,464,2462,45201
28-05-2018,14,16836,17493,6077,2262,42667,1138,663,454,2255,44922
28-05-2018,15,16534,17265,5947,2169,41915,1247,605,448,2300,44215
28-05-2018,16,16254,17429,6187,2210,42081,1140,439,392,1971,44052
28-05-2018,17,16042,17268,6263,2236,41810,1133,462,407,2002,43812
28-05-2018,18,15991,17145,6412,2213,41760,1118,458,422,1998,43758
28-05-2018,19,16155,17096,6449,2016,41717,1106,371,448,1925,43642
28-05-2018,20,16081,16940,6375,1689,41085,1114,283,472,1869,42954
28-05-2018,21,15828,16638,6219,1627,40312,1105,221,517,1843,42155
28-05-2018,22,14708,16234,6148,1736,38827,1090,221,385,1696,40523
28-05-2018,23,11749,15447,5950,1565,34711,1118,210,429,1757,36468
29-05-2018,0,10242,14716,5620,1502,32079,1000,173,402,1575,33654
29-05-2018,1,9287,14189,5468,1503,30447,946,167,341,1454,31901
29-05-2018,2,8917,14243,5531,1542,30232,958,168,305,1431,31663
29-05-2018,3,8769,14123,5545,1377,29815,1009,170,277,1456,31271
29-05-2018,4,8920,13960,5547,1234,29662,1045,189,255,1489,31151
29-05-2018,5,10111,14458,5645,1257,31470,1183,336,232,1751,33221
29-05-2018,6,13503,16009,5926,1382,36821,1286,439,213,1938,38759
29-05-2018,7,16206,17472,6367,1597,41643,1289,727,448,2464,44107
29-05-2018,8,16631,17675,6449,1734,42489,1281,855,447,2583,45072
29-05-2018,9,16430,17734,6467,1898,42529,1264,1002,472,2738,45267
29-05-2018,10,16403,17714,6523,2059,42701,1268,1095,494,2857,45558
29-05-2018,11,16292,17684,6439,2193,42608,1269,1015,503,2787,45395
29-05-2018,12,16159,17897,6476,2294,42829,1273,998,499,2770,45599
29-05-2018,13,15972,17859,6508,2389,42730,1270,986,496,2752,45482
29-05-2018,14,15268,17541,6554,2515,41878,1280,785,449,2514,44392
29-05-2018,15,14910,17167,6469,2472,41018,1282,758,436,2476,43494
29-05-2018,16,14782,17524,6341,2355,41002,1300,376,406,2082,43084
29-05-2018,17,15413,17745,6466,2515,42139,1304,375,390,2069,44208
29-05-2018,18,15855,17627,6587,2448,42517,1303,381,388,2072,44589
29-05-2018,19,16021,17368,6629,1969,41988,1305,381,379,2065,44053
29-05-2018,20,15424,16917,6498,1735,40577,1318,394,413,2125,42702
29-05-2018,21,14678,16185,6387,2053,39303,1340,333,307,1980,41283
29-05-2018,22,14083,16196,6321,1814,38415,1361,332,233,1926,40341
29-05-2018,23,11339,15391,6035,2302,35068,1339,315,231,1885,36953
30-05-2018,0,10215,14916,5874,2390,33395,1149,164,215,1528,34923
30-05-2018,1,9298,14397,5717,2414,31825,1115,157,207,1479,33304
30-05-2018,2,8781,14304,5623,2489,31198,1103,160,214,1477,32675
30-05-2018,3,8878,14074,5602,2482,31039,1076,162,212,1450,32489
30-05-2018,4,9263,14229,5524,2474,31489,1108,165,219,1492,32981
30-05-2018,5,10278,14483,5592,2583,32936,1231,224,222,1677,34613
30-05-2018,6,13652,15777,5900,2700,38028,1275,298,230,1803,39831
30-05-2018,7,16204,17900,6374,2547,43025,1309,697,438,2444,45469
30-05-2018,8,16448,18233,6590,2612,43884,1297,921,455,2673,46557
30-05-2018,9,16148,18066,6559,2862,43636,1285,1018,441,2744,46380
30-05-2018,10,15931,17517,6507,3171,43127,1289,1139,479,2907,46034
30-05-2018,11,15982,17316,6504,3431,43234,1296,1096,464,2856,46090
30-05-2018,12,15715,16948,6477,3589,42729,1305,1099,470,2874,45603
30-05-2018,13,15849,16855,6495,3729,42928,1310,1080,443,2833,45761
30-05-2018,14,15864,16710,6286,3506,42366,1325,917,443,2685,45051
30-05-2018,15,15947,16808,6035,3149,41939,1335,797,349,2481,44420
30-05-2018,16,16129,16840,6106,2912,41988,1321,439,308,2068,44056
30-05-2018,17,16375,17388,6172,2749,42684,1310,440,410,2160,44844
30-05-2018,18,16052,17173,6239,2694,42158,1296,275,427,1998,44156
30-05-2018,19,15952,17177,6484,2350,41963,1291,292,265,1848,43811
30-05-2018,20,16390,17283,6121,2117,41911,1290,238,287,1815,43726
30-05-2018,21,16010,16950,5871,2068,40900,1303,221,295,1819,42719
30-05-2018,22,15300,16837,5650,2028,39816,1330,209,334,1873,41689
30-05-2018,23,13834,15893,5425,1796,36949,1306,200,361,1867,38816
31-05-2018,0,11083,15178,5328,1776,33366,1321,158,335,1814,35180
31-05-2018,1,9701,14752,5141,1922,31517,1271,155,310,1736,33253
31-05-2018,2,9235,14529,4932,1969,30664,1223,155,331,1709,32373
31-05-2018,3,9114,14548,4858,1990,30509,1189,155,341,1685,32194
31-05-2018,4,9159,14657,4886,2062,30764,1170,155,317,1642,32406
31-05-2018,5,9887,15050,5003,2159,32098,1123,219,284,1626,33724
31-05-2018,6,12580,16190,5414,2247,36431,1131,466,227,1824,38255
31-05-2018,7,15509,17601,5730,2403,41243,1143,810,418,2371,43614
31-05-2018,8,16236,17929,5885,2578,42629,1140,875,455,2470,45099
31-05-2018,9,15549,17699,5814,2887,41950,1135,862,446,2443,44393
31-05-2018,10,15456,17686,5778,3204,42123,1134,995,487,2616,44739
31-05-2018,11,15055,17597,5803,3399,41855,1140,911,524,2575,44430
31-05-2018,12,14519,17715,5918,3406,41559,1130,971,534,2635,44194
31-05-2018,13,14669,17895,5820,3280,41664,1135,877,389,2401,44065
31-05-2018,14,14760,18042,5560,3196,41558,1128,642,291,2061,43619
31-05-2018,15,14366,17935,5466,3052,40819,1088,519,281,1888,42707
31-05-2018,16,13969,17891,5433,2916,40210,1107,308,277,1692,41902
31-05-2018,17,14785,17896,5501,2750,40932,1090,293,284,1667,42599
31-05-2018,18,15773,18271,5969,2483,42496,1094,296,287,1677,44173
31-05-2018,19,15988,18279,5832,2146,42245,1094,300,280,1674,43919
31-05-2018,20,15682,18510,5584,1893,41668,1091,314,314,1719,43387
31-05-2018,21,15193,17855,5434,1943,40426,1081,315,376,1772,42198
31-05-2018,22,14275,17460,5427,2032,39193,1088,304,434,1826,41019
31-05-2018,23,11713,16617,5385,1914,35629,1126,193,434,1753,37382
01-06-2018,0,10629,15214,5427,1922,33191,1057,168,436,1661,34852
01-06-2018,1,9575,14692,5570,1815,31652,1001,167,433,1601,33253
01-06-2018,2,9246,14518,5653,1724,31142,982,169,413,1564,32706
01-06-2018,3,9156,14427,5735,1659,30977,1007,174,397,1578,32555
01-06-2018,4,9256,14231,5837,1601,30927,1022,171,416,1609,32536
01-06-2018,5,10741,14445,5755,1544,32485,1163,229,395,1787,34272
01-06-2018,6,13863,16224,6083,1599,37769,1181,365,314,1860,39629
01-06-2018,7,15139,17322,6282,1624,40367,1242,929,449,2620,42987
01-06-2018,8,15521,17878,6660,1678,41738,1287,882,438,2607,44345
01-06-2018,9,15738,17975,6577,1758,42050,1290,966,443,2699,44749
01-06-2018,10,15886,17777,6511,2021,42195,1292,1081,463,2836,45031
01-06-2018,11,15582,17791,6432,2042,41848,1304,1156,465,2925,44773
01-06-2018,12,15522,17758,6374,2166,41820,1317,1072,457,2846,44666
01-06-2018,13,15411,17586,6218,2234,41450,1313,1051,435,2799,44249
01-06-2018,14,15251,17407,6115,2131,40904,1302,856,408,2566,43470
01-06-2018,15,15130,16912,5885,2012,39940,1300,753,315,2368,42308
01-06-2018,16,15080,16566,5615,1727,38987,1293,725,220,2238,41225
01-06-2018,17,15164,16386,5681,1490,38721,1227,358,199,1784,40505
01-06-2018,18,16483,16491,5921,1376,40271,1216,333,183,1732,42003
01-06-2018,19,16670,16555,5874,1132,40231,1234,323,349,1906,42137
01-06-2018,20,16251,16098,5457,939,38745,1283,257,307,1847,40592
01-06-2018,21,15640,15608,5366,904,37516,1229,181,391,1801,39317
01-06-2018,22,15159,15515,5359,892,36925,1263,193,241,1697,38622
01-06-2018,23,13980,15005,5107,944,35036,1291,153,228,1672,36708
02-06-2018,0,11277,13737,4878,865,30758,1023,127,236,1386,32144
02-06-2018,1,10236,13254,4768,807,29066,941,123,232,1296,30362
02-06-2018,2,9941,13021,4566,791,28320,909,121,241,1271,29591
02-06-2018,3,9659,12938,4538,748,27884,844,121,277,1242,29126
02-06-2018,4,9571,12918,4548,685,27722,827,122,245,1194,28916
02-06-2018,5,9780,13129,4569,694,28171,810,123,228,1161,29332
02-06-2018,6,10824,13475,4517,723,29539,796,125,224,1145,30684
02-06-2018,7,12549,13990,4596,814,31947,823,215,204,1242,33189
02-06-2018,8,13971,14821,4810,901,34504,886,300,210,1396,35900
02-06-2018,9,14836,15209,5014,1174,36234,794,441,203,1438,37672
02-06-2018,10,14605,15352,5062,1303,36323,820,490,372,1682,38005
02-06-2018,11,14417,15380,5154,1400,36352,819,490,367,1676,38028
02-06-2018,12,14146,15397,5121,1377,36042,826,494,385,1705,37747
02-06-2018,13,13241,14747,5054,1380,34422,836,451,248,1535,35957
02-06-2018,14,12820,14588,5113,1315,33835,844,393,261,1498,35333
02-06-2018,15,12911,14336,5088,1322,33656,859,377,267,1503,35159
02-06-2018,16,13030,14487,5103,1291,33910,862,299,240,1401,35311
02-06-2018,17,13750,14921,5204,1165,35040,865,298,220,1383,36423
02-06-2018,18,13936,15239,5262,999,35436,869,288,206,1363,36799
02-06-2018,19,14023,15400,5231,892,35546,862,293,165,1320,36866
02-06-2018,20,14269,15479,5208,814,35770,882,259,172,1313,37083
02-06-2018,21,14006,15441,5284,783,35514,903,258,148,1309,36823
02-06-2018,22,13382,14992,5350,772,34496,940,204,151,1295,35791
02-06-2018,23,12181,14012,5320,876,32391,958,123,151,1232,33623
03-06-2018,0,11138,12717,5221,885,29960,880,122,145,1147,31107
03-06-2018,1,10191,12009,5018,940,28158,878,121,152,1151,29309
03-06-2018,2,9397,12033,5017,919,27365,890,121,150,1161,28526
03-06-2018,3,9015,11998,5039,875,26927,867,121,153,1141,28068
03-06-2018,4,8682,11951,4982,878,26495,819,123,159,1101,27596
03-06-2018,5,8912,12087,4913,905,26819,833,123,155,1111,27930
03-06-2018,6,9768,12135,4872,926,27702,849,123,148,1120,28822
03-06-2018,7,10438,12464,4749,997,28649,807,122,157,1086,29735
03-06-2018,8,11555,13099,4807,1102,30564,780,181,155,1116,31680
03-06-2018,9,12346,13759,4935,1221,32261,786,295,183,1264,33525
03-06-2018,10,12828,14127,5055,1411,33422,780,297,199,1276,34698
03-06-2018,11,12873,14249,5164,1627,33912,770,296,217,1283,35195
03-06-2018,12,12841,14551,5224,1766,34382,758,299,239,1296,35678
03-06-2018,13,12291,14621,5252,1875,34038,749,299,255,1303,35341
03-06-2018,14,11853,14611,5172,1988,33622,780,296,259,1335,34957
03-06-2018,15,11578,14638,5154,1964,33335,839,299,274,1412,34747
03-06-2018,16,11424,14628,5253,1975,33280,823,255,249,1327,34607
03-06-2018,17,11860,15026,5412,1973,34272,806,248,219,1273,35545
03-06-2018,18,12588,15357,5462,1961,35369,814,329,176,1319,36688
03-06-2018,19,13861,15753,5555,1783,36951,824,357,149,1330,38281
03-06-2018,20,14826,16157,5654,1563,38201,836,359,148,1343,39544
03-06-2018,21,15145,16485,5737,1625,38993,848,392,162,1402,40395
03-06-2018,22,14310,16481,5707,1784,38282,855,358,186,1399,39681
03-06-2018,23,11638,15664,5629,1636,34566,786,147,203,1136,35702
04-06-2018,0,10036,15290,5589,1734,32650,627,129,191,947,33597
04-06-2018,1,9220,15115,5668,1767,31770,589,129,182,900,32670
04-06-2018,2,8789,14918,5612,1912,31232,608,132,199,939,32171
04-06-2018,3,8755,14850,5618,1985,31207,589,135,224,948,32155
04-06-2018,4,8769,15202,5581,2036,31588,616,131,235,982,32570
04-06-2018,5,9669,15664,5718,2017,33068,679,148,239,1066,34134
04-06-2018,6,13010,17488,6191,2160,38849,700,338,240,1278,40127
04-06-2018,7,15143,18896,6602,2217,42858,699,377,432,1508,44366
04-06-2018,8,15613,19899,6838,2460,44811,699,348,463,1510,46321
04-06-2018,9,15743,19936,6946,2645,45270,713,505,531,1749,47019
04-06-2018,10,15874,19986,6902,2817,45580,748,604,576,1928,47508
04-06-2018,11,15841,19877,6904,3034,45656,798,686,620,2104,47760
04-06-2018,12,15666,19919,6837,2967,45390,843,559,664,2066,47456
04-06-2018,13,15129,19631,6776,3008,44545,868,485,653,2006,46551
04-06-2018,14,14871,19461,6693,2988,44012,890,345,695,1930,45942
04-06-2018,15,14605,19381,6571,2923,43481,893,283,685,1861,45342
04-06-2018,16,14386,19174,6582,2700,42841,873,312,627,1812,44653
04-06-2018,17,15448,19470,6667,2921,44505,830,333,602,1765,46270
04-06-2018,18,15924,19371,6622,2906,44825,855,349,403,1607,46432
04-06-2018,19,15521,19288,6670,2492,43970,869,320,536,1725,45695
04-06-2018,20,15089,18729,6564,2225,42608,870,311,402,1583,44191
04-06-2018,21,14759,18237,6542,1942,41482,865,275,227,1367,42849
04-06-2018,22,14094,18183,6542,1767,40587,842,293,226,1361,41948
04-06-2018,23,12471,17285,6369,1515,37640,857,140,219,1216,38856
05-06-2018,0,11422,15819,6197,1338,34776,869,137,216,1222,35998
05-06-2018,1,10556,15507,6103,1160,33325,878,135,214,1227,34552
05-06-2018,2,10232,15442,6003,988,32665,878,135,192,1205,33870
05-06-2018,3,10189,15643,6039,935,32807,878,131,169,1178,33985
05-06-2018,4,10043,15724,6005,1102,32874,890,131,164,1185,34059
05-06-2018,5,10931,16205,6123,1353,34613,877,133,163,1173,35786
05-06-2018,6,14352,17758,6471,1543,40123,871,168,169,1208,41331
05-06-2018,7,16336,18652,6755,1648,43393,855,308,350,1513,44906
05-06-2018,8,16186,19660,6906,1987,44740,867,467,399,1733,46473
05-06-2018,9,16432,19636,6922,2247,45236,869,786,458,2113,47349
05-06-2018,10,16659,19775,6976,2170,45582,878,715,467,2060,47642
05-06-2018,11,16656,19760,6888,2179,45483,863,710,525,2098,47581
05-06-2018,12,16674,19589,6812,2081,45157,853,694,626,2173,47330
05-06-2018,13,16731,19342,6795,2103,44972,875,573,633,2081,47053
05-06-2018,14,16355,18995,6634,2063,44048,867,571,540,1978,46026
05-06-2018,15,16530,19015,6259,1628,43432,833,589,533,1955,45387
05-06-2018,16,16430,18894,6130,1481,42934,809,596,507,1912,44846
05-06-2018,17,16750,18830,6165,1543,43289,848,513,506,1867,45156
05-06-2018,18,16723,18445,6464,1281,42914,856,258,514,1628,44542
05-06-2018,19,17005,18118,6364,1316,42803,842,253,466,1561,44364
05-06-2018,20,16926,18015,5988,1177,42105,827,198,368,1393,43498
05-06-2018,21,16491,17819,5717,1058,41085,822,151,319,1292,42377
05-06-2018,22,16111,17497,5720,1113,40442,830,151,302,1283,41725
05-06-2018,23,14121,15890,5481,1001,36494,826,140,270,1236,37730
06-06-2018,0,11924,14560,5201,1060,32746,712,135,259,1106,33852
06-06-2018,1,10642,14322,5198,1130,31293,686,130,274,1090,32383
06-06-2018,2,10020,13952,5199,1203,30375,678,128,270,1076,31451
06-06-2018,3,9969,13799,5223,1198,30190,684,131,290,1105,31295
06-06-2018,4,10095,13911,5247,1167,30419,697,157,270,1124,31543
06-06-2018,5,11027,14185,5415,1186,31814,731,192,253,1176,32990
06-06-2018,6,13563,16028,5781,1322,36695,784,659,206,1649,38344
06-06-2018,7,15702,17295,6240,1453,40690,805,890,383,2078,42768
06-06-2018,8,16287,17810,6175,1597,41869,819,1156,431,2406,44275
06-06-2018,9,16509,18019,6317,1656,42503,825,1198,424,2447,44950
06-06-2018,10,16978,18014,6251,1769,43013,844,1200,422,2466,45479
06-06-2018,11,16845,17782,6243,1818,42688,849,1199,440,2488,45176
06-06-2018,12,16136,17558,6302,1716,41713,856,1198,462,2516,44229
06-06-2018,13,15659,17361,6297,1875,41191,868,1142,443,2453,43644
06-06-2018,14,15482,17178,6244,1856,40761,884,1144,467,2495,43256
06-06-2018,15,16403,17468,5957,1576,41405,899,1120,286,2305,43710
06-06-2018,16,16551,17697,5667,1621,41535,829,1111,314,2254,43789
06-06-2018,17,17009,17926,5820,1640,42395,804,1010,266,2080,44475
06-06-2018,18,17224,18011,5992,1492,42720,818,639,210,1667,44387
06-06-2018,19,17127,17731,6079,1371,42309,829,546,188,1563,43872
06-06-2018,20,16816,17507,5766,1319,41408,828,268,256,1352,42760
06-06-2018,21,16549,17137,5635,1301,40622,826,126,164,1116,41738
06-06-2018,22,15066,16197,5724,1297,38284,830,126,162,1118,39402
06-06-2018,23,12522,14999,5571,1328,34420,819,125,172,1116,35536
07-06-2018,0,10891,13484,5415,1333,31124,808,135,144,1087,32211
07-06-2018,1,9807,13286,5366,1326,29785,783,123,150,1056,30841
07-06-2018,2,9346,13382,5432,1307,29467,768,123,182,1073,30540
07-06-2018,3,9127,13404,5431,1250,29211,766,124,201,1091,30302
07-06-2018,4,8934,13924,5446,1275,29581,765,123,180,1068,30649
07-06-2018,5,9907,14408,5600,1309,31224,774,123,169,1066,32290
07-06-2018,6,13385,16542,6102,1396,37426,778,385,161,1324,38750
07-06-2018,7,16480,18497,6519,1625,43121,809,674,311,1794,44915
07-06-2018,8,16959,18691,6464,1764,43879,903,1064,342,2309,46188
07-06-2018,9,16467,18686,6378,1871,43402,786,1234,370,2390,45792
07-06-2018,10,16557,19017,6452,2025,44052,801,1141,367,2309,46361
07-06-2018,11,16341,18959,6457,2143,43900,837,1189,399,2425,46325
07-06-2018,12,15602,18681,6467,2039,42789,869,1148,398,2415,45204
07-06-2018,13,15457,18626,6389,2066,42537,894,1083,442,2419,44956
07-06-2018,14,15832,18619,6412,1969,42832,917,953,408,2278,45110
07-06-2018,15,16880,18894,6201,1817,43792,928,761,253,1942,45734
07-06-2018,16,16574,19276,6075,1671,43596,921,548,234,1703,45299
07-06-2018,17,16862,19218,6005,1715,43801,918,538,215,1671,45472
07-06-2018,18,16534,18773,6118,1584,43008,896,527,176,1599,44607
07-06-2018,19,16600,18469,6219,1362,42651,891,528,148,1567,44218
07-06-2018,20,16578,18445,5818,1147,41987,863,368,128,1359,43346
07-06-2018,21,16487,17828,5539,1011,40865,826,165,210,1201,42066
07-06-2018,22,15807,17469,5376,878,39530,827,146,237,1210,40740
07-06-2018,23,13589,15413,5106,818,34927,809,145,171,1125,36052
08-06-2018,0,11716,13945,5062,789,31514,803,145,218,1166,32680
08-06-2018,1,10713,13341,4909,813,29777,790,147,248,1185,30962
08-06-2018,2,10529,13142,4831,761,29262,793,154,297,1244,30506
08-06-2018,3,10882,13044,4872,698,29497,786,147,336,1269,30766
08-06-2018,4,10985,13342,4955,691,29973,757,135,318,1210,31183
08-06-2018,5,12151,13732,5237,683,31803,747,135,289,1171,32974
08-06-2018,6,15196,16015,5792,879,37883,775,512,244,1531,39414
08-06-2018,7,17595,17416,6234,1196,42441,790,886,392,2068,44509
08-06-2018,8,18090,17766,6251,1389,43498,790,1226,397,2413,45911
08-06-2018,9,17963,17682,6173,1459,43278,784,1166,422,2372,45650
08-06-2018,10,17655,17590,6138,1574,42957,792,1109,442,2343,45300
08-06-2018,11,18101,17804,6128,1614,43647,789,1118,437,2344,45991
08-06-2018,12,17466,17251,6090,1558,42365,779,1098,441,2318,44683
08-06-2018,13,17354,16733,6156,1670,41913,779,936,422,2137,44050
08-06-2018,14,17014,16550,6108,1697,41370,776,886,418,2080,43450
08-06-2018,15,16870,16280,5882,1746,40777,765,886,231,1882,42659
08-06-2018,16,16937,16213,5751,1631,40533,769,688,212,1669,42202
08-06-2018,17,17468,16543,5666,1567,41245,821,655,291,1767,43012
08-06-2018,18,17165,16332,5627,1490,40614,881,701,364,1946,42560
08-06-2018,19,17134,16362,5674,1226,40398,798,703,326,1827,42225
08-06-2018,20,17001,16059,5394,1123,39578,839,569,161,1569,41147
08-06-2018,21,16729,15476,5169,970,38343,853,160,166,1179,39522
08-06-2018,22,16709,15271,5027,790,37797,773,144,167,1084,38881
08-06-2018,23,15161,14174,4760,770,34866,766,141,194,1101,35967
09-06-2018,0,13188,12801,4588,648,31225,868,172,242,1282,32507
09-06-2018,1,12323,12027,4450,678,29478,876,182,234,1292,30770
09-06-2018,2,11866,11788,4430,626,28710,881,184,223,1288,29998
09-06-2018,3,11615,11632,4358,603,28209,890,177,231,1298,29507
09-06-2018,4,11319,11426,4332,610,27689,854,178,243,1275,28964
09-06-2018,5,11412,11441,4345,628,27826,839,177,198,1214,29040
09-06-2018,6,12631,12044,4557,735,29967,870,171,141,1182,31149
09-06-2018,7,14150,12888,5027,786,32851,885,173,133,1191,34042
09-06-2018,8,15273,13843,5310,931,35357,896,270,311,1477,36834
09-06-2018,9,15986,14097,5587,989,36660,892,690,349,1931,38591
09-06-2018,10,16086,14298,5670,1066,37121,899,689,358,1946,39067
09-06-2018,11,15951,14177,5596,1156,36880,905,701,377,1983,38863
09-06-2018,12,15392,14107,5423,1144,36067,903,806,349,2058,38125
09-06-2018,13,14933,13876,5298,1135,35243,904,812,360,2076,37319
09-06-2018,14,14483,13880,5247,1136,34747,896,539,214,1649,36396
09-06-2018,15,14428,13858,5087,1098,34471,904,534,205,1643,36114
09-06-2018,16,14761,13886,4832,1103,34583,889,546,192,1627,36210
09-06-2018,17,15520,13914,4924,1028,35387,826,530,167,1523,36910
09-06-2018,18,16325,14190,5389,995,36898,869,224,342,1435,38333
09-06-2018,19,16458,14551,5324,863,37197,868,220,155,1243,38440
09-06-2018,20,16280,14291,4917,728,36216,877,173,155,1205,37421
09-06-2018,21,16041,13707,4628,591,34967,872,165,169,1206,36173
09-06-2018,22,15413,13350,4529,589,33883,881,178,175,1234,35117
09-06-2018,23,13281,12763,4298,589,30930,880,175,194,1249,32179
10-06-2018,0,12276,11922,4393,567,29157,695,168,216,1079,30236
10-06-2018,1,11521,11514,4364,552,27951,675,168,214,1057,29008
10-06-2018,2,11143,11316,4327,553,27338,683,165,214,1062,28400
10-06-2018,3,10494,11160,4281,556,26490,694,164,211,1069,27559
10-06-2018,4,10444,11081,4271,572,26368,671,165,197,1033,27401
10-06-2018,5,10729,11067,4220,556,26573,667,170,195,1032,27605
10-06-2018,6,11202,11333,4299,592,27427,664,174,204,1042,28469
10-06-2018,7,12187,11618,4508,636,28950,659,181,161,1001,29951
10-06-2018,8,13241,12049,4640,658,30588,669,186,158,1013,31601
10-06-2018,9,14416,12583,4652,644,32296,660,190,166,1016,33312
10-06-2018,10,15270,13092,4673,769,33805,663,188,185,1036,34841
10-06-2018,11,15604,13311,4689,890,34494,662,184,202,1048,35542
10-06-2018,12,15442,13416,4764,921,34543,672,179,192,1043,35586
10-06-2018,13,14937,13392,4843,1093,34264,673,172,195,1040,35304
10-06-2018,14,13949,13297,4781,1164,33192,666,186,185,1037,34229
10-06-2018,15,13548,13229,4737,1101,32616,666,217,164,1047,33663
10-06-2018,16,13939,13367,4756,988,33052,662,203,149,1014,34066
10-06-2018,17,14815,13699,4675,997,34187,662,242,141,1045,35232
10-06-2018,18,15897,14049,4613,1115,35674,685,260,128,1073,36747
10-06-2018,19,16600,14284,4614,1172,36673,718,481,124,1323,37996
10-06-2018,20,16621,14464,4653,1201,36940,753,574,154,1481,38421
10-06-2018,21,16620,14437,4692,1213,36963,756,565,219,1540,38503
10-06-2018,22,16391,13880,4708,1322,36301,765,270,297,1332,37633
10-06-2018,23,13640,12804,4515,1384,32344,782,237,329,1348,33692
11-06-2018,0,12002,12276,4495,1651,30425,880,195,318,1393,31818
11-06-2018,1,10626,11915,4445,1913,28898,893,195,281,1369,30267
11-06-2018,2,10377,11839,4448,2187,28850,926,198,268,1392,30242
11-06-2018,3,10275,11887,4372,2258,28793,1030,192,245,1467,30260
11-06-2018,4,10259,12356,4482,2429,29527,1047,191,218,1456,30983
11-06-2018,5,11679,12698,4612,2616,31604,1032,194,187,1413,33017
11-06-2018,6,14787,14098,4810,2799,36495,1005,207,232,1444,37939
11-06-2018,7,16663,15223,5206,3008,40101,999,491,284,1774,41875
11-06-2018,8,16988,16044,5438,3278,41747,1002,583,372,1957,43704
11-06-2018,9,16967,16201,5530,3404,42104,1006,971,380,2357,44461
11-06-2018,10,16961,16307,5652,3556,42476,1001,929,331,2261,44737
11-06-2018,11,16932,16053,5693,4026,42704,1000,905,328,2233,44937
11-06-2018,12,16725,16054,5653,4352,42786,1003,906,434,2343,45129
11-06-2018,13,16495,15961,5642,4677,42776,1000,894,411,2305,45081
11-06-2018,14,16079,15850,5723,4855,42508,1017,876,228,2121,44629
11-06-2018,15,16217,15808,5675,4653,42354,1023,791,224,2038,44392
11-06-2018,16,16065,15885,5656,4635,42242,1016,711,186,1913,44155
11-06-2018,17,16657,16200,5685,4888,43431,1021,617,257,1895,45326
11-06-2018,18,16651,16398,5478,4691,43219,960,370,287,1617,44836
11-06-2018,19,16409,16250,5452,4103,42215,924,356,273,1553,43768
11-06-2018,20,16204,15844,5491,3755,41296,968,351,250,1569,42865
11-06-2018,21,15789,15528,5554,3498,40369,996,350,257,1603,41972
11-06-2018,22,14938,15144,5599,3046,38727,984,348,262,1594,40321
11-06-2018,23,12491,14314,5242,2951,34999,989,348,265,1602,36601
12-06-2018,0,10171,13078,5204,3291,31745,996,355,266,1617,33362
12-06-2018,1,9013,12820,5256,3278,30367,1002,362,284,1648,32015
12-06-2018,2,8571,12817,5283,3027,29699,1004,364,310,1678,31377
12-06-2018,3,9032,12765,5234,2720,29752,994,358,313,1665,31417
12-06-2018,4,9838,12916,5167,2518,30440,971,355,299,1625,32065
12-06-2018,5,11401,12751,5162,2294,31609,993,355,269,1617,33226
12-06-2018,6,14605,14277,5481,2152,36515,994,364,232,1590,38105
12-06-2018,7,16815,15371,5901,2218,40303,993,568,316,1877,42180
12-06-2018,8,17735,15792,6028,2133,41689,996,788,444,2228,43917
12-06-2018,9,17967,15945,6050,2102,42064,1047,1010,487,2544,44608
12-06-2018,10,17795,16014,6095,1982,41887,1032,999,489,2520,44407
12-06-2018,11,17582,15972,6070,1953,41577,1021,997,497,2515,44092
12-06-2018,12,17500,15903,5922,1859,41185,1008,998,495,2501,43686
12-06-2018,13,17456,15795,5874,1900,41026,1006,996,509,2511,43537
12-06-2018,14,17498,15710,5846,1862,40917,1004,994,392,2390,43307
12-06-2018,15,17526,15411,5799,1916,40652,1016,968,400,2384,43036
12-06-2018,16,17562,15461,5734,1811,40568,1028,938,348,2314,42882
12-06-2018,17,17665,15757,5595,1813,40831,1031,769,269,2069,42900
12-06-2018,18,17598,15618,5635,1847,40697,1031,408,308,1747,42444
12-06-2018,19,17269,15681,5558,1710,40219,1041,405,262,1708,41927
12-06-2018,20,17008,15532,5459,1661,39660,1040,401,276,1717,41377
12-06-2018,21,16312,14856,5528,1720,38417,1047,394,238,1679,40096
12-06-2018,22,16223,14624,5360,1746,37953,1050,482,181,1713,39666
12-06-2018,23,14631,13236,4984,1685,34536,1062,361,179,1602,36138
13-06-2018,0,12378,11767,4772,1818,30736,1048,345,158,1551,32287
13-06-2018,1,11231,11557,4626,1841,29257,1043,338,156,1537,30794
13-06-2018,2,10971,11359,4743,1926,29000,1036,337,157,1530,30530
13-06-2018,3,10665,11251,4847,1930,28692,1030,340,128,1498,30190
13-06-2018,4,10506,11680,4876,1978,29041,1020,340,107,1467,30508
13-06-2018,5,11525,12040,5094,2196,30856,1014,344,110,1468,32324
13-06-2018,6,14951,14026,5495,2432,36905,1005,730,152,1887,38792
13-06-2018,7,17231,15951,5961,2967,42109,1004,866,319,2189,44298
13-06-2018,8,17721,16362,6203,3174,43460,1001,1086,338,2425,45885
13-06-2018,9,17570,16367,6255,3442,43634,1005,1373,345,2723,46357
13-06-2018,10,17317,16391,6236,3651,43596,1010,1393,351,2754,46350
13-06-2018,11,17164,16444,6127,3850,43588,1003,1368,355,2726,46314
13-06-2018,12,17052,16354,6146,3955,43507,1011,1387,353,2751,46258
13-06-2018,13,16712,16160,6068,4055,42995,1014,1258,339,2611,45606
13-06-2018,14,16576,15814,6166,4415,42970,1007,1059,341,2407,45377
13-06-2018,15,16187,15791,6009,4519,42505,1007,832,244,2083,44588
13-06-2018,16,16318,15477,5718,4249,41763,1009,801,169,1979,43742
13-06-2018,17,16466,15507,5842,3954,41768,1016,809,153,1978,43746
13-06-2018,18,16862,15748,5967,3923,42501,1013,598,137,1748,44249
13-06-2018,19,17207,15760,5990,3611,42569,1012,547,128,1687,44256
13-06-2018,20,17317,15849,5706,3042,41914,1017,464,133,1614,43528
13-06-2018,21,17069,15340,5597,2479,40484,1024,447,129,1600,42084
13-06-2018,22,16628,14882,5499,1995,39004,1030,413,125,1568,40572
13-06-2018,23,14476,13635,5166,1588,34867,1028,346,151,1525,36392
14-06-2018,0,12752,12044,4996,1562,31354,1024,345,135,1504,32858
14-06-2018,1,10996,11470,4848,1579,28894,1028,345,147,1520,30414
14-06-2018,2,9819,11536,4660,1633,27648,1031,346,136,1513,29161
14-06-2018,3,9825,11696,4698,1631,27850,1041,342,139,1522,29372
14-06-2018,4,10102,12141,4699,1561,28505,1063,341,124,1528,30033
14-06-2018,5,10732,12460,5044,1583,29820,1075,344,121,1540,31360
14-06-2018,6,13772,14331,5434,1926,35463,1067,591,114,1772,37235
14-06-2018,7,16020,15912,5817,2519,40268,1111,853,212,2176,42444
14-06-2018,8,17055,16564,6047,3093,42759,1171,910,325,2406,45165
14-06-2018,9,16916,16390,6128,3519,42955,1171,1066,309,2546,45501
14-06-2018,10,16763,16348,6123,4110,43343,1172,1074,323,2569,45912
14-06-2018,11,16005,16325,6228,4554,43113,1180,1098,342,2620,45733
14-06-2018,12,15552,16196,6382,4578,42710,1185,1147,310,2642,45352
14-06-2018,13,14984,16207,6402,5081,42674,1189,1107,301,2597,45271
14-06-2018,14,14200,16339,6290,5174,42003,1190,1109,162,2461,44464
14-06-2018,15,14249,16083,6007,5143,41481,1195,847,172,2214,43695
14-06-2018,16,14153,16259,5597,4836,40845,1193,715,175,2083,42928
14-06-2018,17,15205,16559,5530,4495,41789,1190,674,183,2047,43836
14-06-2018,18,15094,16814,6011,4337,42257,1183,363,186,1732,43989
14-06-2018,19,14933,16888,6044,4330,42196,1180,347,162,1689,43885
14-06-2018,20,14729,16944,5613,3874,41160,1173,348,142,1663,42823
14-06-2018,21,14788,16845,5607,3128,40370,1171,348,144,1663,42033
14-06-2018,22,13957,16700,5550,2568,38775,1188,348,154,1690,40465
14-06-2018,23,11157,15599,5374,2235,34366,1203,342,149,1694,36060
15-06-2018,0,9847,14860,5534,1927,32168,1192,340,149,1681,33849
15-06-2018,1,9467,14517,5579,1808,31370,1164,344,134,1642,33012
15-06-2018,2,8843,14425,5579,1643,30488,1156,348,135,1639,32127
15-06-2018,3,8741,14282,5538,1453,30015,1170,347,132,1649,31664
15-06-2018,4,9174,14630,5567,1267,30638,1175,346,129,1650,32288
15-06-2018,5,10525,14747,5588,1239,32099,1189,347,131,1667,33766
15-06-2018,6,14682,16720,5848,1401,38651,1184,348,175,1707,40358
15-06-2018,7,15835,17307,6259,1734,41135,1199,368,330,1897,43032
15-06-2018,8,16419,17811,6473,2042,42746,1205,673,351,2229,44975
15-06-2018,9,16487,17740,6508,2170,42904,1206,935,359,2500,45404
15-06-2018,10,16722,17715,6491,2263,43191,1218,915,361,2494,45685
15-06-2018,11,16837,17585,6531,2386,43340,1214,898,365,2477,45817
15-06-2018,12,16746,17537,6586,2228,43097,1223,934,365,2522,45619
15-06-2018,13,16563,17146,6436,2091,42236,1219,904,376,2499,44735
15-06-2018,14,16434,17130,6362,2084,42010,1220,886,387,2493,44503
15-06-2018,15,16208,16835,5949,1954,40948,1210,767,215,2192,43140
15-06-2018,16,16039,16768,5692,1755,40253,1193,585,217,1995,42248
15-06-2018,17,16307,16864,5762,1499,40433,1184,583,172,1939,42372
15-06-2018,18,16161,16501,6083,1230,39977,1162,354,167,1683,41660
15-06-2018,19,16307,16219,6026,974,39528,1156,353,144,1653,41181
15-06-2018,20,16008,15734,5495,781,38017,1140,353,132,1625,39642
15-06-2018,21,15769,15224,5438,702,37133,1150,374,134,1658,38791
15-06-2018,22,15797,14503,5541,679,36521,1131,348,135,1614,38135
15-06-2018,23,14746,13470,5522,628,34367,1140,342,141,1623,35990
16-06-2018,0,12630,11892,5479,566,30565,1046,192,144,1382,31947
16-06-2018,1,11319,10941,5305,614,28178,1049,183,139,1371,29549
16-06-2018,2,10778,10709,5138,636,27261,1049,183,141,1373,28634
16-06-2018,3,10556,10670,5045,639,26909,897,184,142,1223,28132
16-06-2018,4,10508,10577,4928,658,26671,889,184,153,1226,27897
16-06-2018,5,11274,10379,4657,662,26972,893,186,168,1247,28219
16-06-2018,6,12581,10492,4451,641,28164,888,191,150,1229,29393
16-06-2018,7,13734,11681,4361,792,30569,893,240,139,1272,31841
16-06-2018,8,14753,12662,4679,983,33079,894,246,140,1280,34359
16-06-2018,9,15373,13114,4859,1150,34497,893,355,146,1394,35891
16-06-2018,10,15675,13297,4994,1372,35336,896,378,154,1428,36764
16-06-2018,11,15375,13017,5010,1562,34965,899,411,179,1489,36454
16-06-2018,12,15117,12999,4972,1554,34644,886,349,284,1519,36163
16-06-2018,13,14555,12919,4883,1646,34004,898,350,194,1442,35446
16-06-2018,14,14577,12862,4848,1728,34015,897,237,204,1338,35353
16-06-2018,15,14476,12850,4766,1661,33753,897,237,200,1334,35087
16-06-2018,16,14586,12627,4778,1629,33619,896,242,192,1330,34949
16-06-2018,17,14818,13118,4753,1584,34273,896,281,181,1358,35631
16-06-2018,18,15323,13386,4744,1541,34997,900,225,165,1290,36287
16-06-2018,19,15863,13514,4715,1508,35601,900,190,158,1248,36849
16-06-2018,20,15291,13354,4895,1603,35143,917,190,141,1248,36391
16-06-2018,21,15085,13110,4760,1553,34508,911,190,136,1237,35745
16-06-2018,22,15012,13001,4787,1513,34313,914,190,141,1245,35558
16-06-2018,23,13800,11556,4571,1453,31380,913,188,144,1245,32625
17-06-2018,0,12449,10890,4551,1416,29307,736,179,202,1117,30424
17-06-2018,1,10949,10437,4371,1318,27074,733,180,118,1031,28105
17-06-2018,2,10247,10401,4291,1265,26205,732,179,115,1026,27231
17-06-2018,3,9766,10392,4235,1260,25654,752,181,115,1048,26702
17-06-2018,4,9772,10374,4187,1214,25548,751,180,109,1040,26588
17-06-2018,5,10017,10337,4185,1217,25757,771,197,108,1076,26833
17-06-2018,6,10479,10554,4218,1248,26499,766,228,114,1108,27607
17-06-2018,7,11133,11236,4230,1489,28090,769,218,123,1110,29200
17-06-2018,8,12049,12291,4308,1909,30555,775,185,134,1094,31649
17-06-2018,9,12848,12905,4362,2350,32466,776,188,146,1110,33576
17-06-2018,10,13159,13483,4434,2792,33869,787,193,159,1139,35008
17-06-2018,11,13066,13918,4573,3275,34834,787,199,168,1154,35988
17-06-2018,12,12862,13762,4532,3534,34691,793,188,174,1155,35846
17-06-2018,13,12675,13723,4534,3956,34887,792,190,171,1153,36040
17-06-2018,14,12557,13754,4558,3450,34320,795,194,165,1154,35474
17-06-2018,15,12559,13797,4529,3676,34562,801,195,159,1155,35717
17-06-2018,16,12650,13931,4512,3945,35038,797,195,150,1142,36180
17-06-2018,17,12897,14066,4529,3563,35055,783,193,141,1117,36172
17-06-2018,18,13329,14380,4469,3509,35688,782,192,123,1097,36785
17-06-2018,19,14286,14636,4564,3300,36786,786,211,112,1109,37895
17-06-2018,20,15146,14886,4736,2901,37669,782,196,186,1164,38833
17-06-2018,21,15362,14851,4905,2392,37511,798,230,114,1142,38653
17-06-2018,22,15029,14735,4989,2041,36794,811,192,133,1136,37930
17-06-2018,23,13350,14093,5035,1768,34248,831,181,149,1161,35409
18-06-2018,0,11187,13259,5006,1644,31094,964,177,168,1309,32403
18-06-2018,1,9854,12624,5093,1542,29113,1014,175,174,1363,30476
18-06-2018,2,9304,12322,5173,1519,28319,1010,176,186,1372,29691
18-06-2018,3,8793,12173,5299,1468,27734,988,178,186,1352,29086
18-06-2018,4,8895,12545,5248,1450,28138,971,183,172,1326,29464
18-06-2018,5,10342,12803,5247,1420,29813,1016,189,166,1371,31184
18-06-2018,6,14426,15716,5549,1585,37276,1146,191,195,1532,38808
18-06-2018,7,16466,17359,5994,2079,41900,1192,225,354,1771,43671
18-06-2018,8,17027,17826,6355,2304,43513,1198,838,350,2386,45899
18-06-2018,9,16991,17997,6416,2456,43860,1186,1032,372,2590,46450
18-06-2018,10,16428,18114,6417,3117,44076,1165,1018,371,2554,46630
18-06-2018,11,15981,17852,6512,3409,43753,1211,985,399,2595,46348
18-06-2018,12,15823,17719,6514,3566,43624,1219,1022,404,2645,46269
18-06-2018,13,15734,18121,6481,3456,43792,1223,1016,441,2680,46472
18-06-2018,14,15376,18041,6433,3471,43320,1230,948,447,2625,45945
18-06-2018,15,15345,18000,6108,3261,42714,1228,598,438,2264,44978
18-06-2018,16,14911,17852,5903,3110,41777,1250,641,270,2161,43938
18-06-2018,17,15880,18032,5909,2897,42718,1248,575,250,2073,44791
18-06-2018,18,16436,18281,6086,2853,43656,1191,441,189,1821,45477
18-06-2018,19,16345,18011,5977,2611,42944,1235,407,153,1795,44739
18-06-2018,20,15732,17815,5685,2290,41522,1233,389,137,1759,43281
18-06-2018,21,15244,17489,5399,2072,40203,1247,352,136,1735,41938
18-06-2018,22,14167,17199,5388,2072,38825,1235,349,154,1738,40563
18-06-2018,23,12028,15847,5195,2105,35174,1241,349,160,1750,36924
19-06-2018,0,10092,14675,5197,2408,32371,1015,343,171,1529,33900
19-06-2018,1,9139,14383,5101,2503,31126,880,343,190,1413,32539
19-06-2018,2,8849,14315,5113,2505,30782,849,349,207,1405,32187
19-06-2018,3,9109,14396,5030,2633,31166,806,348,214,1368,32534
19-06-2018,4,9512,14591,4936,2599,31637,832,354,200,1386,33023
19-06-2018,5,9920,15019,4988,2530,32458,1124,364,216,1704,34162
19-06-2018,6,12360,16931,5505,2774,37569,1283,372,243,1898,39467
19-06-2018,7,14603,19365,5973,2863,42805,1321,386,456,2163,44968
19-06-2018,8,15170,19999,6085,3274,44528,1329,389,504,2222,46750
19-06-2018,9,14603,20053,6178,3659,44493,1347,590,566,2503,46996
19-06-2018,10,14443,19748,6189,4100,44482,1343,396,654,2393,46875
19-06-2018,11,14389,19711,6214,4305,44619,1340,393,689,2422,47041
19-06-2018,12,14282,19524,6207,4402,44415,1362,417,712,2491,46906
19-06-2018,13,14196,19579,6182,4108,44064,1370,405,752,2527,46591
19-06-2018,14,13917,19768,6128,4180,43994,1380,389,771,2540,46534
19-06-2018,15,13465,19514,5645,4056,42679,1364,395,584,2343,45022
19-06-2018,16,13266,19251,5385,3918,41821,1350,372,557,2279,44100
19-06-2018,17,13680,19278,5421,3874,42253,1379,400,539,2318,44571
19-06-2018,18,13906,19290,5523,4117,42836,1375,416,501,2292,45128
19-06-2018,19,14131,19122,5504,3540,42297,1328,411,469,2208,44505
19-06-2018,20,13706,19066,5419,2846,41037,1323,404,426,2153,43190
19-06-2018,21,13423,18742,5435,2466,40066,1336,376,382,2094,42160
19-06-2018,22,12997,17885,5465,2284,38630,1343,377,371,2091,40721
19-06-2018,23,12020,16884,5324,1971,36200,1355,373,383,2111,38311
20-06-2018,0,11443,16248,5558,1726,34975,1340,367,383,2090,37065
20-06-2018,1,10075,15813,5625,1618,33132,1300,358,377,2035,35167
20-06-2018,2,9722,15724,5565,1478,32489,1304,363,344,2011,34500
20-06-2018,3,9631,15557,5539,1178,31905,1319,356,342,2017,33922
20-06-2018,4,9947,15893,5623,952,32415,1326,354,349,2029,34444
20-06-2018,5,10948,16048,5592,897,33487,1350,364,353,2067,35554
20-06-2018,6,14244,18369,5762,1297,39673,1357,373,368,2098,41771
20-06-2018,7,15574,19215,5930,1707,42426,1319,378,465,2162,44588
20-06-2018,8,15875,19541,6104,2067,43586,1322,514,656,2492,46078
20-06-2018,9,15724,19454,6147,2512,43837,1330,486,622,2438,46275
20-06-2018,10,15641,19289,6128,3506,44562,1332,422,665,2419,46981
20-06-2018,11,14999,18994,6056,4184,44233,1314,407,676,2397,46630
20-06-2018,12,14385,18648,5970,4707,43712,1343,559,688,2590,46302
20-06-2018,13,14363,18548,5909,5117,43936,1320,475,682,2477,46413
20-06-2018,14,13856,18334,5773,5127,43088,1310,402,676,2388,45476
20-06-2018,15,13423,18090,5852,4947,42312,1307,384,701,2392,44704
20-06-2018,16,13089,17807,5825,4689,41411,1312,382,642,2336,43747
20-06-2018,17,13860,18096,5831,4275,42064,1300,534,404,2238,44302
20-06-2018,18,14723,18526,5970,3719,42937,1288,427,302,2017,44954
20-06-2018,19,15069,18626,6022,3338,43056,1299,454,221,1974,45030
20-06-2018,20,13825,18249,5898,3761,41733,1282,370,182,1834,43567
20-06-2018,21,13445,17543,5640,3989,40618,1280,372,183,1835,42453
20-06-2018,22,13085,16981,5615,3693,39375,1267,377,247,1891,41266
20-06-2018,23,12156,16072,5550,3531,37310,1248,379,290,1917,39227
21-06-2018,0,11788,14685,5358,3044,34876,1204,380,312,1896,36772
21-06-2018,1,10803,14175,5179,2950,33109,1114,383,312,1809,34918
21-06-2018,2,10504,14178,4998,2891,32572,1036,374,301,1711,34283
21-06-2018,3,9961,14367,4785,2713,31826,1086,367,298,1751,33577
21-06-2018,4,9656,14582,4517,2507,31263,1109,370,309,1788,33051
21-06-2018,5,9959,14859,4525,2400,31743,1187,371,301,1859,33602
21-06-2018,6,13755,17231,4927,2582,38495,1188,387,278,1853,40348
21-06-2018,7,16635,18439,5441,2634,43150,1185,538,288,2011,45161
21-06-2018,8,17168,18614,5634,2944,44360,1195,1006,481,2682,47042
21-06-2018,9,16165,18047,5521,3407,43141,1198,1222,499,2919,46060
21-06-2018,10,15423,17806,5648,3667,42545,1217,1063,501,2781,45326
21-06-2018,11,15173,17637,5657,3997,42464,1230,1095,530,2855,45319
21-06-2018,12,14920,17457,5703,4101,42182,1239,1078,554,2871,45053
21-06-2018,13,14669,17412,5766,4256,42103,1249,810,575,2634,44737
21-06-2018,14,14166,17215,5619,4851,41850,1271,789,533,2593,44443
21-06-2018,15,13732,17133,5198,4534,40598,1258,550,480,2288,42886
21-06-2018,16,13401,17030,4866,4688,39985,1236,510,450,2196,42181
21-06-2018,17,13171,17117,4883,4817,39989,1208,504,269,1981,41970
21-06-2018,18,12642,16648,5061,4768,39119,1157,460,460,2077,41196
21-06-2018,19,12226,16557,4887,4718,38390,1196,435,622,2253,40643
21-06-2018,20,11807,16374,4680,4589,37450,1220,453,270,1943,39393
21-06-2018,21,11328,16151,4642,4294,36415,958,400,157,1515,37930
21-06-2018,22,10823,15680,4645,4000,35148,803,370,267,1440,36588
21-06-2018,23,10489,15032,4548,3815,33886,705,163,358,1226,35112
22-06-2018,0,9969,14468,4576,3227,32242,584,155,407,1146,33388
22-06-2018,1,9290,14545,4540,3172,31548,557,156,367,1080,32628
22-06-2018,2,8982,14635,4720,3018,31353,593,161,347,1101,32454
22-06-2018,3,8910,14660,4926,2526,31023,607,162,338,1107,32130
22-06-2018,4,8727,14881,5036,1934,30580,650,159,370,1179,31759
22-06-2018,5,8543,14838,5097,2542,31021,647,179,405,1231,32252
22-06-2018,6,9379,15980,5236,2487,33082,665,388,439,1492,34574
22-06-2018,7,10917,17817,5626,2629,36987,806,391,478,1675,38662
22-06-2018,8,11839,18264,5676,2996,38775,912,389,713,2014,40789
22-06-2018,9,11901,18533,5759,3281,39474,807,389,769,1965,41439
22-06-2018,10,11621,18550,5772,3523,39466,814,399,766,1979,41445
22-06-2018,11,11515,18460,5620,3785,39381,815,400,740,1955,41336
22-06-2018,12,11657,18176,5639,3997,39467,822,392,740,1954,41421
22-06-2018,13,11649,17884,5735,4255,39523,788,390,737,1915,41438
22-06-2018,14,11751,17552,5522,4563,39390,765,374,705,1844,41234
22-06-2018,15,11420,17228,5184,4869,38702,724,367,465,1556,40258
22-06-2018,16,10895,16944,5041,5022,37904,699,362,411,1472,39376
22-06-2018,17,10670,17310,5029,4970,37979,710,358,301,1369,39348
22-06-2018,18,9958,17232,5459,4798,37448,774,355,369,1498,38946
22-06-2018,19,9589,16961,5500,4824,36875,718,376,360,1454,38329
22-06-2018,20,9597,16189,5098,4772,35656,630,357,170,1157,36813
22-06-2018,21,9413,15540,4962,4669,34585,573,352,202,1127,35712
22-06-2018,22,9428,15532,4913,4565,34439,587,353,233,1173,35612
22-06-2018,23,9547,15006,4784,4482,33819,611,334,233,1178,34997
23-06-2018,0,9083,15023,4663,4312,33082,594,140,252,986,34068
23-06-2018,1,8597,14367,4634,4291,31889,579,133,260,972,32861
23-06-2018,2,8307,14184,4679,4258,31429,574,129,288,991,32420
23-06-2018,3,7831,13934,4575,4146,30488,561,128,275,964,31452
23-06-2018,4,7302,13889,4445,4057,29693,537,128,227,892,30585
23-06-2018,5,7155,13963,4366,3964,29450,521,132,170,823,30273
23-06-2018,6,7686,13998,4390,3842,29916,525,134,143,802,30718
23-06-2018,7,7854,14377,4413,3951,30594,580,139,139,858,31452
23-06-2018,8,8703,14912,4532,4150,32296,631,138,211,980,33276
23-06-2018,9,9650,15250,4676,4227,33805,632,137,212,981,34786
23-06-2018,10,10304,16028,4798,4161,35292,621,141,191,953,36245
23-06-2018,11,10182,16281,4962,4102,35527,593,176,236,1005,36532
23-06-2018,12,10153,16271,5165,3967,35556,572,139,194,905,36461
23-06-2018,13,9822,15933,5420,3792,34968,567,134,173,874,35842
23-06-2018,14,9645,15555,5625,3760,34586,568,134,176,878,35464
23-06-2018,15,9594,15502,5541,3865,34502,556,166,154,876,35378
23-06-2018,16,9355,15504,5518,3735,34113,548,160,148,856,34969
23-06-2018,17,9871,15679,5525,3680,34755,469,155,141,765,35520
23-06-2018,18,9964,15460,5432,3602,34457,453,152,146,751,35208
23-06-2018,19,10081,15333,5312,3484,34209,437,151,153,741,34950
23-06-2018,20,9886,14975,5333,3354,33548,430,135,140,705,34253
23-06-2018,21,9777,14613,5315,3291,32995,430,134,152,716,33711
23-06-2018,22,9710,14581,5327,3243,32860,437,128,151,716,33576
23-06-2018,23,9090,13995,5200,3102,31388,440,139,146,725,32113
24-06-2018,0,7932,13343,5032,2986,29292,443,129,222,794,30086
24-06-2018,1,7348,12847,4900,2858,27952,458,126,196,780,28732
24-06-2018,2,7148,12756,4846,2686,27435,500,124,146,770,28205
24-06-2018,3,6881,12690,4724,2464,26758,524,126,164,814,27572
24-06-2018,4,6811,12401,4678,2293,26183,533,130,192,855,27038
24-06-2018,5,6828,12409,4647,2053,25938,566,134,159,859,26797
24-06-2018,6,7115,12467,4617,1883,26082,571,132,147,850,26932
24-06-2018,7,8013,12765,4593,1848,27219,596,134,150,880,28099
24-06-2018,8,9494,13570,4658,1807,29528,621,134,141,896,30424
24-06-2018,9,10118,14501,4637,1778,31033,699,135,145,979,32012
24-06-2018,10,11008,14780,4688,1832,32308,770,138,156,1064,33372
24-06-2018,11,11212,14856,4770,1845,32683,795,154,173,1122,33805
24-06-2018,12,11294,14771,4866,1813,32744,864,157,183,1204,33948
24-06-2018,13,11114,14497,4858,1856,32326,861,159,214,1234,33560
24-06-2018,14,11079,14455,4817,1919,32271,814,164,266,1244,33515
24-06-2018,15,10909,14501,4873,1979,32262,823,163,309,1295,33557
24-06-2018,16,10903,14478,4946,1922,32249,798,167,296,1261,33510
24-06-2018,17,11292,14924,5001,1810,33026,931,147,249,1327,34353
24-06-2018,18,11940,15165,4975,1693,33774,957,143,232,1332,35106
24-06-2018,19,12655,15507,5055,1645,34862,969,143,221,1333,36195
24-06-2018,20,12608,15531,5100,1517,34757,920,138,198,1256,36013
24-06-2018,21,13181,15864,5179,1499,35723,925,135,173,1233,36956
24-06-2018,22,12630,15549,5200,1525,34906,979,135,158,1272,36178
24-06-2018,23,10328,14580,5155,1552,31616,965,133,140,1238,32854
25-06-2018,0,9340,12679,5000,1544,28563,979,132,128,1239,29802
25-06-2018,1,8498,12522,4953,1589,27561,996,134,128,1258,28819
25-06-2018,2,7718,12295,4945,1539,26498,1011,161,131,1303,27801
25-06-2018,3,7657,12439,4927,1493,26516,1026,159,149,1334,27850
25-06-2018,4,8123,12696,4902,1509,27230,1029,163,141,1333,28563
25-06-2018,5,9729,13385,4979,1449,29543,1074,243,142,1459,31002
25-06-2018,6,14280,15621,5184,1489,36575,1096,296,167,1559,38134
25-06-2018,7,15166,17064,5724,1652,39607,1072,310,326,1708,41315
25-06-2018,8,16145,17487,5887,1847,41366,1001,755,343,2099,43465
25-06-2018,9,16531,17764,5856,1980,42133,1018,741,353,2112,44245
25-06-2018,10,16679,17833,6138,2090,42739,1022,638,353,2013,44752
25-06-2018,11,16500,17748,6202,2306,42758,1035,711,350,2096,44854
25-06-2018,12,16456,17704,6145,2344,42650,1087,651,337,2075,44725
25-06-2018,13,16429,17639,6026,2362,42456,1087,699,365,2151,44607
25-06-2018,14,16297,17644,5999,2312,42252,1094,524,361,1979,44231
25-06-2018,15,15661,17624,5738,2335,41359,1073,307,337,1717,43076
25-06-2018,16,14966,17619,5650,2189,40424,1023,290,147,1460,41884
25-06-2018,17,15651,18005,5662,2072,41391,1038,290,136,1464,42855
25-06-2018,18,16044,18235,5735,2017,42031,1061,289,128,1478,43509
25-06-2018,19,15766,18108,5691,1994,41560,1068,289,128,1485,43045
25-06-2018,20,14734,17876,5552,1710,39873,1012,289,121,1422,41295
25-06-2018,21,14487,17598,5510,1509,39105,1039,288,120,1447,40552
25-06-2018,22,14087,16885,5421,1230,37624,1069,288,119,1476,39100
25-06-2018,23,12474,15561,5481,1287,34803,1065,287,120,1472,36275
26-06-2018,0,10522,14226,5500,1183,31432,1068,285,122,1475,32907
26-06-2018,1,9405,14024,5614,1008,30051,1060,285,122,1467,31518
26-06-2018,2,8490,13377,5545,917,28331,1065,286,126,1477,29808
26-06-2018,3,8245,13284,5599,797,27926,1079,288,139,1506,29432
26-06-2018,4,8094,13450,5669,830,28042,1078,290,146,1514,29556
26-06-2018,5,9354,13775,5687,786,29603,1075,289,145,1509,31112
26-06-2018,6,13908,15927,6029,829,36694,1074,288,206,1568,38262
26-06-2018,7,15587,17266,6154,1013,40020,1077,316,177,1570,41590
26-06-2018,8,16415,17678,6334,1224,41651,1077,646,353,2076,43727
26-06-2018,9,16576,17917,6476,1356,42327,1077,642,365,2084,44411
26-06-2018,10,16641,18013,6438,1504,42598,1075,616,373,2064,44662
26-06-2018,11,16650,18096,6546,1560,42852,1077,686,379,2142,44994
26-06-2018,12,16503,18039,6553,1563,42659,1079,788,379,2246,44905
26-06-2018,13,16488,18097,6627,1532,42744,1028,732,374,2134,44878
26-06-2018,14,16283,18134,6543,1410,42371,996,583,406,1985,44356
26-06-2018,15,15990,17994,6143,1338,41466,997,545,209,1751,43217
26-06-2018,16,15415,17597,6111,1293,40416,992,394,189,1575,41991
26-06-2018,17,16191,17701,6109,1081,41083,994,387,171,1552,42635
26-06-2018,18,16233,17759,6204,965,41161,975,390,162,1527,42688
26-06-2018,19,16363,17858,6224,777,41224,1013,342,140,1495,42719
26-06-2018,20,15390,17580,6300,602,39872,1017,343,127,1487,41359
26-06-2018,21,14599,17111,6462,419,38590,1019,351,127,1497,40087
26-06-2018,22,13954,16646,6618,466,37684,1070,294,132,1496,39180
26-06-2018,23,11829,15553,6498,447,34327,1059,290,155,1504,35831
27-06-2018,0,10237,13973,6298,442,30950,1049,287,155,1491,32441
27-06-2018,1,9071,13590,6226,432,29319,1051,288,160,1499,30818
27-06-2018,2,8393,13434,6229,464,28520,1051,287,187,1525,30045
27-06-2018,3,8207,13339,6158,477,28180,1069,287,211,1567,29747
27-06-2018,4,8281,13494,6036,572,28383,1075,287,244,1606,29989
27-06-2018,5,10002,13789,5913,691,30397,1081,289,259,1629,32026
27-06-2018,6,13982,16102,6244,994,37324,1086,287,207,1580,38904
27-06-2018,7,15260,17751,6325,1487,40823,1070,302,344,1716,42539
27-06-2018,8,15873,18318,6541,1647,42380,1074,629,359,2062,44442
27-06-2018,9,15959,18271,6636,1821,42686,1038,766,368,2172,44858
27-06-2018,10,16249,18450,6692,1927,43317,994,787,385,2166,45483
27-06-2018,11,15898,18365,6715,2008,42987,1073,773,404,2250,45237
27-06-2018,12,15877,18582,6642,2072,43172,1085,866,403,2354,45526
27-06-2018,13,15776,18273,6571,2080,42701,1046,858,398,2302,45003
27-06-2018,14,15910,18028,6577,2067,42582,1091,733,391,2215,44797
27-06-2018,15,15414,17816,6544,2049,41823,1090,629,400,2119,43942
27-06-2018,16,14869,17530,6272,2133,40803,1056,651,200,1907,42710
27-06-2018,17,15407,17723,6282,1955,41368,1049,429,237,1715,43083
27-06-2018,18,16584,17572,6260,1788,42206,1069,355,227,1651,43857
27-06-2018,19,16713,17586,6268,1541,42108,1004,406,251,1661,43769
27-06-2018,20,15572,17219,6164,1335,40290,1001,404,300,1705,41995
27-06-2018,21,15184,16471,6100,1222,38979,1006,404,293,1703,40682
27-06-2018,22,14462,15829,6077,1045,37414,1086,301,337,1724,39138
27-06-2018,23,12077,14184,5874,749,32885,1092,293,365,1750,34635
28-06-2018,0,10210,12921,5707,687,29525,1102,289,363,1754,31279
28-06-2018,1,8290,12701,5782,618,27390,1097,289,362,1748,29138
28-06-2018,2,7637,12743,5776,604,26760,1095,286,384,1765,28525
28-06-2018,3,7376,12577,5735,617,26305,1096,286,384,1766,28071
28-06-2018,4,7448,12813,5684,604,26549,1086,287,383,1756,28305
28-06-2018,5,9585,13363,5782,682,29411,1079,288,358,1725,31136
28-06-2018,6,13682,15578,6100,994,36354,1075,289,321,1685,38039
28-06-2018,7,15930,17603,6441,1209,41183,1072,290,278,1640,42823
28-06-2018,8,17403,18234,6481,1330,43447,1073,290,244,1607,45054
28-06-2018,9,17106,18233,6545,1517,43402,1072,306,242,1620,45022
28-06-2018,10,16963,18033,6538,1690,43224,1074,410,212,1696,44920
28-06-2018,11,16556,17982,6628,1834,43001,1046,410,216,1672,44673
28-06-2018,12,16318,18173,6660,2009,43163,1029,751,277,2057,45220
28-06-2018,13,16177,18179,6600,2131,43087,1074,694,302,2070,45157
28-06-2018,14,15517,18202,6469,2176,42364,1035,613,392,2040,44404
28-06-2018,15,15213,18147,6238,2028,41628,1028,536,246,1810,43438
28-06-2018,16,14379,18471,6091,1926,40867,1025,479,221,1725,42592
28-06-2018,17,14657,18750,6093,1963,41463,1033,404,316,1753,43216
28-06-2018,18,15374,18886,6140,1947,42347,1025,393,267,1685,44032
28-06-2018,19,15309,18963,6228,1788,42289,1023,403,148,1574,43863
28-06-2018,20,14074,19019,6144,1646,40883,1010,409,164,1583,42466
28-06-2018,21,12944,17906,5824,1667,38342,1045,399,179,1623,39965
28-06-2018,22,12700,17416,5766,1788,37669,1129,376,189,1694,39363
28-06-2018,23,10044,16926,5654,1736,34361,1150,303,163,1616,35977
29-06-2018,0,8873,16102,5700,1742,32419,846,291,149,1286,33705
29-06-2018,1,8491,15597,5822,1833,31743,765,292,138,1195,32938
29-06-2018,2,8297,15545,5936,1801,31580,808,293,140,1241,32821
29-06-2018,3,7800,15579,6120,1875,31374,790,295,162,1247,32621
29-06-2018,4,7895,15746,6232,1919,31793,754,295,207,1256,33049
29-06-2018,5,8224,16308,6442,1959,32935,1004,296,229,1529,34464
29-06-2018,6,10607,17953,6843,2023,37426,1053,305,284,1642,39068
29-06-2018,7,13006,19331,7323,2123,41783,1168,667,378,2213,43996
29-06-2018,8,14231,19651,7635,2160,43676,1159,841,427,2427,46103
29-06-2018,9,15275,19737,7826,2124,44962,1171,783,491,2445,47407
29-06-2018,10,15250,19564,7830,2175,44818,1156,711,524,2391,47209
29-06-2018,11,14613,19283,7645,2506,44048,1158,644,538,2340,46388
29-06-2018,12,13645,19031,7568,2623,42868,1183,696,573,2452,45320
29-06-2018,13,12842,18889,7470,2839,42041,1211,611,627,2449,44490
29-06-2018,14,12386,18637,7394,2871,41289,1244,568,532,2344,43633
29-06-2018,15,11752,18213,7378,2901,40246,1165,402,473,2040,42286
29-06-2018,16,11387,18114,7253,2867,39622,1210,319,474,2003,41625
29-06-2018,17,11548,18038,7272,2399,39258,1194,362,452,2008,41266
29-06-2018,18,12635,18153,7361,2095,40244,1182,327,431,1940,42184
29-06-2018,19,13764,18348,7023,1883,41018,1174,329,387,1890,42908
29-06-2018,20,13838,18081,6592,1664,40176,1145,324,360,1829,42005
29-06-2018,21,13161,17542,6791,1573,39067,1182,320,311,1813,40880
29-06-2018,22,11920,16536,6918,1492,36866,1179,313,344,1836,38702
29-06-2018,23,10433,14987,6773,1333,33527,1193,311,271,1775,35302
30-06-2018,0,8956,13446,6664,1204,30270,887,214,273,1374,31644
30-06-2018,1,7635,12930,6636,1137,28338,864,205,285,1354,29692
30-06-2018,2,7012,12730,6646,1065,27454,876,198,290,1364,28818
30-06-2018,3,6813,12462,6493,1010,26779,843,194,299,1336,28115
30-06-2018,4,6699,12691,6393,855,26638,833,230,299,1362,28000
30-06-2018,5,7208,12933,6395,866,27402,813,239,288,1340,28742
30-06-2018,6,8348,13275,6423,913,28960,803,220,316,1339,30299
30-06-2018,7,9576,13849,6386,861,30671,792,207,479,1478,32149
30-06-2018,8,10784,15242,6580,840,33447,784,207,456,1447,34894
30-06-2018,9,11110,15366,6796,1006,34279,793,204,376,1373,35652
30-06-2018,10,11739,15559,6940,1219,35458,812,216,429,1457,36915
30-06-2018,11,11631,15570,6873,1424,35497,803,241,409,1453,36950
30-06-2018,12,11240,15258,6640,1564,34703,821,233,380,1434,36137
30-06-2018,13,10546,14717,6637,1729,33629,805,246,370,1421,35050
30-06-2018,14,9696,14589,6498,1737,32521,783,227,353,1363,33884
30-06-2018,15,9477,14590,6425,1801,32294,794,230,326,1350,33644
30-06-2018,16,9590,14658,6394,1819,32460,780,228,349,1357,33817
30-06-2018,17,10305,14871,6296,1780,33253,778,225,338,1341,34594
30-06-2018,18,11034,15110,6150,1750,34043,760,224,337,1321,35364
30-06-2018,19,11738,15099,6089,1629,34556,759,216,333,1308,35864
30-06-2018,20,11297,15097,5879,1451,33726,763,212,326,1301,35027
30-06-2018,21,10517,14730,5900,1206,32355,779,205,313,1297,33652
30-06-2018,22,10274,14497,5938,1150,31859,799,205,318,1322,33181
30-06-2018,23,9524,13592,5922,1226,30264,842,197,351,1390,31654
01-07-2018,0,8380,12852,5927,1445,28604,872,192,377,1441,30045
01-07-2018,1,7466,12713,5851,1361,27391,892,192,377,1461,28852
01-07-2018,2,7055,12462,5883,1260,26659,880,195,370,1445,28104
01-07-2018,3,6800,12439,5809,1203,26251,890,194,365,1449,27700
01-07-2018,4,6623,12469,5639,1107,25837,887,200,349,1436,27273
01-07-2018,5,6616,12402,5566,1046,25628,989,197,346,1532,27160
01-07-2018,6,7758,12858,5482,1041,27139,1028,262,326,1616,28755
01-07-2018,7,8591,13427,5559,1007,28586,1041,221,375,1637,30223
01-07-2018,8,8672,13914,5650,1100,29336,1046,430,403,1879,31215
01-07-2018,9,8878,14040,5769,1355,30042,1060,428,424,1912,31954
01-07-2018,10,9149,14567,5789,1462,30967,1067,431,431,1929,32896
01-07-2018,11,9308,14585,5827,1486,31206,1047,417,448,1912,33118
01-07-2018,12,9296,14523,5843,1467,31130,1032,354,440,1826,32956
01-07-2018,13,9239,14427,5886,1442,30993,1054,231,423,1708,32701
01-07-2018,14,9130,14319,5864,1514,30827,1027,219,401,1647,32474
01-07-2018,15,9195,14197,5815,1517,30724,1039,216,398,1653,32377
01-07-2018,16,9125,14477,5806,1498,30906,1014,218,375,1607,32513
01-07-2018,17,9199,14895,5783,1431,31309,1045,210,338,1593,32902
01-07-2018,18,9710,15069,5875,1334,31987,1027,204,323,1554,33541
01-07-2018,19,10839,15272,5856,1186,33154,1082,200,315,1597,34751
01-07-2018,20,11233,15325,5887,1047,33493,1096,208,306,1610,35103
01-07-2018,21,10689,15123,6019,895,32727,1098,214,287,1599,34326
01-07-2018,22,10642,14867,5978,850,32336,1095,211,300,1606,33942
01-07-2018,23,9994,14345,6024,833,31196,1027,214,319,1560,32756
02-07-2018,0,9744,12507,6109,795,29154,1211,210,318,1739,30893
02-07-2018,1,8720,11961,6128,699,27508,1232,203,295,1730,29238
02-07-2018,2,8250,11962,6049,588,26849,1238,219,323,1780,28629
02-07-2018,3,7970,12043,6085,634,26732,1258,221,299,1778,28510
02-07-2018,4,7587,12389,6031,719,26727,1261,256,402,1919,28646
02-07-2018,5,8599,12869,5971,751,28189,1287,352,334,1973,30162
02-07-2018,6,12143,14399,6200,790,33532,1308,497,272,2077,35609
02-07-2018,7,15695,16393,6501,1231,39820,1316,602,406,2324,42144
02-07-2018,8,16565,17311,6798,1344,42018,1289,601,440,2330,44348
02-07-2018,9,16174,17051,6771,1726,41724,1352,598,454,2404,44128
02-07-2018,10,16115,17011,6618,1870,41614,1365,596,354,2315,43929
02-07-2018,11,16207,17169,6712,1864,41953,1375,582,294,2251,44204
02-07-2018,12,16238,17368,6716,1970,42293,1372,498,329,2199,44492
02-07-2018,13,16186,17235,6691,2160,42273,1373,491,269,2133,44406
02-07-2018,14,15772,17039,6590,2275,41674,1357,486,280,2123,43797
02-07-2018,15,15492,16918,6499,2500,41410,1370,488,209,2067,43477
02-07-2018,16,15439,16950,6370,2651,41411,1365,367,205,1937,43348
02-07-2018,17,15611,17154,6389,2666,41820,1236,359,205,1800,43620
02-07-2018,18,15723,17225,6459,2569,41976,1077,355,229,1661,43637
02-07-2018,19,16035,17325,6624,2279,42263,1070,354,214,1638,43901
02-07-2018,20,15995,17162,6484,1968,41610,1060,353,266,1679,43289
02-07-2018,21,16035,16839,6394,1824,41093,1031,353,172,1556,42649
02-07-2018,22,15477,15583,6238,1684,38981,1019,344,177,1540,40521
02-07-2018,23,12143,13854,6160,1559,33716,1016,349,176,1541,35257
03-07-2018,0,10565,12660,6054,1488,30768,997,346,171,1514,32282
03-07-2018,1,9276,12175,6011,1519,28981,988,346,173,1507,30488
03-07-2018,2,8488,12232,5904,1450,28075,980,345,170,1495,29570
03-07-2018,3,8417,12346,5746,1382,27892,985,345,160,1490,29382
03-07-2018,4,8301,12578,5684,1148,27712,982,349,156,1487,29199
03-07-2018,5,9706,12932,5920,1206,29764,977,353,155,1485,31249
03-07-2018,6,13014,14768,6194,1481,35458,973,355,182,1510,36968
03-07-2018,7,15989,16775,6552,1497,40812,978,618,251,1847,42659
03-07-2018,8,16717,17483,6821,1462,42483,973,829,222,2024,44507
03-07-2018,9,16930,17399,6813,1952,43094,970,839,269,2078,45172
03-07-2018,10,16805,17399,6816,2121,43142,972,844,258,2074,45216
03-07-2018,11,16589,17087,6808,2273,42758,972,803,310,2085,44843
03-07-2018,12,16430,16969,6891,2337,42627,974,744,307,2025,44652
03-07-2018,13,16637,16811,6750,2366,42565,974,613,363,1950,44515
03-07-2018,14,16394,16867,6786,2314,42361,975,415,322,1712,44073
03-07-2018,15,16261,16696,6814,2245,42017,974,397,368,1739,43756
03-07-2018,16,15691,16870,6578,2179,41318,1006,462,281,1749,43067
03-07-2018,17,15926,17024,6479,2067,41497,1072,443,325,1840,43337
03-07-2018,18,16298,17433,6480,1885,42095,1068,427,333,1828,43923
03-07-2018,19,16252,17308,6426,1640,41626,1043,544,333,1920,43546
03-07-2018,20,16011,17046,6150,1436,40643,1040,507,382,1929,42572
03-07-2018,21,15744,16725,6048,1405,39922,1037,359,261,1657,41579
03-07-2018,22,15708,16426,6051,1465,39651,1037,354,272,1663,41314
03-07-2018,23,13652,15340,5835,1363,36191,993,346,266,1605,37796
04-07-2018,0,11602,14464,5648,1131,32845,893,345,231,1469,34314
04-07-2018,1,9936,14149,5515,1188,30789,896,342,221,1459,32248
04-07-2018,2,9230,13763,5665,1174,29831,889,341,236,1466,31297
04-07-2018,3,8864,13475,5597,1018,28954,885,338,221,1444,30398
04-07-2018,4,9023,13769,5675,1010,29476,883,339,216,1438,30914
04-07-2018,5,10148,13978,5812,931,30869,923,346,211,1480,32349
04-07-2018,6,13946,15239,6127,1091,36404,985,363,178,1526,37930
04-07-2018,7,16467,17001,6455,1204,41126,988,619,202,1809,42935
04-07-2018,8,17101,17619,6817,1297,42834,987,814,253,2054,44888
04-07-2018,9,17137,17849,6839,1413,43239,988,822,229,2039,45278
04-07-2018,10,16981,17587,6889,1579,43037,992,821,210,2023,45060
04-07-2018,11,16853,17595,6970,1657,43076,999,820,180,1999,45075
04-07-2018,12,16618,17524,7020,1659,42822,998,824,175,1997,44819
04-07-2018,13,16894,17330,6999,1745,42969,997,825,175,1997,44966
04-07-2018,14,16886,17067,6928,1777,42660,996,730,261,1987,44647
04-07-2018,15,16739,16560,6963,1841,42103,986,567,231,1784,43887
04-07-2018,16,16803,16587,7003,1770,42165,985,365,266,1616,43781
04-07-2018,17,16725,17012,7117,1773,42627,1009,384,283,1676,44303
04-07-2018,18,16398,16817,7017,1749,41981,1014,381,216,1611,43592
04-07-2018,19,16168,16403,7014,1642,41229,1023,379,175,1577,42806
04-07-2018,20,16316,16004,6924,1572,40815,1028,359,254,1641,42456
04-07-2018,21,16166,15880,6736,1456,40237,1087,354,172,1613,41850
04-07-2018,22,15674,15160,6585,1564,38984,1131,348,246,1725,40709
04-07-2018,23,13983,13457,6513,1435,35388,1132,349,182,1663,37051
05-07-2018,0,12052,12393,6408,1402,32256,1130,346,166,1642,33898
05-07-2018,1,10214,11921,6332,1309,29776,1076,345,157,1578,31354
05-07-2018,2,9346,11761,6249,1186,28542,1084,344,151,1579,30121
05-07-2018,3,9038,11808,5916,1248,28011,1082,346,149,1577,29588
05-07-2018,4,9118,11994,5666,1266,28044,999,348,132,1479,29523
05-07-2018,5,11001,12457,5429,1211,30098,1007,349,131,1487,31585
05-07-2018,6,13963,13351,5703,1539,34557,1159,357,167,1683,36240
05-07-2018,7,16066,15584,5987,1680,39314,1243,625,188,2056,41370
05-07-2018,8,16632,16526,6412,1701,41272,1278,805,143,2226,43498
05-07-2018,9,16791,16774,6682,1856,42103,1281,832,153,2266,44369
05-07-2018,10,16974,16842,6819,1933,42569,1249,832,155,2236,44805
05-07-2018,11,16981,16783,6971,1891,42625,1285,833,162,2280,44905
05-07-2018,12,16982,15996,7019,2034,42031,1259,834,150,2243,44274
05-07-2018,13,16893,15978,7092,2294,42256,1250,747,165,2162,44418
05-07-2018,14,16532,15905,7032,2545,42014,1249,467,193,1909,43923
05-07-2018,15,15966,15933,6903,2654,41456,1224,391,209,1824,43280
05-07-2018,16,15955,15676,6898,2652,41182,1216,362,198,1776,42958
05-07-2018,17,15776,15497,7057,2783,41114,1225,361,192,1778,42892
05-07-2018,18,15936,15246,7116,2833,41133,1233,354,169,1756,42889
05-07-2018,19,16050,14731,7071,2702,40554,1272,353,171,1796,42350
05-07-2018,20,15811,14254,6902,2637,39603,1238,355,167,1760,41363
05-07-2018,21,14925,13409,6684,2651,37670,1273,354,168,1795,39465
05-07-2018,22,14494,13131,6559,2632,36817,1319,348,178,1845,38662
05-07-2018,23,12310,12250,6438,2358,33357,1288,348,185,1821,35178
06-07-2018,0,11031,11230,6396,2382,31040,1239,347,178,1764,32804
06-07-2018,1,9583,10868,6378,2597,29426,1264,344,175,1783,31209
06-07-2018,2,8324,10729,6351,2867,28272,1297,344,188,1829,30101
06-07-2018,3,7779,10782,6198,3021,27780,1313,344,165,1822,29602
06-07-2018,4,7704,11293,6034,3104,28137,1316,348,150,1814,29951
06-07-2018,5,8974,11926,6096,3116,30113,1311,350,145,1806,31919
06-07-2018,6,12157,13614,6087,3271,35128,1314,355,140,1809,36937
06-07-2018,7,14619,15030,6339,3517,39505,1299,617,143,2059,41564
06-07-2018,8,15185,15514,6579,4054,41333,1282,689,164,2135,43468
06-07-2018,9,15851,15790,6636,4101,42379,1275,692,183,2150,44529
06-07-2018,10,16065,15863,6690,4210,42827,1249,691,205,2145,44972
06-07-2018,11,15933,15839,6742,4372,42887,1237,695,234,2166,45053
06-07-2018,12,15615,15790,6691,4844,42940,1228,638,283,2149,45089
06-07-2018,13,15043,15695,6611,4824,42174,1164,585,322,2071,44245
06-07-2018,14,14131,15284,6391,4889,40695,1169,407,361,1937,42632
06-07-2018,15,13680,15118,6358,4884,40040,1174,405,361,1940,41980
06-07-2018,16,13198,14706,6286,4842,39033,1163,366,377,1906,40939
06-07-2018,17,12524,14328,6261,4700,37814,1158,355,373,1886,39700
06-07-2018,18,12386,14374,6218,4455,37432,1172,355,335,1862,39294
06-07-2018,19,12530,14119,6195,4089,36933,1142,356,312,1810,38743
06-07-2018,20,11841,13912,6237,3806,35797,1151,356,288,1795,37592
06-07-2018,21,11303,13434,6246,3612,34594,1172,356,252,1780,36374
06-07-2018,22,10861,12977,6379,3430,33646,1223,350,247,1820,35466
06-07-2018,23,9501,12258,6431,3351,31542,1241,350,240,1831,33373
07-07-2018,0,9135,11236,6383,3460,30214,1092,348,232,1672,31886
07-07-2018,1,7950,10938,6268,3531,28687,1070,346,223,1639,30326
07-07-2018,2,7480,11000,6197,3644,28321,1072,347,195,1614,29935
07-07-2018,3,7258,10910,6151,3616,27935,1060,346,172,1578,29513
07-07-2018,4,7262,10908,5943,3583,27698,1058,348,153,1559,29257
07-07-2018,5,7221,11037,5794,3534,27587,1048,356,141,1545,29132
07-07-2018,6,8169,11338,5707,3578,28793,1046,358,140,1544,30337
07-07-2018,7,8618,11684,5676,3889,29865,1040,676,140,1856,31721
07-07-2018,8,9427,13029,5994,4128,32578,1040,707,152,1899,34477
07-07-2018,9,10570,13498,6035,4116,34218,1047,689,167,1903,36121
07-07-2018,10,10850,13890,6032,4099,34872,1070,695,188,1953,36825
07-07-2018,11,10750,13778,6061,4069,34658,1056,711,200,1967,36625
07-07-2018,12,10872,13607,6052,3973,34503,1048,709,219,1976,36479
07-07-2018,13,10621,13619,6092,3879,34212,1069,612,255,1936,36148
07-07-2018,14,10204,13407,6132,3753,33496,1076,438,285,1799,35295
07-07-2018,15,9954,13359,6133,3666,33113,1061,401,338,1800,34913
07-07-2018,16,9742,13161,6131,3483,32518,1043,403,358,1804,34322
07-07-2018,17,10009,13271,6188,3292,32760,1041,385,359,1785,34545
07-07-2018,18,10633,13137,6229,3002,32999,1034,386,342,1762,34761
07-07-2018,19,10302,13136,6246,2728,32412,1039,390,318,1747,34159
07-07-2018,20,9789,13043,6309,2471,31612,1027,387,282,1696,33308
07-07-2018,21,9569,13249,6304,2299,31421,1031,385,272,1688,33109
07-07-2018,22,9058,13034,6254,2203,30551,1048,383,248,1679,32230
07-07-2018,23,9008,12102,6213,2200,29523,1043,376,240,1659,31182
08-07-2018,0,7918,11547,6215,2148,27829,1037,370,212,1619,29448
08-07-2018,1,7208,11296,6187,1978,26669,1038,367,198,1603,28272
08-07-2018,2,7102,11169,6100,1773,26143,997,368,207,1572,27715
08-07-2018,3,6672,10996,6067,1608,25344,805,372,228,1405,26749
08-07-2018,4,6607,10748,6003,1504,24863,855,375,237,1467,26330
08-07-2018,5,6950,10782,5930,1357,25018,884,384,226,1494,26512
08-07-2018,6,7863,10858,5855,1259,25836,898,386,207,1491,27327
08-07-2018,7,8880,10828,5800,1321,26830,911,549,199,1659,28489
08-07-2018,8,9793,11391,5834,1375,28395,913,709,238,1860,30255
08-07-2018,9,10218,12154,5873,1469,29715,883,731,295,1909,31624
08-07-2018,10,11076,12681,5877,1525,31161,840,727,306,1873,33034
08-07-2018,11,11273,12833,5872,1615,31594,880,724,324,1928,33522
08-07-2018,12,11264,12888,5842,1726,31719,892,724,394,2010,33729
08-07-2018,13,11049,12818,5827,1816,31512,920,630,436,1986,33498
08-07-2018,14,10895,12791,5791,1947,31425,921,451,464,1836,33261
08-07-2018,15,10637,12708,5722,2226,31293,898,395,475,1768,33061
08-07-2018,16,10694,12688,5627,2462,31471,917,394,443,1754,33225
08-07-2018,17,11016,12898,5621,2458,31994,894,393,403,1690,33684
08-07-2018,18,11404,13027,5619,2481,32531,878,389,330,1597,34128
08-07-2018,19,11576,13187,5779,2492,33033,881,388,287,1556,34589
08-07-2018,20,11852,13426,5843,2615,33737,880,387,249,1516,35253
08-07-2018,21,11464,13346,5825,2543,33179,874,386,237,1497,34676
08-07-2018,22,11784,13639,5922,2538,33884,871,379,326,1576,35460
08-07-2018,23,10463,12200,5826,2650,31139,880,368,244,1492,32631
09-07-2018,0,9194,11468,5826,2734,29222,857,362,247,1466,30688
09-07-2018,1,7923,11293,5616,2861,27696,824,360,239,1423,29119
09-07-2018,2,7131,11049,5543,3140,26865,838,377,210,1425,28290
09-07-2018,3,6623,10938,5565,3399,26525,849,358,192,1399,27924
09-07-2018,4,6675,11059,5491,3730,26956,926,360,184,1470,28426
09-07-2018,5,7532,11210,5541,3910,28193,1047,368,164,1579,29772
09-07-2018,6,10714,12964,5700,4186,33566,1051,379,140,1570,35136
09-07-2018,7,13699,14540,5903,4287,38428,1044,589,205,1838,40266
09-07-2018,8,14916,15408,6003,4389,40715,1044,673,196,1913,42628
09-07-2018,9,14763,15437,6156,4822,41177,1044,686,220,1950,43127
09-07-2018,10,14011,15267,6179,4840,40297,1040,687,237,1964,42261
09-07-2018,11,14128,15232,6273,4817,40450,1043,684,210,1937,42387
09-07-2018,12,14399,15231,6266,4688,40584,1046,685,242,1973,42557
09-07-2018,13,14299,15115,6289,4681,40384,1056,608,226,1890,42274
09-07-2018,14,14221,15169,6323,4427,40140,1067,487,240,1794,41934
09-07-2018,15,14095,14973,6139,4489,39697,1060,429,249,1738,41435
09-07-2018,16,13906,14880,6033,4455,39274,1065,390,222,1677,40951
09-07-2018,17,14146,14953,6005,4199,39305,1071,386,220,1677,40982
09-07-2018,18,14853,15254,5983,3938,40029,1070,386,223,1679,41708
09-07-2018,19,15601,15134,5965,3355,40054,1020,388,122,1530,41584
09-07-2018,20,15200,14924,6044,2978,39147,1005,391,118,1514,40661
09-07-2018,21,15224,14736,6134,2468,38562,1023,391,117,1531,40093
09-07-2018,22,14234,14048,5953,2176,36412,1033,380,163,1576,37988
09-07-2018,23,11514,12860,5809,1830,32011,1054,362,114,1530,33541
10-07-2018,0,9560,12157,5873,1698,29288,1047,355,197,1599,30887
10-07-2018,1,8312,11748,5701,1785,27548,1041,354,239,1634,29182
10-07-2018,2,7480,11683,5574,1972,26708,1042,353,110,1505,28213
10-07-2018,3,7084,11531,5564,2002,26180,1042,353,106,1501,27681
10-07-2018,4,6954,11608,5648,2032,26242,1046,358,102,1506,27748
10-07-2018,5,8169,11801,5792,2256,28020,1041,370,104,1515,29535
10-07-2018,6,11715,13143,5899,2233,32990,1024,384,108,1516,34506
10-07-2018,7,14577,15199,6015,2522,38313,1053,624,161,1838,40151
10-07-2018,8,15584,16186,6038,2688,40497,1147,719,248,2114,42611
10-07-2018,9,16150,16223,6120,2841,41334,1051,1057,240,2348,43682
10-07-2018,10,16215,16302,6174,3065,41755,1159,1062,224,2445,44200
10-07-2018,11,16204,16359,6220,3028,41813,1156,1063,195,2414,44227
10-07-2018,12,16222,16413,6415,3032,42084,1127,1068,362,2557,44641
10-07-2018,13,16078,16051,6391,3264,41784,1115,985,366,2466,44250
10-07-2018,14,15893,15687,6428,3039,41047,1062,849,248,2159,43206
10-07-2018,15,15857,15700,6381,2733,40671,1045,548,267,1860,42531
10-07-2018,16,15650,15693,6313,2341,39997,1043,402,257,1702,41699
10-07-2018,17,15583,15996,6150,1994,39724,1045,469,138,1652,41376
10-07-2018,18,15608,16020,6166,1670,39464,1030,477,130,1637,41101
10-07-2018,19,15726,15988,6248,1491,39455,1029,430,124,1583,41038
10-07-2018,20,15380,15548,6052,1414,38393,1035,377,119,1531,39924
10-07-2018,21,14916,14787,5985,1362,37049,1046,380,136,1562,38611
10-07-2018,22,14877,14046,6010,1413,36346,1046,375,162,1583,37929
10-07-2018,23,12489,12020,5906,1137,31552,1044,357,171,1572,33124
11-07-2018,0,10566,11365,5917,1139,28988,940,384,174,1498,30486
11-07-2018,1,9799,11184,5716,1386,28087,750,382,181,1313,29400
11-07-2018,2,9175,10954,5632,1468,27228,744,382,177,1303,28531
11-07-2018,3,8911,10840,5579,1504,26836,775,426,186,1387,28223
11-07-2018,4,8316,11114,5616,1481,26526,835,526,194,1555,28081
11-07-2018,5,9355,11456,5649,1308,27768,953,547,172,1672,29440
11-07-2018,6,13129,12753,5759,1573,33214,1010,609,145,1764,34978
11-07-2018,7,15687,14973,6097,1777,38535,1017,754,220,1991,40526
11-07-2018,8,16266,16349,6316,1822,40753,1010,782,197,1989,42742
11-07-2018,9,16398,16645,6410,1985,41439,1020,765,310,2095,43534
11-07-2018,10,16671,16607,6493,2185,41957,1028,811,298,2137,44094
11-07-2018,11,16889,16548,6420,2370,42227,1031,1098,147,2276,44503
11-07-2018,12,16642,16157,6350,2542,41691,1028,1061,297,2386,44077
11-07-2018,13,16494,15871,6407,2568,41340,1033,1146,182,2361,43701
11-07-2018,14,16323,15827,6329,2532,41012,1028,1034,190,2252,43264
11-07-2018,15,16440,15519,6274,2522,40754,1027,650,205,1882,42636
11-07-2018,16,16213,15569,6218,2468,40469,1029,522,208,1759,42228
11-07-2018,17,16048,15961,6183,2394,40588,1033,464,194,1691,42279
11-07-2018,18,15985,16518,6102,2233,40838,1018,453,189,1660,42498
11-07-2018,19,16096,16344,6090,1964,40494,1016,441,190,1647,42141
11-07-2018,20,15961,15547,6134,1673,39316,1017,447,180,1644,40960
11-07-2018,21,15560,14883,6117,1572,38133,1023,431,205,1659,39792
11-07-2018,22,15235,14337,6188,1431,37192,1025,377,225,1627,38819
11-07-2018,23,13449,12779,6018,1203,33447,1029,358,228,1615,35062
12-07-2018,0,11065,11543,5839,1010,29456,1026,350,218,1594,31050
12-07-2018,1,10095,11132,5729,855,27810,1022,351,250,1623,29433
12-07-2018,2,9561,10988,5633,871,27053,1025,350,245,1620,28673
12-07-2018,3,9461,10929,5603,903,26897,1025,350,240,1615,28512
12-07-2018,4,9170,11196,5638,877,26884,1027,359,246,1632,28516
12-07-2018,5,9999,11427,5719,882,28028,1019,382,231,1632,29660
12-07-2018,6,12618,12932,5820,1059,32429,1013,612,179,1804,34233
12-07-2018,7,15542,14970,6154,1490,38156,1014,716,190,1920,40076
12-07-2018,8,16218,16209,5893,1677,39997,1016,904,215,2135,42132
12-07-2018,9,16411,16340,6003,1782,40534,1018,1283,271,2572,43106
12-07-2018,10,16809,16633,6150,1869,41463,1011,1118,294,2423,43886
12-07-2018,11,16570,16488,6354,1940,41353,1022,1105,277,2404,43757
12-07-2018,12,16479,16025,6429,1958,40893,1039,1197,277,2513,43406
12-07-2018,13,16171,15341,6385,1962,39860,1045,1183,274,2502,42362
12-07-2018,14,15777,15324,6271,1963,39336,1046,1051,300,2397,41733
12-07-2018,15,15432,15133,6207,2084,38857,1053,766,186,2005,40862
12-07-2018,16,15151,14856,6132,1932,38073,1052,408,236,1696,39769
12-07-2018,17,15530,15482,6079,1857,38946,963,439,406,1808,40754
12-07-2018,18,15670,15865,6057,1733,39325,969,400,315,1684,41009
12-07-2018,19,15929,15959,5991,1533,39412,1026,391,266,1683,41095
12-07-2018,20,15771,15479,5936,1398,38585,1019,393,269,1681,40266
12-07-2018,21,15549,14768,5834,1299,37449,1028,379,184,1591,39040
12-07-2018,22,15437,13795,5918,1535,36685,1037,370,177,1584,38269
12-07-2018,23,12933,12256,5727,1425,32340,1051,349,166,1566,33906
13-07-2018,0,11199,10917,5558,1336,29011,1145,339,157,1641,30652
13-07-2018,1,10007,10591,5463,1283,27344,1150,338,128,1616,28960
13-07-2018,2,9526,10504,5402,1599,27031,1137,340,121,1598,28629
13-07-2018,3,9175,10528,5400,1632,26735,1128,338,129,1595,28330
13-07-2018,4,8776,10734,5442,1655,26607,1119,347,123,1589,28196
13-07-2018,5,9611,11009,5492,1698,27811,1119,369,114,1602,29413
13-07-2018,6,12695,12528,5822,1719,32764,1109,468,118,1695,34459
13-07-2018,7,15786,14376,6125,2140,38428,1112,501,116,1729,40157
13-07-2018,8,16607,15546,6454,2190,40797,1098,616,123,1837,42634
13-07-2018,9,16737,15799,6632,2315,41484,1117,690,134,1941,43425
13-07-2018,10,16267,15468,6581,2464,40781,1104,724,158,1986,42767
13-07-2018,11,15402,15180,6492,2717,39791,1106,670,173,1949,41740
13-07-2018,12,15349,14432,6525,2905,39210,1123,610,176,1909,41119
13-07-2018,13,15274,14329,6565,2948,39117,1113,595,167,1875,40992
13-07-2018,14,14640,14247,6361,3069,38316,1098,553,199,1850,40166
13-07-2018,15,14465,14245,6232,3159,38100,1113,408,271,1792,39892
13-07-2018,16,14239,14074,6000,3210,37523,1100,421,153,1674,39197
13-07-2018,17,15051,14109,5904,2998,38062,893,473,267,1633,39695
13-07-2018,18,15828,14519,5781,3176,39304,812,518,336,1666,40970
13-07-2018,19,15733,14603,5803,3169,39309,872,414,304,1590,40899
13-07-2018,20,15273,13968,5839,2923,38002,806,487,284,1577,39579
13-07-2018,21,14994,13515,5864,2749,37122,832,404,190,1426,38548
13-07-2018,22,14915,12646,5684,2692,35938,1005,386,159,1550,37488
13-07-2018,23,12438,11805,5527,2450,32220,1096,373,178,1647,33867
14-07-2018,0,11234,10629,5497,2524,29884,1024,316,153,1493,31377
14-07-2018,1,10064,10440,5466,2646,28617,1023,290,140,1453,30070
14-07-2018,2,9053,10230,5389,2418,27091,1031,286,136,1453,28544
14-07-2018,3,8149,10153,5413,2231,25947,1038,284,137,1459,27406
14-07-2018,4,7742,10304,5364,1984,25396,1041,283,139,1463,26859
14-07-2018,5,7897,10260,5321,1850,25328,1036,286,134,1456,26784
14-07-2018,6,8921,10378,5296,1885,26480,1034,289,125,1448,27928
14-07-2018,7,9604,10453,5387,1980,27423,949,381,140,1470,28893
14-07-2018,8,11685,10819,5542,2023,30069,1021,398,220,1639,31708
14-07-2018,9,12293,12062,5620,2173,32149,1025,469,134,1628,33777
14-07-2018,10,12359,12242,5683,2206,32491,1024,514,144,1682,34173
14-07-2018,11,12338,12445,5727,2329,32841,1032,516,165,1713,34554
14-07-2018,12,11897,12146,5762,2428,32233,1032,470,158,1660,33893
14-07-2018,13,11449,11662,5821,2606,31539,1036,468,184,1688,33227
14-07-2018,14,11023,11256,5822,2751,30853,1043,382,205,1630,32483
14-07-2018,15,10768,11156,5787,2882,30593,1040,344,227,1611,32204
14-07-2018,16,10901,11207,5790,2956,30853,1026,295,232,1553,32406
14-07-2018,17,11284,11234,5673,2948,31139,1022,294,217,1533,32672
14-07-2018,18,12544,11599,5668,2807,32618,1025,291,203,1519,34137
14-07-2018,19,14019,11734,5734,2503,33991,1033,288,174,1495,35486
14-07-2018,20,14490,11660,5709,2097,33956,1042,288,174,1504,35460
14-07-2018,21,14021,11677,5734,1897,33329,1053,290,178,1521,34850
14-07-2018,22,13963,11665,5656,1863,33147,1057,291,178,1526,34673
14-07-2018,23,11374,11158,5530,1909,29970,1043,288,198,1529,31499
15-07-2018,0,9265,11269,5534,1969,28038,939,289,214,1442,29480
15-07-2018,1,7826,11179,5436,1916,26357,946,285,216,1447,27804
15-07-2018,2,7429,11256,5504,1740,25931,939,286,226,1451,27382
15-07-2018,3,7329,11138,5515,1685,25668,934,285,262,1481,27149
15-07-2018,4,7105,11004,5516,1582,25207,931,286,243,1460,26667
15-07-2018,5,7139,10890,5535,1501,25065,932,295,228,1455,26520
15-07-2018,6,7771,10891,5536,1474,25673,929,382,191,1502,27175
15-07-2018,7,8842,11099,5525,1491,26956,921,502,151,1574,28530
15-07-2018,8,9825,11259,5696,1659,28439,926,565,138,1629,30068
15-07-2018,9,10714,11659,5752,1726,29852,935,566,151,1652,31504
15-07-2018,10,11264,11781,5741,1816,30602,925,567,177,1669,32271
15-07-2018,11,11367,11832,5761,1863,30823,935,568,216,1719,32542
15-07-2018,12,10997,11941,5898,1892,30728,918,572,245,1735,32463
15-07-2018,13,10798,11991,5923,1919,30631,956,576,244,1776,32407
15-07-2018,14,10842,11978,5912,1930,30663,956,583,281,1820,32483
15-07-2018,15,10828,12175,5886,1895,30785,950,543,268,1761,32546
15-07-2018,16,11172,12259,5905,1856,31194,958,407,301,1666,32860
15-07-2018,17,11733,12280,5893,1696,31603,963,305,291,1559,33162
15-07-2018,18,12522,12329,5795,1508,32154,961,298,288,1547,33701
15-07-2018,19,13791,12743,5894,1352,33781,960,296,231,1487,35268
15-07-2018,20,14459,12758,5947,1239,34403,969,296,205,1470,35873
15-07-2018,21,14953,12675,6009,1123,34762,976,296,228,1500,36262
15-07-2018,22,14829,12531,6051,1064,34475,979,301,298,1578,36053
15-07-2018,23,12119,11839,5930,1043,30932,980,304,279,1563,32495
16-07-2018,0,9706,11496,5802,873,27877,1153,304,286,1743,29620
16-07-2018,1,8188,11390,5644,883,26105,1158,302,298,1758,27863
16-07-2018,2,7712,11273,5537,793,25317,1156,298,288,1742,27059
16-07-2018,3,7531,11243,5533,771,25078,1154,298,274,1726,26804
16-07-2018,4,7256,11266,5559,806,24888,1152,298,262,1712,26600
16-07-2018,5,8208,11403,5572,845,26030,1153,299,253,1705,27735
16-07-2018,6,12069,12388,5708,1138,31305,1148,382,216,1746,33051
16-07-2018,7,15812,13869,5952,1366,36998,1143,550,184,1877,38875
16-07-2018,8,16658,15230,6192,1525,39605,1142,598,180,1920,41525
16-07-2018,9,16769,15653,6419,1708,40548,1132,619,254,2005,42553
16-07-2018,10,16888,15727,6466,1806,40888,1142,649,308,2099,42987
16-07-2018,11,16709,15616,6492,1894,40712,1148,738,266,2152,42864
16-07-2018,12,16176,15190,6369,1939,39674,1156,938,259,2353,42027
16-07-2018,13,16214,14653,6379,1935,39182,1160,888,264,2312,41494
16-07-2018,14,15720,14633,6319,1922,38595,1171,839,271,2281,40876
16-07-2018,15,15846,14869,6212,2007,38934,1173,600,298,2071,41005
16-07-2018,16,15306,14570,6255,1917,38048,1111,387,444,1942,39990
16-07-2018,17,16103,15035,6152,1888,39177,1092,369,434,1895,41072
16-07-2018,18,16345,15164,6107,1795,39412,1081,392,358,1831,41243
16-07-2018,19,16302,15212,6123,1717,39353,1069,438,203,1710,41063
16-07-2018,20,16023,14851,5998,1539,38413,1087,439,306,1832,40245
16-07-2018,21,16143,14538,6025,1469,38175,1136,409,227,1772,39947
16-07-2018,22,15347,13988,6007,1402,36744,1209,370,234,1813,38557
16-07-2018,23,11796,12977,5829,1288,31891,1216,298,264,1778,33669
17-07-2018,0,9331,12055,5807,1138,28331,1227,290,298,1815,30146
17-07-2018,1,7948,11848,5750,1100,26647,1234,292,338,1864,28511
17-07-2018,2,7404,11786,5775,1061,26025,1225,292,353,1870,27895
17-07-2018,3,7033,11737,5815,1050,25636,1236,293,364,1893,27529
17-07-2018,4,6756,12043,5827,910,25536,1223,294,364,1881,27417
17-07-2018,5,7319,12168,5865,858,26211,1199,294,335,1828,28039
17-07-2018,6,10721,12835,5917,1047,30520,1168,384,304,1856,32376
17-07-2018,7,14638,14151,6098,1296,36185,1145,557,241,1943,38128
17-07-2018,8,16116,15004,6379,1341,38841,1132,624,258,2014,40855
17-07-2018,9,16478,15024,6405,1447,39355,1163,628,308,2099,41454
17-07-2018,10,16258,14752,6442,1585,39038,1194,639,364,2197,41235
17-07-2018,11,16079,14643,6376,1662,38759,1226,650,495,2371,41130
17-07-2018,12,15479,14045,6537,1666,37726,1239,649,389,2277,40003
17-07-2018,13,14795,13688,6703,1707,36893,1243,605,396,2244,39137
17-07-2018,14,14806,13737,6385,1618,36546,1255,617,454,2326,38872
17-07-2018,15,14794,13618,6173,1633,36220,1265,538,519,2322,38542
17-07-2018,16,14485,13662,6170,1615,35935,1260,377,545,2182,38117
17-07-2018,17,14701,13522,6130,1654,36007,1250,324,629,2203,38210
17-07-2018,18,14911,13867,6086,1482,36345,1235,337,497,2069,38414
17-07-2018,19,15801,14402,6126,1365,37694,1216,296,388,1900,39594
17-07-2018,20,15824,14347,6006,1135,37312,1158,318,430,1906,39218
17-07-2018,21,14925,13969,5941,1054,35891,1200,334,357,1891,37782
17-07-2018,22,14505,13978,6042,1086,35612,1225,292,396,1913,37525
17-07-2018,23,11340,12648,5900,986,30875,1239,292,355,1886,32761
18-07-2018,0,9110,12019,6086,1011,28225,1232,292,357,1881,30106
18-07-2018,1,7652,11742,6168,1106,26668,1225,293,377,1895,28563
18-07-2018,2,7067,11690,6181,1109,26047,1224,292,382,1898,27945
18-07-2018,3,6681,11780,6101,1040,25603,1218,292,374,1884,27487
18-07-2018,4,6637,12261,6071,1051,26020,1198,292,362,1852,27872
18-07-2018,5,7432,12512,5973,1139,27057,1193,304,334,1831,28888
18-07-2018,6,9796,13347,5898,1355,30395,1187,408,274,1869,32264
18-07-2018,7,13300,14444,5901,1682,35327,1289,599,224,2112,37439
18-07-2018,8,15064,15039,5252,1922,37276,1357,709,223,2289,39565
18-07-2018,9,15448,14921,5669,2042,38080,1289,779,225,2293,40373
18-07-2018,10,14775,14826,5805,2262,37668,1301,952,357,2610,40278
18-07-2018,11,14858,14626,5884,2397,37763,1363,861,552,2776,40539
18-07-2018,12,14561,14329,5788,2552,37230,1466,862,497,2825,40055
18-07-2018,13,14356,14088,5880,2697,37022,1483,815,368,2666,39688
18-07-2018,14,13969,14209,5877,2832,36886,1348,810,369,2527,39413
18-07-2018,15,13431,14037,5855,2916,36239,1348,735,367,2450,38689
18-07-2018,16,13121,13939,5819,2815,35694,1341,570,307,2218,37912
18-07-2018,17,13702,13999,5753,2882,36337,1341,508,319,2168,38505
18-07-2018,18,14594,14722,5793,2877,37986,1332,308,313,1953,39939
18-07-2018,19,15296,14829,5787,2720,38634,1306,295,341,1942,40576
18-07-2018,20,15430,14933,5829,2407,38600,1270,299,356,1925,40525
18-07-2018,21,14696,15075,6572,2293,38636,1243,296,335,1874,40510
18-07-2018,22,13668,15084,5570,2118,36441,1287,291,336,1914,38355
18-07-2018,23,10815,13024,5092,2035,30966,1317,292,362,1971,32937
19-07-2018,0,8957,12419,4954,1955,28286,1237,293,327,1857,30143
19-07-2018,1,7825,12041,4915,2053,26834,1217,290,287,1794,28628
19-07-2018,2,7065,11747,4876,2020,25708,1227,285,262,1774,27482
19-07-2018,3,6573,12257,4777,1915,25522,1214,284,219,1717,27239
19-07-2018,4,6635,12597,4672,1687,25591,1207,285,222,1714,27305
19-07-2018,5,7356,12785,4541,1751,26435,1213,317,340,1870,28305
19-07-2018,6,10177,13557,4834,1901,30471,1452,511,202,2165,32636
19-07-2018,7,13783,14288,5133,2094,35297,1460,804,263,2527,37824
19-07-2018,8,15154,14632,5517,2379,37683,1446,848,236,2530,40213
19-07-2018,9,15089,14589,5682,2580,37940,1415,839,251,2505,40445
19-07-2018,10,14895,14054,5600,2644,37194,1434,841,308,2583,39777
19-07-2018,11,14480,13536,5544,2673,36234,1459,1015,271,2745,38979
19-07-2018,12,14002,13289,5879,2802,35973,1459,887,331,2677,38650
19-07-2018,13,14012,13334,5790,2850,35987,1463,823,315,2601,38588
19-07-2018,14,14085,13264,5717,2769,35836,1464,810,309,2583,38419
19-07-2018,15,14335,13128,5621,2803,35888,1485,798,336,2619,38507
19-07-2018,16,15110,13491,5544,2745,36890,1510,478,305,2293,39183
19-07-2018,17,15683,14086,5444,2620,37831,1493,456,301,2250,40081
19-07-2018,18,15803,14635,5510,2572,38521,1492,427,303,2222,40743
19-07-2018,19,15685,14976,5419,2388,38469,1478,418,237,2133,40602
19-07-2018,20,15704,14823,5409,2148,38084,1484,363,273,2120,40204
19-07-2018,21,15733,14397,5467,1988,37585,1492,311,180,1983,39568
19-07-2018,22,15125,13932,5299,1927,36284,1499,303,167,1969,38253
19-07-2018,23,11692,12657,4843,1893,31086,1356,304,169,1829,32915
20-07-2018,0,9756,11574,4674,1763,27766,1210,300,179,1689,29455
20-07-2018,1,8778,11386,4564,1783,26509,1196,301,180,1677,28186
20-07-2018,2,8174,11365,4501,1743,25783,1186,299,177,1662,27445
20-07-2018,3,7507,11438,4450,1795,25191,1194,300,174,1668,26859
20-07-2018,4,7225,11878,4475,1772,25349,1167,300,173,1640,26989
20-07-2018,5,8084,11731,4550,1812,26178,1161,320,159,1640,27818
20-07-2018,6,11076,13075,4654,1927,30733,1243,522,187,1952,32685
20-07-2018,7,14717,14248,5131,2099,36194,1265,592,186,2043,38237
20-07-2018,8,15834,14752,5457,2363,38407,1244,639,209,2092,40499
20-07-2018,9,15957,14797,5539,2610,38904,1252,669,274,2195,41099
20-07-2018,10,16116,14418,5516,2704,38753,1255,677,394,2326,41079
20-07-2018,11,16265,14182,5718,2870,39037,1243,658,416,2317,41354
20-07-2018,12,15606,13833,6320,2989,38751,1257,769,325,2351,41102
20-07-2018,13,15559,13449,6266,3068,38342,1265,720,298,2283,40625
20-07-2018,14,15436,13216,6094,2963,37709,1260,737,354,2351,40060
20-07-2018,15,15627,13290,5946,2720,37583,1253,604,361,2218,39801
20-07-2018,16,15549,13590,5975,2484,37597,1198,412,381,1991,39588
20-07-2018,17,15674,14176,6004,2265,38120,1224,311,415,1950,40070
20-07-2018,18,15593,14367,5944,2077,37980,1226,298,337,1861,39841
20-07-2018,19,15538,14240,5910,1802,37489,1224,300,327,1851,39340
20-07-2018,20,15392,13857,5784,1479,36511,1181,349,285,1815,38326
20-07-2018,21,14602,13531,5722,1388,35242,1144,442,287,1873,37115
20-07-2018,22,13740,13127,5760,1333,33962,1143,411,380,1934,35896
20-07-2018,23,10788,12078,5755,1335,29956,1225,350,241,1816,31772
21-07-2018,0,8946,11565,5842,1330,27685,1029,353,211,1593,29278
21-07-2018,1,7638,11365,5846,1148,25997,1021,347,206,1574,27571
21-07-2018,2,6922,11290,5763,1086,25063,1023,287,202,1512,26575
21-07-2018,3,6809,11252,5785,1111,24956,1018,286,208,1512,26468
21-07-2018,4,6622,11255,5787,1073,24737,1022,272,195,1489,26226
21-07-2018,5,6709,11286,5797,1085,24878,1024,300,132,1456,26334
21-07-2018,6,7813,11205,5757,1127,25904,1026,290,124,1440,27344
21-07-2018,7,9550,11189,5841,1187,27766,1022,284,130,1436,29202
21-07-2018,8,11749,11996,5991,1489,31225,955,295,170,1420,32645
21-07-2018,9,13812,12392,6089,1760,34053,955,364,213,1532,35585
21-07-2018,10,13984,12639,6074,1936,34633,960,355,288,1603,36236
21-07-2018,11,14173,12748,6105,2117,35143,963,506,260,1729,36872
21-07-2018,12,13427,12641,6045,2236,34348,956,399,284,1639,35987
21-07-2018,13,12301,12514,5926,2319,33060,941,368,353,1662,34722
21-07-2018,14,11884,12515,5961,2372,32732,914,406,360,1680,34412
21-07-2018,15,11740,12624,5929,2352,32645,940,403,297,1640,34285
21-07-2018,16,11613,12711,5954,2239,32517,962,318,264,1544,34061
21-07-2018,17,12752,13065,6038,2025,33880,969,287,221,1477,35357
21-07-2018,18,14086,13133,6172,1881,35271,973,317,193,1483,36754
21-07-2018,19,14497,12800,5938,1621,34857,971,306,183,1460,36317
21-07-2018,20,14345,12451,5943,1385,34124,976,286,179,1441,35565
21-07-2018,21,13900,12341,5919,1230,33391,977,302,178,1457,34848
21-07-2018,22,13331,12236,5851,1227,32647,973,321,167,1461,34108
21-07-2018,23,10695,11596,5916,1242,29448,971,280,167,1418,30866
22-07-2018,0,9182,11053,5845,1251,27330,879,279,164,1322,28652
22-07-2018,1,8220,11064,5814,1100,26199,886,277,162,1325,27524
22-07-2018,2,7775,10936,5753,1121,25585,878,277,157,1312,26897
22-07-2018,3,7392,10774,5674,1097,24938,870,278,149,1297,26235
22-07-2018,4,7019,10745,5546,1125,24436,864,279,146,1289,25725
22-07-2018,5,6909,10776,5544,1161,24391,867,280,127,1274,25665
22-07-2018,6,7392,10837,5652,1205,25086,865,283,134,1282,26368
22-07-2018,7,8710,10822,5792,1286,26610,866,376,155,1397,28007
22-07-2018,8,9869,10763,5829,1560,28023,875,395,162,1432,29455
22-07-2018,9,10777,11044,5949,1933,29706,883,396,163,1442,31148
22-07-2018,10,11118,11339,5976,2016,30449,886,411,182,1479,31928
22-07-2018,11,11273,11333,6014,2164,30786,929,410,183,1522,32308
22-07-2018,12,11082,11532,6082,2290,30986,962,394,188,1544,32530
22-07-2018,13,10925,11574,6069,2323,30891,964,392,267,1623,32514
22-07-2018,14,10470,11566,6040,2300,30377,940,395,280,1615,31992
22-07-2018,15,10215,11540,6023,2261,30041,944,394,230,1568,31609
22-07-2018,16,10228,11636,6108,2309,30279,942,304,243,1489,31768
22-07-2018,17,10615,11696,6197,2254,30763,946,304,238,1488,32251
22-07-2018,18,11391,11818,6235,2154,31598,944,284,221,1449,33047
22-07-2018,19,13048,11926,6293,1967,33233,938,283,212,1433,34666
22-07-2018,20,13866,11955,6329,1786,33936,928,284,222,1434,35370
22-07-2018,21,14304,12176,6519,1704,34704,933,282,243,1458,36162
22-07-2018,22,13608,12046,6589,1701,33944,917,278,260,1455,35399
22-07-2018,23,10975,11275,6478,1658,30387,959,278,264,1501,31888
23-07-2018,0,8395,11186,6383,1446,27409,1145,277,246,1668,29077
23-07-2018,1,6805,10905,6248,1446,25404,1165,275,244,1684,27088
23-07-2018,2,6551,10801,6193,1473,25020,1159,277,230,1666,26686
23-07-2018,3,6475,10833,6027,1460,24796,1146,277,238,1661,26457
23-07-2018,4,6438,11451,5999,1469,25357,1235,278,235,1748,27105
23-07-2018,5,7170,11362,6025,1502,26059,1249,283,189,1721,27780
23-07-2018,6,11104,12134,6130,1816,31184,1256,440,234,1930,33114
23-07-2018,7,14987,13194,6247,2029,36457,1260,630,169,2059,38516
23-07-2018,8,16005,14097,6422,2203,38728,1263,732,154,2149,40877
23-07-2018,9,16236,14620,6616,2277,39749,1259,847,192,2298,42047
23-07-2018,10,16376,14339,6713,2516,39946,1192,848,290,2330,42276
23-07-2018,11,16359,14404,6657,2603,40026,1175,848,243,2266,42292
23-07-2018,12,16466,13747,6736,2603,39552,1174,847,255,2276,41828
23-07-2018,13,15909,13338,6814,2516,38578,1173,717,301,2191,40769
23-07-2018,14,15881,13400,6816,2508,38605,1169,620,310,2099,40704
23-07-2018,15,16203,13462,6648,2526,38840,1171,498,323,1992,40832
23-07-2018,16,16452,13447,6520,2571,38991,1166,406,312,1884,40875
23-07-2018,17,16353,14195,6460,2541,39549,1183,345,293,1821,41370
23-07-2018,18,16023,14467,6418,2232,39139,1166,312,285,1763,40902
23-07-2018,19,16044,14224,6368,1937,38574,1166,326,261,1753,40327
23-07-2018,20,16041,13651,6342,1716,37750,1099,339,260,1698,39448
23-07-2018,21,15915,13544,6392,1568,37419,1023,401,292,1716,39135
23-07-2018,22,15635,13093,6345,1487,36562,1062,317,316,1695,38257
23-07-2018,23,13572,11962,6183,1305,33023,1116,280,241,1637,34660
24-07-2018,0,10946,11130,6004,1267,29347,1068,278,298,1644,30991
24-07-2018,1,9466,10734,5801,1200,27200,1075,277,305,1657,28857
24-07-2018,2,8222,10547,5658,1098,25527,1072,276,252,1600,27127
24-07-2018,3,7748,10559,5639,1116,25061,1079,277,245,1601,26662
24-07-2018,4,7761,11148,5661,1105,25676,1104,278,207,1589,27265
24-07-2018,5,8861,11207,5759,1089,26916,1125,312,192,1629,28545
24-07-2018,6,12594,12504,5960,1109,32168,1216,387,165,1768,33936
24-07-2018,7,15494,13342,6112,1261,36209,1209,629,137,1975,38184
24-07-2018,8,16258,14158,6439,1429,38283,1213,859,164,2236,40519
24-07-2018,9,16517,14278,6450,1515,38760,1216,1214,210,2640,41400
24-07-2018,10,16751,14116,6528,1632,39028,1219,1162,270,2651,41679
24-07-2018,11,16799,14033,6555,1749,39134,1226,1167,283,2676,41810
24-07-2018,12,16622,13573,6527,1737,38461,1217,1266,278,2761,41222
24-07-2018,13,16564,13292,6499,1826,38180,1207,1189,219,2615,40795
24-07-2018,14,16711,13427,6405,1812,38355,1209,1049,245,2503,40858
24-07-2018,15,16715,13784,6273,1806,38578,1210,761,278,2249,40827
24-07-2018,16,16541,13960,6162,1854,38515,1216,659,254,2129,40644
24-07-2018,17,16394,14228,6071,1679,38373,1224,672,228,2124,40497
24-07-2018,18,16297,14139,6146,1535,38117,1216,877,235,2328,40445
24-07-2018,19,16215,14022,6172,1371,37781,1201,832,218,2251,40032
24-07-2018,20,15707,13804,5933,1172,36617,1182,853,205,2240,38857
24-07-2018,21,15637,13666,5887,1142,36330,1188,461,218,1867,38197
24-07-2018,22,15558,13339,5868,1113,35878,1209,289,265,1763,37641
24-07-2018,23,13847,12556,5599,1075,33076,1219,283,177,1679,34755
25-07-2018,0,11771,11845,5597,1050,30263,1149,279,203,1631,31894
25-07-2018,1,9825,11362,5539,1045,27769,1150,277,186,1613,29382
25-07-2018,2,8708,11195,5600,1014,26516,1152,276,158,1586,28102
25-07-2018,3,8505,10936,5634,1029,26105,1140,277,147,1564,27669
25-07-2018,4,8384,11190,5566,1050,26190,1132,278,148,1558,27748
25-07-2018,5,9747,11319,5617,1068,27750,1159,351,152,1662,29412
25-07-2018,6,12951,12341,5886,1108,32288,1217,712,162,2091,34379
25-07-2018,7,15052,12877,6330,1300,35561,1215,992,147,2354,37915
25-07-2018,8,15748,13337,6549,1400,37034,1210,977,170,2357,39391
25-07-2018,9,16093,13615,6635,1537,37881,1211,1005,179,2395,40276
25-07-2018,10,16394,13498,6562,1689,38144,1205,1021,182,2408,40552
25-07-2018,11,16666,13793,6577,1827,38863,1209,1010,279,2498,41361
25-07-2018,12,16792,13879,6738,1901,39311,1218,998,405,2621,41932
25-07-2018,13,16300,13591,6611,1922,38425,1228,965,402,2595,41020
25-07-2018,14,16250,13751,6442,1879,38323,1226,942,220,2388,40711
25-07-2018,15,16136,13991,6369,1961,38458,1241,829,249,2319,40777
25-07-2018,16,15824,13926,6417,1967,38134,1237,748,239,2224,40358
25-07-2018,17,15670,13860,6488,1960,37979,1231,867,226,2324,40303
25-07-2018,18,15983,13649,6311,1859,37800,1187,961,219,2367,40167
25-07-2018,19,15909,13459,6246,1698,37312,1215,874,207,2296,39608
25-07-2018,20,15468,12984,6222,1607,36282,1220,839,190,2249,38531
25-07-2018,21,15221,13163,6168,1525,36077,1220,477,211,1908,37985
25-07-2018,22,15142,12678,6119,1516,35457,1189,356,232,1777,37234
25-07-2018,23,13802,11783,5961,1437,32983,1230,283,211,1724,34707
26-07-2018,0,10562,11570,5862,1359,29352,1149,282,216,1647,30999
26-07-2018,1,9344,11292,5761,1388,27785,1128,279,195,1602,29387
26-07-2018,2,8392,11251,5725,1396,26764,1119,278,191,1588,28352
26-07-2018,3,7892,11217,5729,1380,26220,1112,278,190,1580,27800
26-07-2018,4,7818,11848,5798,1401,26866,1111,281,171,1563,28429
26-07-2018,5,8901,12089,5865,1406,28260,1148,287,200,1635,29895
26-07-2018,6,12140,12700,5983,1485,32309,1209,385,161,1755,34064
26-07-2018,7,15232,13051,6124,1526,35935,1208,525,158,1891,37826
26-07-2018,8,16129,13389,6439,1649,37606,1206,735,188,2129,39735
26-07-2018,9,16451,13882,6323,1792,38448,1202,1132,193,2527,40975
26-07-2018,10,16729,14048,6594,1863,39234,1216,1097,231,2544,41778
26-07-2018,11,16621,13644,6602,1900,38767,1216,1167,239,2622,41389
26-07-2018,12,16541,13131,6556,1942,38171,1224,1238,217,2679,40850
26-07-2018,13,16438,12867,6620,1938,37864,1236,1164,250,2650,40514
26-07-2018,14,16444,13028,6482,1870,37823,1229,1034,216,2479,40302
26-07-2018,15,16510,13067,6486,1743,37806,1231,732,218,2181,39987
26-07-2018,16,16621,13359,6339,1645,37964,1235,693,233,2161,40125
26-07-2018,17,16537,13656,6290,1542,38025,1228,618,192,2038,40063
26-07-2018,18,16399,13525,6327,1566,37816,1223,710,221,2154,39970
26-07-2018,19,16260,13270,6461,1597,37588,1218,693,217,2128,39716
26-07-2018,20,16087,13029,6220,1481,36817,1223,683,209,2115,38932
26-07-2018,21,15525,12847,6164,1533,36070,1225,302,247,1774,37844
26-07-2018,22,14364,12398,6300,1693,34755,1227,286,261,1774,36529
26-07-2018,23,11341,11288,6280,1723,30631,1223,286,274,1783,32414
27-07-2018,0,9516,11042,6339,1698,28593,1224,283,257,1764,30357
27-07-2018,1,8119,11048,6219,1824,27211,1219,283,221,1723,28934
27-07-2018,2,7284,10762,6129,1853,26029,1206,283,222,1711,27740
27-07-2018,3,7094,10906,6071,1845,25917,1198,282,229,1709,27626
27-07-2018,4,7017,11146,6065,1686,25914,1199,283,254,1736,27650
27-07-2018,5,8445,11258,5997,1680,27380,1208,289,240,1737,29117
27-07-2018,6,11861,12351,6006,1726,31945,1206,413,216,1835,33780
27-07-2018,7,14798,13291,6287,1867,36243,1206,649,184,2039,38282
27-07-2018,8,16017,13749,6419,2005,38191,1206,771,229,2206,40397
27-07-2018,9,16173,14093,6423,2176,38866,1209,1112,279,2600,41466
27-07-2018,10,16441,14399,6476,2385,39701,1224,1185,314,2723,42424
27-07-2018,11,15886,14270,6527,2427,39111,1239,1262,305,2806,41917
27-07-2018,12,15520,13801,6559,2606,38487,1258,1258,299,2815,41302
27-07-2018,13,14874,13423,6361,2624,37282,1276,1262,280,2818,40100
27-07-2018,14,14266,13363,6196,2721,36547,1280,1113,287,2680,39227
27-07-2018,15,14449,13498,6335,2901,37183,1259,655,248,2162,39345
27-07-2018,16,15105,13828,6257,3057,38247,1262,525,277,2064,40311
27-07-2018,17,15479,14015,6089,3094,38676,1268,525,283,2076,40752
27-07-2018,18,15390,13837,6034,3094,38356,1263,445,261,1969,40325
27-07-2018,19,15259,13408,6110,2682,37458,1254,389,253,1896,39354
27-07-2018,20,14637,12859,6138,2689,36322,1252,296,242,1790,38112
27-07-2018,21,14061,12963,6278,2589,35892,1247,295,293,1835,37727
27-07-2018,22,12294,12625,6334,2608,33862,1247,295,329,1871,35733
27-07-2018,23,9959,12096,6301,2650,31007,1255,299,228,1782,32789
28-07-2018,0,8566,12100,6139,2609,29415,1090,291,259,1640,31055
28-07-2018,1,7524,11980,5953,2562,28020,1082,288,268,1638,29658
28-07-2018,2,7206,11990,5983,2474,27653,1093,288,260,1641,29294
28-07-2018,3,6867,11930,5935,2491,27224,1081,287,269,1637,28861
28-07-2018,4,6661,11830,5817,2548,26858,1079,292,274,1645,28503
28-07-2018,5,6277,11656,5548,2611,26092,1068,292,261,1621,27713
28-07-2018,6,7019,11390,5376,2640,26424,1063,382,227,1672,28096
28-07-2018,7,8565,11544,5364,2858,28332,1063,415,192,1670,30002
28-07-2018,8,10539,11974,5644,3374,31530,1074,471,206,1751,33281
28-07-2018,9,11870,12212,5780,3806,33668,1087,484,345,1916,35584
28-07-2018,10,12146,12279,5862,4047,34334,1073,538,316,1927,36261
28-07-2018,11,11939,12451,5877,4033,34301,1079,598,295,1972,36273
28-07-2018,12,11576,12499,5890,4211,34175,1085,612,283,1980,36155
28-07-2018,13,10701,12541,5850,4243,33335,1061,644,298,2003,35338
28-07-2018,14,10512,12531,5700,3968,32712,1045,587,294,1926,34638
28-07-2018,15,10149,12678,5641,3905,32374,1074,539,284,1897,34271
28-07-2018,16,10269,12806,5666,3639,32379,1113,418,237,1768,34147
28-07-2018,17,10451,13031,5705,3111,32299,1097,426,173,1696,33995
28-07-2018,18,10937,13329,5724,2501,32493,1092,379,179,1650,34143
28-07-2018,19,11576,13520,5861,2047,33004,1091,324,173,1588,34592
28-07-2018,20,12009,13636,5967,1472,33083,1072,324,185,1581,34664
28-07-2018,21,12258,13853,5976,1369,33456,1096,319,236,1651,35107
28-07-2018,22,11962,13883,6126,1301,33272,1095,319,267,1681,34953
28-07-2018,23,9456,12761,6115,1231,29562,1102,294,272,1668,31230
29-07-2018,0,7573,12032,5958,1219,26784,954,291,262,1507,28291
29-07-2018,1,6660,11910,5807,1407,25785,950,289,252,1491,27276
29-07-2018,2,6329,11731,5815,1440,25316,963,289,224,1476,26792
29-07-2018,3,6165,11643,5832,1610,25251,961,288,243,1492,26743
29-07-2018,4,6149,11627,5847,1531,25156,942,289,219,1450,26606
29-07-2018,5,6401,11630,5717,1425,25173,979,290,197,1466,26639
29-07-2018,6,6957,11431,5456,1423,25266,981,385,188,1554,26820
29-07-2018,7,8196,11461,5346,1357,26359,1038,502,176,1716,28075
29-07-2018,8,9451,11787,5525,1384,28148,1071,549,210,1830,29978
29-07-2018,9,10273,11907,5773,1536,29491,972,471,374,1817,31308
29-07-2018,10,10759,12183,5870,1724,30538,974,496,204,1674,32212
29-07-2018,11,10773,12310,5968,1789,30842,976,476,188,1640,32482
29-07-2018,12,10607,12436,6072,1821,30937,979,502,201,1682,32619
29-07-2018,13,10562,12540,6070,1844,31016,977,491,221,1689,32705
29-07-2018,14,10598,12340,5921,1806,30665,991,493,205,1689,32354
29-07-2018,15,10471,12193,5912,1691,30267,984,490,212,1686,31953
29-07-2018,16,10422,12484,5926,1702,30533,979,395,217,1591,32124
29-07-2018,17,11033,12673,5889,1682,31277,977,315,232,1524,32801
29-07-2018,18,11684,12363,5853,1673,31574,948,357,191,1496,33070
29-07-2018,19,13550,12453,5831,1712,33547,882,455,156,1493,35040
29-07-2018,20,14305,12590,5981,1682,34557,869,491,147,1507,36064
29-07-2018,21,14453,12692,6170,1696,35012,897,482,147,1526,36538
29-07-2018,22,14658,12210,6222,1812,34903,895,413,197,1505,36408
29-07-2018,23,12277,11834,6203,1879,32194,968,291,155,1414,33608
30-07-2018,0,9042,10861,6092,1823,27820,1136,283,202,1621,29441
30-07-2018,1,7698,10662,5953,1768,26081,1137,280,184,1601,27682
30-07-2018,2,7201,10638,5947,1658,25443,1129,280,133,1542,26985
30-07-2018,3,6968,10669,5862,1616,25116,1129,282,206,1617,26733
30-07-2018,4,7177,10997,5847,1697,25718,1123,309,123,1555,27273
30-07-2018,5,8195,11037,5729,1638,26598,1110,408,127,1645,28243
30-07-2018,6,11328,12269,5767,1706,31070,1087,919,140,2146,33216
30-07-2018,7,14488,12718,5994,1677,34877,1085,990,250,2325,37202
30-07-2018,8,15465,13567,6198,1763,36994,1075,1101,572,2748,39742
30-07-2018,9,16021,13946,6204,1656,37827,1074,1175,576,2825,40652
30-07-2018,10,16138,14107,6414,1719,38377,1097,1182,598,2877,41254
30-07-2018,11,16043,14050,6580,1881,38556,1097,1231,592,2920,41476
30-07-2018,12,16044,13850,6581,1897,38373,1099,1275,588,2962,41335
30-07-2018,13,16210,13670,6699,1855,38433,1106,1182,586,2874,41307
30-07-2018,14,15769,13329,6408,1869,37374,1084,1169,603,2856,40230
30-07-2018,15,15845,13519,6273,1937,37575,1055,1128,409,2592,40167
30-07-2018,16,16101,13564,6046,1926,37638,1110,899,219,2228,39866
30-07-2018,17,15972,14045,6110,1774,37903,1103,856,226,2185,40088
30-07-2018,18,15861,13841,6014,1576,37293,1095,846,236,2177,39470
30-07-2018,19,15948,13377,5942,1424,36689,1079,835,215,2129,38818
30-07-2018,20,15761,13226,5870,1276,36134,1094,805,167,2066,38200
30-07-2018,21,15774,13398,6064,1265,36501,1110,489,208,1807,38308
30-07-2018,22,15192,13225,6070,1455,35942,1110,309,202,1621,37563
30-07-2018,23,11963,11576,5951,1636,31127,1110,282,209,1601,32728
31-07-2018,0,9821,10920,5877,1699,28318,1016,284,224,1524,29842
31-07-2018,1,8995,10674,5715,1837,27222,952,280,209,1441,28663
31-07-2018,2,8912,10461,5810,1841,27023,967,279,198,1444,28467
31-07-2018,3,8649,10417,5818,1888,26771,962,280,181,1423,28194
31-07-2018,4,8206,10294,5856,1970,26326,958,281,175,1414,27740
31-07-2018,5,9255,10602,5782,1851,27489,1004,353,158,1515,29004
31-07-2018,6,12137,11757,5715,1993,31601,1057,757,159,1973,33574
31-07-2018,7,14732,12671,6289,1949,35640,1056,994,173,2223,37863
31-07-2018,8,15540,13947,6431,1985,37903,1056,1010,565,2631,40534
31-07-2018,9,15961,14363,6666,2093,39085,1055,1062,581,2698,41783
31-07-2018,10,15613,15075,6741,2242,39672,1054,1102,598,2754,42426
31-07-2018,11,15746,14902,6912,2421,39981,1052,1056,612,2720,42701
31-07-2018,12,15372,14515,6984,2452,39324,1058,1152,614,2824,42148
31-07-2018,13,14835,14142,6970,2598,38544,1054,1082,622,2758,41302
31-07-2018,14,14396,13878,6909,2535,37719,1051,1163,378,2592,40311
31-07-2018,15,14755,13533,6916,2821,38025,1048,1071,238,2357,40382
31-07-2018,16,14701,13857,6592,3300,38450,1051,1053,237,2341,40791
31-07-2018,17,15181,13837,6367,3435,38820,1052,1087,218,2357,41177
31-07-2018,18,15427,14160,6350,2556,38494,1045,1036,193,2274,40768
31-07-2018,19,15488,14098,6268,1818,37672,1044,1017,212,2273,39945
31-07-2018,20,15065,13724,6130,1394,36313,1047,834,216,2097,38410
31-07-2018,21,14987,13262,6166,1226,35641,1044,542,254,1840,37481
31-07-2018,22,14697,13421,6178,1236,35532,1023,507,305,1835,37367
31-07-2018,23,12383,12234,5902,1120,31638,1034,473,309,1816,33454
01-08-2018,0,9052,11293,5813,993,27152,1026,477,305,1808,28960
01-08-2018,1,8721,11044,5690,1047,26503,1046,478,279,1803,28306
01-08-2018,2,8344,10881,5585,968,25777,1075,476,262,1813,27590
01-08-2018,3,8225,10762,5534,867,25389,1083,473,230,1786,27175
01-08-2018,4,8219,10835,5514,832,25400,1058,475,192,1725,27125
01-08-2018,5,8892,10624,5496,838,25850,1059,482,174,1715,27565
01-08-2018,6,12270,11303,5646,857,30075,1051,493,196,1740,31815
01-08-2018,7,14988,12864,6006,1204,35061,1074,910,184,2168,37229
01-08-2018,8,15597,14037,6268,1352,37253,1072,969,373,2414,39667
01-08-2018,9,15707,14224,6547,1472,37949,1096,1044,565,2705,40654
01-08-2018,10,15878,14308,6705,1547,38439,1072,1198,575,2845,41284
01-08-2018,11,15932,14436,6671,1553,38592,1093,1269,590,2952,41544
01-08-2018,12,15864,14490,6742,1670,38766,1103,1182,592,2877,41643
01-08-2018,13,15772,14522,6776,1716,38786,1055,1187,587,2829,41615
01-08-2018,14,15722,14664,6780,1786,38952,1084,1099,577,2760,41712
01-08-2018,15,15644,14260,6552,1843,38300,1137,1093,577,2807,41107
01-08-2018,16,15778,14331,6579,1811,38499,1139,974,184,2297,40796
01-08-2018,17,15841,14477,6354,1619,38291,1177,907,168,2252,40543
01-08-2018,18,15628,14470,6276,1492,37867,1155,899,149,2203,40070
01-08-2018,19,15585,14216,6181,1296,37278,1137,893,139,2169,39447
01-08-2018,20,15612,13729,5873,1138,36352,1098,943,138,2179,38531
01-08-2018,21,15491,13722,5691,1103,36009,1050,959,155,2164,38173
01-08-2018,22,15196,13708,5724,1079,35707,1128,733,147,2008,37715
01-08-2018,23,13236,12154,5676,955,32021,1129,520,164,1813,33834
02-08-2018,0,10494,10569,5734,851,27649,1131,515,170,1816,29465
02-08-2018,1,9466,10242,5629,811,26149,1131,482,172,1785,27934
02-08-2018,2,9360,9647,5601,847,25456,1124,477,145,1746,27202
02-08-2018,3,8805,9670,5580,812,24869,1155,473,145,1773,26642
02-08-2018,4,8593,9783,5608,775,24758,1220,471,145,1836,26594
02-08-2018,5,9356,9973,5644,648,25623,1227,475,145,1847,27470
02-08-2018,6,12900,11442,5847,841,31031,1227,480,145,1852,32883
02-08-2018,7,15302,13136,6265,1081,35784,1227,731,161,2119,37903
02-08-2018,8,15823,13662,6515,1245,37246,1182,1120,208,2510,39756
02-08-2018,9,15998,13816,6642,1354,37811,1182,1140,190,2512,40323
02-08-2018,10,15998,13963,6737,1547,38244,1190,1278,209,2677,40921
02-08-2018,11,16075,14152,6776,1658,38660,1140,1234,215,2589,41249
02-08-2018,12,15967,14211,6719,1805,38703,1135,1259,217,2611,41314
02-08-2018,13,16147,14278,6648,1923,38995,1137,1314,216,2667,41662
02-08-2018,14,16295,14284,6466,1921,38965,1186,1185,207,2578,41543
02-08-2018,15,16257,14289,6374,1935,38854,1190,1180,205,2575,41429
02-08-2018,16,16160,14390,6355,1823,38728,1183,1160,208,2551,41279
02-08-2018,17,16080,14386,6190,1563,38219,1180,1159,207,2546,40765
02-08-2018,18,16003,14211,6153,1392,37760,1138,1086,179,2403,40163
02-08-2018,19,15969,13940,6111,1206,37227,1139,1092,173,2404,39631
02-08-2018,20,15350,13388,5890,1055,35684,1143,1080,172,2395,38079
02-08-2018,21,15332,13220,5924,976,35453,1148,1105,183,2436,37889
02-08-2018,22,15124,12912,6003,955,34994,1206,866,181,2253,37247
02-08-2018,23,13749,12013,5988,889,32640,1211,512,144,1867,34507
03-08-2018,0,11871,11025,5935,943,29774,1220,469,159,1848,31622
03-08-2018,1,10040,10600,5798,975,27414,1225,468,167,1860,29274
03-08-2018,2,9419,10578,5715,943,26655,1224,467,170,1861,28516
03-08-2018,3,9019,10657,5668,937,26282,1222,464,146,1832,28114
03-08-2018,4,9208,11213,5680,937,27039,1238,467,146,1851,28890
03-08-2018,5,9953,11982,5730,928,28593,1258,470,151,1879,30472
03-08-2018,6,13804,12669,5720,1192,33386,1271,492,176,1939,35325
03-08-2018,7,15065,13303,6126,1290,35784,1297,909,187,2393,38177
03-08-2018,8,15676,13852,6314,1535,37378,1303,1064,202,2569,39947
03-08-2018,9,16102,14178,6355,1674,38310,1326,1055,496,2877,41187
03-08-2018,10,16229,14175,6413,1848,38664,1324,1055,512,2891,41555
03-08-2018,11,16161,14503,6345,1876,38886,1329,971,622,2922,41808
03-08-2018,12,16122,14611,6352,1752,38836,1355,999,466,2820,41656
03-08-2018,13,16135,14569,6488,1884,39077,1349,969,475,2793,41870
03-08-2018,14,16196,14368,6482,1835,38882,1360,997,415,2772,41654
03-08-2018,15,16115,14122,6390,1858,38486,1334,1016,347,2697,41183
03-08-2018,16,16147,14080,6135,1885,38250,1311,986,337,2634,40884
03-08-2018,17,16158,14154,6028,1696,38036,1344,953,282,2579,40615
03-08-2018,18,16114,14192,5870,1576,37753,1316,967,252,2535,40288
03-08-2018,19,16020,14027,5698,1558,37302,1255,984,378,2617,39919
03-08-2018,20,15266,13215,5605,1531,35619,1257,1174,418,2849,38468
03-08-2018,21,15132,13230,5561,1380,35303,1262,1123,222,2607,37910
03-08-2018,22,14744,13013,5618,1231,34606,1300,953,203,2456,37062
03-08-2018,23,14029,12380,5620,1230,33258,1360,510,172,2042,35300
04-08-2018,0,13304,11744,5537,1319,31904,1169,411,161,1741,33645
04-08-2018,1,11221,11596,5373,1387,29577,1259,363,151,1773,31350
04-08-2018,2,9630,11437,5259,1447,27773,1277,318,145,1740,29513
04-08-2018,3,8873,11172,5106,1461,26612,1264,314,141,1719,28331
04-08-2018,4,8415,11086,5046,1507,26055,1251,313,134,1698,27753
04-08-2018,5,8381,10910,4996,1392,25679,1236,318,134,1688,27367
04-08-2018,6,9477,10601,5034,1218,26331,1243,321,146,1710,28041
04-08-2018,7,11956,11064,5212,1489,29722,1219,321,152,1692,31414
04-08-2018,8,14148,11876,5250,1696,32971,1194,379,188,1761,34732
04-08-2018,9,14998,12209,5417,1903,34528,1191,579,224,1994,36522
04-08-2018,10,15019,12317,5478,2140,34955,1196,634,255,2085,37040
04-08-2018,11,14367,12073,5479,2385,34304,1210,662,274,2146,36450
04-08-2018,12,13555,11575,5403,2727,33259,1227,581,311,2119,35378
04-08-2018,13,12513,11179,5360,2937,31989,1196,473,359,2028,34017
04-08-2018,14,12495,11294,5372,3060,32222,1219,432,368,2019,34241
04-08-2018,15,12281,11544,5344,3150,32320,1228,218,350,1796,34116
04-08-2018,16,12671,11866,5376,2894,32807,1240,230,309,1779,34586
04-08-2018,17,13529,12240,5435,2740,33944,1243,245,289,1777,35721
04-08-2018,18,14428,12415,5359,2912,35115,1225,236,255,1716,36831
04-08-2018,19,14274,11885,5289,3063,34511,1198,228,209,1635,36146
04-08-2018,20,14181,11833,5338,2902,34256,1212,228,168,1608,35864
04-08-2018,21,14156,11943,5285,2879,34265,1170,229,219,1618,35883
04-08-2018,22,13184,11669,5281,3071,33206,1197,177,193,1567,34773
04-08-2018,23,10521,11451,5185,3386,30545,1218,129,191,1538,32083
05-08-2018,0,9884,10976,5074,3065,28999,980,130,185,1295,30294
05-08-2018,1,9115,11075,5081,3079,28348,895,129,168,1192,29540
05-08-2018,2,8667,10937,5058,3229,27892,892,128,189,1209,29101
05-08-2018,3,7953,10933,5008,3621,27515,878,128,201,1207,28722
05-08-2018,4,7904,11016,4915,3743,27580,881,130,206,1217,28797
05-08-2018,5,8028,10959,4825,3623,27435,899,133,239,1271,28706
05-08-2018,6,8155,11105,4802,3519,27582,916,132,211,1259,28841
05-08-2018,7,8440,11347,4731,3699,28217,918,131,183,1232,29449
05-08-2018,8,9271,11331,4760,4005,29365,945,131,203,1279,30644
05-08-2018,9,9761,11495,4854,4073,30183,984,131,258,1373,31556
05-08-2018,10,10070,11672,4958,3985,30687,991,130,329,1450,32137
05-08-2018,11,10304,12049,4911,3938,31202,964,132,369,1465,32667
05-08-2018,12,10009,12353,4849,4059,31270,950,127,435,1512,32782
05-08-2018,13,9894,12717,4899,4200,31711,959,134,490,1583,33294
05-08-2018,14,9576,12926,4793,4340,31635,952,136,509,1597,33232
05-08-2018,15,9117,12526,4774,4401,30818,931,136,514,1581,32399
05-08-2018,16,9288,12734,4757,4372,31150,937,141,482,1560,32710
05-08-2018,17,10038,13183,4764,4188,32175,938,144,459,1541,33716
05-08-2018,18,11683,13467,4892,3546,33587,944,149,443,1536,35123
05-08-2018,19,12599,13671,4975,3318,34564,947,144,338,1429,35993
05-08-2018,20,13116,13776,5069,2975,34938,946,141,275,1362,36300
05-08-2018,21,14229,13905,5167,2637,35938,961,140,263,1364,37302
05-08-2018,22,13546,13658,5198,2369,34768,991,137,304,1432,36200
05-08-2018,23,11558,12919,5169,2301,31948,975,133,273,1381,33329
06-08-2018,0,9543,13064,5142,2304,30054,1067,133,288,1488,31542
06-08-2018,1,8479,12939,5172,2095,28685,1107,133,281,1521,30206
06-08-2018,2,8268,13017,5216,2050,28551,1116,131,281,1528,30079
06-08-2018,3,8089,13095,5207,1907,28299,1119,130,267,1516,29815
06-08-2018,4,8183,13433,5238,1796,28651,1136,131,259,1526,30177
06-08-2018,5,8895,13585,5288,1670,29439,1178,135,255,1568,31007
06-08-2018,6,13159,15059,5535,1692,35445,1174,193,255,1622,37067
06-08-2018,7,14446,16022,5684,1703,37855,1226,388,283,1897,39752
06-08-2018,8,15299,16416,5830,1871,39417,1203,597,392,2192,41609
06-08-2018,9,15347,16419,5885,1957,39609,1291,869,390,2550,42159
06-08-2018,10,15392,16420,6140,2076,40028,1296,903,403,2602,42630
06-08-2018,11,15669,16664,6160,2217,40711,1299,899,426,2624,43335
06-08-2018,12,16086,16620,6180,2452,41337,1253,898,580,2731,44068
06-08-2018,13,15925,16485,6044,2656,41110,1237,896,641,2774,43884
06-08-2018,14,15681,16415,6007,2784,40888,1233,812,638,2683,43571
06-08-2018,15,15840,16201,5977,2919,40939,1262,799,627,2688,43627
06-08-2018,16,15739,15794,5993,2812,40339,1288,800,563,2651,42990
06-08-2018,17,15892,15652,6027,2471,40044,1396,932,375,2703,42747
06-08-2018,18,16014,15502,5921,2088,39525,1380,952,422,2754,42279
06-08-2018,19,15827,14957,5730,1799,38313,1292,1267,483,3042,41355
06-08-2018,20,15782,14468,5681,1483,37414,1265,1139,387,2791,40205
06-08-2018,21,15676,14223,5638,1319,36856,1264,944,228,2436,39292
06-08-2018,22,15355,13505,5615,1188,35664,1253,883,197,2333,37997
06-08-2018,23,14660,12216,5581,1118,33576,1235,689,173,2097,35673
07-08-2018,0,13586,11405,5600,1076,31668,1294,319,157,1770,33438
07-08-2018,1,12371,11202,5535,911,30021,1308,312,156,1776,31797
07-08-2018,2,11194,11127,5421,683,28426,1299,312,164,1775,30201
07-08-2018,3,10093,10908,5488,680,27170,1287,313,189,1789,28959
07-08-2018,4,10113,11203,5486,670,27472,1279,334,200,1813,29285
07-08-2018,5,11793,11520,5579,825,29719,1268,316,195,1779,31498
07-08-2018,6,14695,13244,5607,937,34484,1252,334,200,1786,36270
07-08-2018,7,15350,14578,5948,1042,36919,1246,515,207,1968,38887
07-08-2018,8,15785,15580,6061,1163,38589,1211,520,443,2174,40763
07-08-2018,9,16048,15590,6222,1276,39138,1217,550,453,2220,41358
07-08-2018,10,16258,15602,6269,1393,39522,1188,598,450,2236,41758
07-08-2018,11,16440,15599,6148,1492,39679,1165,671,475,2311,41990
07-08-2018,12,16621,15582,6103,1707,40013,1166,700,447,2313,42326
07-08-2018,13,16400,15567,6039,1792,39798,1165,914,268,2347,42145
07-08-2018,14,16251,15575,5998,1866,39688,1161,677,259,2097,41785
07-08-2018,15,16151,15528,5940,1915,39536,1165,629,252,2046,41582
07-08-2018,16,15969,15477,5862,1854,39162,1164,588,626,2378,41540
07-08-2018,17,15945,15610,5798,1836,39189,1171,597,609,2377,41566
07-08-2018,18,15955,15325,5852,1770,38901,1175,641,382,2198,41099
07-08-2018,19,16011,15217,5781,1749,38758,1158,697,351,2206,40964
07-08-2018,20,15628,14814,5584,1822,37849,1150,609,334,2093,39942
07-08-2018,21,15600,14993,5539,1872,38005,1155,629,192,1976,39981
07-08-2018,22,15208,14362,5580,1836,36986,1200,374,125,1699,38685
07-08-2018,23,12475,12691,5448,1874,32489,1239,333,125,1697,34186
08-08-2018,0,10090,11573,5367,2180,29210,1174,314,119,1607,30817
08-08-2018,1,8959,11696,5385,2495,28534,1172,314,118,1604,30138
08-08-2018,2,8522,11732,5344,2502,28102,1166,315,132,1613,29715
08-08-2018,3,8328,11798,5393,2320,27838,1161,317,140,1618,29456
08-08-2018,4,8646,12403,5412,2174,28636,1161,321,155,1637,30273
08-08-2018,5,9231,12521,5509,2216,29477,1168,322,169,1659,31136
08-08-2018,6,12180,13858,5761,2292,34091,1237,328,166,1731,35822
08-08-2018,7,15725,15706,6107,2111,39649,1213,394,218,1825,41474
08-08-2018,8,16793,16861,6275,2105,42034,1196,622,190,2008,44042
08-08-2018,9,16754,16795,6436,2028,42014,1198,628,303,2129,44143
08-08-2018,10,16295,16804,6469,1864,41432,1207,637,292,2136,43568
08-08-2018,11,16518,16304,6485,1629,40936,1204,638,516,2358,43294
08-08-2018,12,15704,15493,6468,1889,39554,1198,613,660,2471,42025
08-08-2018,13,15350,15609,6330,2211,39500,1183,778,632,2593,42093
08-08-2018,14,15094,15593,6414,2386,39489,1178,722,426,2326,41815
08-08-2018,15,15112,15696,6310,2846,39965,1167,538,430,2135,42100
08-08-2018,16,15350,15571,6235,3028,40185,1157,476,430,2063,42248
08-08-2018,17,16039,16044,6087,2560,40728,1157,537,420,2114,42842
08-08-2018,18,16566,16265,6077,2332,41240,1178,553,402,2133,43373
08-08-2018,19,15968,15938,6029,2235,40171,1171,539,388,2098,42269
08-08-2018,20,14493,15414,6079,2846,38832,1196,538,429,2163,40995
08-08-2018,21,14556,15628,6129,2570,38883,1216,503,429,2148,41031
08-08-2018,22,13686,14901,6221,2311,37121,1278,453,345,2076,39197
08-08-2018,23,11689,13520,6209,2175,33593,1345,341,397,2083,35676
09-08-2018,0,10307,13033,6173,1923,31435,1206,334,407,1947,33382
09-08-2018,1,9194,12799,6201,1627,29821,1201,337,382,1920,31741
09-08-2018,2,8788,12686,6174,1286,28934,1198,335,358,1891,30825
09-08-2018,3,8618,12911,6147,1068,28744,1193,336,354,1883,30627
09-08-2018,4,9070,13296,6279,995,29640,1179,336,360,1875,31515
09-08-2018,5,9798,13283,6255,897,30235,1175,334,349,1858,32093
09-08-2018,6,13426,14568,6432,993,35420,1244,401,317,1962,37382
09-08-2018,7,15311,15247,6520,1198,38276,1322,531,292,2145,40421
09-08-2018,8,16350,15641,6758,1309,40058,1326,545,350,2221,42279
09-08-2018,9,16445,15820,6963,1550,40779,1339,590,469,2398,43177
09-08-2018,10,16408,15598,7075,1665,40748,1357,652,572,2581,43329
09-08-2018,11,16325,15388,7205,1713,40630,1343,579,822,2744,43374
09-08-2018,12,16440,15297,7267,1678,40682,1348,745,799,2892,43574
09-08-2018,13,16611,15207,7288,1693,40801,1365,629,769,2763,43564
09-08-2018,14,16660,15209,7274,1624,40768,1380,691,673,2744,43512
09-08-2018,15,16325,15042,7223,1582,40171,1366,603,433,2402,42573
09-08-2018,16,15777,14631,7073,1663,39144,1326,542,332,2200,41344
09-08-2018,17,15898,14667,6896,1808,39269,1294,500,310,2104,41373
09-08-2018,18,15704,14322,6592,2085,38704,1274,411,278,1963,40667
09-08-2018,19,15697,14255,6399,2411,38762,1253,426,275,1954,40716
09-08-2018,20,14574,13090,6129,2675,36469,1258,430,304,1992,38461
09-08-2018,21,13592,12836,6096,2746,35271,1287,436,373,2096,37367
09-08-2018,22,11879,12389,5964,2865,33097,1321,427,411,2159,35256
09-08-2018,23,9738,11148,5720,3203,29810,1341,420,440,2201,32011
10-08-2018,0,8530,10816,5612,3585,28541,1347,363,439,2149,30690
10-08-2018,1,8148,10954,5478,3725,28306,1171,344,438,1953,30259
10-08-2018,2,7911,11243,5395,3789,28339,1105,342,440,1887,30226
10-08-2018,3,7888,11587,5302,4001,28777,1107,339,450,1896,30673
10-08-2018,4,8009,12137,5275,4224,29647,1130,337,456,1923,31570
10-08-2018,5,7854,12615,5255,4527,30251,1306,340,480,2126,32377
10-08-2018,6,9655,13313,5495,4892,33356,1365,347,486,2198,35554
10-08-2018,7,13126,14552,6003,5124,38806,1348,567,473,2388,41194
10-08-2018,8,14734,15528,6237,5311,41810,1361,550,627,2538,44348
10-08-2018,9,14908,15518,6272,5632,42330,1400,556,814,2770,45100
10-08-2018,10,14672,15960,6216,5851,42700,1380,548,863,2791,45491
10-08-2018,11,13926,16354,6279,5930,42489,1226,554,851,2631,45120
10-08-2018,12,12586,16375,6488,6078,41527,1220,557,834,2611,44138
10-08-2018,13,11593,16351,6577,5811,40331,1203,491,804,2498,42829
10-08-2018,14,11180,16280,6616,5627,39704,1190,490,562,2242,41946
10-08-2018,15,10937,16394,6533,5182,39046,1184,659,405,2248,41294
10-08-2018,16,11628,16679,6233,4839,39379,1131,585,447,2163,41542
10-08-2018,17,13354,16436,6168,3864,39823,1109,552,338,1999,41822
10-08-2018,18,14183,16382,6211,3348,40124,1117,601,302,2020,42144
10-08-2018,19,14665,16510,6089,2757,40021,1112,506,361,1979,42000
10-08-2018,20,14134,16218,6020,2218,38590,1112,469,227,1808,40398
10-08-2018,21,14041,16297,6142,1811,38290,1143,442,233,1818,40108
10-08-2018,22,13778,15686,6142,1402,37008,1149,396,210,1755,38763
10-08-2018,23,12514,14662,6014,1507,34696,1121,373,234,1728,36424
11-08-2018,0,10277,13756,6005,1512,31549,801,363,246,1410,32959
11-08-2018,1,8914,13306,6056,1460,29737,773,355,269,1397,31134
11-08-2018,2,8334,13164,6110,1359,28966,671,339,240,1250,30216
11-08-2018,3,7597,13044,6103,1454,28199,550,320,212,1082,29281
11-08-2018,4,7486,12962,6092,1597,28136,546,320,186,1052,29188
11-08-2018,5,7611,12926,6115,1836,28489,645,320,151,1116,29605
11-08-2018,6,8160,12783,6233,2045,29221,700,320,138,1158,30379
11-08-2018,7,9484,12684,6460,2204,30833,697,320,129,1146,31979
11-08-2018,8,10353,12738,6544,2342,31977,718,320,134,1172,33149
11-08-2018,9,10722,13220,6559,2445,32946,684,376,140,1200,34146
11-08-2018,10,10945,13282,6617,2605,33450,698,391,136,1225,34675
11-08-2018,11,11083,13205,6630,2782,33700,704,367,137,1208,34908
11-08-2018,12,11257,13053,6589,3121,34019,708,319,145,1172,35191
11-08-2018,13,11032,12909,6553,3381,33875,686,316,161,1163,35038
11-08-2018,14,10444,12617,6506,3691,33260,673,314,160,1147,34407
11-08-2018,15,9867,12398,6383,3765,32413,665,313,164,1142,33555
11-08-2018,16,10265,12600,6309,3847,33021,669,314,161,1144,34165
11-08-2018,17,11491,12867,6230,3838,34427,676,307,155,1138,35565
11-08-2018,18,12668,13076,6225,4365,36335,659,317,154,1130,37465
11-08-2018,19,14298,13521,6260,4087,38167,643,317,156,1116,39283
11-08-2018,20,14397,13442,6321,3546,37706,638,318,179,1135,38841
11-08-2018,21,14428,13549,6310,3344,37632,655,319,180,1154,38786
11-08-2018,22,13132,13148,6136,3361,35779,665,319,186,1170,36949
11-08-2018,23,11599,12527,5920,3323,33369,670,297,205,1172,34541
12-08-2018,0,10229,12070,5829,3275,31405,704,134,258,1096,32501
12-08-2018,1,9331,11860,5671,3116,29980,700,139,316,1155,31135
12-08-2018,2,8860,11801,5505,2933,29098,641,139,361,1141,30239
12-08-2018,3,8369,11871,5424,2678,28340,605,142,412,1159,29499
12-08-2018,4,8236,12088,5383,2385,28094,575,147,474,1196,29290
12-08-2018,5,8313,12243,5296,2124,27977,588,160,458,1206,29183
12-08-2018,6,8375,12083,5180,1963,27602,627,166,497,1290,28892
12-08-2018,7,8267,12114,5135,1900,27416,618,152,513,1283,28699
12-08-2018,8,9173,12431,5157,1982,28744,635,151,537,1323,30067
12-08-2018,9,9989,12661,5252,2102,30005,664,163,513,1340,31345
12-08-2018,10,10663,12975,5321,2190,31148,682,171,527,1380,32528
12-08-2018,11,10798,12964,5336,2122,31219,696,177,565,1438,32657
12-08-2018,12,11162,12953,5429,1956,31501,699,177,594,1470,32971
12-08-2018,13,11049,12913,5405,1891,31259,674,174,587,1435,32694
12-08-2018,14,11244,12836,5328,1725,31133,714,178,574,1466,32599
12-08-2018,15,11302,12967,5348,1726,31343,748,185,581,1514,32857
12-08-2018,16,11365,13113,5443,1656,31578,862,191,558,1611,33189
12-08-2018,17,12355,13324,5450,1424,32553,823,192,523,1538,34091
12-08-2018,18,14260,13973,5553,1370,35157,862,191,482,1535,36692
12-08-2018,19,16219,14072,5600,1351,37242,880,190,449,1519,38761
12-08-2018,20,16303,14302,5701,1455,37763,873,189,400,1462,39225
12-08-2018,21,16468,14295,5822,1441,38024,901,188,369,1458,39482
12-08-2018,22,15478,13865,5606,1462,36411,858,179,351,1388,37799
12-08-2018,23,14072,12960,5465,1382,33879,870,175,339,1384,35263
13-08-2018,0,12491,12680,5394,1299,31865,969,166,324,1459,33324
13-08-2018,1,10698,12298,5476,1272,29744,1018,162,335,1515,31259
13-08-2018,2,10114,12314,5410,1249,29087,1059,154,283,1496,30583
13-08-2018,3,9853,12305,5384,1296,28838,1124,148,243,1515,30353
13-08-2018,4,9945,12703,5449,1330,29427,1173,143,225,1541,30968
13-08-2018,5,10969,13288,5659,1461,31377,1234,165,201,1600,32977
13-08-2018,6,14022,14634,6058,1621,36335,1254,347,214,1815,38150
13-08-2018,7,15448,16426,6491,1826,40191,1276,317,231,1824,42015
13-08-2018,8,15995,16472,6685,2098,41250,1292,333,351,1976,43226
13-08-2018,9,15634,16356,6631,2211,40834,1312,619,464,2395,43229
13-08-2018,10,15802,16284,6623,2150,40860,1334,691,463,2488,43348
13-08-2018,11,16097,16549,6891,2151,41690,1349,969,422,2740,44430
13-08-2018,12,16251,16681,6882,2085,41899,1344,966,460,2770,44669
13-08-2018,13,16199,16532,6797,1912,41441,1337,771,304,2412,43853
13-08-2018,14,15634,16259,6757,1741,40390,1334,643,265,2242,42632
13-08-2018,15,15548,16325,6746,1602,40222,1333,871,264,2468,42690
13-08-2018,16,15355,16290,6686,1551,39882,1308,826,256,2390,42272
13-08-2018,17,15254,16396,6685,1593,39929,1270,697,253,2220,42149
13-08-2018,18,14970,16429,6471,1423,39294,1265,894,249,2408,41702
13-08-2018,19,14954,16416,6403,1412,39185,1294,665,246,2205,41390
13-08-2018,20,15513,16351,6269,1526,39659,1262,407,244,1913,41572
13-08-2018,21,15841,16103,6252,1572,39768,1290,317,252,1859,41627
13-08-2018,22,15187,14817,5995,1576,37575,1279,311,262,1852,39427
13-08-2018,23,14375,12539,5616,1376,33906,1272,310,273,1855,35761
14-08-2018,0,12148,11622,5570,1182,30524,1173,310,291,1774,32298
14-08-2018,1,10594,11229,5460,1173,28458,1156,308,329,1793,30251
14-08-2018,2,10051,11300,5372,1270,27992,1150,309,348,1807,29799
14-08-2018,3,9536,11232,5306,1207,27282,1140,309,329,1778,29060
14-08-2018,4,9965,11732,5283,1096,28077,1137,310,333,1780,29857
14-08-2018,5,11545,11895,5373,1106,29918,1148,314,356,1818,31736
14-08-2018,6,15006,14155,5687,1221,36071,1271,322,369,1962,38033
14-08-2018,7,16440,16259,6039,1452,40191,1346,326,358,2030,42221
14-08-2018,8,16528,16551,6168,1562,40809,1435,515,325,2275,43084
14-08-2018,9,16261,16489,5941,1586,40277,1437,1122,484,3043,43320
14-08-2018,10,16460,16233,5906,1705,40305,1436,1075,566,3077,43382
14-08-2018,11,16769,16098,5927,1512,40307,1436,1019,639,3094,43401
14-08-2018,12,16865,16214,6049,1497,40626,1330,767,596,2693,43319
14-08-2018,13,16200,16106,6167,1803,40276,1329,763,469,2561,42837
14-08-2018,14,15570,15898,6076,1866,39412,1301,797,408,2506,41918
14-08-2018,15,15500,15792,6035,1867,39194,1314,685,332,2331,41525
14-08-2018,16,15181,15802,5773,1881,38635,1268,362,286,1916,40551
14-08-2018,17,15781,15751,5699,1778,39009,1287,409,278,1974,40983
14-08-2018,18,16202,15777,5634,1830,39442,1339,410,268,2017,41459
14-08-2018,19,16113,16002,5686,1845,39647,1340,604,264,2208,41855
14-08-2018,20,16146,16052,5756,1700,39654,1349,462,271,2082,41736
14-08-2018,21,16019,16027,5784,1592,39421,1351,485,314,2150,41571
14-08-2018,22,15496,14958,5543,1594,37591,1352,326,330,2008,39599
14-08-2018,23,14534,12705,5335,1623,34198,1352,328,346,2026,36224
15-08-2018,0,12475,11192,5120,1448,30236,1348,316,229,1893,32129
15-08-2018,1,11144,10816,4953,1484,28397,1350,309,219,1878,30275
15-08-2018,2,10530,10804,4983,1602,27919,1352,309,211,1872,29791
15-08-2018,3,9987,10811,5005,1617,27422,1346,308,226,1880,29302
15-08-2018,4,9797,11366,5044,1431,27638,1339,309,249,1897,29535
15-08-2018,5,10898,11418,5182,1360,28859,1337,312,225,1874,30733
15-08-2018,6,13777,12227,5378,1306,32690,1337,320,196,1853,34543
15-08-2018,7,15809,14249,5575,1213,36846,1339,330,200,1869,38715
15-08-2018,8,16349,15356,5789,1395,38889,1339,332,249,1920,40809
15-08-2018,9,16246,15360,5811,1538,38955,1326,322,251,1899,40854
15-08-2018,10,16290,15343,5718,1750,39102,1328,323,284,1935,41037
15-08-2018,11,16251,15428,5767,1824,39269,1330,322,315,1967,41236
15-08-2018,12,16084,15194,5818,1982,39078,1339,325,326,1990,41068
15-08-2018,13,15831,15023,5834,1996,38684,1325,325,346,1996,40680
15-08-2018,14,15013,14898,5749,2019,37679,1285,321,374,1980,39659
15-08-2018,15,14988,14817,5579,2206,37591,1292,329,385,2006,39597
15-08-2018,16,15330,14111,5490,2180,37112,1303,327,366,1996,39108
15-08-2018,17,16205,15055,5630,2101,38992,1329,335,326,1990,40982
15-08-2018,18,16866,16258,5737,1876,40739,1314,340,271,1925,42664
15-08-2018,19,16820,16165,5721,1797,40503,1296,341,252,1889,42392
15-08-2018,20,16542,15357,5715,1682,39294,1242,430,239,1911,41205
15-08-2018,21,16605,15323,5609,1619,39156,1227,422,231,1880,41036
15-08-2018,22,15971,14222,5509,1585,37288,1323,320,232,1875,39163
15-08-2018,23,14526,12685,5348,1524,34083,1323,317,221,1861,35944
16-08-2018,0,12940,12249,5280,1647,32117,1321,310,202,1833,33950
16-08-2018,1,11368,12100,5190,1689,30347,1326,305,179,1810,32157
16-08-2018,2,11278,12081,5192,1722,30273,1318,305,172,1795,32068
16-08-2018,3,10924,12049,5114,1811,29899,1315,305,158,1778,31677
16-08-2018,4,10877,12373,5096,1879,30225,1321,307,147,1775,32000
16-08-2018,5,12320,12750,5058,2106,32235,1320,309,148,1777,34012
16-08-2018,6,15950,14585,5619,2258,38412,1316,356,176,1848,40260
16-08-2018,7,16885,16127,6082,2664,41758,1322,659,303,2284,44042
16-08-2018,8,17326,17004,6245,3053,43628,1322,686,544,2552,46180
16-08-2018,9,17285,17313,6238,3440,44276,1322,639,598,2559,46835
16-08-2018,10,17205,16426,6242,3859,43732,1311,628,651,2590,46322
16-08-2018,11,16610,15751,6267,4223,42852,1269,935,638,2842,45694
16-08-2018,12,15879,15194,6183,4187,41444,1271,1131,704,3106,44550
16-08-2018,13,15648,15033,6154,4145,40979,1272,1084,709,3065,44044
16-08-2018,14,15821,15218,6004,4101,41146,1288,989,616,2893,44039
16-08-2018,15,16688,15566,5962,3930,42145,1304,986,434,2724,44869
16-08-2018,16,16899,16017,5927,3832,42675,1262,904,344,2510,45185
16-08-2018,17,17357,16561,5922,3617,43457,1258,901,332,2491,45948
16-08-2018,18,17296,16532,5846,3437,43112,1251,873,318,2442,45554
16-08-2018,19,17126,16347,5804,3137,42416,1241,871,309,2421,44837
16-08-2018,20,16621,15678,5862,2680,40842,1287,850,335,2472,43314
16-08-2018,21,16352,15657,5983,2214,40207,1296,764,319,2379,42586
16-08-2018,22,15122,14938,5911,1965,37935,1336,485,302,2123,40058
16-08-2018,23,13475,14161,5955,1802,35393,1315,465,301,2081,37474
17-08-2018,0,12262,13711,5911,1621,33505,1222,464,134,1820,35325
17-08-2018,1,11569,13609,5938,1515,32632,1226,463,144,1833,34465
17-08-2018,2,11166,13459,5874,1327,31827,1212,465,150,1827,33654
17-08-2018,3,11018,13547,5881,1169,31616,1214,467,171,1852,33468
17-08-2018,4,11194,13998,5963,1268,32423,1205,493,181,1879,34302
17-08-2018,5,12122,14147,6046,1351,33666,1272,473,184,1929,35595
17-08-2018,6,15240,15337,6248,1522,38348,1368,478,188,2034,40382
17-08-2018,7,16658,16421,6675,1696,41451,1319,553,177,2049,43500
17-08-2018,8,16757,17270,6872,1800,42698,1338,903,327,2568,45266
17-08-2018,9,16790,16761,6871,1771,42193,1318,992,549,2859,45052
17-08-2018,10,16892,16311,7017,1930,42150,1333,1038,564,2935,45085
17-08-2018,11,17043,16320,7146,2099,42608,1344,1173,572,3089,45697
17-08-2018,12,17108,16587,7092,2156,42942,1347,1238,580,3165,46107
17-08-2018,13,17208,16463,6930,2290,42891,1362,1201,555,3118,46009
17-08-2018,14,16388,15988,6717,2318,41412,1367,994,558,2919,44331
17-08-2018,15,15829,15363,6573,2352,40120,1367,990,352,2709,42829
17-08-2018,16,16651,15451,6494,2340,40937,1369,988,181,2538,43475
17-08-2018,17,17003,15135,6392,2355,40886,1368,906,176,2450,43336
17-08-2018,18,17091,14874,6501,2162,40627,1344,905,155,2404,43031
17-08-2018,19,17127,14382,6533,1873,39914,1330,903,147,2380,42294
17-08-2018,20,16643,13960,6444,1627,38675,1309,923,148,2380,41055
17-08-2018,21,16553,13473,6403,1576,38004,1310,734,199,2243,40247
17-08-2018,22,15743,13256,6509,1526,37035,1287,511,214,2012,39047
17-08-2018,23,14433,12460,6295,1568,34755,1269,469,193,1931,36686
18-08-2018,0,13513,11504,6318,1588,32924,1232,470,200,1902,34826
18-08-2018,1,12576,11331,6170,1612,31690,1251,472,201,1924,33614
18-08-2018,2,12189,11228,6036,1812,31266,1253,474,191,1918,33184
18-08-2018,3,11933,10994,5976,1934,30837,1223,474,181,1878,32715
18-08-2018,4,11424,10947,5875,1961,30207,1219,473,178,1870,32077
18-08-2018,5,10910,10792,5754,2100,29557,1177,475,175,1827,31384
18-08-2018,6,11891,11009,5723,2251,30874,1182,482,185,1849,32723
18-08-2018,7,13729,11731,5795,2417,33672,1181,594,170,1945,35617
18-08-2018,8,15285,12322,5869,2742,36220,1175,948,172,2295,38515
18-08-2018,9,15681,12699,6011,3353,37744,1178,1008,556,2742,40486
18-08-2018,10,15280,13232,6070,3693,38276,1188,987,583,2758,41034
18-08-2018,11,14552,13672,6115,4073,38412,1194,967,604,2765,41177
18-08-2018,12,12195,13665,6033,4502,36395,1192,1008,536,2736,39131
18-08-2018,13,11611,13870,5939,4712,36131,1199,952,575,2726,38857
18-08-2018,14,11969,14163,5990,4800,36923,1198,905,427,2530,39453
18-08-2018,15,12363,14528,6095,4642,37628,1184,930,314,2428,40056
18-08-2018,16,13067,14577,6139,4490,38273,1191,813,222,2226,40499
18-08-2018,17,13269,15235,6286,4331,39121,1176,694,208,2078,41199
18-08-2018,18,13721,15245,6273,4029,39268,1148,630,204,1982,41250
18-08-2018,19,13435,15254,6286,3646,38621,1132,538,224,1894,40515
18-08-2018,20,13185,15348,6270,3297,38100,1134,672,218,2024,40124
18-08-2018,21,13324,15211,6276,2996,37807,1207,488,201,1896,39703
18-08-2018,22,12092,14835,6341,3004,36273,1246,481,196,1923,38196
18-08-2018,23,11043,14452,6415,2845,34755,1265,467,180,1912,36667
19-08-2018,0,10467,13794,6378,2813,33453,1348,373,183,1904,35357
19-08-2018,1,10097,13700,6349,2636,32781,1223,297,207,1727,34508
19-08-2018,2,10030,13434,6339,2428,32231,1172,298,240,1710,33941
19-08-2018,3,10258,13424,6273,2245,32198,1181,329,267,1777,33975
19-08-2018,4,10283,13545,6226,2199,32255,1171,357,286,1814,34069
19-08-2018,5,10151,13377,6102,2113,31744,1208,328,284,1820,33564
19-08-2018,6,10084,13172,6056,1963,31275,1329,309,295,1933,33208
19-08-2018,7,11051,13106,6009,1871,32037,1368,319,281,1968,34005
19-08-2018,8,11690,12914,6056,1702,32362,1312,334,263,1909,34271
19-08-2018,9,12172,13036,6114,1737,33060,1307,360,263,1930,34990
19-08-2018,10,11742,13231,6018,1806,32796,1331,358,305,1994,34790
19-08-2018,11,11499,13363,6063,1849,32775,1348,338,350,2036,34811
19-08-2018,12,11363,13518,6107,1808,32798,1350,332,385,2067,34865
19-08-2018,13,11095,13581,6072,1874,32623,1371,327,350,2048,34671
19-08-2018,14,10728,13644,6049,1901,32322,1399,324,319,2042,34364
19-08-2018,15,10423,13341,6055,2040,31859,1405,323,282,2010,33869
19-08-2018,16,10881,13474,6032,2069,32455,1364,327,274,1965,34420
19-08-2018,17,12857,14163,6108,2092,35222,1383,342,237,1962,37184
19-08-2018,18,15237,14487,6274,2236,38234,1325,407,185,1917,40151
19-08-2018,19,15738,14679,6344,2312,39074,1284,434,158,1876,40950
19-08-2018,20,15909,14436,6419,2319,39082,1276,605,197,2078,41160
19-08-2018,21,16035,14601,6336,2489,39461,1267,366,272,1905,41366
19-08-2018,22,14961,14137,6213,2528,37840,1275,391,243,1909,39749
19-08-2018,23,12761,13550,6145,2506,34963,1296,297,206,1799,36762
20-08-2018,0,11275,12056,6118,2511,,1206,292,173,1671,
20-08-2018,1,10995,11911,5986,2398,31007,1190,289,192,1671,32678
20-08-2018,2,10898,11972,5891,2344,30820,1179,289,188,1656,32476
20-08-2018,3,10518,12055,5748,2314,30351,1172,289,183,1644,31995
20-08-2018,4,11006,12786,5698,2368,31574,1166,345,194,1705,33279
20-08-2018,5,12384,13403,5657,2360,33518,1167,309,207,1683,35201
20-08-2018,6,16115,14841,5821,2620,39113,1195,431,292,1918,41031
20-08-2018,7,17824,15926,6129,2892,42484,1291,917,318,2526,45010
20-08-2018,8,17743,16618,6367,3296,,1284,925,498,2707,
20-08-2018,9,17673,16425,6366,3881,44344,1283,1241,581,3105,47449
20-08-2018,10,17641,16093,6260,4132,44127,1285,1412,621,3318,47445
20-08-2018,11,17342,15615,6405,4319,43680,1299,941,459,2699,46379
20-08-2018,12,17319,15477,6340,4465,43600,1308,939,550,2797,46397
20-08-2018,13,17281,15320,6296,4428,43326,1314,932,548,2794,46120
20-08-2018,14,17380,14983,6215,4591,43170,1334,930,497,2761,45931
20-08-2018,15,17114,14814,5963,4627,42518,1340,859,493,2692,45210
20-08-2018,16,17011,15050,5736,4564,42361,1342,805,459,2606,44967
20-08-2018,17,17158,15247,5760,4332,42497,1349,764,488,2601,45098
20-08-2018,18,17121,15342,5718,4022,42204,1360,670,512,2542,44746
20-08-2018,19,17043,15467,5648,3521,41679,1351,655,510,2516,44195
20-08-2018,20,17093,15384,5619,2875,40973,1298,860,533,2691,43664
20-08-2018,21,16959,15252,5595,2635,40441,1306,495,451,2252,42693
20-08-2018,22,15969,14563,5451,2499,38482,1327,483,409,2219,40701
20-08-2018,23,13745,13551,5408,2391,35095,1314,482,333,2129,37224
21-08-2018,0,12642,12484,5451,2194,32772,1381,484,302,2167,34939
21-08-2018,1,11890,12243,5510,2149,31792,1381,529,276,2186,33978
21-08-2018,2,11768,12124,5543,2122,31557,1349,547,268,2164,33721
21-08-2018,3,11813,12159,5599,1918,31488,1397,477,242,2116,33604
21-08-2018,4,11923,12892,5671,1751,32237,1443,478,245,2166,34403
21-08-2018,5,13457,13081,5834,1583,33955,1515,482,273,2270,36225
21-08-2018,6,15966,14915,6139,1666,38686,1487,502,355,2344,41030
21-08-2018,7,17384,16061,6621,1718,41784,1520,644,529,2693,44477
21-08-2018,8,17251,16533,6817,1885,42486,1508,978,770,3256,45742
21-08-2018,9,16657,16815,6783,1972,42228,1534,1105,810,3449,45677
21-08-2018,10,16813,16169,6793,2047,41821,1559,1212,769,3540,45361
21-08-2018,11,17003,16150,6846,1980,41981,1553,1027,797,3377,45358
21-08-2018,12,16965,16004,6935,1904,41809,1562,949,812,3323,45132
21-08-2018,13,16943,15970,6909,1793,41614,1565,987,823,3375,44989
21-08-2018,14,16819,16010,7005,1818,41653,1604,972,721,3297,44950
21-08-2018,15,16603,15848,6993,1771,41215,1570,930,728,3228,44443
21-08-2018,16,16645,15792,6952,1596,40986,1539,858,705,3102,44088
21-08-2018,17,16622,15741,6938,1515,40818,1588,824,668,3080,43898
21-08-2018,18,16425,15686,7000,1334,40446,1608,729,620,2957,43403
21-08-2018,19,16402,15325,7052,1228,40005,1568,845,599,3012,43017
21-08-2018,20,16315,15071,6951,1138,39477,1563,873,519,2955,42432
21-08-2018,21,16548,14990,6890,1027,39455,1546,864,245,2655,42110
21-08-2018,22,16034,13968,6632,815,37448,1525,488,220,2233,39681
21-08-2018,23,15483,12384,6223,841,34932,1487,470,196,2153,37085
22-08-2018,0,15157,10926,6048,1057,33189,1353,468,167,1988,35177
22-08-2018,1,14798,10760,5907,1245,32711,1379,466,146,1991,34702
22-08-2018,2,14519,10703,5751,1432,32406,1355,466,137,1958,34364
22-08-2018,3,13210,11033,5541,1743,31528,1330,468,124,1922,33450
22-08-2018,4,13185,11616,5487,2055,32343,1331,503,131,1965,34308
22-08-2018,5,13717,12129,5573,2215,33634,1345,528,255,2128,35762
22-08-2018,6,15133,15093,6019,2288,38532,1435,491,478,2404,40936
22-08-2018,7,15945,16710,6428,2324,41409,1415,998,520,2933,44342
22-08-2018,8,16059,16899,6543,2567,42068,1414,1401,742,3557,45625
22-08-2018,9,16206,16945,6474,2678,42302,1428,1280,710,3418,45720
22-08-2018,10,16340,17067,6537,3087,43032,1442,1096,788,3326,46358
22-08-2018,11,16435,17231,6649,3416,43731,1428,1014,702,3144,46875
22-08-2018,12,15902,16601,6425,3723,42652,1421,1013,714,3148,45800
22-08-2018,13,16101,16301,6388,3837,42627,1442,1013,695,3150,45777
22-08-2018,14,16266,16516,6451,3989,43222,1445,1016,671,3132,46354
22-08-2018,15,15995,17028,6420,3899,43342,1466,1019,513,2998,46340
22-08-2018,16,16147,16910,6528,3719,43305,1461,940,500,2901,46206
22-08-2018,17,16346,17183,6737,3544,43810,1489,927,517,2933,46743
22-08-2018,18,16560,17054,6793,3179,43587,1497,715,481,2693,46280
22-08-2018,19,16612,16851,6864,2639,42967,1484,903,461,2848,45815
22-08-2018,20,16737,16582,6823,2268,42410,1493,933,474,2900,45310
22-08-2018,21,16595,15799,6810,2184,41389,1531,552,223,2306,43695
22-08-2018,22,15296,14865,6535,2179,38877,1542,507,234,2283,41160
22-08-2018,23,13490,13778,6304,1941,35513,1487,497,294,2278,37791
23-08-2018,0,12434,12791,6277,1746,33247,1387,495,344,2226,35473
23-08-2018,1,11634,12503,6093,1502,31731,1330,491,361,2182,33913
23-08-2018,2,11365,12439,5988,1429,31220,1304,493,373,2170,33390
23-08-2018,3,11482,12513,5970,1339,31305,1301,495,344,2140,33445
23-08-2018,4,11782,12527,6082,1239,31631,1426,495,313,2234,33865
23-08-2018,5,13444,12471,6220,1357,33493,1448,498,292,2238,35731
23-08-2018,6,15381,15123,6521,1365,38390,1547,500,280,2327,40717
23-08-2018,7,16233,16789,6848,1513,41384,1569,509,364,2442,43826
23-08-2018,8,16576,17320,7028,1729,42652,1575,921,701,3197,45849
23-08-2018,9,16707,17227,7036,1881,42851,1578,1024,753,3355,46206
23-08-2018,10,16813,17116,6767,2009,42705,1574,1146,786,3506,46211
23-08-2018,11,16701,17026,6775,2158,42661,1569,928,785,3282,45943
23-08-2018,12,16617,15781,6653,2379,41432,1565,1025,817,3407,44839
23-08-2018,13,16468,15213,6468,2588,40737,1569,931,796,3296,44033
23-08-2018,14,16537,15098,6586,2788,41009,1538,936,760,3234,44243
23-08-2018,15,16744,15094,6708,2775,41323,1514,929,675,3118,44441
23-08-2018,16,16148,14762,6551,2781,40244,1497,930,589,3016,43260
23-08-2018,17,16357,14628,6696,2579,40260,1493,1013,763,3269,43529
23-08-2018,18,16512,14993,6795,2364,40664,1472,1169,761,3402,44066
23-08-2018,19,16841,14963,6929,1989,40723,1469,1433,832,3734,44457
23-08-2018,20,17148,14560,7020,1755,40484,1494,1112,746,3352,43836
23-08-2018,21,16928,14097,6791,1750,39566,1506,942,331,2779,42345
23-08-2018,22,16328,13132,6440,1652,37554,1495,513,305,2313,39867
23-08-2018,23,15215,11899,5877,1559,34550,1501,501,319,2321,36871
24-08-2018,0,14311,11068,5588,1610,32579,1506,496,321,2323,34902
24-08-2018,1,14286,10973,5498,1705,32463,1494,488,319,2301,34764
24-08-2018,2,13402,11061,5414,1618,31495,1460,488,310,2258,33753
24-08-2018,3,12471,11363,5347,1617,30799,1471,487,299,2257,33056
24-08-2018,4,12231,11702,5571,1701,31205,1506,487,296,2289,33494
24-08-2018,5,13302,12225,6037,1604,33168,1543,493,305,2341,35509
24-08-2018,6,15685,14141,6464,1741,38031,1532,498,339,2369,40400
24-08-2018,7,16646,15391,6820,1758,40617,1511,507,445,2463,43080
24-08-2018,8,17547,15821,6982,2108,42458,1504,810,363,2677,45135
24-08-2018,9,17644,15692,6916,2529,42782,1488,966,292,2746,45528
24-08-2018,10,17844,15440,6853,2671,42808,1490,1073,697,3260,46068
24-08-2018,11,17813,15381,6741,2907,42842,1515,1054,818,3387,46229
24-08-2018,12,16779,14408,6547,3380,41114,1540,1097,812,3449,44563
24-08-2018,13,16167,13874,6493,3736,40270,1548,1087,821,3456,43726
24-08-2018,14,15315,13956,6363,3541,39174,1528,942,859,3329,42503
24-08-2018,15,15225,13568,6352,3427,38573,1447,928,614,2989,41562
24-08-2018,16,14894,13602,6452,3410,38357,1355,847,587,2789,41146
24-08-2018,17,15347,13596,6518,3294,38755,1317,671,585,2573,41328
24-08-2018,18,16346,14082,6596,3050,40074,1324,541,591,2456,42530
24-08-2018,19,16233,14079,6655,2699,39667,1303,513,617,2433,42100
24-08-2018,20,16372,14187,6599,2392,39550,1283,616,522,2421,41971
24-08-2018,21,16272,13819,6488,2380,38958,1304,597,194,2095,41053
24-08-2018,22,14826,12900,6159,2416,36303,1328,488,201,2017,38320
24-08-2018,23,13925,12141,5974,2224,34265,1327,478,214,2019,36284
25-08-2018,0,13557,11444,6149,1995,33145,1147,300,225,1672,34817
25-08-2018,1,12798,11006,6188,1992,31984,1133,298,205,1636,33620
25-08-2018,2,12177,10812,6181,1955,31127,1135,294,207,1636,32763
25-08-2018,3,12392,10775,6079,1997,31244,1132,293,222,1647,32891
25-08-2018,4,12393,10640,6060,2031,31123,1109,291,220,1620,32743
25-08-2018,5,12495,10581,6023,1868,30967,1105,294,216,1615,32582
25-08-2018,6,13218,10835,6024,1777,31854,1061,295,199,1555,33409
25-08-2018,7,14732,11888,6038,1724,34382,1068,295,178,1541,35923
25-08-2018,8,15623,12862,6368,1790,36645,1062,302,174,1538,38183
25-08-2018,9,16156,13476,6590,1868,38090,1053,778,362,2193,40283
25-08-2018,10,16510,13100,6732,1881,38224,1049,967,332,2348,40572
25-08-2018,11,16374,12544,6669,1827,37414,1039,955,341,2335,39749
25-08-2018,12,15712,12212,6564,1805,36293,1038,909,352,2299,38592
25-08-2018,13,14646,11865,6460,1701,34672,1047,758,358,2163,36835
25-08-2018,14,14290,11774,6320,1573,33957,1036,317,216,1569,35526
25-08-2018,15,14451,11849,6290,1314,33904,1024,300,161,1485,35389
25-08-2018,16,15394,11989,6321,1377,35080,1036,369,154,1559,36639
25-08-2018,17,16022,12306,6375,1476,36179,1046,374,160,1580,37759
25-08-2018,18,16289,13535,6554,1454,37835,1036,373,156,1565,39400
25-08-2018,19,16271,13734,6605,1330,37941,961,376,155,1492,39433
25-08-2018,20,16214,13541,6706,1509,37969,957,570,159,1686,39655
25-08-2018,21,16032,13321,6703,1558,37614,938,386,184,1508,39122
25-08-2018,22,15432,11946,6360,1841,35579,926,382,203,1511,37090
25-08-2018,23,13658,10686,6024,2005,32374,921,370,198,1489,33863
26-08-2018,0,11734,9542,5874,1899,29050,911,199,218,1328,30378
26-08-2018,1,11199,9212,5727,1934,28072,913,197,233,1343,29415
26-08-2018,2,10625,9098,5648,1883,27255,904,197,249,1350,28605
26-08-2018,3,10539,9138,5533,2111,27321,897,192,249,1338,28659
26-08-2018,4,10346,9085,5477,2185,27094,906,190,221,1317,28411
26-08-2018,5,10144,9109,5391,2262,26907,934,194,211,1339,28246
26-08-2018,6,10089,9107,5298,2190,26684,1003,201,197,1401,28085
26-08-2018,7,11456,9637,5114,2264,28471,976,206,184,1366,29837
26-08-2018,8,13085,9927,5226,2408,30648,992,204,176,1372,32020
26-08-2018,9,13454,10641,5341,2772,32209,973,206,170,1349,33558
26-08-2018,10,13565,11200,5447,3013,33224,985,207,177,1369,34593
26-08-2018,11,13848,11284,5514,3219,33865,1024,222,195,1441,35306
26-08-2018,12,13866,11263,5410,3200,33739,1041,205,223,1469,35208
26-08-2018,13,13093,11329,5444,3007,32874,1033,208,241,1482,34356
26-08-2018,14,12428,11297,5342,2967,32036,1024,213,191,1428,33464
26-08-2018,15,12276,11213,5349,2706,31545,1032,212,199,1443,32988
26-08-2018,16,13161,11348,5344,2342,32194,1034,213,175,1422,33616
26-08-2018,17,14777,11680,5563,2007,34026,1036,213,164,1413,35439
26-08-2018,18,15895,13434,5747,1784,36862,1065,209,154,1428,38290
26-08-2018,19,16667,13876,5903,1436,37882,1075,208,153,1436,39318
26-08-2018,20,17086,13889,6034,1350,38359,1057,225,306,1588,39947
26-08-2018,21,17013,13858,6053,1492,38416,1060,219,173,1452,39868
26-08-2018,22,16134,12619,5748,1582,36083,1056,201,162,1419,37502
26-08-2018,23,13086,10814,5496,1739,31136,1055,195,154,1404,32540
27-08-2018,0,12059,9850,5511,1942,29362,1190,193,157,1540,30902
27-08-2018,1,10752,9381,5315,2265,27713,1224,191,166,1581,29294
27-08-2018,2,9979,9305,5398,2484,27167,1251,189,159,1599,28766
27-08-2018,3,9560,9201,5400,2884,27045,1318,189,149,1656,28701
27-08-2018,4,9550,9512,5380,3305,27747,1361,191,158,1710,29457
27-08-2018,5,10673,10257,5578,3531,30040,1426,231,158,1815,31855
27-08-2018,6,13644,12633,5613,3727,35617,1452,322,157,1931,37548
27-08-2018,7,15675,14272,5939,4206,40094,1445,449,154,2048,42142
27-08-2018,8,16433,15154,6000,3824,41410,1442,727,310,2479,43889
27-08-2018,9,16472,15307,5926,4114,41820,1451,1136,374,2961,44781
27-08-2018,10,16356,15548,5893,4229,42025,1448,1140,335,2923,44948
27-08-2018,11,16093,15428,5908,3951,41380,1448,1167,344,2959,44339
27-08-2018,12,15913,15346,5896,3714,40870,1451,1273,341,3065,43935
27-08-2018,13,15770,15263,5861,3741,40636,1457,1125,376,2958,43594
27-08-2018,14,15613,15059,5863,3847,40381,1463,1028,348,2839,43220
27-08-2018,15,15109,14927,5851,3803,39690,1412,864,333,2609,42299
27-08-2018,16,15540,15032,5781,3812,40166,1372,757,164,2293,42459
27-08-2018,17,17045,15313,5851,3629,41839,1400,569,145,2114,43953
27-08-2018,18,17378,15318,5889,3684,42269,1421,653,137,2211,44480
27-08-2018,19,16933,15609,5846,3460,41847,1423,840,143,2406,44253
27-08-2018,20,16973,15508,5827,3041,41350,1422,887,339,2648,43998
27-08-2018,21,16923,14594,5879,2994,40390,1417,581,213,2211,42601
27-08-2018,22,15952,13130,5598,2905,37585,1392,562,258,2212,39797
27-08-2018,23,13254,11745,5313,2651,32961,1380,551,287,2218,35179
28-08-2018,0,13741,10986,5338,2582,32646,1359,561,284,2204,34850
28-08-2018,1,12849,10615,5325,2521,31312,1356,567,274,2197,33509
28-08-2018,2,13210,10463,5433,2325,31432,1353,558,248,2159,33591
28-08-2018,3,13177,10506,5555,2269,31507,1352,563,235,2150,33657
28-08-2018,4,13175,11086,5726,2318,32304,1365,566,239,2170,34474
28-08-2018,5,14475,11955,5879,2240,34549,1380,572,238,2190,36739
28-08-2018,6,15846,14549,6242,2145,38782,1456,597,291,2344,41126
28-08-2018,7,16814,15609,6647,2250,41321,1482,1133,571,3186,44507
28-08-2018,8,17136,15806,6750,2222,41912,1573,1565,970,4108,46020
28-08-2018,9,17264,15935,6707,1998,41903,1450,1478,1019,3947,45850
28-08-2018,10,17187,15597,6486,2335,41604,1458,1205,968,3631,45235
28-08-2018,11,16971,15516,6339,2466,41293,1452,1110,791,3353,44646
28-08-2018,12,17075,15229,6122,2421,40848,1456,893,764,3113,43961
28-08-2018,13,17038,15002,6270,2348,40659,1458,988,766,3212,43871
28-08-2018,14,17027,14846,6224,2214,40312,1460,868,735,3063,43375
28-08-2018,15,16887,14913,6229,2178,40207,1450,917,733,3100,43307
28-08-2018,16,17099,15125,6273,2005,40501,1440,1093,726,3259,43760
28-08-2018,17,17238,15029,6474,1844,40585,1438,1260,944,3642,44227
28-08-2018,18,17394,14734,6513,1635,40277,1435,1551,899,3885,44162
28-08-2018,19,17249,14434,6736,1428,39848,1443,1565,919,3927,43775
28-08-2018,20,17422,14530,6723,1344,40019,1450,1379,910,3739,43758
28-08-2018,21,17316,14124,6616,1260,39316,1451,1226,682,3359,42675
28-08-2018,22,16679,13426,6364,1119,37588,1360,565,306,2231,39819
28-08-2018,23,15566,11594,6045,917,34122,1352,540,300,2192,36314
29-08-2018,0,14986,10477,5780,904,32147,1277,555,301,2133,34280
29-08-2018,1,13773,9901,5591,872,30135,1259,554,299,2112,32247
29-08-2018,2,12902,9595,5625,884,29006,1252,552,298,2102,31108
29-08-2018,3,12132,9564,5650,893,28239,1243,548,295,2086,30325
29-08-2018,4,12512,9858,5684,968,29022,1245,553,294,2092,31114
29-08-2018,5,14289,10694,6004,996,31983,1291,571,321,2183,34166
29-08-2018,6,15965,13720,6518,1230,37434,1436,608,304,2348,39782
29-08-2018,7,16755,14711,6919,1376,39762,1433,1077,722,3232,42994
29-08-2018,8,17060,14675,6990,1481,40205,1414,1581,910,3905,44110
29-08-2018,9,17341,14820,6906,1620,40688,1430,1260,910,3600,44288
29-08-2018,10,17307,14925,6836,1801,40868,1432,1010,920,3362,44230
29-08-2018,11,17138,14778,6834,1938,40687,1434,1025,796,3255,43942
29-08-2018,12,17174,14528,6776,1956,40434,1442,984,729,3155,43589
29-08-2018,13,16875,14351,6633,2077,39937,1446,859,709,3014,42951
29-08-2018,14,16710,14275,6571,2171,39726,1458,894,720,3072,42798
29-08-2018,15,16571,13987,6569,2179,39307,1491,983,718,3192,42499
29-08-2018,16,16603,13813,6647,2072,39135,1476,986,724,3186,42321
29-08-2018,17,16745,14761,6880,2040,40427,1467,1014,758,3239,43666
29-08-2018,18,16626,14965,6949,1898,40437,1459,1015,746,3220,43657
29-08-2018,19,16847,14756,7080,1802,40486,1461,1004,754,3219,43705
29-08-2018,20,16874,14702,7161,1817,40553,1479,592,522,2593,43146
29-08-2018,21,16423,13912,7229,1836,39400,1476,570,490,2536,41936
29-08-2018,22,14607,12530,6857,1627,35622,1448,553,443,2444,38066
29-08-2018,23,12160,11173,6621,1408,31362,1434,536,295,2265,33627
30-08-2018,0,11463,10680,6620,1327,30090,1424,527,123,2074,32164
30-08-2018,1,10853,10162,6641,1267,28923,1436,524,123,2083,31006
30-08-2018,2,10227,9887,6610,1184,27908,1432,523,122,2077,29985
30-08-2018,3,9788,9742,6555,1053,27140,1427,527,124,2078,29218
30-08-2018,4,10493,9997,6613,1141,28244,1435,531,125,2091,30335
30-08-2018,5,12365,10442,6775,1153,30735,1436,552,128,2116,32851
30-08-2018,6,15314,13149,6990,1286,36741,1428,591,177,2196,38937
30-08-2018,7,16853,14751,7216,1613,40434,1417,812,317,2546,42980
30-08-2018,8,17729,14856,7232,1834,41651,1417,1028,527,2972,44623
30-08-2018,9,17749,14771,7133,2102,41754,1423,1199,539,3161,44915
30-08-2018,10,17497,14627,7117,2272,41513,1421,1240,540,3201,44714
30-08-2018,11,17308,14651,7139,2381,41480,1436,1353,564,3353,44833
30-08-2018,12,16673,14520,7074,2349,40617,1462,1536,557,3555,44172
30-08-2018,13,16370,14516,7115,2397,40398,1493,1515,554,3562,43960
30-08-2018,14,16061,14222,6977,2443,39704,1493,1247,484,3224,42928
30-08-2018,15,16027,14306,6871,2621,39826,1494,995,363,2852,42678
30-08-2018,16,16137,14342,6779,2810,40067,1495,768,165,2428,42495
30-08-2018,17,17087,14304,6795,2906,41092,1491,622,147,2260,43352
30-08-2018,18,17596,14636,6926,2888,42047,1494,564,138,2196,44243
30-08-2018,19,17700,14811,7039,2688,42238,1485,782,335,2602,44840
30-08-2018,20,17417,14941,6884,2486,41727,1486,998,155,2639,44366
30-08-2018,21,16999,13857,6462,2397,39716,1478,593,179,2250,41966
30-08-2018,22,15522,12319,6193,2164,36198,1481,559,216,2256,38454
30-08-2018,23,12847,11099,5870,2110,31925,1450,547,256,2253,34178
31-08-2018,0,11842,10177,5702,2211,29931,1232,539,290,2061,31992
31-08-2018,1,10829,10054,5583,2080,28545,1203,532,311,2046,30591
31-08-2018,2,10603,10119,5560,1977,28259,1177,533,317,2027,30286
31-08-2018,3,10897,10158,5565,1987,28607,1173,536,322,2031,30638
31-08-2018,4,11423,10423,5679,1943,29468,1179,545,334,2058,31526
31-08-2018,5,13271,11123,5888,2053,32335,1236,560,396,2192,34527
31-08-2018,6,16008,13591,6152,2134,37887,1369,594,610,2573,40460
31-08-2018,7,17522,15213,6648,2399,41783,1363,801,692,2856,44639
31-08-2018,8,17857,15692,6769,2436,42756,1386,1059,967,3412,46168
31-08-2018,9,17946,15739,6887,2547,43120,1377,1398,954,3729,46849
31-08-2018,10,17980,15808,7037,2670,43496,1383,1029,996,3408,46904
31-08-2018,11,17945,15711,7056,2522,43234,1392,997,952,3341,46575
31-08-2018,12,17353,15000,6956,2752,42061,1391,996,987,3374,45435
31-08-2018,13,17644,14521,6874,2693,41732,1396,1001,963,3360,45092
31-08-2018,14,17733,14611,6742,2507,41594,1399,1001,712,3112,44706
31-08-2018,15,17832,14553,6768,2357,41511,1400,1007,401,2808,44319
31-08-2018,16,17663,14607,6812,2276,41359,1400,830,666,2896,44255
31-08-2018,17,17621,14943,6849,2156,41568,1407,774,619,2800,44368
31-08-2018,18,17406,14949,6949,1981,41287,1408,782,378,2568,43855
31-08-2018,19,17448,14906,7019,1764,41136,1411,780,388,2579,43715
31-08-2018,20,17244,14726,7030,1658,40658,1410,877,290,2577,43235
31-08-2018,21,17319,13974,6998,1480,39770,1405,710,175,2290,42060
31-08-2018,22,16788,12328,6620,1379,37117,1404,563,175,2142,39259
31-08-2018,23,16063,11037,6254,1187,34542,1283,549,183,2015,36557
01-09-2018,0,15490,10342,6122,1117,33072,933,577,181,1691,34763
01-09-2018,1,13890,9873,5926,1014,30702,932,543,182,1657,32359
01-09-2018,2,13287,9679,5763,1013,29743,921,540,185,1646,31389
01-09-2018,3,12101,9333,5579,969,27982,924,542,188,1654,29636
01-09-2018,4,11552,9194,5514,987,27247,918,544,179,1641,28888
01-09-2018,5,11936,9290,5544,1044,27815,920,555,183,1658,29473
01-09-2018,6,13125,9878,5686,964,29653,942,562,195,1699,31352
01-09-2018,7,15008,11137,5797,1077,33020,993,572,188,1753,34773
01-09-2018,8,16655,12414,6108,1214,36391,991,581,186,1758,38149
01-09-2018,9,17485,13424,6380,1305,38595,1009,580,193,1782,40377
01-09-2018,10,17524,13418,6374,1362,38679,1027,580,321,1928,40607
01-09-2018,11,17399,13270,6281,1240,38192,1034,669,297,2000,40192
01-09-2018,12,17062,12851,6099,1231,37243,1020,643,364,2027,39270
01-09-2018,13,16435,12236,5906,1271,35848,1033,586,222,1841,37689
01-09-2018,14,15727,12053,5777,1182,34740,1049,581,204,1834,36574
01-09-2018,15,15530,11782,5705,1274,34291,1024,589,199,1812,36103
01-09-2018,16,16107,11918,5823,1221,35069,1000,596,182,1778,36847
01-09-2018,17,16958,12820,6124,1223,37126,1005,597,165,1767,38893
01-09-2018,18,17332,13548,6446,1164,38491,991,589,144,1724,40215
01-09-2018,19,17361,13550,6527,1054,38493,991,581,140,1712,40205
01-09-2018,20,17591,13774,6699,992,39056,1057,570,183,1810,40866
01-09-2018,21,17095,13302,6521,942,37860,1080,567,137,1784,39644
01-09-2018,22,15580,11946,6157,834,34517,1104,556,132,1792,36309
01-09-2018,23,13526,10296,5810,791,30423,1048,551,132,1731,32154
02-09-2018,0,12903,9231,5569,850,28554,1131,365,134,1630,30184
02-09-2018,1,12133,8978,5404,801,27317,1145,346,132,1623,28940
02-09-2018,2,11263,8952,5333,712,26259,1139,344,128,1611,27870
02-09-2018,3,10988,8759,5353,651,25750,1127,344,134,1605,27355
02-09-2018,4,11000,8711,5339,645,25695,1142,349,133,1624,27319
02-09-2018,5,10913,8743,5407,652,25716,1133,355,126,1614,27330
02-09-2018,6,11129,9177,5479,659,26446,1129,363,125,1617,28063
02-09-2018,7,11767,9344,5553,765,27429,1127,375,128,1630,29059
02-09-2018,8,13055,9844,5680,902,29481,1156,384,134,1674,31155
02-09-2018,9,13832,10465,5855,1195,31349,1166,385,147,1698,33047
02-09-2018,10,14129,10775,5883,1288,32075,1140,382,147,1669,33744
02-09-2018,11,14406,10861,5934,1349,32550,1197,379,149,1725,34275
02-09-2018,12,14224,10929,5947,1416,32515,1228,375,148,1751,34266
02-09-2018,13,13319,10964,5907,1437,31626,1372,371,145,1888,33514
02-09-2018,14,13227,11216,5758,1387,31589,1401,372,151,1924,33513
02-09-2018,15,13611,11373,5862,1442,32289,1380,395,156,1931,34220
02-09-2018,16,13873,11393,5863,1413,32542,1369,398,153,1920,34462
02-09-2018,17,14876,12038,5989,1362,34267,1344,403,149,1896,36163
02-09-2018,18,16319,12598,6269,1407,36593,1300,395,141,1836,38429
02-09-2018,19,16615,13154,6284,1374,37427,1372,400,148,1920,39347
02-09-2018,20,16642,13769,6521,1363,38297,1397,408,228,2033,40330
02-09-2018,21,15933,13267,6450,1401,37050,1394,404,170,1968,39018
02-09-2018,22,13695,12189,6328,1402,33616,1400,381,174,1955,35571
02-09-2018,23,11701,11286,6056,1342,30387,1417,363,173,1953,32340
03-09-2018,0,10782,10322,5932,1237,28272,1494,353,194,2041,30313
03-09-2018,1,10416,10054,5887,1265,27622,1473,352,229,2054,29676
03-09-2018,2,10268,9910,5950,1232,27361,1457,349,260,2066,29427
03-09-2018,3,10123,9802,6089,1262,27277,1430,348,242,2020,29297
03-09-2018,4,10290,9903,6294,1271,27759,1433,354,217,2004,29763
03-09-2018,5,12663,10621,6580,1414,31280,1486,379,200,2065,33345
03-09-2018,6,15926,13334,7042,1644,37947,1483,434,225,2142,40089
03-09-2018,7,17584,14857,7505,1983,41929,1485,796,261,2542,44471
03-09-2018,8,17999,15450,7355,2026,42831,1495,1077,455,3027,45858
03-09-2018,9,17926,15469,7261,2109,42766,1496,1362,468,3326,46092
03-09-2018,10,17842,15504,7405,2200,42950,1494,1153,386,3033,45983
03-09-2018,11,17809,15312,7572,2402,43095,1496,1280,398,3174,46269
03-09-2018,12,17768,15265,7609,2396,43038,1498,1477,363,3338,46376
03-09-2018,13,17834,15236,7418,2376,42865,1492,1287,367,3146,46011
03-09-2018,14,18019,15273,7266,2152,42709,1484,1010,369,2863,45572
03-09-2018,15,18228,15058,7307,2114,42709,1485,935,374,2794,45503
03-09-2018,16,18372,14932,7174,2067,42546,1480,779,172,2431,44977
03-09-2018,17,18050,15122,7132,1953,42258,1488,750,176,2414,44672
03-09-2018,18,17751,14688,7024,1894,41357,1480,654,181,2315,43672
03-09-2018,19,17809,14722,6999,1643,41174,1484,725,241,2450,43624
03-09-2018,20,18000,14760,7102,1561,41423,1495,589,301,2385,43808
03-09-2018,21,17609,14106,6828,1468,40012,1501,576,351,2428,42440
03-09-2018,22,15479,12805,6488,1339,36112,1461,563,341,2365,38477
03-09-2018,23,13182,11407,6201,1205,31995,1394,573,309,2276,34271
04-09-2018,0,12610,10484,6240,1177,30511,1244,567,283,2094,32605
04-09-2018,1,11796,10072,6197,1063,29130,1242,547,260,2049,31179
04-09-2018,2,11023,9954,6192,961,28130,1245,546,250,2041,30171
04-09-2018,3,10802,10004,6215,949,27969,1245,546,227,2018,29987
04-09-2018,4,11178,10298,6300,941,28718,1245,551,205,2001,30719
04-09-2018,5,12938,11502,6548,914,31901,1256,625,193,2074,33975
04-09-2018,6,16491,14018,7027,1194,38731,1321,584,282,2187,40918
04-09-2018,7,17900,15336,7271,1387,41893,1362,758,371,2491,44384
04-09-2018,8,18318,15426,7239,1421,42403,1439,1333,563,3335,45738
04-09-2018,9,18636,15711,7157,1515,43019,1346,1214,565,3125,46144
04-09-2018,10,18760,15690,7118,1697,43264,1349,1212,557,3118,46382
04-09-2018,11,18426,15513,7063,1842,42845,1364,1361,574,3299,46144
04-09-2018,12,17993,15408,7024,1766,42191,1368,1337,516,3221,45412
04-09-2018,13,17947,15149,6797,1780,41673,1367,951,430,2748,44421
04-09-2018,14,17887,15101,6622,1717,41328,1367,898,332,2597,43925
04-09-2018,15,18169,15092,6628,1688,41577,1360,900,363,2623,44200
04-09-2018,16,18334,15316,6726,1579,41956,1351,791,329,2471,44427
04-09-2018,17,18410,15370,6716,1482,41977,1342,793,332,2467,44444
04-09-2018,18,18079,15275,6689,1331,41372,1292,779,325,2396,43768
04-09-2018,19,18081,15443,6874,1242,41639,1332,1009,375,2716,44355
04-09-2018,20,18284,15561,6910,1227,41983,1333,1084,466,2883,44866
04-09-2018,21,18125,14602,6625,1100,40452,1269,579,172,2020,42472
04-09-2018,22,17128,13297,6330,991,37748,1234,554,165,1953,39701
04-09-2018,23,14931,12133,5953,892,33909,1215,539,162,1916,35825
05-09-2018,0,13689,10729,5832,909,31160,1181,537,185,1903,33063
05-09-2018,1,12752,10232,5731,948,29663,1109,536,202,1847,31510
05-09-2018,2,12006,9974,5689,708,28376,1101,534,216,1851,30227
05-09-2018,3,11847,9912,5742,703,28207,1097,533,186,1816,30023
05-09-2018,4,12072,10178,5869,817,28939,1093,541,192,1826,30765
05-09-2018,5,13618,11393,6277,851,32138,1123,559,173,1855,33993
05-09-2018,6,17113,13859,6772,1039,38784,1179,586,203,1968,40752
05-09-2018,7,18382,15429,7055,1150,42017,1188,944,184,2316,44333
05-09-2018,8,18705,15637,7219,1261,42822,1192,1238,356,2786,45608
05-09-2018,9,18682,15612,7183,1362,42839,1160,1402,359,2921,45760
05-09-2018,10,18777,15639,7107,1453,42977,1163,1298,365,2826,45803
05-09-2018,11,18569,15455,7291,1558,42874,1166,1317,370,2853,45727
05-09-2018,12,18494,14877,7157,1638,42165,1166,1072,342,2580,44745
05-09-2018,13,18272,14657,6959,1597,41484,1167,1059,343,2569,44053
05-09-2018,14,18324,14617,6680,1492,41113,1163,971,292,2426,43539
05-09-2018,15,18679,14842,6672,1607,41800,1165,1155,180,2500,44300
05-09-2018,16,18626,15159,6818,1471,42075,1174,1032,140,2346,44421
05-09-2018,17,18450,15363,6958,1400,42171,1185,1029,337,2551,44722
05-09-2018,18,18384,15140,7034,1279,41839,1180,928,180,2288,44127
05-09-2018,19,18305,15468,7213,1247,42233,1180,1169,329,2678,44911
05-09-2018,20,18246,15386,7143,1460,42234,1194,1101,336,2631,44865
05-09-2018,21,17810,14339,6826,1274,40249,1234,583,182,1999,42248
05-09-2018,22,17162,12975,6343,1221,37700,1315,554,187,2056,39756
05-09-2018,23,15078,11822,5993,1182,34075,1318,538,190,2046,36121
06-09-2018,0,13406,10285,5853,1135,30679,1253,581,180,2014,32693
06-09-2018,1,12421,9747,5787,1014,28969,1221,578,165,1964,30933
06-09-2018,2,11998,9596,5675,1004,28274,1223,578,158,1959,30233
06-09-2018,3,11977,9754,5650,973,28355,1225,579,157,1961,30316
06-09-2018,4,12485,10157,5789,953,29382,1260,585,146,1991,31373
06-09-2018,5,14165,11244,6081,1033,32521,1299,606,134,2039,34560
06-09-2018,6,16994,13967,6629,1445,39035,1367,683,132,2182,41217
06-09-2018,7,18231,15435,7058,1616,42339,1472,1061,149,2682,45021
06-09-2018,8,18403,15676,7175,1825,43081,1474,1197,507,3178,46259
06-09-2018,9,18624,15812,7173,1815,43424,1476,1268,504,3248,46672
06-09-2018,10,18462,15712,7102,2289,43565,1475,1085,540,3100,46665
06-09-2018,11,18363,15424,7012,2541,43342,1477,1268,536,3281,46623
06-09-2018,12,18595,15159,6874,2840,43470,1483,1316,540,3339,46809
06-09-2018,13,18254,14911,6762,2977,42907,1489,1247,538,3274,46181
06-09-2018,14,18464,15194,6787,3073,43519,1489,1322,486,3297,46816
06-09-2018,15,18642,15265,6729,3087,43723,1490,1222,458,3170,46893
06-09-2018,16,18698,15411,6901,3076,44085,1495,1174,373,3042,47127
06-09-2018,17,18708,15702,7026,2836,44271,1473,1122,270,2865,47136
06-09-2018,18,18593,15630,7065,2798,44087,1477,1097,380,2954,47041
06-09-2018,19,18574,15839,7075,2783,44272,1487,1161,489,3137,47409
06-09-2018,20,18627,15494,6838,2936,43896,1497,1140,543,3180,47076
06-09-2018,21,17972,14521,6461,3078,42031,1508,641,299,2448,44479
06-09-2018,22,16363,13390,5919,3357,39029,1506,608,295,2409,41438
06-09-2018,23,14409,11923,5681,3349,35362,1470,592,288,2350,37712
07-09-2018,0,13618,11234,5614,3156,33621,1442,582,268,2292,35913
07-09-2018,1,12798,10419,5558,3184,31959,1471,576,252,2299,34258
07-09-2018,2,12463,10314,5556,3122,31454,1484,572,235,2291,33745
07-09-2018,3,12463,10275,5564,3005,31306,1502,577,220,2299,33605
07-09-2018,4,12537,10424,5682,2773,31417,1501,584,225,2310,33727
07-09-2018,5,14219,11462,5905,2616,34202,1511,602,268,2381,36583
07-09-2018,6,17186,14355,6323,2495,40360,1580,630,276,2486,42846
07-09-2018,7,18605,16138,6837,2584,44164,1568,718,241,2527,46691
07-09-2018,8,18847,16263,7072,2633,44814,1583,993,529,3105,47919
07-09-2018,9,18806,16428,7046,2555,44835,1587,1072,496,3155,47990
07-09-2018,10,18862,16597,7123,2526,45107,1585,1069,514,3168,48275
07-09-2018,11,18957,16083,6905,2421,44366,1589,1157,391,3137,47503
07-09-2018,12,18771,15913,6718,2081,43483,1592,1315,350,3257,46740
07-09-2018,13,17524,15208,6576,2076,41384,1562,1169,385,3116,44500
07-09-2018,14,16855,14553,6057,2027,39493,1555,970,381,2906,42399
07-09-2018,15,16470,14317,5951,2063,38802,1589,952,219,2760,41562
07-09-2018,16,16819,14526,6011,2268,39624,1565,816,206,2587,42211
07-09-2018,17,17606,14652,6085,2258,40601,1546,773,196,2515,43116
07-09-2018,18,18013,14710,6257,2600,41580,1529,752,186,2467,44047
07-09-2018,19,17873,15265,6433,2548,42118,1553,990,261,2804,44922
07-09-2018,20,17364,15033,6476,2250,41122,1584,965,278,2827,43949
07-09-2018,21,16108,14311,6496,2405,39320,1631,583,201,2415,41735
07-09-2018,22,14797,13391,6297,2185,36671,1603,576,182,2361,39032
07-09-2018,23,12735,12448,5725,2223,33131,1642,566,163,2371,35502
08-09-2018,0,11886,10852,5690,2285,30712,1333,290,167,1790,32502
08-09-2018,1,11425,10206,5562,2357,29550,1290,282,170,1742,31292
08-09-2018,2,10973,9955,5493,2383,28805,1262,278,175,1715,30520
08-09-2018,3,10331,9778,5521,2448,28078,1230,281,169,1680,29758
08-09-2018,4,9969,9720,5608,2667,27964,1221,283,181,1685,29649
08-09-2018,5,10492,9733,5695,2862,28783,1248,284,174,1706,30489
08-09-2018,6,11193,10419,5684,2948,30243,1221,289,176,1686,31929
08-09-2018,7,12323,11311,5551,3170,32356,1207,389,162,1758,34114
08-09-2018,8,14933,12092,5465,3322,35812,1231,561,141,1933,37745
08-09-2018,9,15439,12706,5373,3575,37096,1238,573,304,2115,39211
08-09-2018,10,15522,12751,5357,3551,37180,1241,540,502,2283,39463
08-09-2018,11,15222,12708,5402,3670,37003,1221,671,424,2316,39319
08-09-2018,12,14466,12653,5337,3834,36290,1203,553,418,2174,38464
08-09-2018,13,13878,12698,5292,3900,35768,1203,428,346,1977,37745
08-09-2018,14,13680,12576,5291,3878,35426,1167,347,294,1808,37234
08-09-2018,15,13799,12729,5287,4287,36102,1166,423,190,1779,37881
08-09-2018,16,13968,12819,5256,4169,36212,1191,413,186,1790,38002
08-09-2018,17,14783,13130,5369,4154,37436,1175,408,183,1766,39202
08-09-2018,18,15935,14070,5651,3740,39396,1187,301,150,1638,41034
08-09-2018,19,16162,14229,5995,3282,39668,1190,300,297,1787,41455
08-09-2018,20,16102,14128,6237,2885,39352,1239,298,494,2031,41383
08-09-2018,21,15656,13643,6240,2721,38262,1213,293,153,1659,39921
08-09-2018,22,14830,12997,5971,2773,36570,1194,289,145,1628,38198
08-09-2018,23,13378,11856,5822,2875,33931,1205,288,151,1644,35575
09-09-2018,0,11316,10695,5753,3080,30844,1225,288,160,1673,32517
09-09-2018,1,9951,9798,5670,2950,28371,1213,284,153,1650,30021
09-09-2018,2,9764,9730,5631,2842,27967,1212,283,144,1639,29606
09-09-2018,3,9799,9553,5616,2919,27887,1214,283,131,1628,29515
09-09-2018,4,9972,9591,5590,2884,28037,1222,283,129,1634,29671
09-09-2018,5,9897,9603,5516,2618,27632,1241,286,126,1653,29285
09-09-2018,6,10383,9923,5486,2515,28308,1210,290,120,1620,29928
09-09-2018,7,11042,10276,5368,2365,29051,1183,316,125,1624,30675
09-09-2018,8,12089,11431,5255,2335,31111,1163,318,129,1610,32721
09-09-2018,9,13668,12246,5246,2457,33617,1218,339,142,1699,35316
09-09-2018,10,14331,12747,5282,2615,34975,1223,477,147,1847,36822
09-09-2018,11,14314,12811,5289,2708,35121,1210,478,153,1841,36962
09-09-2018,12,14038,12757,5295,2675,34767,1177,477,157,1811,36578
09-09-2018,13,13613,12600,5277,2658,34149,1181,478,165,1824,35973
09-09-2018,14,13197,12611,5279,2666,33753,1180,476,163,1819,35572
09-09-2018,15,12765,12530,5256,2847,33399,1184,477,155,1816,35215
09-09-2018,16,13649,12608,5283,2692,34232,1180,477,149,1806,36038
09-09-2018,17,15230,13412,5422,2415,36479,1180,478,144,1802,38281
09-09-2018,18,16726,14336,5712,2161,38936,1176,478,140,1794,40730
09-09-2018,19,16811,14651,5983,2135,39579,1198,477,141,1816,41395
09-09-2018,20,17310,14793,6215,2195,40514,1226,478,280,1984,42498
09-09-2018,21,16305,14379,6147,2115,38947,1142,476,146,1764,40711
09-09-2018,22,15183,13384,6039,2075,36680,1141,470,144,1755,38435
09-09-2018,23,12993,11940,5792,2267,32992,1164,466,128,1758,34750
10-09-2018,0,11810,11028,5707,2463,31008,1120,322,124,1566,32574
10-09-2018,1,10692,10833,5657,2646,29828,1139,288,120,1547,31375
10-09-2018,2,9899,10815,5625,2804,29143,1136,287,119,1542,30685
10-09-2018,3,9453,10801,5557,2571,28381,1130,288,118,1536,29917
10-09-2018,4,9985,11277,5605,2307,29175,1190,288,118,1596,30771
10-09-2018,5,12791,12210,5785,2329,33115,1342,298,119,1759,34874
10-09-2018,6,16501,14581,5994,2609,39685,1420,465,145,2030,41715
10-09-2018,7,17923,16043,6311,2932,43210,1417,674,215,2306,45516
10-09-2018,8,18166,16505,6337,3005,44012,1418,923,604,2945,46957
10-09-2018,9,18503,16810,6480,2957,44751,1436,993,609,3038,47789
10-09-2018,10,18200,16766,6441,3365,44772,1436,985,599,3020,47792
10-09-2018,11,17713,16532,6494,3685,44425,1439,981,607,3027,47452
10-09-2018,12,17506,16441,6288,3680,43915,1534,944,602,3080,46995
10-09-2018,13,16955,16033,6078,3570,42636,1511,867,591,2969,45605
10-09-2018,14,17086,16015,6025,3569,42695,1481,854,600,2935,45630
10-09-2018,15,17031,15894,6006,3359,42290,1382,831,681,2894,45184
10-09-2018,16,17672,16054,6119,3245,43090,1348,516,809,2673,45763
10-09-2018,17,17921,16348,6094,3246,43610,1353,506,680,2539,46149
10-09-2018,18,17573,15760,6276,3114,42724,1406,505,627,2538,45262
10-09-2018,19,17627,15768,6434,2849,42678,1438,665,845,2948,45626
10-09-2018,20,17032,15762,6486,2713,41994,1465,506,666,2637,44631
10-09-2018,21,16130,14870,6519,2476,39995,1467,483,452,2402,42397
10-09-2018,22,15021,13634,6398,2335,37388,1479,484,309,2272,39660
10-09-2018,23,13944,12673,6256,2098,34972,1481,468,324,2273,37245
11-09-2018,0,13093,11686,6245,2121,33145,1490,298,168,1956,35101
11-09-2018,1,12579,11372,6215,2111,32277,1287,298,197,1782,34059
11-09-2018,2,11870,11367,6269,1935,31441,1181,299,217,1697,33138
11-09-2018,3,11359,11305,6227,1945,30836,1157,295,218,1670,32506
11-09-2018,4,11563,11474,6203,1973,31213,1175,299,217,1691,32904
11-09-2018,5,13398,12011,6304,2096,33811,1382,311,212,1905,35716
11-09-2018,6,16249,14490,6750,2771,40260,1466,324,182,1972,42232
11-09-2018,7,17033,15881,7228,3237,43381,1468,391,340,2199,45580
11-09-2018,8,16826,16256,7524,3361,43967,1432,615,506,2553,46520
11-09-2018,9,17010,16290,7275,3643,44217,1441,681,501,2623,46840
11-09-2018,10,16472,16260,7158,3815,43707,1451,693,527,2671,46378
11-09-2018,11,15974,16271,6926,4198,43370,1454,680,566,2700,46070
11-09-2018,12,15410,16406,6662,5198,43676,1462,795,441,2698,46374
11-09-2018,13,14493,16317,6519,4161,41490,1462,714,428,2604,44094
11-09-2018,14,14264,16253,6290,4495,41302,1446,542,437,2425,43727
11-09-2018,15,14264,16716,6228,4659,41866,1480,328,402,2210,44076
11-09-2018,16,15094,16818,6415,4394,42722,1492,312,307,2111,44833
11-09-2018,17,15487,16872,6526,4078,42962,1535,341,228,2104,45066
11-09-2018,18,15568,16579,6701,3866,42714,1535,358,253,2146,44860
11-09-2018,19,16155,16344,6875,3415,42791,1552,611,485,2648,45439
11-09-2018,20,16339,16134,6464,3466,42403,1536,574,593,2703,45106
11-09-2018,21,15949,15203,6218,3476,40846,1520,352,468,2340,43186
11-09-2018,22,15012,14126,5969,3086,38194,1548,342,475,2365,40559
11-09-2018,23,13302,12886,5770,2938,34898,1567,341,516,2424,37322
12-09-2018,0,12242,12281,5658,3191,33372,1533,338,533,2404,35776
12-09-2018,1,12004,12096,5499,3376,32975,1414,335,532,2281,35256
12-09-2018,2,11830,12125,5464,3143,32561,1357,328,548,2233,34794
12-09-2018,3,11846,12167,5419,3268,32700,1331,324,531,2186,34886
12-09-2018,4,12526,12578,5470,3272,33847,1332,327,468,2127,35974
12-09-2018,5,13859,13172,5655,3269,35956,1529,363,455,2347,38303
12-09-2018,6,16350,15353,6037,3677,41417,1623,370,453,2446,43863
12-09-2018,7,17671,16875,6506,3741,44793,1602,375,590,2567,47360
12-09-2018,8,17742,17603,6568,3644,45558,1639,541,769,2949,48507
12-09-2018,9,17705,17664,6577,3644,45589,1633,558,759,2950,48539
12-09-2018,10,17344,17627,6660,3774,45406,1618,543,722,2883,48289
12-09-2018,11,17062,17330,6583,4089,45063,1656,545,725,2926,47989
12-09-2018,12,16776,16939,6548,4443,44707,1645,602,592,2839,47546
12-09-2018,13,16174,16660,6353,4573,43761,1654,543,563,2760,46521
12-09-2018,14,16157,16114,6236,4730,43237,1638,551,522,2711,45948
12-09-2018,15,15917,16101,6256,4571,42847,1586,626,433,2645,45492
12-09-2018,16,16255,16382,6359,4494,43490,1557,548,432,2537,46027
12-09-2018,17,17249,16492,6372,4419,44532,1588,626,393,2607,47139
12-09-2018,18,17833,16734,6522,3887,44977,1607,627,526,2760,47737
12-09-2018,19,18113,17079,6748,3403,45345,1611,811,699,3121,48466
12-09-2018,20,18083,16686,6394,3385,44547,1612,839,523,2974,47521
12-09-2018,21,17190,16217,6158,3253,42819,1449,521,389,2359,45178
12-09-2018,22,15370,15290,6128,2924,39711,1377,485,381,2243,41954
12-09-2018,23,14418,14168,6100,2532,37217,1370,503,368,2241,39458
13-09-2018,0,14290,13007,6171,2447,35917,1221,328,342,1891,37808
13-09-2018,1,14067,12541,6226,2262,35097,1108,321,331,1760,36857
13-09-2018,2,14019,12469,6213,2102,34801,1141,314,302,1757,36558
13-09-2018,3,14445,12487,6236,2018,35184,1137,311,276,1724,36908
13-09-2018,4,14826,12982,6478,1869,36155,1156,307,272,1735,37890
13-09-2018,5,15691,13669,6739,1989,38088,1292,351,261,1904,39992
13-09-2018,6,17558,15084,6990,2081,41714,1310,365,254,1929,43643
13-09-2018,7,18916,16196,7236,2272,44622,1316,619,516,2451,47073
13-09-2018,8,19144,16781,7344,2493,45762,1316,1022,505,2843,48605
13-09-2018,9,18858,16512,7250,2579,45199,1321,892,592,2805,48004
13-09-2018,10,18554,16308,7240,2915,45017,1296,838,636,2770,47787
13-09-2018,11,18501,16291,7213,2863,44869,1238,799,705,2742,47611
13-09-2018,12,18667,16305,7157,3112,45242,1257,1038,499,2794,48036
13-09-2018,13,18180,15814,6984,3210,44189,1251,1037,482,2770,46959
13-09-2018,14,18134,15523,6947,3490,44093,1243,1099,390,2732,46825
13-09-2018,15,18216,15549,6913,3447,44126,1258,1020,325,2603,46729
13-09-2018,16,18487,16121,7020,3353,44982,1239,880,201,2320,47302
13-09-2018,17,18856,15923,6872,3352,45003,1239,819,182,2240,47243
13-09-2018,18,18678,15872,6999,2982,44531,1194,919,357,2470,47001
13-09-2018,19,18812,16283,7170,2912,45176,1201,962,521,2684,47860
13-09-2018,20,18794,15805,6698,2940,44236,1207,1031,336,2574,46810
13-09-2018,21,18603,15193,6221,2838,42855,1211,598,158,1967,44822
13-09-2018,22,17500,14003,6217,2488,40208,1199,478,164,1841,42049
13-09-2018,23,16145,12626,6085,2571,37427,1202,476,161,1839,39266
14-09-2018,0,15554,11670,5955,2557,35736,1198,474,154,1826,37562
14-09-2018,1,14888,11443,5915,2784,35031,1182,471,153,1806,36837
14-09-2018,2,14733,11193,5963,2763,34653,1181,467,145,1793,36446
14-09-2018,3,14509,11106,5996,2731,34343,1161,467,140,1768,36111
14-09-2018,4,14687,11425,6071,2672,34855,1176,467,141,1784,36639
14-09-2018,5,15911,12905,6399,2783,37998,1186,503,136,1825,39823
14-09-2018,6,17623,14814,6972,3151,42560,1185,525,140,1850,44410
14-09-2018,7,18618,16375,7195,3220,45409,1182,921,153,2256,47665
14-09-2018,8,19196,16782,7309,3328,46616,1185,1098,284,2567,49183
14-09-2018,9,19082,17051,7406,3309,46848,1206,1110,477,2793,49641
14-09-2018,10,18976,17090,7512,3417,46994,1225,1233,292,2750,49744
14-09-2018,11,18605,16825,7506,3205,46141,1234,1193,268,2695,48836
14-09-2018,12,18163,16974,7433,3202,45771,1228,1202,279,2709,48480
14-09-2018,13,17671,16553,7060,3118,44402,1145,1198,229,2572,46974
14-09-2018,14,17712,16064,6835,3181,43793,1161,1175,230,2566,46359
14-09-2018,15,17596,15432,6704,3052,42784,1187,1148,223,2558,45342
14-09-2018,16,17645,15686,6865,3146,43343,1170,943,198,2311,45654
14-09-2018,17,17475,16713,7021,3194,44402,1194,930,170,2294,46696
14-09-2018,18,17253,16851,7127,3309,44540,1186,791,146,2123,46663
14-09-2018,19,17368,16536,7156,3219,44279,1206,1140,168,2514,46793
14-09-2018,20,17089,15902,6715,3065,42772,1232,846,150,2228,45000
14-09-2018,21,16224,14961,6392,3041,40618,1210,492,149,1851,42469
14-09-2018,22,15346,13751,6163,2887,38147,1162,436,153,1751,39898
14-09-2018,23,14479,13012,5996,2678,36164,1208,456,157,1821,37985
15-09-2018,0,14512,12446,5956,2459,35374,1242,155,167,1564,36938
15-09-2018,1,13837,12189,5761,2473,34261,1070,137,175,1382,35643
15-09-2018,2,12744,11410,5689,2468,32312,993,136,195,1324,33636
15-09-2018,3,11941,11120,5635,2384,31080,992,136,205,1333,32413
15-09-2018,4,12140,11059,5667,2278,31142,998,132,239,1369,32511
15-09-2018,5,12254,11177,5765,2263,31460,1156,196,231,1583,33043
15-09-2018,6,13188,11740,5915,2322,33167,1235,177,221,1633,34800
15-09-2018,7,14192,12545,6108,2576,35423,1256,151,267,1674,37097
15-09-2018,8,16021,13866,6474,2664,39025,1257,144,213,1614,40639
15-09-2018,9,16160,14001,6505,2939,39606,1275,341,385,2001,41607
15-09-2018,10,15447,13733,6490,3224,38892,1271,322,530,2123,41015
15-09-2018,11,14922,13692,6462,3611,38687,1233,283,399,1915,40602
15-09-2018,12,14431,13260,6421,3393,37506,1226,217,277,1720,39226
15-09-2018,13,14224,13283,6343,3094,36943,1249,169,309,1727,38670
15-09-2018,14,14321,13733,6348,3048,37449,1262,155,261,1678,39127
15-09-2018,15,14726,14004,6386,2892,38008,1264,148,279,1691,39699
15-09-2018,16,15052,14383,6434,3003,38871,1219,164,365,1748,40619
15-09-2018,17,15726,15314,6602,2937,40579,1224,175,297,1696,42275
15-09-2018,18,16676,15915,6675,2698,41965,1163,193,345,1701,43666
15-09-2018,19,16978,16219,6731,2310,42238,1166,171,363,1700,43938
15-09-2018,20,16520,15881,6676,2373,41451,1181,186,271,1638,43089
15-09-2018,21,16138,15384,6512,2147,40179,1166,164,315,1645,41824
15-09-2018,22,15440,14467,6334,1955,38196,1135,151,327,1613,39809
15-09-2018,23,14956,13137,6245,1745,36084,1164,148,284,1596,37680
16-09-2018,0,15099,11950,6255,1611,34917,828,140,299,1267,36184
16-09-2018,1,14362,11453,6166,1631,33613,816,136,279,1231,34844
16-09-2018,2,13090,11092,6094,1522,31798,791,136,258,1185,32983
16-09-2018,3,12333,11060,6114,1262,30769,832,137,238,1207,31976
16-09-2018,4,12220,10994,6139,1227,30582,842,136,248,1226,31808
16-09-2018,5,12323,11068,6175,1230,30796,844,138,280,1262,32058
16-09-2018,6,12319,11441,6202,1267,31229,829,144,324,1297,32526
16-09-2018,7,12349,11897,6387,1491,32125,820,146,351,1317,33442
16-09-2018,8,13618,12596,6242,1882,34340,845,149,328,1322,35662
16-09-2018,9,14826,13255,6339,2121,36540,869,152,338,1359,37899
16-09-2018,10,14547,13334,6545,2332,36759,834,153,386,1373,38132
16-09-2018,11,14020,13246,6584,2809,36658,835,149,389,1373,38031
16-09-2018,12,13989,13225,6497,3248,36959,847,155,421,1423,38382
16-09-2018,13,13106,13091,6494,3682,36371,839,154,397,1390,37761
16-09-2018,14,12591,13110,6512,3942,36157,846,152,380,1378,37535
16-09-2018,15,13108,13244,6491,4064,36907,858,153,373,1384,38291
16-09-2018,16,14588,13630,6518,4183,38917,851,153,340,1344,40261
16-09-2018,17,15914,14547,6546,4338,41346,842,146,265,1253,42599
16-09-2018,18,16319,15050,6766,4274,42410,905,146,217,1268,43678
16-09-2018,19,16640,15894,7118,3568,43221,906,457,584,1947,45168
16-09-2018,20,16477,15513,7027,3817,42835,916,378,573,1867,44702
16-09-2018,21,16002,14802,6676,3805,41284,901,147,242,1290,42574
16-09-2018,22,15070,13675,6230,3740,38715,857,146,257,1260,39975
16-09-2018,23,14494,12379,6071,3449,36394,831,144,288,1263,37657
17-09-2018,0,13344,11470,5973,3176,33962,875,137,313,1325,35287
17-09-2018,1,12788,11299,5889,3232,33208,860,133,319,1312,34520
17-09-2018,2,12872,11385,5849,3004,33110,906,132,332,1370,34480
17-09-2018,3,12473,11509,5836,2834,32652,948,135,362,1445,34097
17-09-2018,4,13365,12160,6017,2389,33932,996,152,370,1518,35450
17-09-2018,5,14741,13059,6256,2321,36376,1248,181,397,1826,38202
17-09-2018,6,16494,16555,6894,2225,42169,1314,357,422,2093,44262
17-09-2018,7,17710,18018,7186,2398,45313,1337,314,436,2087,47400
17-09-2018,8,18199,18225,7305,2409,46138,1374,522,773,2669,48807
17-09-2018,9,18073,18308,7266,2314,45961,1396,521,592,2509,48470
17-09-2018,10,17870,18456,7154,2228,45708,1388,521,640,2549,48257
17-09-2018,11,17927,18221,6972,2272,45393,1385,663,834,2882,48275
17-09-2018,12,17534,17757,6908,2236,44435,1390,759,835,2984,47419
17-09-2018,13,17606,17145,6600,2171,43523,1403,615,822,2840,46363
17-09-2018,14,17695,16469,6596,2089,42850,1364,539,623,2526,45376
17-09-2018,15,17661,16615,6852,2255,43383,1331,531,502,2364,45747
17-09-2018,16,17850,17265,7274,2184,44573,1323,526,469,2318,46891
17-09-2018,17,17860,17688,7282,2273,45103,1355,522,445,2322,47425
17-09-2018,18,17499,17640,7423,2324,44888,1387,712,404,2503,47391
17-09-2018,19,17673,17869,7585,2258,45385,1392,836,758,2986,48371
17-09-2018,20,17432,16734,7379,2373,43919,1379,633,702,2714,46633
17-09-2018,21,17338,15492,6954,2322,42105,1360,494,333,2187,44292
17-09-2018,22,16757,14302,6707,2159,39926,1337,463,327,2127,42053
17-09-2018,23,15232,13326,6373,2040,36972,1279,466,272,2017,38989
18-09-2018,0,14836,12175,6314,2137,35463,1024,297,238,1559,37022
18-09-2018,1,14454,11232,6232,2250,34167,992,281,224,1497,35664
18-09-2018,2,13281,11170,6215,2217,32885,934,278,222,1434,34319
18-09-2018,3,12736,11417,6237,2203,32592,903,278,204,1385,33977
18-09-2018,4,13085,12106,6393,2138,33723,909,277,199,1385,35108
18-09-2018,5,14058,13217,6695,2286,36258,1022,311,241,1574,37832
18-09-2018,6,16216,15844,7254,2594,41908,1157,539,183,1879,43787
18-09-2018,7,17392,17040,7696,3016,45144,1200,522,231,1953,47097
18-09-2018,8,17728,17102,7735,3124,45690,1181,616,569,2366,48056
18-09-2018,9,17719,16965,7631,3095,45412,1201,965,567,2733,48145
18-09-2018,10,17570,16732,7483,3191,44976,1218,873,594,2685,47661
18-09-2018,11,17294,16647,7405,3168,44514,1222,812,600,2634,47148
18-09-2018,12,16817,16347,7322,3022,43509,1149,906,599,2654,46163
18-09-2018,13,16602,15587,7090,3233,42513,1140,908,633,2681,45194
18-09-2018,14,16488,15475,6825,3613,42399,1150,754,636,2540,44939
18-09-2018,15,16068,15468,6750,3826,42112,1161,729,448,2338,44450
18-09-2018,16,16049,15745,6750,4275,42818,1171,532,410,2113,44931
18-09-2018,17,16228,16528,6933,4231,43918,1185,500,397,2082,46000
18-09-2018,18,16213,16817,6962,4190,44182,1198,564,309,2071,46253
18-09-2018,19,16128,16859,7024,4114,44125,1266,881,655,2802,46927
18-09-2018,20,15818,15904,6738,3926,42386,1231,569,639,2439,44825
18-09-2018,21,15418,15204,6401,3552,40577,1203,505,396,2104,42681
18-09-2018,22,14376,14167,6120,3386,38049,1197,497,395,2089,40138
18-09-2018,23,13589,13137,5853,3098,35677,1201,475,400,2076,37753
19-09-2018,0,13219,12560,5697,2927,34402,914,313,398,1625,36027
19-09-2018,1,12627,12435,5620,2890,33572,878,306,398,1582,35154
19-09-2018,2,12800,12397,5583,2761,33542,874,304,395,1573,35115
19-09-2018,3,12767,12810,5659,2655,33891,923,301,374,1598,35489
19-09-2018,4,13403,13510,5879,2490,35283,944,297,353,1594,36877
19-09-2018,5,14339,14579,6223,2583,37725,1027,301,346,1674,39399
19-09-2018,6,15976,16707,6699,2710,42091,1114,315,352,1781,43872
19-09-2018,7,16944,17862,7090,2778,44675,1110,308,433,1851,46526
19-09-2018,8,17165,18270,7261,2928,45625,1106,378,941,2425,48050
19-09-2018,9,17216,18322,7092,3404,46034,1101,488,1002,2591,48625
19-09-2018,10,16764,18036,6989,3549,45340,1095,462,1021,2578,47918
19-09-2018,11,16685,17664,6984,3635,44969,1085,486,1050,2621,47590
19-09-2018,12,16541,17174,6827,3127,43669,1093,690,1070,2853,46522
19-09-2018,13,16029,16623,6499,3555,42705,1120,515,1068,2703,45408
19-09-2018,14,15582,16276,6384,3519,41761,1121,455,1087,2663,44424
19-09-2018,15,15972,16029,6438,3968,42408,1122,347,1074,2543,44951
19-09-2018,16,16501,16559,6585,3840,43487,1113,311,891,2315,45802
19-09-2018,17,16618,17277,6781,3714,44391,1078,335,881,2294,46685
19-09-2018,18,16550,17476,6877,4003,44906,1074,331,1016,2421,47327
19-09-2018,19,16561,17577,7134,4299,45571,1081,686,998,2765,48336
19-09-2018,20,16048,16803,6713,4388,43951,1046,418,908,2372,46323
19-09-2018,21,14670,16238,6367,4337,41613,947,331,375,1653,43266
19-09-2018,22,13252,15124,6012,4232,38622,961,310,369,1640,40262
19-09-2018,23,11874,14457,5666,4210,36208,908,358,372,1638,37846
20-09-2018,0,11765,13744,5606,4066,35182,761,359,216,1336,36518
20-09-2018,1,11094,13885,5481,3743,34203,721,290,228,1239,35442
20-09-2018,2,10693,13904,5470,3470,33538,709,289,234,1232,34770
20-09-2018,3,11027,14170,5639,3120,33956,698,285,225,1208,35164
20-09-2018,4,11932,14584,5863,2891,35270,851,357,242,1450,36720
20-09-2018,5,13302,15257,6312,2627,37500,964,299,264,1527,39027
20-09-2018,6,14917,17053,6956,2705,41631,1018,658,302,1978,43609
20-09-2018,7,16409,18116,7236,2923,44684,1027,680,515,2222,46906
20-09-2018,8,17048,18052,7301,2999,45400,1039,998,679,2716,48116
20-09-2018,9,16773,18335,7303,3132,45542,1069,961,631,2661,48203
20-09-2018,10,16375,18527,7327,2978,45208,1078,955,629,2662,47870
20-09-2018,11,16120,18290,7277,3165,44851,1090,932,620,2642,47493
20-09-2018,12,15994,18776,7157,3248,45175,1070,995,627,2692,47867
20-09-2018,13,15756,18116,7061,3081,44014,1094,882,612,2588,46602
20-09-2018,14,15306,17455,7074,2865,42700,1107,819,591,2517,45217
20-09-2018,15,15722,17702,7123,2438,42986,1109,902,604,2615,45601
20-09-2018,16,16090,18544,7309,1913,43856,1086,997,389,2472,46328
20-09-2018,17,16702,18662,7472,2108,44945,1057,1007,370,2434,47379
20-09-2018,18,16621,18730,7492,2056,44901,1061,1083,370,2514,47415
20-09-2018,19,17160,18979,7560,1920,45619,1068,1000,577,2645,48264
20-09-2018,20,16654,18334,7386,1827,44201,1063,796,575,2434,46635
20-09-2018,21,16437,17166,7134,1966,42702,1023,499,282,1804,44506
20-09-2018,22,15134,15988,6939,2172,40235,954,467,268,1689,41924
20-09-2018,23,13677,14786,6816,2668,37947,979,542,234,1755,39702
21-09-2018,0,12135,13799,6666,3309,35909,997,318,198,1513,37422
21-09-2018,1,11111,13541,6425,3547,34626,814,281,184,1279,35905
21-09-2018,2,10599,13459,6348,3300,33707,665,300,189,1154,34861
21-09-2018,3,10461,13359,6306,3475,33600,652,284,226,1162,34762
21-09-2018,4,10661,13426,6346,3875,34307,648,291,298,1237,35544
21-09-2018,5,11387,14196,6659,3652,35895,700,300,372,1372,37267
21-09-2018,6,13357,16565,7072,3704,40696,901,326,453,1680,42376
21-09-2018,7,15494,17929,7307,3808,44537,849,337,486,1672,46209
21-09-2018,8,15980,17925,7386,3890,45180,895,622,747,2264,47444
21-09-2018,9,15542,17549,7244,4625,44961,1012,975,721,2708,47669
21-09-2018,10,15060,17370,7111,5124,44666,1025,900,550,2475,47141
21-09-2018,11,14726,16971,7122,4913,43733,989,706,637,2332,46065
21-09-2018,12,14346,16448,7045,4720,42560,1027,706,898,2631,45191
21-09-2018,13,14123,16729,6841,4601,42294,939,549,957,2445,44739
21-09-2018,14,13863,16771,6735,4859,42230,993,548,785,2326,44556
21-09-2018,15,13738,17064,6652,4667,42122,997,542,769,2308,44430
21-09-2018,16,13813,17313,6784,4634,42545,1048,537,637,2222,44767
21-09-2018,17,13592,17701,6852,4870,43014,1048,531,534,2113,45127
21-09-2018,18,13950,17717,6929,4519,43117,1092,570,545,2207,45324
21-09-2018,19,14145,18030,7079,4648,43903,1105,576,624,2305,46208
21-09-2018,20,13026,17260,6803,4650,41739,1036,547,615,2198,43937
21-09-2018,21,12861,16288,6681,4340,40170,996,526,604,2126,42296
21-09-2018,22,11591,15440,6340,4221,37593,812,466,579,1857,39450
21-09-2018,23,10203,15491,6109,4157,35960,661,322,526,1509,37469
22-09-2018,0,10196,15240,6053,3921,35410,636,153,487,1276,36686
22-09-2018,1,9706,15052,6017,3988,34763,648,155,460,1263,36026
22-09-2018,2,9320,15152,6079,4104,34655,639,147,412,1198,35853
22-09-2018,3,9314,15097,6139,4100,34651,688,145,321,1154,35805
22-09-2018,4,9471,15139,6183,4408,35200,688,152,266,1106,36306
22-09-2018,5,9774,15196,6243,4415,35628,659,164,405,1228,36856
22-09-2018,6,10726,15338,6283,4034,36382,608,184,449,1241,37623
22-09-2018,7,11486,15218,6335,3526,36563,627,191,524,1342,37905
22-09-2018,8,12088,15623,6383,3965,38061,718,191,537,1446,39507
22-09-2018,9,12562,15867,6575,4275,39281,732,195,559,1486,40767
22-09-2018,10,12716,16047,6498,4701,39964,738,203,660,1601,41565
22-09-2018,11,12894,16238,6537,4755,40426,715,268,548,1531,41957
22-09-2018,12,12741,16129,6630,4569,40069,646,280,585,1511,41580
22-09-2018,13,12527,16088,6422,4166,39203,651,238,613,1502,40705
22-09-2018,14,12055,16039,6235,4089,38418,647,246,609,1502,39920
22-09-2018,15,11990,16111,6303,4095,38501,646,245,606,1497,39998
22-09-2018,16,12493,16103,6304,4656,39555,632,247,570,1449,41004
22-09-2018,17,12968,16266,6546,4876,40656,607,250,500,1357,42013
22-09-2018,18,13474,16775,6761,4325,41337,657,247,525,1429,42766
22-09-2018,19,13730,16864,6890,4548,42033,677,254,816,1747,43780
22-09-2018,20,13422,16513,6817,4298,41050,667,253,803,1723,42773
22-09-2018,21,12924,16184,6692,4104,39905,667,250,535,1452,41357
22-09-2018,22,12100,15654,6481,4124,38359,569,233,484,1286,39645
22-09-2018,23,11219,15022,6216,4109,36566,531,219,504,1254,37820
23-09-2018,0,10764,15235,6110,3768,35878,522,209,503,1234,37112
23-09-2018,1,10232,14752,6038,3856,34878,555,201,390,1146,36024
23-09-2018,2,10248,14797,6025,3746,34816,605,205,345,1155,35971
23-09-2018,3,10467,14682,6000,3837,34986,646,210,373,1229,36215
23-09-2018,4,10984,14759,5951,3669,35364,633,214,411,1258,36622
23-09-2018,5,11824,15010,6017,3537,36390,599,224,452,1275,37665
23-09-2018,6,12298,14784,5983,3468,36535,700,233,441,1374,37909
23-09-2018,7,12812,14396,5860,3413,36481,749,249,527,1525,38006
23-09-2018,8,14508,15231,5860,3332,38931,749,255,492,1496,40427
23-09-2018,9,15065,15725,5988,3438,40217,794,257,545,1596,41813
23-09-2018,10,15292,16115,6123,3615,41146,822,257,603,1682,42828
23-09-2018,11,15394,16114,6262,3774,41545,858,253,505,1616,43161
23-09-2018,12,15487,15677,6355,3766,41287,889,250,512,1651,42938
23-09-2018,13,15066,15484,6456,3771,40777,948,252,470,1670,42447
23-09-2018,14,14803,15051,6456,3744,40055,941,249,468,1658,41713
23-09-2018,15,14333,14521,6536,3757,39148,927,248,446,1621,40769
23-09-2018,16,14077,14599,6625,3910,39214,897,242,425,1564,40778
23-09-2018,17,14718,15506,6841,3911,40975,785,258,496,1539,42514
23-09-2018,18,15409,16367,7000,3638,42414,753,267,452,1472,43886
23-09-2018,19,15843,16999,7113,3345,43300,728,814,553,2095,45395
23-09-2018,20,15432,16543,7018,3246,42239,673,454,499,1626,43865
23-09-2018,21,14164,15810,6833,3653,40459,649,225,298,1172,41631
23-09-2018,22,13087,14770,6555,3811,38224,728,206,248,1182,39406
23-09-2018,23,12132,13895,6144,3922,36093,741,196,204,1141,37234
24-09-2018,0,10940,13719,5922,3512,34095,592,180,188,960,35055
24-09-2018,1,10576,13765,5805,3705,33850,514,178,168,860,34710
24-09-2018,2,10168,13713,5753,4031,33665,517,179,164,860,34525
24-09-2018,3,10216,13848,5692,4037,33793,514,181,168,863,34656
24-09-2018,4,10924,14162,5788,3801,34676,533,185,183,901,35577
24-09-2018,5,12869,14837,6244,3615,37565,733,201,233,1167,38732
24-09-2018,6,15300,16825,6915,3464,42504,848,326,287,1461,43965
24-09-2018,7,17444,18423,7403,3631,46901,862,461,550,1873,48774
24-09-2018,8,17785,18771,7543,3522,47621,917,527,638,2082,49703
24-09-2018,9,16686,18553,7564,4379,47181,987,570,614,2171,49352
24-09-2018,10,16255,18262,7495,4586,46598,921,590,676,2187,48785
24-09-2018,11,15470,18045,7538,4283,45336,915,587,592,2094,47430
24-09-2018,12,15495,17929,7389,4276,45090,929,588,577,2094,47184
24-09-2018,13,15499,17061,7119,4496,44177,919,595,620,2134,46311
24-09-2018,14,15390,16711,6892,4678,43671,906,560,545,2011,45682
24-09-2018,15,15251,16589,6991,4713,43543,920,601,551,2072,45615
24-09-2018,16,15610,16787,7255,4937,44588,958,614,522,2094,46682
24-09-2018,17,16577,17656,7315,4484,46033,1011,611,504,2126,48159
24-09-2018,18,17010,18055,7619,3978,46664,1015,646,665,2326,48990
24-09-2018,19,17796,18435,7767,3897,47894,1034,797,800,2631,50525
24-09-2018,20,17482,17783,7436,3994,46696,1019,628,711,2358,49054
24-09-2018,21,16411,16523,7131,3949,44014,1026,616,471,2113,46127
24-09-2018,22,15112,15409,6880,3726,41127,865,568,337,1770,42897
24-09-2018,23,13768,14894,6669,3507,38837,869,539,347,1755,40592
25-09-2018,0,12859,14498,6567,3350,37275,864,383,318,1565,38840
25-09-2018,1,12947,14174,6503,3230,36857,843,369,298,1510,38367
25-09-2018,2,13163,14084,6474,2951,36672,839,365,317,1521,38193
25-09-2018,3,13527,14281,6415,2759,36981,838,369,332,1539,38520
25-09-2018,4,13757,14700,6615,2673,37746,847,378,346,1571,39317
25-09-2018,5,15405,16512,7024,2514,41456,877,404,358,1639,43095
25-09-2018,6,18056,18669,7441,2551,46719,993,429,528,1950,48669
25-09-2018,7,19236,19621,7743,2707,49308,1011,444,638,2093,51401
25-09-2018,8,19126,19910,7781,2646,49466,1010,662,701,2373,51839
25-09-2018,9,18059,19752,7644,2761,48218,1026,657,728,2411,50629
25-09-2018,10,17522,19257,7545,2949,47273,1005,651,781,2437,49710
25-09-2018,11,17307,18665,7404,3163,46540,946,652,836,2434,48974
25-09-2018,12,17265,18859,7315,3263,46704,954,670,845,2469,49173
25-09-2018,13,17268,18165,7317,3227,45978,928,627,820,2375,48353
25-09-2018,14,16703,18078,7428,3177,45387,898,604,830,2332,47719
25-09-2018,15,17006,18502,7447,3279,46235,909,602,850,2361,48596
25-09-2018,16,17158,18963,7442,3217,46780,902,592,742,2236,49016
25-09-2018,17,17239,19450,7535,3376,47601,916,743,707,2366,49967
25-09-2018,18,17578,19782,7694,3295,48351,953,747,687,2387,50738
25-09-2018,19,17647,19865,7797,3511,48820,954,990,721,2665,51485
25-09-2018,20,16684,18832,7565,3575,46657,927,752,685,2364,49021
25-09-2018,21,15829,17679,7402,3610,44521,893,590,553,2036,46557
25-09-2018,22,14356,16557,7080,3765,41760,901,551,342,1794,43554
25-09-2018,23,12602,16147,6852,3901,39503,841,558,363,1762,41265
26-09-2018,0,11504,15464,6603,4342,37912,624,211,384,1219,39131
26-09-2018,1,10777,15375,6420,4500,37071,587,210,391,1188,38259
26-09-2018,2,10574,15377,6364,4704,37019,615,210,423,1248,38267
26-09-2018,3,10386,15647,6414,4621,37067,596,206,475,1277,38344
26-09-2018,4,10411,15952,6387,4816,37565,620,221,492,1333,38898
26-09-2018,5,11362,16379,6711,4834,39288,646,254,496,1396,40684
26-09-2018,6,13957,17156,7420,5124,43658,788,295,495,1578,45236
26-09-2018,7,15506,18507,7741,4669,46424,867,476,709,2052,48476
26-09-2018,8,15575,18673,7817,4702,46768,878,788,952,2618,49386
26-09-2018,9,15555,18517,7801,4908,46781,880,324,932,2136,48917
26-09-2018,10,15540,18773,7860,5101,47275,879,282,965,2126,49401
26-09-2018,11,14939,18425,7866,5217,46447,877,298,971,2146,48593
26-09-2018,12,14544,18081,7840,5350,45815,866,301,955,2122,47937
26-09-2018,13,14494,17633,7501,5063,44690,850,287,827,1964,46654
26-09-2018,14,14100,17466,7328,4896,43790,846,294,641,1781,45571
26-09-2018,15,14521,17571,7359,4895,44346,856,312,647,1815,46161
26-09-2018,16,14891,17896,7516,4989,45293,877,329,645,1851,47144
26-09-2018,17,15346,18219,7605,4905,46072,897,320,807,2024,48096
26-09-2018,18,15804,18362,7901,4362,46430,884,361,1002,2247,48677
26-09-2018,19,16095,18354,8107,4072,46629,879,335,1003,2217,48846
26-09-2018,20,15650,17741,7411,3792,44593,796,289,944,2029,46622
26-09-2018,21,14712,17124,7235,3616,42688,775,276,641,1692,44380
26-09-2018,22,13192,16533,6923,3329,39977,707,247,639,1593,41570
26-09-2018,23,11852,16363,6770,3229,38215,663,244,633,1540,39755
27-09-2018,0,10923,16360,6767,3113,37164,670,239,635,1544,38708
27-09-2018,1,10700,16192,6836,2838,36568,671,230,623,1524,38092
27-09-2018,2,10724,16084,6921,2753,36482,668,221,604,1493,37975
27-09-2018,3,10919,16103,6962,2888,36872,661,231,619,1511,38383
27-09-2018,4,11440,16429,7057,2957,37884,666,233,609,1508,39392
27-09-2018,5,13652,16646,7357,2724,40379,700,249,593,1542,41921
27-09-2018,6,17137,17826,7882,2667,45513,845,298,576,1719,47232
27-09-2018,7,19185,18745,8216,3097,49244,883,348,837,2068,51312
27-09-2018,8,19284,18744,8358,3971,50358,895,435,898,2228,52586
27-09-2018,9,18967,18067,8312,4590,49938,892,409,919,2220,52158
27-09-2018,10,18599,17644,8307,4939,49488,901,430,951,2282,51770
27-09-2018,11,18316,17621,8163,5002,49103,901,417,931,2249,51352
27-09-2018,12,18042,17092,7972,5342,48448,883,424,928,2235,50683
27-09-2018,13,17804,16713,7686,5571,47774,845,449,778,2072,49846
27-09-2018,14,17086,16325,7507,5541,46460,828,420,611,1859,48319
27-09-2018,15,17185,16524,7436,5525,46670,841,434,571,1846,48516
27-09-2018,16,17377,16911,7796,5650,47733,890,437,603,1930,49663
27-09-2018,17,18004,16917,8099,5304,48322,882,435,465,1782,50104
27-09-2018,18,18088,16969,8200,4964,48221,887,668,861,2416,50637
27-09-2018,19,18383,17200,8250,4775,48606,903,913,951,2767,51373
27-09-2018,20,17984,16814,7699,4741,47239,827,456,969,2252,49491
27-09-2018,21,17439,16213,7079,4646,45375,800,435,637,1872,47247
27-09-2018,22,16564,15442,6673,4411,43091,756,400,629,1785,44876
27-09-2018,23,15827,14638,6288,4217,40971,648,392,635,1675,42646
28-09-2018,0,14343,14211,6137,4109,38800,728,253,639,1620,40420
28-09-2018,1,13936,13953,5983,4162,38032,641,239,641,1521,39553
28-09-2018,2,14159,14049,6008,4428,38645,598,243,639,1480,40125
28-09-2018,3,14183,14246,6073,4425,38929,612,242,639,1493,40422
28-09-2018,4,14333,14634,6417,4342,39728,664,249,637,1550,41278
28-09-2018,5,15670,15007,7053,4277,42010,847,281,631,1759,43769
28-09-2018,6,17670,17287,7823,4285,47065,966,378,615,1959,49024
28-09-2018,7,19420,18788,8246,4299,50753,1028,629,767,2424,53177
28-09-2018,8,20418,18733,8244,4344,51739,974,846,947,2767,54506
28-09-2018,9,19989,18601,8044,4591,51227,965,1094,940,2999,54226
28-09-2018,10,19085,18394,7899,4995,50375,967,1025,936,2928,53303
28-09-2018,11,18234,17711,7827,4834,48605,957,1233,885,3075,51680
28-09-2018,12,17739,17166,7779,4716,47400,960,1242,822,3024,50424
28-09-2018,13,17406,16964,7532,4217,46120,944,794,775,2513,48633
28-09-2018,14,17008,16718,7249,4332,45308,894,608,714,2216,47524
28-09-2018,15,16791,16368,7352,4372,44884,862,615,706,2183,47067
28-09-2018,16,16696,16031,7609,4359,44695,947,613,678,2238,46933
28-09-2018,17,17561,16700,7662,4311,46234,953,725,680,2358,48592
28-09-2018,18,18666,17275,7948,4353,48242,958,1010,747,2715,50957
28-09-2018,19,19329,17995,8068,4075,49468,960,1230,756,2946,52414
28-09-2018,20,19345,17544,7593,3580,48063,970,762,585,2317,50380
28-09-2018,21,18970,16922,7105,3353,46350,905,445,273,1623,47973
28-09-2018,22,18631,16153,6801,3105,44691,852,386,270,1508,46199
28-09-2018,23,18414,15482,6405,2867,43168,790,419,278,1487,44655
29-09-2018,0,18127,14466,6201,2642,41437,781,411,246,1438,42875
29-09-2018,1,17452,14007,6120,2398,39978,779,408,271,1458,41436
29-09-2018,2,17375,13891,6164,2161,39591,780,377,264,1421,41012
29-09-2018,3,17279,13887,6180,1958,39303,773,357,264,1394,40697
29-09-2018,4,17190,14117,6218,1871,39396,792,360,249,1401,40797
29-09-2018,5,17138,15032,6383,1879,40434,813,420,237,1470,41904
29-09-2018,6,16519,15844,6865,1891,41120,942,418,233,1593,42713
29-09-2018,7,16198,16225,7245,1979,41648,945,420,251,1616,43264
29-09-2018,8,16844,16401,7429,2061,42737,960,424,549,1933,44670
29-09-2018,9,17313,16623,7497,2315,43748,965,532,541,2038,45786
29-09-2018,10,17173,16602,7501,2803,44079,958,689,585,2232,46311
29-09-2018,11,15669,16280,7390,3280,42620,963,698,606,2267,44887
29-09-2018,12,14559,15986,7283,3746,41575,981,701,613,2295,43870
29-09-2018,13,14114,15639,7234,4195,41180,897,530,614,2041,43221
29-09-2018,14,13759,16085,7310,4280,41433,792,424,443,1659,43092
29-09-2018,15,14114,16591,7433,4388,42527,759,431,312,1502,44029
29-09-2018,16,14681,16867,7483,4307,43338,874,432,315,1621,44959
29-09-2018,17,15420,17286,7669,4146,44520,977,419,265,1661,46181
29-09-2018,18,16102,17343,8055,4176,45677,1032,463,653,2148,47825
29-09-2018,19,16172,17714,8040,4080,46004,1060,948,717,2725,48729
29-09-2018,20,15426,17335,7709,4034,44504,986,502,671,2159,46663
29-09-2018,21,14466,16465,7482,4050,42465,947,444,483,1874,44339
29-09-2018,22,13621,16374,7253,3768,41019,792,399,511,1702,42721
29-09-2018,23,12462,16133,7023,3782,39399,734,399,523,1656,41055
30-09-2018,0,11433,15951,7072,3911,38368,740,239,535,1514,39882
30-09-2018,1,11068,15856,6962,3919,37806,726,236,538,1500,39306
30-09-2018,2,11065,15632,6879,3878,37454,725,234,530,1489,38943
30-09-2018,3,10993,15532,6874,3711,37110,758,232,517,1507,38617
30-09-2018,4,11176,15426,6875,3597,37074,841,233,531,1605,38679
30-09-2018,5,11363,15543,6823,3528,37257,958,234,571,1763,39020
30-09-2018,6,11567,15665,6748,3274,37253,969,238,568,1775,39028
30-09-2018,7,11536,15737,6788,3112,37174,889,239,572,1700,38874
30-09-2018,8,12205,15991,6720,3286,38202,860,256,584,1700,39902
30-09-2018,9,13497,16192,6771,3242,39701,861,294,563,1718,41419
30-09-2018,10,13547,16277,6877,3414,40115,874,293,571,1738,41853
30-09-2018,11,13079,15989,6827,3729,39624,956,288,606,1850,41474
30-09-2018,12,12785,15782,6713,3707,38988,1002,283,604,1889,40877
30-09-2018,13,12528,15711,6738,3538,38516,918,278,602,1798,40314
30-09-2018,14,12828,15715,6864,3319,38725,962,291,583,1836,40561
30-09-2018,15,13121,15573,7003,2984,38683,1003,298,514,1815,40498
30-09-2018,16,14261,15933,7115,2732,40042,1096,301,402,1799,41841
30-09-2018,17,16990,16568,7169,2769,43497,1145,309,354,1808,45305
30-09-2018,18,18157,17270,7378,2831,45636,1234,307,458,1999,47635
30-09-2018,19,18204,17357,7419,2741,45722,1244,326,642,2212,47934
30-09-2018,20,17381,16828,7368,2721,44298,1185,312,493,1990,46288
30-09-2018,21,17468,16788,7282,2427,43965,1025,302,438,1765,45730
30-09-2018,22,16485,16630,7014,2292,42421,1019,261,458,1738,44159
30-09-2018,23,15363,15841,6850,2215,40268,994,232,444,1670,41938
01-10-2018,0,14921,14737,6661,1904,38223,1255,219,418,1892,40115
01-10-2018,1,15233,14326,6494,1838,37890,1228,215,410,1853,39743
01-10-2018,2,15535,14084,6479,1706,37804,1191,219,395,1805,39609
01-10-2018,3,15836,14039,6506,1755,38137,1173,224,360,1757,39894
01-10-2018,4,16256,14591,6613,1869,39330,1240,263,309,1812,41142
01-10-2018,5,17040,15832,6925,2135,41932,1426,294,288,2008,43940
01-10-2018,6,18781,17148,6981,2574,45485,1500,422,275,2197,47682
01-10-2018,7,19955,18243,7250,2908,48356,1540,758,633,2931,51287
01-10-2018,8,20218,18413,7326,3144,49101,1514,1182,660,3356,52457
01-10-2018,9,20023,17990,7331,3162,48506,1492,1192,585,3269,51775
01-10-2018,10,19853,17795,7329,3365,48343,1505,1175,582,3262,51605
01-10-2018,11,18959,17346,7301,3562,47168,1498,1141,551,3190,50358
01-10-2018,12,18348,16867,7168,3928,46312,1496,1101,593,3190,49502
01-10-2018,13,18038,16707,7031,4044,45820,1496,1125,571,3192,49012
01-10-2018,14,18396,16887,6970,3830,46083,1462,1104,571,3137,49220
01-10-2018,15,18830,17066,6926,3696,46518,1378,1053,597,3028,49546
01-10-2018,16,18633,16879,6917,3745,46174,1398,777,538,2713,48887
01-10-2018,17,18865,17279,7016,3873,47033,1373,785,531,2689,49722
01-10-2018,18,19608,17657,7208,3849,48324,1389,1022,559,2970,51294
01-10-2018,19,19747,17699,7307,4061,48815,1451,1104,563,3118,51933
01-10-2018,20,19151,17230,6874,4041,47298,1440,1049,579,3068,50366
01-10-2018,21,18606,17080,6675,3536,45897,1397,611,187,2195,48092
01-10-2018,22,18000,16745,5966,3238,43950,1372,603,172,2147,46097
01-10-2018,23,16639,15630,5550,2860,40681,1356,572,194,2122,42803
02-10-2018,0,15752,13833,5503,3081,38170,1304,218,174,1696,39866
02-10-2018,1,15014,13588,5464,3134,37201,1292,250,183,1725,38926
02-10-2018,2,14858,13534,5427,3171,36989,1311,246,190,1747,38736
02-10-2018,3,14885,13443,5569,2924,36822,1306,248,204,1758,38580
02-10-2018,4,14736,13321,5695,2878,36631,1304,299,214,1817,38448
02-10-2018,5,17101,14522,6281,3019,40922,1310,272,222,1804,42726
02-10-2018,6,18636,16785,7132,3091,45645,1314,335,447,2096,47741
02-10-2018,7,19829,18150,7306,3371,48658,1317,346,621,2284,50942
02-10-2018,8,20180,17855,7330,3814,49179,1332,904,621,2857,52036
02-10-2018,9,19968,17351,7124,4397,48840,1323,1001,443,2767,51607
02-10-2018,10,19092,17313,7104,4834,48343,1289,911,498,2698,51041
02-10-2018,11,18836,17920,7083,4705,48544,1296,783,514,2593,51137
02-10-2018,12,18309,17400,7066,4583,47357,1313,713,692,2718,50075
02-10-2018,13,17830,17079,7043,5072,47025,1319,443,679,2441,49466
02-10-2018,14,17983,17222,6899,4991,47095,1308,323,713,2344,49439
02-10-2018,15,17794,17398,6945,4945,47081,1290,283,612,2185,49266
02-10-2018,16,17788,17264,7048,4826,46926,1326,255,595,2176,49102
02-10-2018,17,17999,17717,7227,4957,47901,1373,264,573,2210,50111
02-10-2018,18,18871,17588,7468,4697,48624,1367,399,597,2363,50987
02-10-2018,19,19060,17329,7414,4825,48628,1378,325,636,2339,50967
02-10-2018,20,18383,16858,6736,5401,47378,1350,277,535,2162,49540
02-10-2018,21,16956,16643,6412,5409,45419,1365,238,584,2187,47606
02-10-2018,22,15545,15841,6130,4541,42058,1349,240,580,2169,44227
02-10-2018,23,14399,15384,5837,4141,39760,1351,234,588,2173,41933
03-10-2018,0,13301,15117,5859,4111,38389,1096,224,553,1873,40262
03-10-2018,1,12483,15064,5957,4048,37552,1065,219,530,1814,39366
03-10-2018,2,12291,14897,5905,3837,36931,1078,211,548,1837,38768
03-10-2018,3,12142,14946,5922,3652,36663,1087,207,476,1770,38433
03-10-2018,4,12480,15156,6236,3438,37310,1148,255,389,1792,39102
03-10-2018,5,13318,15831,6700,3352,39202,1311,248,499,2058,41260
03-10-2018,6,16238,17326,7216,3388,44168,1301,272,644,2217,46385
03-10-2018,7,18300,17887,7613,3707,47507,1295,332,635,2262,49769
03-10-2018,8,19238,17964,7864,3903,48968,1258,340,705,2303,51271
03-10-2018,9,19297,17802,7742,3924,48763,1223,352,693,2268,51031
03-10-2018,10,19155,17641,7659,4170,48626,1217,327,820,2364,50990
03-10-2018,11,18756,17290,7605,4264,47914,1220,308,674,2202,50116
03-10-2018,12,18333,17209,7599,4110,47250,1201,329,645,2175,49425
03-10-2018,13,17950,17013,7510,4137,46610,1200,333,572,2105,48715
03-10-2018,14,17650,16911,7357,4036,45955,1214,351,534,2099,48054
03-10-2018,15,17414,16871,7248,3934,45468,1224,321,549,2094,47562
03-10-2018,16,17399,16994,7375,3833,45601,1270,402,593,2265,47866
03-10-2018,17,18356,17385,7556,4016,47316,1217,413,798,2428,49744
03-10-2018,18,19487,18962,7886,3955,50288,1243,395,820,2458,52746
03-10-2018,19,19971,19642,7931,4347,51890,1271,408,833,2512,54402
03-10-2018,20,19253,18553,7654,4229,49689,1282,411,633,2326,52015
03-10-2018,21,18532,17717,7362,3815,47426,1268,391,655,2314,49740
03-10-2018,22,17196,16572,6984,3411,44163,1275,293,572,2140,46303
03-10-2018,23,16033,16003,6755,2951,41742,1287,233,506,2026,43768
04-10-2018,0,16450,15096,6588,2826,40960,1261,227,467,1955,42915
04-10-2018,1,15911,14758,6480,2336,39487,1230,227,489,1946,41433
04-10-2018,2,15942,14730,6487,2034,39193,1212,255,452,1919,41112
04-10-2018,3,16745,14782,6478,1899,39904,1213,240,471,1924,41828
04-10-2018,4,17147,14876,6820,1834,40676,1238,290,368,1896,42572
04-10-2018,5,17980,16112,7350,1971,43412,1281,374,316,1971,45383
04-10-2018,6,19858,18092,7852,2344,48147,1342,497,356,2195,50342
04-10-2018,7,20280,18096,7963,2624,48962,1342,1058,816,3216,52178
04-10-2018,8,20812,18061,7906,2326,49105,1409,1070,762,3241,52346
04-10-2018,9,20653,18023,7806,2416,48899,1419,1087,734,3240,52139
04-10-2018,10,20356,17321,7657,2788,48122,1405,1100,672,3177,51299
04-10-2018,11,19811,17199,7620,3086,47716,1406,1099,695,3200,50916
04-10-2018,12,20022,16878,7571,3084,47554,1412,954,782,3148,50702
04-10-2018,13,19882,16556,7449,3565,47453,1412,921,770,3103,50556
04-10-2018,14,19689,16207,7227,3990,47113,1398,920,737,3055,50168
04-10-2018,15,19326,16817,7337,4097,47577,1368,699,688,2755,50332
04-10-2018,16,19729,17184,7643,4107,48663,1351,702,681,2734,51397
04-10-2018,17,19388,17586,7771,4110,48856,1356,1032,683,3071,51927
04-10-2018,18,19477,18499,7985,4091,50054,1365,1077,682,3124,53178
04-10-2018,19,19767,18618,7950,4045,50380,1374,1040,674,3088,53468
04-10-2018,20,19143,17716,7598,4139,48598,1361,889,642,2892,51490
04-10-2018,21,18297,16747,7477,4338,46861,1353,588,230,2171,49032
04-10-2018,22,17412,16084,7280,4126,44903,1335,368,247,1950,46853
04-10-2018,23,15736,15697,7052,3856,42343,1299,365,298,1962,44305
05-10-2018,0,15072,14927,7092,3743,40834,1063,365,320,1748,42582
05-10-2018,1,13781,14379,7136,3194,38492,990,367,312,1669,40161
05-10-2018,2,13239,14402,7130,3063,37835,1053,372,343,1768,39603
05-10-2018,3,13036,14532,7180,3186,37934,1097,378,363,1838,39772
05-10-2018,4,13522,14987,7326,3101,38936,1127,381,409,1917,40853
05-10-2018,5,15280,16086,7624,2756,41746,1253,407,439,2099,43845
05-10-2018,6,17546,17775,8018,2899,46236,1332,542,493,2367,48603
05-10-2018,7,19303,18576,8315,3153,49348,1358,972,611,2941,52289
05-10-2018,8,19610,18398,8570,3346,49922,1368,1113,806,3287,53209
05-10-2018,9,19931,18672,8444,3344,50391,1367,1073,831,3271,53662
05-10-2018,10,19477,18904,8301,3265,49945,1376,935,861,3172,53117
05-10-2018,11,19099,18443,8199,3077,48817,1381,1007,736,3124,51941
05-10-2018,12,18560,17644,8066,3013,47283,1360,1087,723,3170,50453
05-10-2018,13,19022,17745,8001,3342,48110,1367,1042,674,3083,51193
05-10-2018,14,18192,17144,7796,3133,46265,1367,993,676,3036,49301
05-10-2018,15,18333,17298,7737,3255,46624,1326,952,678,2956,49580
05-10-2018,16,18497,18069,7744,3264,47574,1320,928,648,2896,50470
05-10-2018,17,18350,18088,7840,3234,47511,1322,949,626,2897,50408
05-10-2018,18,18637,18336,8119,3128,48220,1319,979,748,3046,51266
05-10-2018,19,18586,18282,8068,3013,47949,1298,923,677,2898,50847
05-10-2018,20,18047,17029,7806,2846,45729,1264,734,531,2529,48258
05-10-2018,21,17696,16723,7875,2773,45068,1257,467,373,2097,47165
05-10-2018,22,17078,15822,7704,2587,43191,1260,397,368,2025,45216
05-10-2018,23,15817,15168,7512,2324,40822,1267,382,432,2081,42903
06-10-2018,0,15976,14512,7377,2005,39871,1174,239,467,1880,41751
06-10-2018,1,15345,14139,7317,1678,38480,1149,248,468,1865,40345
06-10-2018,2,15397,13995,7258,1410,38062,1138,245,444,1827,39889
06-10-2018,3,15606,13788,7237,1345,37974,1097,240,427,1764,39738
06-10-2018,4,16113,13663,7296,1336,38408,1115,234,402,1751,40159
06-10-2018,5,16454,13824,7491,1351,39120,1154,237,393,1784,40904
06-10-2018,6,17108,14358,7442,1616,40525,1094,274,413,1781,42306
06-10-2018,7,18065,14986,7400,1810,42263,1133,314,426,1873,44136
06-10-2018,8,18825,15485,7347,1943,43601,1232,317,541,2090,45691
06-10-2018,9,19558,16036,7449,1929,44973,1197,313,706,2216,47189
06-10-2018,10,19738,15972,7644,2005,45359,1193,313,661,2167,47526
06-10-2018,11,19518,15562,7607,2061,44748,1184,443,674,2301,47049
06-10-2018,12,19495,15414,7504,2165,44578,1190,305,587,2082,46660
06-10-2018,13,19492,15199,7420,2132,44242,1186,308,514,2008,46250
06-10-2018,14,19583,15011,7422,2012,44029,1174,308,360,1842,45871
06-10-2018,15,19643,15038,7574,2167,44422,1155,301,320,1776,46198
06-10-2018,16,19648,15291,7616,2401,44954,1136,296,302,1734,46688
06-10-2018,17,20099,16070,7681,2671,46522,1152,288,518,1958,48480
06-10-2018,18,20151,16890,7637,2858,47537,1130,285,528,1943,49480
06-10-2018,19,20028,16655,7498,2943,47124,1132,387,543,2062,49186
06-10-2018,20,19342,15997,7424,2821,45584,1116,287,504,1907,47491
06-10-2018,21,19142,15339,7233,2515,44230,1083,253,407,1743,45973
06-10-2018,22,18227,14824,7042,2299,42393,1076,217,399,1692,44085
06-10-2018,23,17348,13568,6720,1890,39528,1067,214,384,1665,41193
07-10-2018,0,17343,12642,6449,2151,38585,951,210,330,1491,40076
07-10-2018,1,16452,12127,6257,2240,37076,937,208,288,1433,38509
07-10-2018,2,15816,12049,6244,2480,36590,934,207,252,1393,37983
07-10-2018,3,14562,12048,6113,2555,35277,934,208,236,1378,36655
07-10-2018,4,14173,12140,6022,2714,35050,937,208,225,1370,36420
07-10-2018,5,15086,12297,6107,2676,36167,951,212,228,1391,37558
07-10-2018,6,16014,12941,6252,2646,37853,956,215,237,1408,39261
07-10-2018,7,17422,13897,6491,2645,40457,965,229,234,1428,41885
07-10-2018,8,19279,14837,6609,2455,43179,1079,279,220,1578,44757
07-10-2018,9,19990,15668,6781,2505,44945,1133,282,205,1620,46565
07-10-2018,10,19954,15812,6908,2519,45192,1124,289,201,1614,46806
07-10-2018,11,19391,15915,6959,2557,44824,1142,298,201,1641,46465
07-10-2018,12,19272,15576,6843,2360,44051,1144,322,203,1669,45720
07-10-2018,13,18828,15002,6652,2175,42657,1135,311,310,1756,44413
07-10-2018,14,18944,14570,6600,2055,42170,1114,312,410,1836,44006
07-10-2018,15,19270,14619,6750,2011,42651,1129,307,391,1827,44478
07-10-2018,16,19271,15146,6926,1988,43332,1091,303,436,1830,45162
07-10-2018,17,19522,16253,7315,1942,45031,1096,296,472,1864,46895
07-10-2018,18,20396,17005,7571,2221,47192,1116,308,847,2271,49463
07-10-2018,19,20413,17168,7595,2339,47515,1116,518,818,2452,49967
07-10-2018,20,19985,16433,7511,2486,46414,1099,308,727,2134,48548
07-10-2018,21,19464,15925,7228,2402,45021,1102,286,516,1904,46925
07-10-2018,22,19004,14993,6922,2611,43531,1094,228,267,1589,45120
07-10-2018,23,18184,14527,6599,2715,42024,1014,256,236,1506,43530
08-10-2018,0,17486,13875,6610,2785,40756,884,224,214,1322,42078
08-10-2018,1,16479,13648,6482,3046,39657,844,224,216,1284,40941
08-10-2018,2,15709,13818,6553,3447,39529,849,226,211,1286,40815
08-10-2018,3,14835,14196,6674,3762,39467,834,254,200,1288,40755
08-10-2018,4,14972,14821,7040,3666,40499,854,265,191,1310,41809
08-10-2018,5,16027,15734,7549,3785,43095,886,374,186,1446,44541
08-10-2018,6,18205,17287,8297,3860,47649,1023,508,190,1721,49370
08-10-2018,7,19068,18645,8430,4154,50298,951,812,567,2330,52628
08-10-2018,8,19262,19018,8442,4343,51065,932,1342,572,2846,53911
08-10-2018,9,19122,19211,8319,4560,51212,911,1181,575,2667,53879
08-10-2018,10,19270,19336,8263,4755,51625,904,879,610,2393,54018
08-10-2018,11,18959,19198,8156,4941,51254,967,1078,528,2573,53827
08-10-2018,12,18496,18972,8163,5102,50734,986,1093,564,2643,53377
08-10-2018,13,18718,18767,8121,4837,50444,976,932,569,2477,52921
08-10-2018,14,18611,18563,8124,4697,49996,983,813,594,2390,52386
08-10-2018,15,18709,18600,8206,4351,49866,1001,690,634,2325,52191
08-10-2018,16,18759,18291,8200,4265,49515,1133,687,613,2433,51948
08-10-2018,17,19225,18560,8181,4180,50147,1137,865,623,2625,52772
08-10-2018,18,19769,18768,8144,3965,50648,1154,1258,647,3059,53707
08-10-2018,19,19796,18594,7974,3991,50356,1107,1227,682,3016,53372
08-10-2018,20,18763,17428,7669,3828,47689,1059,961,659,2679,50368
08-10-2018,21,18260,16314,7476,3628,45679,1020,665,390,2075,47754
08-10-2018,22,17329,15399,7143,3600,43472,1013,641,398,2052,45524
08-10-2018,23,15629,14534,6750,3881,40793,1008,586,410,2004,42797
09-10-2018,0,14897,14241,6616,3077,38831,1013,665,401,2079,40910
09-10-2018,1,14502,14065,6542,3036,38147,1007,580,391,1978,40125
09-10-2018,2,14353,13828,6457,2705,37344,1004,583,366,1953,39297
09-10-2018,3,14493,13735,6523,2634,37385,967,584,361,1912,39297
09-10-2018,4,14655,14094,6713,2465,37929,991,664,345,2000,39929
09-10-2018,5,16119,14752,7074,2628,40574,1042,675,357,2074,42648
09-10-2018,6,18026,16537,7366,2826,44755,1105,741,357,2203,46958
09-10-2018,7,19010,17392,7525,3408,47334,1168,879,673,2720,50054
09-10-2018,8,19215,17949,7771,3646,48582,1215,1300,680,3195,51777
09-10-2018,9,19034,18102,7594,3977,48709,1082,1223,664,2969,51678
09-10-2018,10,18788,18143,7603,4171,48704,1071,1101,719,2891,51595
09-10-2018,11,18390,18388,7526,4464,48768,1065,999,732,2796,51564
09-10-2018,12,17878,17728,7613,4864,48084,1051,997,736,2784,50868
09-10-2018,13,17943,18006,7702,4728,48380,986,1023,724,2733,51113
09-10-2018,14,17948,17903,7757,4662,48271,993,931,537,2461,50732
09-10-2018,15,17531,17810,7773,4538,47654,1009,895,347,2251,49905
09-10-2018,16,17604,17634,7703,4199,47141,1069,822,326,2217,49358
09-10-2018,17,18097,17836,7759,4646,48339,1066,949,641,2656,50995
09-10-2018,18,18698,18011,7893,4384,48986,1125,1128,700,2953,51939
09-10-2018,19,18731,17656,7834,4037,48259,1150,1074,749,2973,51232
09-10-2018,20,18051,16136,7590,3638,45415,1026,967,600,2593,48008
09-10-2018,21,17565,15477,7294,3597,43933,949,660,492,2101,46034
09-10-2018,22,16492,15119,7016,3380,42008,908,602,482,1992,44000
09-10-2018,23,15345,14592,6805,2975,39715,904,594,450,1948,41663
10-10-2018,0,14987,14470,6775,2918,39149,949,663,417,2029,41178
10-10-2018,1,14481,14222,6684,2658,38045,956,592,377,1925,39970
10-10-2018,2,14226,14106,6639,2351,37320,985,586,366,1937,39257
10-10-2018,3,14628,14155,6712,2131,37628,969,618,376,1963,39591
10-10-2018,4,15302,14545,6881,2047,38776,983,646,390,2019,40795
10-10-2018,5,16507,15166,7165,2235,41075,1105,655,366,2126,43201
10-10-2018,6,18325,17069,7380,2540,45315,1168,669,366,2203,47518
10-10-2018,7,19244,18073,7527,2658,47503,1200,1214,704,3118,50621
10-10-2018,8,19488,17843,7549,2483,47364,1242,1340,660,3242,50606
10-10-2018,9,19703,17921,7640,2505,47772,1061,1267,631,2959,50731
10-10-2018,10,19721,17556,7715,2569,47561,1019,1205,643,2867,50428
10-10-2018,11,19574,17243,7628,2467,46912,1002,1199,645,2846,49758
10-10-2018,12,19528,16757,7526,2249,46059,1053,1193,649,2895,48954
10-10-2018,13,19424,16475,7385,2205,45489,1048,1189,645,2882,48371
10-10-2018,14,19458,16558,7349,2198,45563,974,1067,588,2629,48192
10-10-2018,15,19262,16826,7435,2270,45795,952,1038,270,2260,48055
10-10-2018,16,18917,17022,7495,2138,45573,949,982,221,2152,47725
10-10-2018,17,19078,17064,7547,2333,46020,1014,859,271,2144,48164
10-10-2018,18,19299,17819,7787,2319,47224,1016,1250,565,2831,50055
10-10-2018,19,19207,17591,7593,2701,47090,1024,1192,543,2759,49849
10-10-2018,20,18928,15802,7207,2671,44607,1019,891,355,2265,46872
10-10-2018,21,18609,14457,7022,2764,42852,971,627,183,1781,44633
10-10-2018,22,17201,13783,6852,2692,40527,970,586,184,1740,42267
10-10-2018,23,15621,12628,6455,2971,37676,891,550,182,1623,39299
11-10-2018,0,14240,12423,6186,3222,36072,824,546,179,1549,37621
11-10-2018,1,13677,12340,6153,3263,35434,820,546,184,1550,36984
11-10-2018,2,12932,12201,6158,3428,34720,713,546,198,1457,36177
11-10-2018,3,13306,12074,6161,3427,34969,698,555,209,1462,36431
11-10-2018,4,14558,12504,6381,2992,36435,809,581,230,1620,38055
11-10-2018,5,15870,13390,6931,3104,39296,927,607,264,1798,41094
11-10-2018,6,17811,15447,7573,3212,44043,962,635,300,1897,45940
11-10-2018,7,19364,16955,7659,3799,47778,945,829,354,2128,49906
11-10-2018,8,19620,17411,7743,3320,48095,903,1162,696,2761,50856
11-10-2018,9,19460,17397,7551,3105,47514,913,1199,651,2763,50277
11-10-2018,10,19164,16868,7449,3390,46871,973,1196,633,2802,49673
11-10-2018,11,18651,16515,7484,3633,46284,998,1191,430,2619,48903
11-10-2018,12,18280,16567,7398,3629,45874,973,1192,440,2605,48479
11-10-2018,13,18274,16356,7342,3506,45479,981,1303,260,2544,48023
11-10-2018,14,18125,16939,7290,3510,45863,993,1193,272,2458,48321
11-10-2018,15,18057,16954,7438,3849,46298,982,1040,276,2298,48596
11-10-2018,16,18687,16903,7454,3540,46583,981,837,276,2094,48677
11-10-2018,17,19290,17368,7806,3452,47915,1018,855,317,2190,50105
11-10-2018,18,19230,17736,8038,3645,48648,988,1234,582,2804,51452
11-10-2018,19,19427,17379,7778,3461,48046,980,1298,631,2909,50955
11-10-2018,20,19316,16852,7443,3255,46865,908,738,473,2119,48984
11-10-2018,21,18888,15688,7072,3174,44824,933,632,425,1990,46814
11-10-2018,22,17697,14583,6720,3160,42159,971,644,420,2035,44194
11-10-2018,23,15786,13672,6553,2610,38621,956,548,408,1912,40533
12-10-2018,0,14924,13345,6491,3011,37770,929,573,406,1908,39678
12-10-2018,1,14457,13596,6330,3030,37413,944,569,410,1923,39336
12-10-2018,2,14393,13553,6312,2866,37125,947,565,388,1900,39025
12-10-2018,3,14707,13581,6390,2837,37515,917,567,392,1876,39391
12-10-2018,4,15189,13762,6528,2457,37937,954,564,376,1894,39831
12-10-2018,5,17049,14925,6973,2517,41464,1049,575,366,1990,43454
12-10-2018,6,18233,16960,7411,3034,45639,1143,644,351,2138,47777
12-10-2018,7,19309,18185,7462,2628,47584,1148,796,714,2658,50242
12-10-2018,8,19722,18321,7512,2496,48050,1121,1336,706,3163,51213
12-10-2018,9,19679,17832,7407,2599,47517,1112,838,679,2629,50146
12-10-2018,10,19590,17834,7473,2975,47874,1138,820,669,2627,50501
12-10-2018,11,19403,17440,7445,3124,47412,1111,620,627,2358,49770
12-10-2018,12,19118,16928,7397,3243,46686,1098,616,569,2283,48969
12-10-2018,13,19088,16397,7375,3148,46008,1084,610,499,2193,48201
12-10-2018,14,18865,16395,7226,3059,45545,1080,608,498,2186,47731
12-10-2018,15,18558,16456,7068,2980,45062,1104,611,438,2153,47215
12-10-2018,16,18595,16609,7159,2730,45095,1156,612,255,2023,47118
12-10-2018,17,18928,17076,7522,3239,46765,1182,628,674,2484,49249
12-10-2018,18,19049,17950,7860,3239,48097,1209,837,751,2797,50894
12-10-2018,19,18823,17393,7573,3422,47211,1195,1311,511,3017,50228
12-10-2018,20,17659,16553,7228,3349,44789,1084,729,484,2297,47086
12-10-2018,21,17188,15449,7048,3334,43018,971,630,346,1947,44965
12-10-2018,22,15879,14924,6878,3549,41231,934,630,319,1883,43114
12-10-2018,23,14555,14024,6540,3583,38701,932,505,303,1740,40441
13-10-2018,0,14173,13887,6381,3031,37470,861,301,276,1438,38908
13-10-2018,1,13681,13852,6225,2966,36725,686,224,286,1196,37921
13-10-2018,2,13179,14009,6179,3049,36417,658,220,289,1167,37584
13-10-2018,3,12879,14161,6126,3251,36418,669,217,289,1175,37593
13-10-2018,4,13158,14347,6132,3423,37061,643,225,279,1147,38208
13-10-2018,5,13879,14507,6094,3402,37884,658,266,258,1182,39066
13-10-2018,6,14366,14950,6217,3420,38954,777,299,225,1301,40255
13-10-2018,7,15084,15388,6303,3454,40230,840,305,215,1360,41590
13-10-2018,8,15967,15584,6536,3466,41553,869,303,218,1390,42943
13-10-2018,9,16585,15967,6710,3484,42746,912,368,386,1666,44412
13-10-2018,10,16909,16318,6775,3562,43564,913,348,372,1633,45197
13-10-2018,11,16855,16245,6775,3757,43631,900,331,381,1612,45243
13-10-2018,12,15761,16282,6806,3741,42591,843,323,355,1521,44112
13-10-2018,13,15244,16329,6844,3670,42089,808,263,349,1420,43509
13-10-2018,14,15200,16118,6867,3628,41813,818,254,192,1264,43077
13-10-2018,15,15433,16302,6939,3588,42261,796,248,199,1243,43504
13-10-2018,16,15960,16541,7020,3432,42953,791,199,186,1176,44129
13-10-2018,17,16893,16801,7264,3118,44076,846,248,363,1457,45533
13-10-2018,18,17354,16929,7259,3335,44876,901,262,582,1745,46621
13-10-2018,19,16665,16895,7023,3400,43984,916,276,654,1846,45830
13-10-2018,20,15331,16621,6838,3288,42079,861,257,361,1479,43558
13-10-2018,21,14252,16176,6767,3374,40568,691,222,381,1294,41862
13-10-2018,22,13414,15647,6529,2816,38407,690,207,384,1281,39688
13-10-2018,23,12516,15394,6331,2616,36858,690,178,388,1256,38114
14-10-2018,0,12254,15120,6368,2704,36447,674,174,353,1201,37648
14-10-2018,1,11854,15077,6380,2782,36095,696,213,343,1252,37347
14-10-2018,2,11348,15023,6378,2751,35500,696,164,304,1164,36664
14-10-2018,3,11188,15085,6423,2572,35269,683,163,253,1099,36368
14-10-2018,4,11658,15136,6466,2445,35705,682,166,244,1092,36797
14-10-2018,5,12085,15126,6459,2780,36451,671,216,252,1139,37590
14-10-2018,6,11899,15150,6475,3025,36550,684,205,256,1145,37695
14-10-2018,7,12797,15447,6476,3082,37803,684,219,283,1186,38989
14-10-2018,8,13444,15391,6581,2874,38290,667,194,315,1176,39466
14-10-2018,9,13565,15362,6637,2849,38414,644,172,306,1122,39536
14-10-2018,10,14279,15571,6705,3098,39654,632,247,270,1149,40803
14-10-2018,11,14620,15418,6647,3053,39738,626,189,276,1091,40829
14-10-2018,12,14031,15232,6545,3112,38919,624,158,311,1093,40012
14-10-2018,13,13440,15297,6577,3186,38501,623,153,286,1062,39563
14-10-2018,14,13748,15415,6691,3113,38966,632,152,285,1069,40035
14-10-2018,15,13996,15622,6731,2920,39271,619,174,263,1056,40327
14-10-2018,16,14073,15938,6851,3114,39976,659,154,270,1083,41059
14-10-2018,17,15369,16958,7183,3019,42530,847,195,336,1378,43908
14-10-2018,18,15914,17418,7385,3494,44213,850,175,432,1457,45670
14-10-2018,19,15340,17432,7370,3849,43991,821,182,480,1483,45474
14-10-2018,20,14316,17443,7251,3622,42633,763,181,498,1442,44075
14-10-2018,21,14095,17146,7073,3357,41672,744,207,506,1457,43129
14-10-2018,22,13460,16422,6930,3074,39886,731,239,481,1451,41337
14-10-2018,23,12395,15729,6706,2832,37664,724,238,423,1385,39049
15-10-2018,0,12021,15166,6702,2307,36196,716,172,412,1300,37496
15-10-2018,1,12360,15039,6749,2256,36404,721,169,379,1269,37673
15-10-2018,2,13022,14892,6718,2008,36640,708,165,358,1231,37871
15-10-2018,3,13791,14665,6730,1841,37028,705,170,330,1205,38233
15-10-2018,4,14380,14826,6790,1737,37734,691,171,319,1181,38915
15-10-2018,5,15933,15623,7310,1821,40687,893,178,336,1407,42094
15-10-2018,6,16512,17157,7595,2509,43776,1055,312,361,1728,45504
15-10-2018,7,17784,18505,8026,2694,47008,1059,704,552,2315,49323
15-10-2018,8,18544,18648,7905,2968,48066,1022,821,728,2571,50637
15-10-2018,9,18674,18571,7719,2961,47927,990,821,640,2451,50378
15-10-2018,10,18583,18597,7673,2872,47726,981,471,572,2024,49750
15-10-2018,11,18601,18417,7540,2459,47017,1029,359,558,1946,48963
15-10-2018,12,18485,18080,7345,2466,46376,1033,435,574,2042,48418
15-10-2018,13,18456,18057,7180,2486,46179,1025,467,552,2044,48223
15-10-2018,14,18611,18159,7155,2364,46290,1036,401,576,2013,48303
15-10-2018,15,18723,18164,7102,2563,46551,1022,386,577,1985,48536
15-10-2018,16,18346,18142,7203,2872,46564,1028,383,612,2023,48587
15-10-2018,17,18405,18199,7558,2901,47064,1060,783,694,2537,49601
15-10-2018,18,18325,18580,7810,3089,47804,1079,941,776,2796,50600
15-10-2018,19,18524,18550,7491,3066,47631,1074,1039,864,2977,50608
15-10-2018,20,18247,17606,6950,2862,45665,1031,792,653,2476,48141
15-10-2018,21,18099,16556,6751,2498,43904,1000,381,451,1832,45736
15-10-2018,22,17584,15962,6472,2328,42347,992,383,418,1793,44140
15-10-2018,23,16761,15026,6160,2257,40203,1012,374,362,1748,41951
16-10-2018,0,16596,14001,6051,2205,38854,1006,333,327,1666,40520
16-10-2018,1,16372,13608,5959,1924,37864,1026,329,325,1680,39544
16-10-2018,2,16561,13555,5872,1975,37964,1016,327,341,1684,39648
16-10-2018,3,16544,13695,5960,1812,38008,1031,326,323,1680,39688
16-10-2018,4,16670,14093,6188,2010,38961,1041,373,304,1718,40679
16-10-2018,5,16909,15071,6670,2109,40759,1081,429,312,1822,42581
16-10-2018,6,17874,16890,7169,2414,44347,1099,671,306,2076,46423
16-10-2018,7,19516,18034,7418,2758,47727,1088,1091,487,2666,50393
16-10-2018,8,19833,18170,7493,2616,48112,1067,1232,636,2935,51047
16-10-2018,9,19648,18083,7467,2650,47849,1031,1221,598,2850,50699
16-10-2018,10,19663,18094,7436,2667,47860,1015,1194,556,2765,50625
16-10-2018,11,19460,18136,7342,2682,47621,1000,1154,553,2707,50328
16-10-2018,12,19422,18063,7281,2712,47477,1000,956,375,2331,49808
16-10-2018,13,19655,17935,7167,2756,47513,980,805,369,2154,49667
16-10-2018,14,19230,17505,7183,2696,46615,947,770,174,1891,48506
16-10-2018,15,19335,17867,7134,2784,47120,952,775,537,2264,49384
16-10-2018,16,19328,17921,7179,2786,47216,974,940,528,2442,49658
16-10-2018,17,19018,18266,7544,2867,47694,976,1120,555,2651,50345
16-10-2018,18,19313,18567,7921,3131,48932,964,1172,644,2780,51712
16-10-2018,19,19149,18545,7670,3136,48499,952,1142,699,2793,51292
16-10-2018,20,18430,17682,6996,2808,45918,932,1091,501,2524,48442
16-10-2018,21,18359,16948,6734,2608,44649,894,593,303,1790,46439
16-10-2018,22,17929,16140,6594,2419,43084,887,584,261,1732,44816
16-10-2018,23,17134,14991,6274,2374,40773,896,561,218,1675,42448
17-10-2018,0,16934,14295,6052,2284,39565,957,557,214,1728,41293
17-10-2018,1,16424,14050,5958,2143,38575,985,556,209,1750,40325
17-10-2018,2,15994,13822,5974,2145,37934,1000,557,197,1754,39688
17-10-2018,3,16076,14066,6096,2149,38387,1010,559,172,1741,40128
17-10-2018,4,15771,14621,6378,2210,38980,1024,563,176,1763,40743
17-10-2018,5,16037,15648,6923,2432,41041,1046,607,165,1818,42859
17-10-2018,6,17079,16988,7688,2908,44663,1120,814,247,2181,46844
17-10-2018,7,18627,18208,7843,3166,47843,1143,1187,415,2745,50588
17-10-2018,8,19184,18396,7884,3369,48834,1156,1222,577,2955,51789
17-10-2018,9,19266,18340,7843,3523,48972,1152,1219,545,2916,51888
17-10-2018,10,19188,17952,7906,3355,48401,1166,1188,522,2876,51277
17-10-2018,11,19163,17928,7873,3308,48272,1160,1123,368,2651,50923
17-10-2018,12,18910,18039,7720,3145,47815,1167,642,345,2154,49969
17-10-2018,13,18825,17709,7610,3131,47278,1174,724,199,2097,49375
17-10-2018,14,19024,17566,7621,2808,47020,1172,611,163,1946,48966
17-10-2018,15,18675,17581,7639,2637,46531,1172,739,158,2069,48600
17-10-2018,16,18442,17533,7940,2391,46306,1197,833,153,2183,48489
17-10-2018,17,18681,17906,8220,2365,47172,1223,875,517,2615,49787
17-10-2018,18,19176,18258,8542,2469,48446,1239,956,610,2805,51251
17-10-2018,19,18676,18188,8234,2485,47583,1242,917,633,2792,50375
17-10-2018,20,18012,17339,7407,2307,45066,1222,802,400,2424,47490
17-10-2018,21,17810,16632,6919,2033,43394,1186,615,250,2051,45445
17-10-2018,22,17481,15923,6538,1703,41646,1197,570,259,2026,43672
17-10-2018,23,16859,15182,6425,1469,39936,1167,559,257,1983,41919
18-10-2018,0,16358,14572,6395,1622,38946,960,549,258,1767,40713
18-10-2018,1,16102,14155,6289,1698,38243,934,560,243,1737,39980
18-10-2018,2,15855,14053,6257,1918,38084,1072,557,213,1842,39926
18-10-2018,3,16168,14053,6282,1931,38436,1091,562,199,1852,40288
18-10-2018,4,16570,14420,6416,2086,39492,1104,559,193,1856,41348
18-10-2018,5,17153,15831,6812,2204,41999,1166,574,188,1928,43927
18-10-2018,6,18141,17561,7498,2668,45867,1222,587,192,2001,47868
18-10-2018,7,19306,18809,7890,3075,49081,1242,972,598,2812,51893
18-10-2018,8,19729,18961,7926,3266,49883,1233,1064,615,2912,52795
18-10-2018,9,19582,18731,7844,3454,49612,1215,1007,631,2853,52465
18-10-2018,10,19607,18808,7741,3762,49918,1205,920,555,2680,52598
18-10-2018,11,19051,18587,7879,4057,49574,1205,557,563,2325,51899
18-10-2018,12,18849,18448,7864,3999,49159,1191,538,364,2093,51252
18-10-2018,13,18811,18202,7728,3797,48538,1187,529,181,1897,50435
18-10-2018,14,18367,18199,7783,3908,48258,1189,523,241,1953,50211
18-10-2018,15,17791,18408,7877,3849,47926,1170,518,262,1950,49876
18-10-2018,16,18144,18230,7867,3759,47999,1163,519,258,1940,49939
18-10-2018,17,19000,18708,8142,3389,49240,1167,760,540,2467,51707
18-10-2018,18,19385,19221,8458,3317,50381,1169,910,569,2648,53029
18-10-2018,19,19371,18887,8141,3214,49613,1180,915,564,2659,52272
18-10-2018,20,18926,18173,7831,2904,47835,1154,839,533,2526,50361
18-10-2018,21,18617,17655,7561,2463,46297,1095,538,176,1809,48106
18-10-2018,22,18161,16899,7390,2181,44630,1072,535,222,1829,46459
18-10-2018,23,17307,16212,7338,2107,42964,1081,551,164,1796,44760
19-10-2018,0,16814,15423,7342,1667,41246,1078,379,163,1620,42866
19-10-2018,1,16466,15117,7351,1733,40667,1066,370,175,1611,42278
19-10-2018,2,16214,14995,7463,1681,40354,1044,379,173,1596,41950
19-10-2018,3,16247,15115,7600,1712,40674,1044,389,173,1606,42280
19-10-2018,4,16647,15347,7714,1754,41465,1049,392,168,1609,43074
19-10-2018,5,17597,16373,7951,1821,43743,1097,397,164,1658,45401
19-10-2018,6,18950,18422,8281,2056,47710,1151,710,175,2036,49746
19-10-2018,7,20370,19867,8459,2278,50975,1166,967,586,2719,53694
19-10-2018,8,20699,20084,8399,2486,51669,1159,991,576,2726,54395
19-10-2018,9,20589,19897,8343,2504,51334,1154,982,569,2705,54039
19-10-2018,10,20559,19583,8183,2763,51089,1152,965,548,2665,53754
19-10-2018,11,20142,19302,8085,2838,50368,1115,916,535,2566,52934
19-10-2018,12,19524,18981,7992,2732,49230,1125,824,531,2480,51710
19-10-2018,13,19347,18545,7861,2628,48381,1178,564,275,2017,50398
19-10-2018,14,19330,18310,7639,2469,47749,1186,589,130,1905,49654
19-10-2018,15,19303,18107,7768,2568,47746,1147,560,130,1837,49583
19-10-2018,16,19194,18165,7883,2493,47736,1163,774,138,2075,49811
19-10-2018,17,19571,18583,8161,2678,48995,1165,865,557,2587,51582
19-10-2018,18,20051,18750,8348,2601,49750,1167,925,577,2669,52419
19-10-2018,19,19733,18793,8138,2592,49257,1177,910,565,2652,51909
19-10-2018,20,19173,18078,7361,2579,47192,1143,832,538,2513,49705
19-10-2018,21,18965,17437,7053,2479,45934,1132,391,133,1656,47590
19-10-2018,22,18611,16948,6907,2463,44930,1112,380,131,1623,46553
19-10-2018,23,17919,16055,6785,2544,43304,1120,404,130,1654,44958
20-10-2018,0,17772,15119,6760,2292,41944,1090,276,130,1496,43440
20-10-2018,1,17493,14975,6488,2421,41377,1077,226,129,1432,42809
20-10-2018,2,17260,14790,6442,2452,40944,1091,229,129,1449,42393
20-10-2018,3,17225,14701,6461,2331,40718,1081,232,133,1446,42164
20-10-2018,4,17404,14915,6650,2280,41248,1029,231,136,1396,42644
20-10-2018,5,17622,15388,6809,2472,42292,989,273,134,1396,43688
20-10-2018,6,17695,15903,7025,2613,43236,982,367,141,1490,44726
20-10-2018,7,17544,16426,7314,2889,44173,1036,302,217,1555,45728
20-10-2018,8,18061,16891,7269,3083,45304,1063,289,246,1598,46902
20-10-2018,9,18486,17484,7279,3287,46535,1034,371,534,1939,48474
20-10-2018,10,18744,17480,7286,3446,46956,1038,302,560,1900,48856
20-10-2018,11,18629,17638,7231,3364,46863,1026,299,300,1625,48488
20-10-2018,12,18327,17466,7191,3137,46120,1020,306,129,1455,47575
20-10-2018,13,18017,17215,7036,3271,45538,1020,305,129,1454,46992
20-10-2018,14,17733,16940,7046,3176,44897,1023,307,133,1463,46360
20-10-2018,15,17852,16849,7030,3109,44840,1018,296,132,1446,46286
20-10-2018,16,18115,17156,7389,2892,45551,1015,307,138,1460,47011
20-10-2018,17,19168,18069,7618,2937,47790,1018,327,189,1534,49324
20-10-2018,18,19193,18740,7704,2978,48616,1019,333,646,1998,50614
20-10-2018,19,19109,17852,7651,2878,47490,1020,329,527,1876,49366
20-10-2018,20,18821,17197,7526,2662,46207,1027,298,386,1711,47918
20-10-2018,21,18513,16627,7581,2305,45025,1030,291,201,1522,46547
20-10-2018,22,18030,16160,7437,2076,43704,1033,275,181,1489,45193
20-10-2018,23,16887,15128,7171,1922,41108,1060,221,129,1410,42518
21-10-2018,0,17128,14986,7065,1817,40997,969,301,131,1401,42398
21-10-2018,1,16262,14804,7101,1847,40015,952,213,132,1297,41312
21-10-2018,2,15293,14892,7092,1785,39064,951,217,132,1300,40364
21-10-2018,3,14644,14979,7273,1731,38627,945,218,136,1299,39926
21-10-2018,4,14790,15301,7435,1853,39379,917,221,137,1275,40654
21-10-2018,5,14998,15649,7653,2005,40305,910,222,135,1267,41572
21-10-2018,6,14994,15963,7822,2184,40964,916,225,133,1274,42238
21-10-2018,7,14857,16129,7888,2353,41227,922,266,132,1320,42547
21-10-2018,8,15515,16423,7918,2678,42535,917,302,132,1351,43886
21-10-2018,9,15959,16705,8031,2784,43479,895,305,132,1332,44811
21-10-2018,10,16237,17077,8140,2854,44308,908,301,131,1340,45648
21-10-2018,11,16589,17152,8171,2949,44860,905,297,133,1335,46195
21-10-2018,12,16426,16902,8024,3257,44609,905,300,149,1354,45963
21-10-2018,13,15618,16544,8055,3437,43654,897,291,162,1350,45004
21-10-2018,14,15858,16534,8071,3580,44042,910,226,170,1306,45348
21-10-2018,15,16161,16783,7981,3803,44728,925,222,164,1311,46039
21-10-2018,16,16530,17170,8045,3964,45711,938,260,169,1367,47078
21-10-2018,17,17495,17953,8021,4032,47500,968,305,187,1460,48960
21-10-2018,18,17883,18200,8045,4116,48246,1051,311,379,1741,49987
21-10-2018,19,17055,17988,7962,4058,47062,1065,321,367,1753,48815
21-10-2018,20,16463,17236,7756,4096,45552,1017,335,301,1653,47205
21-10-2018,21,15734,17038,7460,3662,43893,1004,271,333,1608,45501
21-10-2018,22,14965,16292,7260,3606,42123,961,255,352,1568,43691
21-10-2018,23,13676,16075,6940,3671,40362,937,258,360,1555,41917
22-10-2018,0,12386,15899,6852,3247,38385,862,254,375,1491,39876
22-10-2018,1,12228,15475,6631,3119,37453,858,255,377,1490,38943
22-10-2018,2,11669,15534,6651,3278,37132,877,256,391,1524,38656
22-10-2018,3,11920,15683,6752,3479,37835,874,257,357,1488,39323
22-10-2018,4,12689,16205,6850,3465,39210,903,283,364,1550,40760
22-10-2018,5,14868,16892,7165,3596,42520,1081,287,377,1745,44265
22-10-2018,6,17591,18974,7803,3884,48252,1147,378,411,1936,50188
22-10-2018,7,19404,20710,8417,3998,52529,1131,483,595,2209,54738
22-10-2018,8,19714,20934,8404,4105,53158,1080,622,659,2361,55519
22-10-2018,9,19031,20975,8442,4241,52689,1101,574,652,2327,55016
22-10-2018,10,18585,20856,8296,4427,52166,1067,457,644,2168,54334
22-10-2018,11,17922,20626,8242,5070,51862,1048,460,598,2106,53968
22-10-2018,12,16931,20293,8293,4945,50463,1021,486,570,2077,52540
22-10-2018,13,16898,20281,8185,4955,50319,997,469,581,2047,52366
22-10-2018,14,16834,19808,8054,4969,49664,1030,553,427,2010,51674
22-10-2018,15,16942,19738,7911,4902,49494,1045,559,385,1989,51483
22-10-2018,16,17523,20177,7962,4430,50092,1035,454,434,1923,52015
22-10-2018,17,18794,20519,8329,4145,51787,1054,496,608,2158,53945
22-10-2018,18,19790,20599,8648,4040,53078,1093,569,586,2248,55326
22-10-2018,19,19228,20443,8501,4086,52258,1086,467,574,2127,54385
22-10-2018,20,17693,19819,8026,4198,49736,1054,450,348,1852,51588
22-10-2018,21,16570,18774,7700,4445,47489,1027,379,301,1707,49196
22-10-2018,22,14998,17512,7428,4613,44551,1017,349,351,1717,46268
22-10-2018,23,13414,16840,7146,4685,42086,901,372,366,1639,43725
23-10-2018,0,12223,16312,6999,4790,40324,782,226,381,1389,41713
23-10-2018,1,11631,16075,6802,4525,39033,749,222,409,1380,40413
23-10-2018,2,11460,15947,6606,4604,38617,748,229,420,1397,40014
23-10-2018,3,11495,15880,6470,4729,38574,747,228,431,1406,39980
23-10-2018,4,11929,15890,6480,4794,39094,774,249,468,1491,40585
23-10-2018,5,13150,16471,6858,4679,41158,916,296,529,1741,42899
23-10-2018,6,16223,18158,7698,4594,46673,975,335,552,1862,48535
23-10-2018,7,18711,19343,8287,4735,51075,1063,341,724,2128,53203
23-10-2018,8,18668,19170,8367,5004,51210,1064,342,761,2167,53377
23-10-2018,9,18316,19127,8358,5429,51229,1064,392,813,2269,53498
23-10-2018,10,18008,18886,8183,6106,51182,1081,386,832,2299,53481
23-10-2018,11,17713,19022,8061,6294,51089,1079,341,822,2242,53331
23-10-2018,12,17094,19175,8050,5737,50056,1085,370,816,2271,52327
23-10-2018,13,16728,19265,7899,5923,49815,1066,383,797,2246,52061
23-10-2018,14,16596,18993,7947,6102,49638,1056,406,747,2209,51847
23-10-2018,15,16474,18913,8036,5526,48949,1043,349,680,2072,51021
23-10-2018,16,16331,19280,8132,5339,49082,1009,337,650,1996,51078
23-10-2018,17,16595,19589,8313,5708,50205,1024,421,694,2139,52344
23-10-2018,18,17194,20119,8341,5957,51613,1017,358,727,2102,53715
23-10-2018,19,16794,19978,8160,5912,50845,1000,336,707,2043,52888
23-10-2018,20,15785,19435,7529,5615,48365,992,318,509,1819,50184
23-10-2018,21,15072,18966,6982,5404,46424,945,262,526,1733,48157
23-10-2018,22,14194,18083,6775,5042,44095,882,258,500,1640,45735
23-10-2018,23,13010,17206,6565,4117,40899,769,259,497,1525,42424
24-10-2018,0,11973,16721,6490,4206,39392,804,295,493,1592,40984
24-10-2018,1,11597,16544,6397,4149,38688,921,259,504,1684,40372
24-10-2018,2,11336,16438,6375,4005,38155,897,255,546,1698,39853
24-10-2018,3,11482,16642,6407,4040,38572,876,259,584,1719,40291
24-10-2018,4,11606,16858,6525,4386,39376,1024,261,600,1885,41261
24-10-2018,5,13224,17760,7005,3927,41916,1080,262,687,2029,43945
24-10-2018,6,16657,19728,7500,3800,47685,1118,343,691,2152,49837
24-10-2018,7,20009,21408,7987,3745,53150,1240,369,816,2425,55575
24-10-2018,8,20603,21685,8291,3978,54557,1250,368,826,2444,57001
24-10-2018,9,21051,21637,8198,3772,54658,1262,415,828,2505,57163
24-10-2018,10,20811,21464,8093,3813,54181,1274,361,818,2453,56634
24-10-2018,11,20281,20906,8068,3916,53171,1273,332,822,2427,55598
24-10-2018,12,19627,20619,7996,3907,52151,1271,336,819,2426,54577
24-10-2018,13,18956,20530,7914,3679,51079,1269,381,803,2453,53532
24-10-2018,14,19229,20370,7863,3594,51057,1256,415,983,2654,53711
24-10-2018,15,19445,20177,7825,3615,51062,1246,417,767,2430,53492
24-10-2018,16,19726,20173,7962,3405,51267,1216,427,755,2398,53665
24-10-2018,17,20612,20411,8267,3422,52712,1210,430,743,2383,55095
24-10-2018,18,21005,20515,8361,3058,52939,1189,580,749,2518,55457
24-10-2018,19,20716,20196,8198,3217,52329,1186,456,698,2340,54669
24-10-2018,20,19695,19774,7535,3753,50759,1144,353,661,2158,52917
24-10-2018,21,18841,19228,7157,4398,49626,1165,338,556,2059,51685
24-10-2018,22,17008,18307,7052,4437,46803,1143,238,428,1809,48612
24-10-2018,23,15308,16671,6882,4585,43445,1106,223,336,1665,45110
25-10-2018,0,13651,15646,6804,4636,40737,1024,220,322,1566,42303
25-10-2018,1,12341,15183,6720,5028,39273,1008,216,264,1488,40761
25-10-2018,2,12105,15209,6748,5017,39078,1088,218,239,1545,40623
25-10-2018,3,12127,15359,6812,4540,38839,1021,222,242,1485,40324
25-10-2018,4,12549,15871,6929,4637,39986,1034,228,223,1485,41471
25-10-2018,5,13925,16580,7257,4828,42592,1103,278,235,1616,44208
25-10-2018,6,17254,18887,7791,4872,48803,1108,299,327,1734,50537
25-10-2018,7,19988,19996,8358,4854,53197,1112,303,445,1860,55057
25-10-2018,8,20185,20349,8459,4925,53920,1133,300,430,1863,55783
25-10-2018,9,19463,20263,8479,5073,53278,1115,304,430,1849,55127
25-10-2018,10,19192,20135,8187,5129,52643,1121,340,447,1908,54551
25-10-2018,11,18847,19871,8179,5030,51928,1118,313,447,1878,53806
25-10-2018,12,18066,19090,8158,5681,50994,1108,321,403,1832,52826
25-10-2018,13,18160,19138,8219,5654,51172,1083,331,371,1785,52957
25-10-2018,14,18312,19221,8144,5488,51167,1108,294,379,1781,52948
25-10-2018,15,18719,18879,8128,5099,50826,1108,340,405,1853,52679
25-10-2018,16,19581,19092,8241,4970,51885,1100,321,420,1841,53726
25-10-2018,17,20703,19403,8606,4492,53204,1111,403,434,1948,55152
25-10-2018,18,21407,19671,8604,4121,53803,1108,366,461,1935,55738
25-10-2018,19,21216,19518,8537,4435,53705,1113,298,438,1849,55554
25-10-2018,20,20601,18975,7904,4149,51628,1108,294,412,1814,53442
25-10-2018,21,19984,18805,7621,4175,50586,1109,319,232,1660,52246
25-10-2018,22,18665,17927,7489,4015,48095,1104,292,173,1569,49664
25-10-2018,23,17447,16424,7369,3328,44567,1104,298,206,1608,46175
26-10-2018,0,17657,15626,7121,3018,43423,1114,294,254,1662,45085
26-10-2018,1,17170,15316,7035,3213,42734,1098,291,220,1609,44343
26-10-2018,2,17245,15294,7046,3002,42588,1109,294,234,1637,44225
26-10-2018,3,17348,15543,7102,2669,42663,1109,299,238,1646,44309
26-10-2018,4,17835,15754,7208,2421,43220,1128,314,231,1673,44893
26-10-2018,5,19914,17221,7752,2341,47227,1120,322,228,1670,48897
26-10-2018,6,21593,19334,8481,2748,52156,1138,365,268,1771,53927
26-10-2018,7,23087,20655,8873,3154,55770,1050,1106,436,2592,58362
26-10-2018,8,23396,20789,8947,3522,56654,1094,1179,425,2698,59352
26-10-2018,9,23008,20541,8765,3841,56155,1133,1129,410,2672,58827
26-10-2018,10,22640,20367,8618,3706,55333,1123,1222,557,2902,58235
26-10-2018,11,22399,20236,8795,3865,55297,1133,777,609,2519,57816
26-10-2018,12,22247,20104,8725,3814,54889,1163,463,363,1989,56878
26-10-2018,13,22062,19718,8629,3525,53935,1136,455,358,1949,55884
26-10-2018,14,21677,19585,8606,3573,53442,1115,456,189,1760,55202
26-10-2018,15,21706,19754,8612,3625,53696,1129,478,192,1799,55495
26-10-2018,16,21809,19951,8748,3412,53920,1124,474,260,1858,55778
26-10-2018,17,22056,20335,8743,3547,54682,1123,566,391,2080,56762
26-10-2018,18,22140,20385,8698,3498,54722,1119,1019,405,2543,57265
26-10-2018,19,21612,19842,8541,3390,53385,1119,758,428,2305,55690
26-10-2018,20,20602,19654,8159,3241,51656,1089,467,328,1884,53540
26-10-2018,21,19580,18997,7974,3387,49936,1098,463,260,1821,51757
26-10-2018,22,16693,17830,7590,3526,45639,1095,443,280,1818,47457
26-10-2018,23,14188,16571,7322,3822,41903,1099,391,322,1812,43715
27-10-2018,0,14204,16275,7185,3998,41662,772,305,403,1480,43142
27-10-2018,1,13051,16043,7093,4312,40500,765,234,439,1438,41938
27-10-2018,2,12444,15912,7186,4428,39969,782,245,459,1486,41455
27-10-2018,3,12107,15994,7242,4829,40172,809,247,464,1520,41692
27-10-2018,4,12465,16132,7297,4904,40800,829,248,460,1537,42337
27-10-2018,5,12923,16466,7241,4614,41245,860,236,458,1554,42799
27-10-2018,6,13183,17376,7443,4493,42496,848,280,466,1594,44090
27-10-2018,7,15226,18606,7627,4018,45479,859,313,500,1672,47151
27-10-2018,8,17753,19303,7746,4149,48951,896,305,561,1762,50713
27-10-2018,9,18713,19844,7923,4645,51125,918,302,624,1844,52969
27-10-2018,10,19174,20518,7962,4852,52506,932,308,639,1879,54385
27-10-2018,11,19108,20704,8035,4862,52709,946,304,676,1926,54635
27-10-2018,12,18776,20809,8032,4842,52459,957,312,651,1920,54379
27-10-2018,13,18687,20767,8051,4635,52141,977,320,610,1907,54048
27-10-2018,14,18567,20697,8065,4433,51761,979,335,672,1986,53747
27-10-2018,15,18930,21069,8091,4168,52258,988,355,623,1966,54224
27-10-2018,16,19823,21206,8208,3718,52955,975,346,697,2018,54973
27-10-2018,17,21262,21656,8476,3425,54819,980,345,671,1996,56815
27-10-2018,18,22149,21727,8460,3306,55643,974,757,808,2539,58182
27-10-2018,19,21114,21344,8398,3252,54109,987,546,796,2329,56438
27-10-2018,20,19926,20888,8353,3054,52221,979,332,587,1898,54119
27-10-2018,21,19617,20683,8209,2804,51314,982,321,589,1892,53206
27-10-2018,22,19127,19259,8084,2649,49120,961,326,566,1853,50973
27-10-2018,23,16964,18019,7935,2465,45383,928,327,548,1803,47186
28-10-2018,0,15343,16627,7868,2258,42096,938,329,496,1763,43859
28-10-2018,1,14112,16125,7788,2242,40268,976,315,470,1761,42029
28-10-2018,2,12912,15428,7621,2045,38007,989,251,470,1710,39717
28-10-2018,2,13003,15496,7627,2045,38171,965,239,357,1561,39732
28-10-2018,3,12980,15511,7797,2197,38483,947,237,357,1541,40024
28-10-2018,4,13236,15582,7718,2382,38919,927,235,269,1431,40350
28-10-2018,5,14015,16099,7728,2515,40356,923,243,258,1424,41780
28-10-2018,6,14649,16675,7844,2711,41878,902,286,235,1423,43301
28-10-2018,7,15955,17163,8071,2893,44083,901,303,227,1431,45514
28-10-2018,8,17983,17761,8100,3134,46978,885,301,316,1502,48480
28-10-2018,9,20199,18262,8046,3333,49842,881,304,216,1401,51243
28-10-2018,10,20423,18362,8017,3431,50233,862,323,260,1445,51678
28-10-2018,11,19203,18438,7972,3756,49370,854,320,185,1359,50729
28-10-2018,12,18465,18606,7996,3626,48692,858,321,197,1376,50068
28-10-2018,13,17933,17459,7767,3731,46890,851,320,196,1367,48257
28-10-2018,14,16859,17637,7821,3735,46052,848,320,198,1366,47418
28-10-2018,15,17777,17948,7836,3678,47238,835,317,183,1335,48573
28-10-2018,16,19550,19104,7989,3752,50396,845,307,324,1476,51872
28-10-2018,17,21772,19846,8259,4045,53922,843,342,308,1493,55415
28-10-2018,18,21706,19877,8329,4270,54182,863,335,332,1530,55712
28-10-2018,19,20389,19208,8093,4481,52170,853,313,326,1492,53662
28-10-2018,20,18168,19163,7915,4352,49599,834,320,339,1493,51092
28-10-2018,21,16749,18176,7797,4397,47121,812,320,327,1459,48580
28-10-2018,22,15305,17611,7634,4367,44917,789,303,346,1438,46355
28-10-2018,23,14564,16856,7606,4016,43043,794,243,350,1387,44430
29-10-2018,0,14184,15500,7457,3975,41117,805,240,372,1417,42534
29-10-2018,1,13807,15212,7438,4207,40664,840,244,403,1487,42151
29-10-2018,2,13558,15299,7473,4201,40533,870,240,434,1544,42077
29-10-2018,3,13725,15445,7603,4255,41029,887,243,434,1564,42593
29-10-2018,4,14567,15829,7903,4275,42575,905,249,448,1602,44177
29-10-2018,5,16779,17327,8450,4504,47058,949,317,468,1734,48792
29-10-2018,6,20666,20158,9056,4666,54547,1064,343,561,1968,56515
29-10-2018,7,22199,21315,9182,5385,58082,1087,400,722,2209,60291
29-10-2018,8,23099,21887,9313,5219,59519,1094,503,749,2346,61865
29-10-2018,9,22905,22014,9276,5279,59475,1086,527,796,2409,61884
29-10-2018,10,22529,21968,9253,5242,58993,1115,523,793,2431,61424
29-10-2018,11,22072,21783,9099,5961,58916,1187,522,660,2369,61285
29-10-2018,12,21837,21918,8965,6054,58774,1184,525,783,2492,61266
29-10-2018,13,21619,21508,8903,5983,58013,1250,519,774,2543,60556
29-10-2018,14,21161,21392,9331,5922,57805,1258,543,599,2400,60205
29-10-2018,15,21436,21576,9484,5665,58162,1306,510,673,2489,60651
29-10-2018,16,21683,21988,9594,5722,58988,1424,783,803,3010,61998
29-10-2018,17,21679,22166,9482,5742,59068,1443,1019,796,3258,62326
29-10-2018,18,21576,22020,9269,5834,58700,1444,940,780,3164,61864
29-10-2018,19,20596,21464,9100,6074,57235,1444,531,615,2590,59825
29-10-2018,20,18666,21033,8638,5906,54243,1264,533,610,2407,56650
29-10-2018,21,16895,20261,8351,5739,51246,1203,491,601,2295,53541
29-10-2018,22,15501,19297,8114,5413,48325,1204,418,594,2216,50541
29-10-2018,23,14219,18186,7987,5273,45666,1219,409,599,2227,47893
30-10-2018,0,13630,17402,7818,5175,44026,1122,296,597,2015,46041
30-10-2018,1,13274,17066,7733,5079,43152,1105,274,584,1963,45115
30-10-2018,2,13231,17031,7746,5061,43070,1098,272,605,1975,45045
30-10-2018,3,13686,17100,7874,5153,43813,1087,272,611,1970,45783
30-10-2018,4,14155,17476,8194,5214,45039,1110,268,611,1989,47028
30-10-2018,5,15268,18136,8683,5306,47393,1230,288,602,2120,49513
30-10-2018,6,17623,20208,9248,5435,52515,1287,410,622,2319,54834
30-10-2018,7,20101,21392,9598,5725,56816,1336,367,633,2336,59152
30-10-2018,8,20152,21727,9561,5771,57211,1380,366,832,2578,59789
30-10-2018,9,20005,21977,9569,5421,56973,1432,367,816,2615,59588
30-10-2018,10,20033,22360,9465,5083,56942,1575,388,833,2796,59738
30-10-2018,11,20087,21485,9424,5029,56025,1517,362,776,2655,58680
30-10-2018,12,19619,21234,9308,4857,55020,1494,367,607,2468,57488
30-10-2018,13,19331,21203,9430,4627,54591,1396,372,607,2375,56966
30-10-2018,14,19283,21213,9521,4471,54488,1465,368,609,2442,56930
30-10-2018,15,20865,21536,9578,4347,56326,1512,375,613,2500,58826
30-10-2018,16,21324,21837,9839,4202,57202,1423,404,828,2655,59857
30-10-2018,17,21737,21786,9851,4054,57428,1423,554,812,2789,60217
30-10-2018,18,21084,21095,9780,4012,55972,1397,383,812,2592,58564
30-10-2018,19,20199,20743,9660,3437,54039,1276,395,772,2443,56482
30-10-2018,20,18650,20022,9257,3028,50959,1197,387,602,2186,53145
30-10-2018,21,17323,18932,8775,2917,47948,1167,365,592,2124,50072
30-10-2018,22,15812,17612,8198,2942,44563,1132,318,586,2036,46599
30-10-2018,23,14270,16784,7856,2930,41841,1093,287,566,1946,43787
31-10-2018,0,13040,15601,7582,3082,39305,1216,264,535,2015,41320
31-10-2018,1,12585,15195,7493,3300,38573,1238,258,526,2022,40595
31-10-2018,2,11991,15244,7506,3638,38380,1278,259,511,2048,40428
31-10-2018,3,11751,15313,7608,3754,38426,1249,257,513,2019,40445
31-10-2018,4,12296,15939,7756,3830,39822,1268,258,514,2040,41862
31-10-2018,5,13842,16872,8243,4117,43074,1359,270,525,2154,45228
31-10-2018,6,17295,18610,8902,4059,48868,1374,355,486,2215,51083
31-10-2018,7,19913,20617,9392,4401,54322,1382,385,663,2430,56752
31-10-2018,8,19373,20763,9470,4795,54401,1374,472,602,2448,56849
31-10-2018,9,18911,20774,9376,4911,53971,1418,553,562,2533,56504
31-10-2018,10,18461,20880,9248,5058,53648,1457,591,556,2604,56252
31-10-2018,11,18884,20971,9222,5183,54260,1397,549,530,2476,56736
31-10-2018,12,19203,20879,9141,4783,54006,1413,557,528,2498,56504
31-10-2018,13,19927,21026,9166,4553,54672,1401,710,493,2604,57276
31-10-2018,14,20757,21237,9123,4129,55244,1383,491,495,2369,57613
31-10-2018,15,21195,21389,9249,3636,55469,1386,771,426,2583,58052
31-10-2018,16,21441,21613,9495,3371,55921,1421,970,428,2819,58740
31-10-2018,17,21907,21843,9320,3455,56524,1436,1224,447,3107,59631
31-10-2018,18,21184,21448,9204,3414,55251,1425,1196,410,3031,58282
31-10-2018,19,19837,20962,8852,3432,53085,1394,631,455,2480,55565
31-10-2018,20,19176,20033,8596,3297,51103,1363,480,184,2027,53130
31-10-2018,21,18032,19068,8457,3109,48666,1386,468,170,2024,50690
31-10-2018,22,15764,17777,8350,2646,44537,1365,464,156,1985,46522
31-10-2018,23,14607,16622,8063,2386,41678,1375,395,151,1921,43599
01-11-2018,0,13532,15364,7856,2543,39295,1350,282,152,1784,41079
01-11-2018,1,13226,15069,7738,2697,38731,1338,309,156,1803,40534
01-11-2018,2,12511,14837,7692,2860,37900,1310,230,203,1743,39643
01-11-2018,3,11834,14597,7613,2966,37009,1274,227,238,1739,38748
01-11-2018,4,12008,14612,7561,3135,37317,1257,229,307,1793,39110
01-11-2018,5,14023,15382,7686,3403,40495,1250,289,352,1891,42386
01-11-2018,6,16769,16846,7930,3875,45421,1244,313,370,1927,47348
01-11-2018,7,18517,18397,7935,3978,48828,1216,313,347,1876,50704
01-11-2018,8,19040,18727,7974,4125,49866,1160,307,319,1786,51652
01-11-2018,9,18932,18609,7906,4168,49616,1128,298,287,1713,51329
01-11-2018,10,19729,18949,7811,4217,50706,1181,299,284,1764,52470
01-11-2018,11,20722,18978,7801,4040,51542,1210,305,295,1810,53352
01-11-2018,12,20652,18750,8003,3788,51194,1210,318,332,1860,53054
01-11-2018,13,21003,19227,8346,3619,52195,1154,327,353,1834,54029
01-11-2018,14,20900,19512,8349,3396,52158,1133,336,401,1870,54028
01-11-2018,15,21388,19910,8389,3254,52943,1229,660,397,2286,55229
01-11-2018,16,21953,20324,8530,3525,54332,1274,638,415,2327,56659
01-11-2018,17,21737,20521,8410,3510,54178,1259,1054,435,2748,56926
01-11-2018,18,21171,20425,8242,3614,53451,1207,974,445,2626,56077
01-11-2018,19,21202,19996,7858,3319,52375,1210,411,433,2054,54429
01-11-2018,20,20459,18963,7589,3062,50074,1201,319,423,1943,52017
01-11-2018,21,19156,18023,7447,2460,47086,1222,318,411,1951,49037
01-11-2018,22,17332,16383,7181,2120,43016,1228,314,406,1948,44964
01-11-2018,23,14124,15381,6897,1676,38079,1224,258,442,1924,40003
02-11-2018,0,13220,14766,6680,1710,36376,1238,240,455,1933,38309
02-11-2018,1,12413,14525,6598,1835,35369,1235,237,444,1916,37285
02-11-2018,2,12261,14627,6558,1879,35326,1252,233,427,1912,37238
02-11-2018,3,11975,14547,6585,2030,35137,1226,235,427,1888,37025
02-11-2018,4,13239,15046,6797,2337,37419,1257,235,431,1923,39342
02-11-2018,5,16252,15979,7197,2659,42088,1258,272,439,1969,44057
02-11-2018,6,19201,18088,8002,3184,48477,1267,253,413,1933,50410
02-11-2018,7,20973,19742,8559,3785,53058,1248,250,378,1876,54934
02-11-2018,8,21423,20067,8661,4020,54173,1260,303,352,1915,56088
02-11-2018,9,21065,19684,8262,4045,53055,1270,302,298,1870,54925
02-11-2018,10,20590,19569,8165,4195,52519,1297,335,262,1894,54413
02-11-2018,11,20102,19463,8049,4618,52233,1299,346,245,1890,54123
02-11-2018,12,20355,19419,7987,4581,52342,1293,362,191,1846,54188
02-11-2018,13,21213,19532,8094,4585,53425,1349,414,333,2096,55521
02-11-2018,14,20875,19666,8200,4582,53325,1335,499,185,2019,55344
02-11-2018,15,20723,19676,8487,4936,53822,1335,470,197,2002,55824
02-11-2018,16,21121,19832,8638,4799,54391,1350,430,411,2191,56582
02-11-2018,17,21892,20269,8735,4765,55662,1376,421,387,2184,57846
02-11-2018,18,21591,20073,8505,4575,54745,1372,512,345,2229,56974
02-11-2018,19,20303,19497,8180,4129,52110,1346,332,156,1834,53944
02-11-2018,20,18566,18982,8034,3668,49250,1316,333,148,1797,51047
02-11-2018,21,17832,18290,8091,3341,47554,1309,340,142,1791,49345
02-11-2018,22,16905,17415,7986,3052,45358,1328,288,160,1776,47134
02-11-2018,23,15593,16591,7712,2791,42688,1341,276,162,1779,44467
03-11-2018,0,15777,15793,7592,2716,41877,1076,347,172,1595,43472
03-11-2018,1,14865,15528,7460,2672,40526,1019,335,198,1552,42078
03-11-2018,2,14371,15596,7424,2566,39958,1043,337,184,1564,41522
03-11-2018,3,14398,15771,7416,2343,39927,1051,338,154,1543,41470
03-11-2018,4,14845,15831,7528,2268,40472,1034,339,163,1536,42008
03-11-2018,5,15890,16183,7601,2125,41801,1052,346,176,1574,43375
03-11-2018,6,16661,16705,7504,2442,43313,1077,343,190,1610,44923
03-11-2018,7,17590,17119,7440,2579,44729,1038,340,200,1578,46307
03-11-2018,8,18723,17504,7576,2978,46781,994,339,226,1559,48340
03-11-2018,9,19790,17783,7668,3204,48445,1043,349,229,1621,50066
03-11-2018,10,20197,17979,7695,3248,49118,1042,411,223,1676,50794
03-11-2018,11,19807,17922,7625,3462,48816,1063,334,240,1637,50453
03-11-2018,12,19224,17682,7613,3703,48222,1045,337,251,1633,49855
03-11-2018,13,18948,17418,7711,3802,47879,1014,338,252,1604,49483
03-11-2018,14,19490,17318,7813,3592,48213,1027,339,233,1599,49812
03-11-2018,15,19811,17638,7921,3453,48824,1038,334,295,1667,50491
03-11-2018,16,20506,18398,8050,3763,50718,1067,393,361,1821,52539
03-11-2018,17,20607,18789,8015,3909,51321,1039,811,464,2314,53635
03-11-2018,18,19863,18945,7924,3945,50677,1051,430,434,1915,52592
03-11-2018,19,18688,18893,7656,3761,48997,1119,339,224,1682,50679
03-11-2018,20,18167,18243,7656,3649,47714,1099,341,186,1626,49340
03-11-2018,21,17424,17491,7515,3560,45992,1089,320,172,1581,47573
03-11-2018,22,15776,16682,7438,3395,43292,1019,331,160,1510,44802
03-11-2018,23,14015,15619,7221,3344,40200,960,328,140,1428,41628
04-11-2018,0,13569,14752,7152,3117,38590,995,313,139,1447,40037
04-11-2018,1,13044,14337,7067,2975,37424,1059,315,138,1512,38936
04-11-2018,2,12694,13952,7073,2969,36690,1074,316,131,1521,38211
04-11-2018,3,12102,13864,7074,3068,36108,1047,316,127,1490,37598
04-11-2018,4,11877,13835,7072,3072,35855,1052,302,119,1473,37328
04-11-2018,5,12261,14184,7195,3031,36672,1057,326,129,1512,38184
04-11-2018,6,13418,14490,7334,3086,38328,1045,326,126,1497,39825
04-11-2018,7,15226,15228,7577,3319,41351,1022,325,120,1467,42818
04-11-2018,8,16644,15626,7788,3551,43609,1013,325,138,1476,45085
04-11-2018,9,18366,16388,7839,3609,46202,1046,324,153,1523,47725
04-11-2018,10,19130,16792,7822,3470,47214,1049,321,153,1523,48737
04-11-2018,11,19311,16998,7893,3455,47658,1065,319,142,1526,49184
04-11-2018,12,18981,17073,7988,3347,47389,1057,319,146,1522,48911
04-11-2018,13,18756,17264,8023,3139,47184,1036,320,164,1520,48704
04-11-2018,14,18699,17324,8093,3220,47339,1059,322,177,1558,48897
04-11-2018,15,19138,17698,8115,3272,48223,1090,324,198,1612,49835
04-11-2018,16,20095,18470,8322,3141,50029,1100,348,287,1735,51764
04-11-2018,17,20375,18654,8389,3173,50591,1092,338,422,1852,52443
04-11-2018,18,20001,18405,8443,3154,50002,1088,341,404,1833,51835
04-11-2018,19,19319,18187,8342,3097,48946,1105,340,438,1883,50829
04-11-2018,20,18697,17875,8481,2930,47984,1113,341,421,1875,49859
04-11-2018,21,17578,17104,8268,2695,45644,1107,336,296,1739,47383
04-11-2018,22,16510,16442,8108,2456,43516,1117,336,294,1747,45263
04-11-2018,23,14383,15624,7900,2011,39919,1147,312,267,1726,41645
05-11-2018,0,13170,15331,7949,1814,38264,1148,261,257,1666,39930
05-11-2018,1,13765,15037,7861,1775,38439,1144,342,252,1738,40177
05-11-2018,2,13932,14937,7830,1774,38474,1162,350,271,1783,40257
05-11-2018,3,13308,14940,8026,1722,37997,1192,316,281,1789,39786
05-11-2018,4,13190,15301,8095,1742,38328,1227,290,278,1795,40123
05-11-2018,5,14977,15913,8226,1892,41009,1322,357,274,1953,42962
05-11-2018,6,18729,17808,8682,2415,47634,1386,449,313,2148,49782
05-11-2018,7,20141,18744,9156,2720,50761,1534,699,515,2748,53509
05-11-2018,8,20155,18830,9407,2763,51155,1538,992,552,3082,54237
05-11-2018,9,20432,18961,9325,2821,51539,1532,871,522,2925,54464
05-11-2018,10,20985,18642,9164,2934,51726,1518,847,508,2873,54599
05-11-2018,11,21044,18646,9083,2966,51739,1522,899,491,2912,54651
05-11-2018,12,21126,18606,9082,2906,51721,1510,786,465,2761,54482
05-11-2018,13,21036,18550,9050,2891,51529,1510,775,484,2769,54298
05-11-2018,14,20713,18647,8998,2987,51344,1514,823,477,2814,54158
05-11-2018,15,20960,19209,9083,2893,52144,1517,947,471,2935,55079
05-11-2018,16,21107,19532,9199,3093,52932,1518,1151,465,3134,56066
05-11-2018,17,21422,20064,9010,3066,53562,1534,967,483,2984,56546
05-11-2018,18,21384,19884,8762,2945,52975,1496,536,461,2493,55468
05-11-2018,19,21042,19410,8511,2894,51858,1465,517,326,2308,54166
05-11-2018,20,20755,18288,8248,2853,50144,1475,502,340,2317,52461
05-11-2018,21,20131,17277,8050,2675,48133,1468,488,281,2237,50370
05-11-2018,22,18182,16305,7756,2651,44894,1468,483,282,2233,47127
05-11-2018,23,16303,15311,7345,2492,41451,1482,478,246,2206,43657
06-11-2018,0,15431,14561,7150,2215,39357,1516,474,215,2205,41562
06-11-2018,1,14599,14307,6984,2348,38237,1551,426,229,2206,40443
06-11-2018,2,14460,14294,6952,2165,37871,1574,405,237,2216,40087
06-11-2018,3,14228,14362,7000,2096,37687,1596,411,238,2245,39932
06-11-2018,4,14830,14869,7124,2077,38901,1629,489,246,2364,41265
06-11-2018,5,17531,15930,7369,2235,43067,1661,489,321,2471,45538
06-11-2018,6,20075,18108,7914,2540,48638,1727,497,482,2706,51344
06-11-2018,7,21180,18719,8324,2733,50955,1720,766,536,3022,53977
06-11-2018,8,21348,18850,8382,2723,51304,1718,820,556,3094,54398
06-11-2018,9,20957,18995,8168,2798,50918,1722,825,509,3056,53974
06-11-2018,10,21049,19121,8164,2762,51096,1794,720,306,2820,53916
06-11-2018,11,21225,19124,8179,2610,51138,1815,595,311,2721,53859
06-11-2018,12,21201,18953,8272,2587,51012,1841,592,459,2892,53904
06-11-2018,13,21390,19113,8545,2463,51511,1761,649,471,2881,54392
06-11-2018,14,21896,19084,8611,2488,52080,1821,722,489,3032,55112
06-11-2018,15,21596,18938,8725,2500,51760,1857,816,532,3205,54965
06-11-2018,16,21632,19155,8717,2439,51945,1870,1123,570,3563,55508
06-11-2018,17,21653,19176,8680,2633,52140,1885,1416,608,3909,56049
06-11-2018,18,21584,19048,8625,2687,51946,1881,1220,606,3707,55653
06-11-2018,19,21560,18766,8204,2588,51119,1859,851,603,3313,54432
06-11-2018,20,21220,17686,7789,2422,49119,1884,529,326,2739,51858
06-11-2018,21,20768,16685,7521,2200,47175,1868,501,319,2688,49863
06-11-2018,22,19903,15261,7277,1940,44382,1866,498,303,2667,47049
06-11-2018,23,17731,14113,6852,1709,40405,1863,493,306,2662,43067
07-11-2018,0,16805,13574,6736,1713,38829,1753,487,307,2547,41376
07-11-2018,1,15791,13200,6585,1799,37376,1745,484,309,2538,39914
07-11-2018,2,14724,13096,6385,2062,36268,1725,485,320,2530,38798
07-11-2018,3,13678,13064,6329,2147,35219,1704,485,320,2509,37728
07-11-2018,4,14798,13466,6385,2308,36957,1691,485,307,2483,39440
07-11-2018,5,16878,14247,6659,2674,40460,1752,485,262,2499,42959
07-11-2018,6,20125,17382,7352,2814,47673,1855,498,279,2632,50305
07-11-2018,7,21285,19268,7718,3353,51623,1855,770,362,2987,54610
07-11-2018,8,21127,19227,7845,3388,51586,1860,995,424,3279,54865
07-11-2018,9,21258,18921,7809,3259,51248,1835,998,431,3264,54512
07-11-2018,10,21205,18719,7763,3156,50842,1839,801,260,2900,53742
07-11-2018,11,21018,18696,7753,3052,50520,1836,793,253,2882,53402
07-11-2018,12,21170,18932,7867,3022,50990,1830,797,261,2888,53878
07-11-2018,13,21293,19646,7809,3138,51887,1821,820,277,2918,54805
07-11-2018,14,21769,19514,7883,2930,52097,1831,979,435,3245,55342
07-11-2018,15,21949,19892,7960,3028,52830,1826,994,465,3285,56115
07-11-2018,16,21984,19837,7951,3249,53019,1826,1153,474,3453,56472
07-11-2018,17,21827,19832,8065,3214,52939,1820,1428,502,3750,56689
07-11-2018,18,21694,19677,7986,2924,52282,1812,1218,485,3515,55797
07-11-2018,19,21465,19222,7924,2799,51411,1813,934,485,3232,54643
07-11-2018,20,21149,18206,7487,2608,49449,1809,754,258,2821,52270
07-11-2018,21,20751,17392,7344,2124,47612,1816,489,264,2569,50181
07-11-2018,22,19467,16340,7542,2042,45391,1733,485,220,2438,47829
07-11-2018,23,17984,15341,7322,2086,42734,1716,486,214,2416,45150
08-11-2018,0,17718,14195,7052,1880,40845,1619,480,215,2314,43159
08-11-2018,1,17229,13806,6384,1817,39237,1620,478,204,2302,41539
08-11-2018,2,16320,13645,6362,1882,38210,1616,478,191,2285,40495
08-11-2018,3,16129,13717,6471,2031,38348,1608,478,177,2263,40611
08-11-2018,4,16821,14246,6782,2056,39905,1601,479,168,2248,42153
08-11-2018,5,18730,15836,7394,2250,44210,1657,485,165,2307,46517
08-11-2018,6,20480,18255,7717,2664,49116,1789,512,177,2478,51594
08-11-2018,7,21743,19360,8084,3020,52207,1807,960,370,3137,55344
08-11-2018,8,21843,19171,8304,3095,52414,1805,999,387,3191,55605
08-11-2018,9,21975,18887,8204,2900,51968,1803,990,354,3147,55115
08-11-2018,10,21721,18809,7969,2742,51241,1810,984,337,3131,54372
08-11-2018,11,21548,18821,7856,2805,51030,1810,987,314,3111,54141
08-11-2018,12,21566,18946,8023,2804,51338,1793,987,318,3098,54436
08-11-2018,13,21586,19285,8314,2905,52091,1800,984,321,3105,55196
08-11-2018,14,21369,19322,8081,3077,51848,1809,988,376,3173,55021
08-11-2018,15,21517,19159,8276,2888,51842,1814,1090,380,3284,55126
08-11-2018,16,22065,19543,8462,2816,52886,1822,1262,376,3460,56346
08-11-2018,17,21932,19684,8519,3059,53194,1826,1414,405,3645,56839
08-11-2018,18,21703,19526,8525,2856,52611,1817,1129,398,3344,55955
08-11-2018,19,21641,18856,8192,2786,51475,1809,994,394,3197,54672
08-11-2018,20,21296,17837,7855,2542,49529,1813,924,324,3061,52590
08-11-2018,21,20835,17305,7682,2101,47924,1826,628,174,2628,50552
08-11-2018,22,19415,16568,7422,1795,45199,1815,492,122,2429,47628
08-11-2018,23,18126,15581,7119,1461,42288,1794,487,125,2406,44694
09-11-2018,0,17985,14758,6946,1368,41059,1740,484,123,2347,43406
09-11-2018,1,17289,14252,6910,1335,39785,1747,483,120,2350,42135
09-11-2018,2,16646,14040,6771,1349,38806,1747,482,118,2347,41153
09-11-2018,3,16634,14151,6859,1427,39071,1730,483,116,2329,41400
09-11-2018,4,17096,15128,7087,1324,40635,1736,483,122,2341,42976
09-11-2018,5,19210,16400,7584,1586,44782,1759,487,122,2368,47150
09-11-2018,6,20512,18053,8043,2297,48906,1785,697,124,2606,51512
09-11-2018,7,21799,19106,8444,2768,52117,1787,980,322,3089,55206
09-11-2018,8,22073,19184,8533,2861,52651,1788,1011,326,3125,55776
09-11-2018,9,21839,19114,8391,2846,52191,1777,1009,318,3104,55295
09-11-2018,10,21558,19127,8269,2944,51898,1782,994,312,3088,54986
09-11-2018,11,21272,18979,8222,3221,51695,1788,955,309,3052,54747
09-11-2018,12,21390,19045,8249,3238,51923,1785,838,320,2943,54866
09-11-2018,13,21582,19113,8406,3058,52161,1788,835,299,2922,55083
09-11-2018,14,21711,19197,8525,2900,52333,1798,793,318,2909,55242
09-11-2018,15,21567,19512,8612,3109,52801,1797,979,328,3104,55905
09-11-2018,16,21781,19387,8663,3752,53585,1792,977,341,3110,56695
09-11-2018,17,22046,19784,8677,3954,54462,1794,955,351,3100,57562
09-11-2018,18,22197,19229,8368,4151,53944,1789,913,323,3025,56969
09-11-2018,19,21168,18331,8054,4081,51634,1669,735,241,2645,54279
09-11-2018,20,20621,17652,7869,3481,49623,1547,466,135,2148,51771
09-11-2018,21,19901,16970,7558,3414,47844,1353,459,132,1944,49788
09-11-2018,22,18594,16181,7379,3335,45489,1216,452,132,1800,47289
09-11-2018,23,16688,14906,7217,2853,41663,1240,447,132,1819,43482
10-11-2018,0,14823,14132,7187,2965,39108,1061,441,127,1629,40737
10-11-2018,1,13559,13784,6889,2843,37074,1013,422,130,1565,38639
10-11-2018,2,12651,13517,6668,2854,35689,1000,374,133,1507,37196
10-11-2018,3,12104,13540,6496,2868,35009,998,373,140,1511,36520
10-11-2018,4,11846,13589,6262,3248,34944,1003,374,146,1523,36467
10-11-2018,5,12179,14130,6322,3521,36152,995,388,155,1538,37690
10-11-2018,6,12871,14506,6497,3888,37762,996,454,157,1607,39369
10-11-2018,7,13898,15114,6664,4100,39777,1044,452,159,1655,41432
10-11-2018,8,15249,15806,6794,4241,42090,1192,468,160,1820,43910
10-11-2018,9,16971,16375,6899,4591,44835,1234,554,181,1969,46804
10-11-2018,10,17688,17273,7074,4775,46811,1244,734,190,2168,48979
10-11-2018,11,17742,17719,7057,5035,47554,1233,736,229,2198,49752
10-11-2018,12,17882,17922,7020,4816,47640,1231,692,225,2148,49788
10-11-2018,13,17647,18463,7029,4545,47684,1242,553,202,1997,49681
10-11-2018,14,18358,18427,7129,4393,48308,1239,538,211,1988,50296
10-11-2018,15,18924,19002,7586,4084,49597,1253,516,228,1997,51594
10-11-2018,16,20111,19326,8079,4047,51564,1284,973,229,2486,54050
10-11-2018,17,20559,19587,8190,3972,52309,1290,976,231,2497,54806
10-11-2018,18,19770,19533,8098,3847,51249,1260,660,231,2151,53400
10-11-2018,19,18406,19276,7891,3578,49151,1241,491,201,1933,51084
10-11-2018,20,16842,18142,7654,3474,46113,1242,466,200,1908,48021
10-11-2018,21,14987,17100,7483,3469,43038,1249,386,199,1834,44872
10-11-2018,22,14350,16521,7404,3438,41714,1247,377,204,1828,43542
10-11-2018,23,12650,15727,7227,3352,38955,1257,378,223,1858,40813
11-11-2018,0,11650,15463,7198,3655,37967,991,378,254,1623,39590
11-11-2018,1,10676,15197,7084,3604,36559,971,377,284,1632,38191
11-11-2018,2,10376,15014,7018,3554,35964,968,382,286,1636,37600
11-11-2018,3,9857,15054,6975,3310,35196,928,382,292,1602,36798
11-11-2018,4,9771,15285,7008,3072,35136,942,386,295,1623,36759
11-11-2018,5,10134,15540,6985,3056,35716,950,387,320,1657,37373
11-11-2018,6,10161,15753,7115,2993,36023,963,389,341,1693,37716
11-11-2018,7,10745,15972,7179,3185,37081,927,390,369,1686,38767
11-11-2018,8,12295,16600,7305,3234,39436,1009,394,387,1790,41226
11-11-2018,9,14149,17034,7395,3172,41751,1016,402,408,1826,43577
11-11-2018,10,15319,17348,7523,2978,43169,1004,474,430,1908,45077
11-11-2018,11,15490,17624,7734,3171,44018,1042,489,453,1984,46002
11-11-2018,12,14350,17698,7828,3568,43444,1058,485,480,2023,45467
11-11-2018,13,13926,17996,7742,3639,43304,1061,480,496,2037,45341
11-11-2018,14,14274,18094,7788,3379,43536,1058,486,479,2023,45559
11-11-2018,15,15563,18014,7860,3333,44771,1059,485,472,2016,46787
11-11-2018,16,17363,18753,8005,3469,47590,1060,483,470,2013,49603
11-11-2018,17,18234,19062,8207,3223,48727,1078,484,470,2032,50759
11-11-2018,18,18184,19267,8301,2808,48560,1071,484,444,1999,50559
11-11-2018,19,17112,18949,8287,2868,47217,1132,487,450,2069,49286
11-11-2018,20,15959,18165,8201,3091,45415,1101,485,411,1997,47412
11-11-2018,21,15003,17630,7890,3427,43951,1126,480,385,1991,45942
11-11-2018,22,14508,16741,7861,3312,42422,1114,473,370,1957,44379
11-11-2018,23,12601,15717,7613,3329,39261,1103,405,363,1871,41132
12-11-2018,0,12037,15428,7503,2862,37831,1133,395,358,1886,39717
12-11-2018,1,12532,15326,7430,3020,38309,1136,390,333,1859,40168
12-11-2018,2,12251,15153,7431,2962,37799,1179,392,333,1904,39703
12-11-2018,3,12595,15136,7514,2757,38003,1205,391,350,1946,39949
12-11-2018,4,12816,15492,7630,2657,38596,1217,399,338,1954,40550
12-11-2018,5,15297,16739,7968,2634,42639,1221,454,366,2041,44680
12-11-2018,6,18996,18792,8428,2730,48947,1284,472,373,2129,51076
12-11-2018,7,20732,20166,8689,3141,52728,1363,476,429,2268,54996
12-11-2018,8,20945,20328,8945,3190,53408,1370,475,536,2381,55789
12-11-2018,9,20578,20484,8870,2953,52886,1363,489,547,2399,55285
12-11-2018,10,20231,20391,8823,2987,52431,1365,597,629,2591,55022
12-11-2018,11,20036,20298,8819,3296,52450,1362,488,578,2428,54878
12-11-2018,12,20220,20044,8906,3344,52515,1351,528,517,2396,54911
12-11-2018,13,20713,20172,9074,3190,53147,1333,572,500,2405,55552
12-11-2018,14,20699,20678,9075,2894,53345,1325,482,495,2302,55647
12-11-2018,15,21072,20869,9108,2950,53999,1346,476,526,2348,56347
12-11-2018,16,21567,20980,9364,2846,54756,1359,606,630,2595,57351
12-11-2018,17,21433,20890,9527,2843,54694,1371,630,644,2645,57339
12-11-2018,18,21154,20614,9408,2878,54055,1356,544,578,2478,56533
12-11-2018,19,20386,20458,9022,2749,52615,1315,494,563,2372,54987
12-11-2018,20,19817,19454,8751,2517,50540,1316,470,482,2268,52808
12-11-2018,21,18786,18159,8607,2278,47831,1317,474,443,2234,50065
12-11-2018,22,17457,16926,8352,1977,44710,1287,481,484,2252,46962
12-11-2018,23,15086,16026,8018,1971,41101,1269,487,490,2246,43347
13-11-2018,0,14262,15266,7906,2133,39568,1152,487,502,2141,41709
13-11-2018,1,13729,14889,7684,2341,38643,1142,488,526,2156,40799
13-11-2018,2,13577,14848,7656,2189,38270,1137,488,514,2139,40409
13-11-2018,3,13499,14767,7593,2230,38088,1044,496,505,2045,40133
13-11-2018,4,14215,14959,7651,2304,39129,1029,517,499,2045,41174
13-11-2018,5,16287,15645,8176,2856,42966,1049,497,472,2018,44984
13-11-2018,6,19637,17913,8809,2750,49110,1253,523,562,2338,51448
13-11-2018,7,20997,19501,8955,3075,52529,1251,811,581,2643,55172
13-11-2018,8,20915,19682,8975,2995,52566,1272,847,565,2684,55250
13-11-2018,9,20364,19408,8724,3280,51778,1283,1048,601,2932,54710
13-11-2018,10,19730,19256,8540,3522,51048,1286,869,516,2671,53719
13-11-2018,11,19408,19305,8397,3701,50812,1311,758,436,2505,53317
13-11-2018,12,19307,19189,8400,3906,50804,1325,853,461,2639,53443
13-11-2018,13,19652,19171,8348,3929,51101,1296,844,446,2586,53687
13-11-2018,14,19671,19125,8503,4030,51330,1276,788,383,2447,53777
13-11-2018,15,20544,19468,8667,3439,52119,1267,747,347,2361,54480
13-11-2018,16,21632,20258,8793,3264,53949,1253,1048,242,2543,56492
13-11-2018,17,21871,20255,8832,3622,54580,1247,1244,331,2822,57402
13-11-2018,18,21528,20257,8721,3509,54016,1248,821,220,2289,56305
13-11-2018,19,20671,19930,8529,3512,52642,1245,677,178,2100,54742
13-11-2018,20,19341,19261,8169,3061,49832,1220,471,173,1864,51696
13-11-2018,21,18492,18435,7780,2572,47281,1141,457,176,1774,49055
13-11-2018,22,17181,16865,7414,2477,43939,1146,451,194,1791,45730
13-11-2018,23,15377,15663,7129,2728,40897,1049,450,190,1689,42586
14-11-2018,0,13372,14881,6912,3035,38200,933,449,184,1566,39766
14-11-2018,1,13376,14892,6838,2737,37843,934,445,160,1539,39382
14-11-2018,2,13862,14780,6782,2615,38039,944,445,140,1529,39568
14-11-2018,3,15025,14898,6802,2595,39320,934,446,141,1521,40841
14-11-2018,4,15899,15164,7166,2268,40496,971,446,170,1587,42083
14-11-2018,5,18324,16765,7772,2353,45214,1090,450,154,1694,46908
14-11-2018,6,21170,19044,8264,2655,51135,1205,480,169,1854,52989
14-11-2018,7,22603,19999,8450,3184,54236,1222,920,148,2290,56526
14-11-2018,8,22896,20231,8501,3418,55048,1198,1051,160,2409,57457
14-11-2018,9,22357,19914,8326,3598,54195,1160,1055,319,2534,56729
14-11-2018,10,21992,19341,8244,3733,53309,1160,1045,443,2648,55957
14-11-2018,11,21882,19356,8267,3662,53168,1175,1037,531,2743,55911
14-11-2018,12,21737,19426,8389,3693,53245,1181,1015,582,2778,56023
14-11-2018,13,22352,20124,8410,3813,54699,1167,1044,383,2594,57293
14-11-2018,14,22862,20407,8413,3816,55499,1123,1046,326,2495,57994
14-11-2018,15,23378,20811,8498,3800,56487,1150,1058,322,2530,59017
14-11-2018,16,23571,20905,8569,3832,56876,1184,1051,335,2570,59446
14-11-2018,17,22928,20887,8644,3919,56378,1188,1345,524,3057,59435
14-11-2018,18,22355,20359,8648,3963,55325,1181,1324,380,2885,58210
14-11-2018,19,21674,19555,8405,3753,53386,1155,1065,357,2577,55963
14-11-2018,20,20345,19603,8088,3576,51611,1173,879,172,2224,53835
14-11-2018,21,19832,19186,7808,2863,49688,1066,462,178,1706,51394
14-11-2018,22,18512,18173,7474,2848,47006,1059,454,179,1692,48698
14-11-2018,23,17037,17119,7299,2806,44261,1076,454,162,1692,45953
15-11-2018,0,15798,17080,7443,2916,43238,1042,451,149,1642,44880
15-11-2018,1,15214,17070,7482,2810,42576,1047,450,144,1641,44217
15-11-2018,2,15273,16947,7447,2651,42318,1061,449,141,1651,43969
15-11-2018,3,15364,17339,7559,2285,42548,1090,449,143,1682,44230
15-11-2018,4,16105,17365,7814,2313,43596,1115,451,143,1709,45305
15-11-2018,5,17288,18578,8322,2586,46774,1187,452,149,1788,48562
15-11-2018,6,18850,20261,8631,3064,50805,1216,463,190,1869,52674
15-11-2018,7,20103,21098,8908,3391,53503,1208,996,410,2614,56117
15-11-2018,8,20160,20976,8976,3361,53471,1212,1046,524,2782,56253
15-11-2018,9,19721,20857,8994,3308,52880,1193,788,522,2503,55383
15-11-2018,10,19434,20628,8903,3429,52395,1201,784,536,2521,54916
15-11-2018,11,19338,20501,8828,3072,51739,1218,1028,364,2610,54349
15-11-2018,12,19392,20511,8887,3015,51806,1205,1062,361,2628,54434
15-11-2018,13,19510,20597,9048,2993,52149,1208,1056,388,2652,54801
15-11-2018,14,19804,20792,9075,3149,52820,1216,1065,380,2661,55481
15-11-2018,15,20244,21028,9184,3362,53818,1237,1067,413,2717,56535
15-11-2018,16,20744,21148,9296,3562,54749,1267,1085,413,2765,57514
15-11-2018,17,20804,21118,9276,3773,54970,1283,1208,406,2897,57867
15-11-2018,18,20537,20938,9163,3834,54472,1268,1102,409,2779,57251
15-11-2018,19,19572,20288,8874,3594,52327,1259,1019,311,2589,54916
15-11-2018,20,18997,19687,8638,3548,50870,1250,559,165,1974,52844
15-11-2018,21,18480,18546,8323,3207,48554,1203,502,171,1876,50430
15-11-2018,22,17050,17627,8026,3203,45907,1193,502,174,1869,47776
15-11-2018,23,15404,16954,7706,2824,42888,1192,499,184,1875,44763
16-11-2018,0,14679,16540,7570,2855,41644,1183,500,183,1866,43510
16-11-2018,1,13586,16580,7582,2825,40575,1185,500,172,1857,42432
16-11-2018,2,13188,16646,7519,2843,40197,1194,502,169,1865,42062
16-11-2018,3,13120,16727,7640,2817,40305,1203,499,176,1878,42183
16-11-2018,4,13565,17094,7753,2814,41226,1222,500,193,1915,43141
16-11-2018,5,16177,18005,8090,3069,45341,1230,518,201,1949,47290
16-11-2018,6,18034,20023,8427,3305,49791,1319,730,192,2241,52032
16-11-2018,7,19631,21451,8548,3625,53255,1325,1053,376,2754,56009
16-11-2018,8,20136,21624,8664,3617,54043,1295,1246,405,2946,56989
16-11-2018,9,19461,21392,8644,3493,52992,1300,1097,407,2804,55796
16-11-2018,10,18870,21320,8684,3550,52425,1333,1086,392,2811,55236
16-11-2018,11,18818,21192,8642,3434,52086,1314,1085,191,2590,54676
16-11-2018,12,18797,21126,8663,3529,52116,1309,1045,198,2552,54668
16-11-2018,13,18901,21183,8733,3152,51969,1267,1105,205,2577,54546
16-11-2018,14,19054,21324,8803,3175,52355,1234,1102,214,2550,54905
16-11-2018,15,19240,21278,9011,3151,52679,1230,1241,336,2807,55486
16-11-2018,16,19869,21484,9033,3527,53913,1272,1098,426,2796,56709
16-11-2018,17,19899,21600,9053,3574,54127,1294,1097,404,2795,56922
16-11-2018,18,19239,21361,8824,3787,53211,1292,958,190,2440,55651
16-11-2018,19,17754,20871,8525,3652,50803,1275,812,190,2277,53080
16-11-2018,20,16252,20178,8446,3065,47941,1225,607,185,2017,49958
16-11-2018,21,15622,19502,8349,2875,46349,1229,511,178,1918,48267
16-11-2018,22,14612,18292,8171,2839,43915,1208,508,170,1886,45801
16-11-2018,23,12874,17475,7985,2914,41248,1224,508,155,1887,43135
17-11-2018,0,12059,16767,7879,2818,39525,1036,502,167,1705,41230
17-11-2018,1,10929,16248,7718,2445,37339,1032,499,171,1702,39041
17-11-2018,2,11507,16086,7750,2381,37724,1043,495,153,1691,39415
17-11-2018,3,10987,15963,7728,2116,36794,1042,499,146,1687,38481
17-11-2018,4,11208,16106,7832,2089,37237,1030,503,143,1676,38913
17-11-2018,5,11339,16003,7939,2045,37326,1019,508,150,1677,39003
17-11-2018,6,12690,16924,8088,2318,40021,1021,510,153,1684,41705
17-11-2018,7,14857,18101,8243,2156,43357,1097,510,156,1763,45120
17-11-2018,8,16427,18430,8351,2352,45560,1117,726,162,2005,47565
17-11-2018,9,17213,18441,8382,2443,46479,1106,939,170,2215,48694
17-11-2018,10,17514,18610,8363,2797,47285,1115,962,174,2251,49536
17-11-2018,11,17614,18807,8395,2768,47585,1134,959,153,2246,49831
17-11-2018,12,17043,19019,8427,2748,47238,1124,932,166,2222,49460
17-11-2018,13,16758,18934,8475,2530,46697,1114,902,176,2192,48889
17-11-2018,14,17114,19199,8697,2571,47582,1108,828,192,2128,49710
17-11-2018,15,18195,20095,8923,2708,49921,1099,997,191,2287,52208
17-11-2018,16,18686,20352,9278,2681,50997,1118,1202,212,2532,53529
17-11-2018,17,18888,20361,9296,2720,51265,1126,1139,193,2458,53723
17-11-2018,18,18377,20170,9162,2630,50340,1117,995,193,2305,52645
17-11-2018,19,17716,20031,9000,2320,49067,1088,809,232,2129,51196
17-11-2018,20,17068,19454,8851,2077,47451,1093,656,229,1978,49429
17-11-2018,21,16898,19123,8734,1940,46696,1061,501,214,1776,48472
17-11-2018,22,16577,18687,8640,1960,45863,1112,494,224,1830,47693
17-11-2018,23,14739,17542,8460,1897,42637,1156,490,224,1870,44507
18-11-2018,0,14517,16723,8301,1833,41375,1083,494,246,1823,43198
18-11-2018,1,12412,16186,8153,1727,38478,1029,496,237,1762,40240
18-11-2018,2,11962,16129,8088,1676,37857,1044,497,235,1776,39633
18-11-2018,3,12460,16202,8011,1807,38480,1037,492,244,1773,40253
18-11-2018,4,12973,16181,7844,1830,38828,1047,496,245,1788,40616
18-11-2018,5,12669,16424,7913,1934,38940,1055,509,256,1820,40760
18-11-2018,6,13755,17336,7920,2145,41154,1057,514,284,1855,43009
18-11-2018,7,14641,17953,8166,2279,43039,1046,523,317,1886,44925
18-11-2018,8,15512,18317,8314,2721,44863,1032,520,324,1876,46739
18-11-2018,9,17439,19058,8538,3020,48056,1039,522,298,1859,49915
18-11-2018,10,17694,19059,8465,3313,48531,1020,499,341,1860,50391
18-11-2018,11,17970,19242,8408,3446,49067,1020,499,353,1872,50939
18-11-2018,12,18343,19279,8264,3562,49449,1002,498,362,1862,51311
18-11-2018,13,18135,19208,8181,3439,48964,1001,495,341,1837,50801
18-11-2018,14,18363,19305,8147,3715,49530,1004,502,318,1824,51354
18-11-2018,15,19456,19756,8317,3848,51378,1062,512,314,1888,53266
18-11-2018,16,19597,19957,8416,4282,52253,1088,723,360,2171,54424
18-11-2018,17,20174,20096,8509,4528,53308,1058,716,374,2148,55456
18-11-2018,18,19868,20113,8418,3969,52368,1060,713,417,2190,54558
18-11-2018,19,18919,19927,8226,3652,50724,967,583,413,1963,52687
18-11-2018,20,17171,19048,7960,3745,47923,951,465,413,1829,49752
18-11-2018,21,16083,18682,7606,3800,46171,963,467,406,1836,48007
18-11-2018,22,15878,18088,7416,3497,44880,960,480,385,1825,46705
18-11-2018,23,13358,17092,7244,3307,41000,978,501,402,1881,42881
19-11-2018,0,11499,16235,7159,3156,38049,1050,504,408,1962,40011
19-11-2018,1,11322,15972,7145,3281,37722,1053,503,409,1965,39687
19-11-2018,2,10883,15966,7133,3462,37445,1051,501,381,1933,39378
19-11-2018,3,10634,15918,7133,3611,37297,1040,503,365,1908,39205
19-11-2018,4,11277,16224,7239,3823,38563,1063,504,365,1932,40495
19-11-2018,5,13900,17260,7629,4047,42838,1235,501,375,2111,44949
19-11-2018,6,18089,19648,8196,4116,50049,1268,577,435,2280,52329
19-11-2018,7,21767,21863,8782,3846,56259,1332,696,391,2419,58678
19-11-2018,8,22545,22028,8915,4125,57613,1377,681,447,2505,60118
19-11-2018,9,21674,21906,8971,4212,56763,1385,676,457,2518,59281
19-11-2018,10,21223,21850,9055,4450,56578,1358,668,461,2487,59065
19-11-2018,11,21049,21683,9048,4443,56222,1391,693,385,2469,58691
19-11-2018,12,21045,21281,9089,4548,55963,1381,686,429,2496,58459
19-11-2018,13,21328,21440,9278,4372,56418,1358,692,328,2378,58796
19-11-2018,14,21291,21644,9428,4233,56595,1367,689,351,2407,59002
19-11-2018,15,21799,21862,9578,4317,57557,1358,702,294,2354,59911
19-11-2018,16,22541,22153,9643,4431,58769,1363,698,314,2375,61144
19-11-2018,17,23124,22341,9699,4309,59474,1364,699,396,2459,61933
19-11-2018,18,21685,22250,9562,4958,58455,1363,700,374,2437,60892
19-11-2018,19,20421,21906,9207,4903,56437,1354,638,339,2331,58768
19-11-2018,20,18351,21035,8801,4473,52660,1343,488,336,2167,54827
19-11-2018,21,16827,19692,8639,4702,49859,1334,489,315,2138,51997
19-11-2018,22,14724,18287,8260,4596,45866,1266,482,300,2048,47914
19-11-2018,23,13671,17130,8088,4400,43290,1228,421,298,1947,45237
20-11-2018,0,12653,16885,7981,4306,41824,1057,420,283,1760,43584
20-11-2018,1,12231,16379,7908,4213,40732,1064,418,268,1750,42482
20-11-2018,2,11975,16467,7872,4059,40375,1061,419,255,1735,42110
20-11-2018,3,11907,16518,7842,4145,40411,1067,419,249,1735,42146
20-11-2018,4,12113,17156,7973,4220,41462,1077,430,252,1759,43221
20-11-2018,5,13771,18355,8288,4356,44771,1189,493,250,1932,46703
20-11-2018,6,17233,20436,8869,4867,51405,1257,529,283,2069,53474
20-11-2018,7,20614,22259,9160,4870,56904,1278,592,293,2163,59067
20-11-2018,8,21358,21979,9278,4512,57127,1358,718,239,2315,59442
20-11-2018,9,20598,22187,9141,4852,56777,1247,824,228,2299,59076
20-11-2018,10,19769,22259,9055,5053,56136,1258,810,248,2316,58452
20-11-2018,11,19801,22127,8949,4997,55876,1244,803,241,2288,58164
20-11-2018,12,19386,21908,8795,5510,55598,1246,829,234,2309,57907
20-11-2018,13,20186,21781,8964,5286,56216,1263,805,199,2267,58483
20-11-2018,14,20889,21950,9220,5000,57058,1271,809,201,2281,59339
20-11-2018,15,21982,22179,9389,5018,58569,1280,843,217,2340,60909
20-11-2018,16,22804,22507,9516,4976,59803,1291,832,212,2335,62138
20-11-2018,17,23044,22612,9575,5017,60250,1275,821,251,2347,62597
20-11-2018,18,22182,22434,9487,5208,59311,1272,775,246,2293,61604
20-11-2018,19,20872,22007,9328,5278,57485,1261,742,213,2216,59701
20-11-2018,20,19936,21188,9150,4913,55187,1251,639,187,2077,57264
20-11-2018,21,19479,19688,9008,4794,52971,1256,528,189,1973,54944
20-11-2018,22,17514,18349,8299,4951,49113,1256,506,195,1957,51070
20-11-2018,23,14618,17268,7732,5162,44780,1235,496,188,1919,46699
21-11-2018,0,14300,16558,7520,4670,43048,933,495,189,1617,44665
21-11-2018,1,13586,16330,7522,4958,42397,954,497,187,1638,44035
21-11-2018,2,13296,16278,7516,4765,41855,972,499,179,1650,43505
21-11-2018,3,13196,16451,7553,4904,42106,998,498,185,1681,43787
21-11-2018,4,13712,16691,7730,5159,43293,1030,495,192,1717,45010
21-11-2018,5,15884,17483,8304,5168,46841,1158,542,204,1904,48745
21-11-2018,6,19794,20133,9026,4898,53852,1298,721,266,2285,56137
21-11-2018,7,21886,21809,9375,5212,58283,1301,704,427,2432,60715
21-11-2018,8,22365,21737,9450,5350,58903,1306,762,437,2505,61408
21-11-2018,9,21691,21898,9177,5212,57979,1304,716,445,2465,60444
21-11-2018,10,21331,21914,9093,5369,57707,1294,737,373,2404,60111
21-11-2018,11,21134,21541,9153,5362,57190,1293,719,253,2265,59455
21-11-2018,12,21203,21618,9223,5466,57509,1298,716,399,2413,59922
21-11-2018,13,21335,21653,9453,5534,57975,1297,713,398,2408,60383
21-11-2018,14,21971,21605,9662,5397,58634,1306,730,380,2416,61050
21-11-2018,15,22971,21665,9849,5173,59658,1307,747,462,2516,62174
21-11-2018,16,23589,22016,9885,5137,60627,1306,812,448,2566,63193
21-11-2018,17,23885,22006,9891,5042,60824,1302,881,450,2633,63457
21-11-2018,18,23435,21821,9869,5188,60313,1273,726,399,2398,62711
21-11-2018,19,22302,21624,9554,5190,58672,1261,717,359,2337,61009
21-11-2018,20,21100,21318,9440,4908,56765,1284,717,157,2158,58923
21-11-2018,21,20362,20691,9314,4457,54824,1302,722,152,2176,57000
21-11-2018,22,18775,19571,9046,3947,51337,1315,721,149,2185,53522
21-11-2018,23,17512,18053,8796,3515,47876,1321,720,145,2186,50062
22-11-2018,0,17659,17355,8696,3211,46921,1337,597,141,2075,48996
22-11-2018,1,16890,17070,8539,3124,45623,1361,589,138,2088,47711
22-11-2018,2,16679,16900,8573,2969,45122,1372,588,134,2094,47216
22-11-2018,3,16761,16930,8603,2859,45154,1384,587,119,2090,47244
22-11-2018,4,17604,17372,8692,2944,46613,1389,589,119,2097,48710
22-11-2018,5,19743,18942,8952,2981,50615,1389,710,119,2218,52833
22-11-2018,6,22616,21169,9478,3239,56502,1400,767,126,2293,58795
22-11-2018,7,24149,22305,9876,3649,59980,1380,1012,355,2747,62727
22-11-2018,8,24511,22058,9939,3810,60317,1358,1097,354,2809,63126
22-11-2018,9,24505,21735,9661,3920,59822,1354,1086,356,2796,62618
22-11-2018,10,24384,21705,9555,3989,59633,1343,1083,516,2942,62575
22-11-2018,11,24358,21713,9528,4035,59634,1340,1045,583,2968,62602
22-11-2018,12,24303,21728,9533,3919,59483,1352,1086,394,2832,62315
22-11-2018,13,24219,21880,9857,3948,59905,1343,1087,507,2937,62842
22-11-2018,14,24355,22342,9815,4078,60591,1352,1085,359,2796,63387
22-11-2018,15,24558,22668,9906,3879,61012,1387,1187,398,2972,63984
22-11-2018,16,24913,22685,9872,3941,61411,1371,1236,401,3008,64419
22-11-2018,17,24759,22427,9942,3880,61007,1375,1375,393,3143,64150
22-11-2018,18,24482,22443,9922,3793,60640,1358,1207,408,2973,63613
22-11-2018,19,24406,22185,9726,3605,59922,1309,987,359,2655,62577
22-11-2018,20,24110,21511,9320,3433,58375,1277,910,359,2546,60921
22-11-2018,21,24033,21038,9103,3161,57335,1277,760,123,2160,59495
22-11-2018,22,22908,20356,8999,2839,55102,1286,760,124,2170,57272
22-11-2018,23,21463,19143,8980,2522,52108,1291,726,124,2141,54249
23-11-2018,0,21353,18216,8909,2276,50756,1221,594,123,1938,52694
23-11-2018,1,20467,17257,8887,2269,48881,1218,586,125,1929,50810
23-11-2018,2,19515,17239,9061,2315,48130,1214,579,126,1919,50049
23-11-2018,3,19431,17597,9243,2290,48560,1207,592,126,1925,50485
23-11-2018,4,20234,18041,9515,2349,50139,1261,594,128,1983,52122
23-11-2018,5,21769,19706,9784,2561,53820,1280,666,128,2074,55894
23-11-2018,6,23204,21957,10194,3087,58443,1292,842,188,2322,60765
23-11-2018,7,24544,22171,10740,3487,60943,1277,1004,552,2833,63776
23-11-2018,8,24756,21967,10775,3816,61314,1356,1200,398,2954,64268
23-11-2018,9,24696,21879,10498,3718,60793,1397,1123,427,2947,63740
23-11-2018,10,24662,21924,10279,3494,60359,1373,1130,550,3053,63412
23-11-2018,11,24489,21704,10220,3243,59656,1354,1149,418,2921,62577
23-11-2018,12,24519,21770,10362,3220,59872,1384,1135,408,2927,62799
23-11-2018,13,24654,21848,10541,3095,60138,1436,1075,367,2878,63016
23-11-2018,14,24785,21919,10632,3132,60468,1428,1073,357,2858,63326
23-11-2018,15,25115,21805,10783,3121,60824,1468,1081,342,2891,63715
23-11-2018,16,24750,22131,10945,3055,60880,1453,1082,352,2887,63767
23-11-2018,17,24604,21779,10869,3104,60356,1444,1179,337,2960,63316
23-11-2018,18,24375,21644,10480,3101,59601,1407,1087,341,2835,62436
23-11-2018,19,23623,21692,10156,2944,58416,1399,1054,345,2798,61214
23-11-2018,20,22351,21275,9962,2723,56312,1366,863,147,2376,58688
23-11-2018,21,21735,21270,9814,2486,55306,1355,857,147,2359,57665
23-11-2018,22,20803,20988,9691,2277,53759,1350,768,137,2255,56014
23-11-2018,23,20044,20032,9644,2171,51892,1338,675,132,2145,54037
24-11-2018,0,19409,18981,9504,1908,49803,1085,661,134,1880,51683
24-11-2018,1,19056,18694,9225,1711,48687,989,654,131,1774,50461
24-11-2018,2,18683,18423,9088,1666,47861,970,654,131,1755,49616
24-11-2018,3,18702,18614,9086,1659,48060,967,650,147,1764,49824
24-11-2018,4,18847,18818,9164,1663,48492,1004,647,152,1803,50295
24-11-2018,5,19300,19183,9330,1651,49464,1010,645,149,1804,51268
24-11-2018,6,19562,20057,9382,1801,50803,974,647,152,1773,52576
24-11-2018,7,19728,20831,9471,2089,52118,1206,676,162,2044,54162
24-11-2018,8,20408,21318,9514,2357,53598,1220,653,180,2053,55651
24-11-2018,9,21176,21876,9503,2538,55093,1223,666,175,2064,57157
24-11-2018,10,21516,21653,9513,2685,55368,1226,666,174,2066,57434
24-11-2018,11,21585,21736,9347,2705,55373,1218,667,166,2051,57424
24-11-2018,12,21709,21725,9334,2649,55418,1228,666,177,2071,57489
24-11-2018,13,21699,21704,9216,2669,55288,1229,667,153,2049,57337
24-11-2018,14,21839,21838,9351,2804,55833,1228,666,151,2045,57878
24-11-2018,15,22267,22368,9472,2976,57083,1235,675,152,2062,59145
24-11-2018,16,22989,22511,9328,3389,58216,1233,751,377,2361,60577
24-11-2018,17,23242,22530,9356,3537,58664,1231,751,269,2251,60915
24-11-2018,18,22863,22271,9249,3363,57745,1241,651,152,2044,59789
24-11-2018,19,22445,21823,9162,3177,56607,1212,652,138,2002,58609
24-11-2018,20,21466,21494,9049,2839,54848,1205,648,139,1992,56840
24-11-2018,21,21109,21579,8858,2743,54289,1169,647,137,1953,56242
24-11-2018,22,20576,20604,8794,2922,52898,1042,645,190,1877,54775
24-11-2018,23,19592,19623,8647,2908,50771,955,645,137,1737,52508
25-11-2018,0,19221,18681,8758,2637,49297,990,645,141,1776,51073
25-11-2018,1,18651,18020,8738,2681,48091,902,645,139,1686,49777
25-11-2018,2,17970,17808,8701,2655,47136,849,644,142,1635,48771
25-11-2018,3,17715,17841,8815,2556,46928,847,644,143,1634,48562
25-11-2018,4,17503,17869,8732,2557,46662,853,644,138,1635,48297
25-11-2018,5,17912,18168,8835,2757,47674,853,645,139,1637,49311
25-11-2018,6,18582,18541,8916,2942,48981,903,644,139,1686,50667
25-11-2018,7,19276,19380,9035,3134,50826,880,647,143,1670,52496
25-11-2018,8,20666,20270,9012,3279,53226,1027,648,144,1819,55045
25-11-2018,9,21944,21122,8944,3282,55293,1066,644,146,1856,57149
25-11-2018,10,22519,21839,8907,3442,56707,1053,642,146,1841,58548
25-11-2018,11,22405,21784,8886,3447,56522,1100,643,142,1885,58407
25-11-2018,12,22522,21689,8858,3626,56696,1079,644,143,1866,58562
25-11-2018,13,22670,21272,8772,3554,56268,1063,643,143,1849,58117
25-11-2018,14,22964,21668,8870,3503,57006,1081,648,169,1898,58904
25-11-2018,15,22976,22100,9249,3511,57838,1097,657,180,1934,59772
25-11-2018,16,23979,22358,9376,3739,59451,1092,736,170,1998,61449
25-11-2018,17,24140,22471,9275,3839,59727,1079,742,203,2024,61751
25-11-2018,18,24015,22290,9245,3914,59465,1067,738,165,1970,61435
25-11-2018,19,23946,21956,9160,3848,58909,1079,653,164,1896,60805
25-11-2018,20,23141,21486,9003,3682,57312,1079,648,178,1905,59217
25-11-2018,21,22548,20904,8807,3464,55723,1073,648,163,1884,57607
25-11-2018,22,21448,19702,8558,3324,53032,1133,646,150,1929,54961
25-11-2018,23,19353,18730,8298,3021,49402,1170,673,141,1984,51386
26-11-2018,0,18906,17794,8176,2853,47729,1349,652,140,2141,49870
26-11-2018,1,18382,17426,7961,2596,46365,1436,647,140,2223,48588
26-11-2018,2,16996,17383,7966,2298,44643,1546,647,140,2333,46976
26-11-2018,3,15492,17465,8077,2222,43255,1540,646,142,2328,45583
26-11-2018,4,15739,17615,8375,2214,43943,1558,647,146,2351,46294
26-11-2018,5,19606,18503,8903,2572,49583,1580,675,219,2474,52057
26-11-2018,6,22996,21422,9544,2886,56850,1580,658,202,2440,59290
26-11-2018,7,24352,21966,10076,3143,59536,1578,1043,160,2781,62317
26-11-2018,8,25021,22036,10407,3125,60589,1581,1149,157,2887,63476
26-11-2018,9,24507,22017,10492,3114,60131,1560,1116,164,2840,62971
26-11-2018,10,24831,21984,10406,3073,60294,1564,1068,174,2806,63100
26-11-2018,11,24445,22299,10266,2952,59963,1429,1109,174,2712,62675
26-11-2018,12,24255,22300,10302,2990,59846,1397,1254,191,2842,62688
26-11-2018,13,24282,22461,10552,2961,60255,1335,1239,197,2771,63026
26-11-2018,14,24311,22673,10642,2883,60510,1354,1149,205,2708,63218
26-11-2018,15,24257,22717,10652,2963,60590,1386,1227,190,2803,63393
26-11-2018,16,24378,22602,10787,3077,60843,1392,1304,207,2903,63746
26-11-2018,17,24430,22738,10904,3163,61236,1396,1465,211,3072,64308
26-11-2018,18,24375,22750,10812,3136,61074,1397,1238,184,2819,63893
26-11-2018,19,24493,22710,10612,2951,60766,1414,1052,201,2667,63433
26-11-2018,20,24275,22242,10115,2818,59449,1399,1037,189,2625,62074
26-11-2018,21,23851,21997,9867,2812,58528,1444,838,194,2476,61004
26-11-2018,22,23003,21069,9687,2744,56503,1452,832,189,2473,58976
26-11-2018,23,20822,20230,9441,2475,52968,1442,847,203,2492,55460
27-11-2018,0,20041,19112,9323,2502,50978,1434,833,209,2476,53454
27-11-2018,1,19431,18721,9221,2444,49817,1430,832,230,2492,52309
27-11-2018,2,19019,18499,9135,2437,49090,1428,829,224,2481,51571
27-11-2018,3,19502,18785,9093,2394,49774,1446,833,235,2514,52288
27-11-2018,4,20941,18983,9229,2358,51509,1441,834,229,2504,54013
27-11-2018,5,23170,20789,9618,2398,55974,1443,834,203,2480,58454
27-11-2018,6,24445,22156,10069,2640,59311,1441,841,256,2538,61849
27-11-2018,7,25379,22727,10260,3012,61379,1449,1238,259,2946,64325
27-11-2018,8,25524,22827,10202,3174,61727,1431,1511,275,3217,64944
27-11-2018,9,25595,22765,10014,3117,61492,1433,1320,261,3014,64506
27-11-2018,10,25529,22687,9915,3286,61417,1444,1242,229,2915,64332
27-11-2018,11,25352,22355,9816,3298,60823,1432,1252,219,2903,63726
27-11-2018,12,25208,21925,9723,3341,60198,1450,1225,155,2830,63028
27-11-2018,13,25474,21815,9719,3357,60364,1459,1274,153,2886,63250
27-11-2018,14,25593,22129,9747,3310,60779,1467,1236,144,2847,63626
27-11-2018,15,25576,22149,9815,3307,60848,1483,1317,189,2989,63837
27-11-2018,16,25758,22554,9893,3474,61679,1491,1370,199,3060,64739
27-11-2018,17,25515,22315,9894,3696,61420,1480,1527,218,3225,64645
27-11-2018,18,25324,22260,9933,3762,61280,1462,1413,200,3075,64355
27-11-2018,19,25492,22423,9941,3691,61547,1452,1284,150,2886,64433
27-11-2018,20,25681,22278,9848,3691,61498,1434,1047,154,2635,64133
27-11-2018,21,25222,22034,9585,3467,60308,1423,841,152,2416,62724
27-11-2018,22,24752,20885,9378,3364,58380,1415,834,146,2395,60775
27-11-2018,23,22519,18969,9023,3468,53979,1408,834,148,2390,56369
28-11-2018,0,20551,17899,8786,3138,50375,1121,833,145,2099,52474
28-11-2018,1,18873,17142,8678,3471,48165,1117,832,148,2097,50262
28-11-2018,2,18345,17206,8782,3518,47853,1127,831,154,2112,49965
28-11-2018,3,17420,17350,8943,3594,47308,1114,831,162,2107,49415
28-11-2018,4,18295,17729,9315,3562,48902,1112,832,189,2133,51035
28-11-2018,5,20711,19335,9790,4066,53903,1179,833,205,2217,56120
28-11-2018,6,24674,21937,10136,3700,60449,1288,954,189,2431,62880
28-11-2018,7,25772,23240,10492,4408,63912,1297,972,183,2452,66364
28-11-2018,8,25677,23524,10586,4768,64556,1297,1278,212,2787,67343
28-11-2018,9,25506,22837,10545,5240,64130,1300,939,214,2453,66583
28-11-2018,10,25146,22617,10266,5429,63458,1299,886,178,2363,65821
28-11-2018,11,24027,22676,10145,5871,62719,1256,852,163,2271,64990
28-11-2018,12,23619,22583,10155,5890,62248,1292,869,189,2350,64598
28-11-2018,13,24021,22923,10213,5924,63081,1284,859,247,2390,65471
28-11-2018,14,24177,23461,10410,6040,64089,1295,877,233,2405,66494
28-11-2018,15,24635,24196,10620,5769,65222,1326,1102,230,2658,67880
28-11-2018,16,24598,24513,10552,5864,65528,1343,1102,237,2682,68210
28-11-2018,17,24290,24235,10306,5954,64784,1358,954,183,2495,67279
28-11-2018,18,23851,24080,10195,5587,63714,1364,927,189,2480,66194
28-11-2018,19,22053,23948,9936,5602,61539,1369,890,204,2463,64002
28-11-2018,20,19425,23073,9495,5862,57856,1206,868,238,2312,60168
28-11-2018,21,17962,22970,9460,5893,56285,1044,683,245,1972,58257
28-11-2018,22,16590,22245,9221,5760,53817,1014,662,250,1926,55743
28-11-2018,23,14950,20675,8883,5960,50469,1021,444,268,1733,52202
29-11-2018,0,13695,20098,8815,5546,48154,859,439,269,1567,49721
29-11-2018,1,13178,19733,8814,5251,46975,820,423,289,1532,48507
29-11-2018,2,13242,19903,8835,5450,47431,839,423,294,1556,48987
29-11-2018,3,12843,20346,8886,5383,47457,828,424,330,1582,49039
29-11-2018,4,12537,21154,8983,5466,48140,830,439,341,1610,49750
29-11-2018,5,13431,22478,9174,5321,50407,843,812,393,2048,52455
29-11-2018,6,18168,24286,9573,5479,57506,1062,839,421,2322,59828
29-11-2018,7,21197,25503,10046,5830,62576,1096,891,446,2433,65009
29-11-2018,8,20833,25522,10066,5556,61977,1122,876,488,2486,64463
29-11-2018,9,20560,25409,9818,5434,61221,1125,894,535,2554,63775
29-11-2018,10,20173,25604,9664,5154,60596,1108,892,564,2564,63160
29-11-2018,11,20184,25199,9632,5316,60332,1104,888,552,2544,62876
29-11-2018,12,20358,24839,9712,5365,60274,1146,888,534,2568,62842
29-11-2018,13,20974,25050,9761,5543,61330,1131,887,511,2529,63859
29-11-2018,14,20808,25008,9909,5370,61095,1138,875,531,2544,63639
29-11-2018,15,20630,25268,10168,5507,61574,1155,877,562,2594,64168
29-11-2018,16,21171,25913,10155,5826,63065,1164,904,585,2653,65718
29-11-2018,17,20834,25606,10097,6307,62845,1181,913,593,2687,65532
29-11-2018,18,20012,24835,10048,5956,60852,1174,929,584,2687,63539
29-11-2018,19,18544,24557,9701,5908,58710,1116,877,599,2592,61302
29-11-2018,20,16681,23507,9366,6088,55643,1081,865,600,2546,58189
29-11-2018,21,15102,22378,9198,6015,52694,950,701,576,2227,54921
29-11-2018,22,13806,21508,9079,5341,49735,937,704,560,2201,51936
29-11-2018,23,13283,20194,8910,5139,47526,933,480,574,1987,49513
30-11-2018,0,12650,19205,8811,5157,45824,933,464,590,1987,47811
30-11-2018,1,11705,18724,8763,5059,44253,909,461,591,1961,46214
30-11-2018,2,11376,18838,8721,5067,44003,911,461,590,1962,45965
30-11-2018,3,10909,18776,8739,4990,43414,906,464,602,1972,45386
30-11-2018,4,11036,19180,8838,5122,44174,908,477,593,1978,46152
30-11-2018,5,12781,20617,9076,4977,47452,951,692,599,2242,49694
30-11-2018,6,16529,23133,9398,4931,53991,1145,707,596,2448,56439
30-11-2018,7,19794,24651,9904,5443,59792,1219,716,598,2533,62325
30-11-2018,8,20367,24782,9898,5622,60668,1311,811,593,2715,63383
30-11-2018,9,20251,24558,9553,5197,59559,1178,916,588,2682,62241
30-11-2018,10,19759,24560,9535,5417,59270,1163,809,611,2583,61853
30-11-2018,11,19582,24453,9514,5424,58974,1156,716,608,2480,61454
30-11-2018,12,19493,24435,9548,5519,58994,1135,721,611,2467,61461
30-11-2018,13,20011,24543,9593,5281,59427,1125,716,758,2599,62026
30-11-2018,14,20187,24735,9747,5609,60279,1119,713,604,2436,62715
30-11-2018,15,20061,24306,9989,5710,60065,1118,697,705,2520,62585
30-11-2018,16,20629,24203,9928,5560,60320,1204,699,801,2704,63024
30-11-2018,17,20746,24268,9777,4968,59759,1209,715,796,2720,62479
30-11-2018,18,20342,24345,9705,4532,58924,1187,710,676,2573,61497
30-11-2018,19,18908,23756,9409,5416,57489,1175,694,573,2442,59931
30-11-2018,20,16760,23064,9206,5364,54393,1149,689,572,2410,56803
30-11-2018,21,16072,22071,9001,5129,52274,1179,691,563,2433,54707
30-11-2018,22,15163,21043,8937,4954,50097,1043,686,542,2271,52368
30-11-2018,23,13435,20211,8891,4840,47378,1011,681,531,2223,49601
01-12-2018,0,12876,19006,8749,4078,44709,881,680,512,2073,46782
01-12-2018,1,12090,18491,8649,3916,43146,866,686,507,2059,45205
01-12-2018,2,11648,18289,8575,3930,42441,895,677,486,2058,44499
01-12-2018,3,11440,18151,8617,4042,42250,874,688,482,2044,44294
01-12-2018,4,11562,18192,8614,3863,42232,874,680,476,2030,44262
01-12-2018,5,11905,18498,8682,3683,42767,873,691,463,2027,44794
01-12-2018,6,13308,19472,8738,3734,45252,878,701,436,2015,47267
01-12-2018,7,14777,20969,8839,4034,48620,892,679,396,1967,50587
01-12-2018,8,16370,22156,9012,4067,51606,988,679,351,2018,53624
01-12-2018,9,17544,22456,9111,4283,53394,1001,786,365,2152,55546
01-12-2018,10,18191,22375,9169,4315,54051,992,841,211,2044,56095
01-12-2018,11,18588,22235,9109,4118,54051,963,705,351,2019,56070
01-12-2018,12,18531,22353,9192,3910,53985,913,698,374,1985,55970
01-12-2018,13,18239,22047,9155,4273,53713,922,681,383,1986,55699
01-12-2018,14,18821,22228,9248,3670,53969,933,662,387,1982,55951
01-12-2018,15,19587,22294,9443,3749,55072,940,693,385,2018,57090
01-12-2018,16,20328,22311,9495,3888,56023,960,726,509,2195,58218
01-12-2018,17,20216,22336,9400,4138,56090,950,659,508,2117,58207
01-12-2018,18,19021,22172,9271,4140,54605,949,663,372,1984,56589
01-12-2018,19,16864,21551,9160,4511,52085,922,665,369,1956,54041
01-12-2018,20,14958,20814,8912,4266,48951,837,662,284,1783,50734
01-12-2018,21,14697,20116,8809,3803,47425,815,658,259,1732,49157
01-12-2018,22,13642,18738,8634,3561,44574,811,652,236,1699,46273
01-12-2018,23,12943,17892,8592,3311,42739,763,651,206,1620,44359
02-12-2018,0,12166,16751,8534,2983,40433,649,652,177,1478,41911
02-12-2018,1,11930,15903,8470,3032,39335,633,651,173,1457,40792
02-12-2018,2,11976,15531,8404,3240,39152,641,507,177,1325,40477
02-12-2018,3,11808,15502,8386,3482,39179,647,424,180,1251,40430
02-12-2018,4,11390,15581,8339,3601,38911,644,424,178,1246,40157
02-12-2018,5,11061,15880,8257,3673,38870,646,511,178,1335,40205
02-12-2018,6,11707,16989,8298,3541,40535,653,644,183,1480,42015
02-12-2018,7,12250,18035,8215,3796,42296,655,646,182,1483,43779
02-12-2018,8,13120,18555,8227,4196,44098,695,645,184,1524,45622
02-12-2018,9,14600,19385,8280,4375,46640,698,642,183,1523,48163
02-12-2018,10,16525,20056,8349,4374,49304,736,642,186,1564,50868
02-12-2018,11,17315,20494,8393,4353,50556,905,676,259,1840,52396
02-12-2018,12,17184,20643,8407,4274,50509,909,650,292,1851,52360
02-12-2018,13,17019,20656,8403,4092,50171,797,671,184,1652,51823
02-12-2018,14,16604,21244,8360,3942,50151,808,649,193,1650,51801
02-12-2018,15,17302,21386,8376,3865,50930,830,666,214,1710,52640
02-12-2018,16,17785,21497,8441,3814,51538,928,651,338,1917,53455
02-12-2018,17,17971,21371,8625,3845,51813,934,653,308,1895,53708
02-12-2018,18,17783,21242,8891,3834,51751,827,659,286,1772,53523
02-12-2018,19,16670,20915,8404,3882,49872,699,728,298,1725,51597
02-12-2018,20,15635,20214,8295,3839,47985,698,732,320,1750,49735
02-12-2018,21,14272,19765,8181,3592,45810,687,730,366,1783,47593
02-12-2018,22,13442,18682,8071,3300,43496,681,709,378,1768,45264
02-12-2018,23,12495,17807,8107,2950,41358,700,519,383,1602,42960
03-12-2018,0,11643,16669,8161,2634,39106,716,649,389,1754,40860
03-12-2018,1,10791,16118,8092,2645,37645,734,522,379,1635,39280
03-12-2018,2,10341,16111,8068,2844,37365,731,511,384,1626,38991
03-12-2018,3,10158,16021,8151,3192,37524,729,511,364,1604,39128
03-12-2018,4,10843,16357,8359,3367,38928,737,533,338,1608,40536
03-12-2018,5,12732,17280,8654,3901,42567,815,659,324,1798,44365
03-12-2018,6,16286,20103,9036,4650,50077,975,753,318,2046,52123
03-12-2018,7,20705,21748,9627,4868,56949,1016,772,359,2147,59096
03-12-2018,8,21770,22368,9750,4811,58699,1016,869,486,2371,61070
03-12-2018,9,21141,22280,9612,4917,57949,1026,864,482,2372,60321
03-12-2018,10,20531,22264,9361,5100,57257,1025,850,485,2360,59617
03-12-2018,11,20017,22194,9326,5549,57086,1027,845,656,2528,59614
03-12-2018,12,19447,21869,9537,5863,56717,1023,1002,522,2547,59264
03-12-2018,13,20372,22246,9582,5638,57839,1015,1060,518,2593,60432
03-12-2018,14,21008,22011,9697,5269,57985,1015,998,509,2522,60507
03-12-2018,15,20805,22269,9867,5451,58394,1017,1008,546,2571,60965
03-12-2018,16,20908,22659,9901,5493,58962,1009,1046,675,2730,61692
03-12-2018,17,21536,22786,9685,5376,59384,1007,983,678,2668,62052
03-12-2018,18,21115,22612,9604,4798,58129,1020,814,509,2343,60472
03-12-2018,19,20079,21973,9379,4524,55957,1016,749,423,2188,58145
03-12-2018,20,18738,21201,9213,4250,53401,967,746,363,2076,55477
03-12-2018,21,17087,20315,8870,4131,50403,962,730,346,2038,52441
03-12-2018,22,14943,19348,8531,4788,47610,822,663,317,1802,49412
03-12-2018,23,12191,18454,8298,5064,44007,749,635,311,1695,45702
04-12-2018,0,11907,18494,8237,5045,43684,742,398,296,1436,45120
04-12-2018,1,11364,17981,8128,4799,42272,725,393,279,1397,43669
04-12-2018,2,11390,17809,8078,4646,41922,727,392,294,1413,43335
04-12-2018,3,11547,17906,8071,4739,42264,756,393,313,1462,43726
04-12-2018,4,11702,18332,8117,5064,43217,749,459,303,1511,44728
04-12-2018,5,13140,19439,8470,5395,46444,824,510,289,1623,48067
04-12-2018,6,15838,21540,9299,5521,52200,1063,684,290,2037,54237
04-12-2018,7,18228,22561,9576,6078,56443,1062,796,304,2162,58605
04-12-2018,8,18706,22836,9443,6109,57094,1049,753,521,2323,59417
04-12-2018,9,18331,23148,9270,6232,56980,1043,717,497,2257,59237
04-12-2018,10,18444,23330,8755,6459,56989,1050,718,496,2264,59253
04-12-2018,11,17644,23498,8722,7074,56938,1018,718,421,2157,59095
04-12-2018,12,17322,23574,9067,6867,56831,1002,709,453,2164,58995
04-12-2018,13,17642,23630,9156,6793,57221,992,706,469,2167,59388
04-12-2018,14,18174,23834,9320,6338,57666,1023,714,567,2304,59970
04-12-2018,15,18770,24361,9383,6244,58758,1007,720,757,2484,61242
04-12-2018,16,19781,25019,9262,5889,59951,983,732,788,2503,62454
04-12-2018,17,20398,25255,9159,5793,60604,999,733,754,2486,63090
04-12-2018,18,19769,25345,9084,5279,59477,1057,713,572,2342,61819
04-12-2018,19,19649,25612,8681,5038,58980,996,705,439,2140,61120
04-12-2018,20,19161,25291,8390,4549,57391,852,533,459,1844,59235
04-12-2018,21,18102,24741,8051,4070,54963,818,487,441,1746,56709
04-12-2018,22,16202,23923,7700,3702,51527,795,496,439,1730,53257
04-12-2018,23,14581,22610,7449,3358,47998,799,497,422,1718,49716
05-12-2018,0,14666,21298,7343,2811,46118,827,492,431,1750,47868
05-12-2018,1,14527,20749,7299,2826,45402,865,490,457,1812,47214
05-12-2018,2,14707,20351,7271,2739,45070,862,492,458,1812,46882
05-12-2018,3,14496,20362,7307,2660,44826,861,496,464,1821,46647
05-12-2018,4,15082,20676,7543,2691,45992,909,491,467,1867,47859
05-12-2018,5,17055,21631,7995,2900,49582,974,495,417,1886,51468
05-12-2018,6,21277,23515,8625,2883,56301,1326,712,436,2474,58775
05-12-2018,7,23678,24331,8963,3525,60496,1316,718,447,2481,62977
05-12-2018,8,24243,24445,8952,3555,61196,1361,725,608,2694,63890
05-12-2018,9,24133,24064,8962,3638,60796,1369,722,784,2875,63671
05-12-2018,10,24181,24002,8745,3402,60330,1399,710,741,2850,63180
05-12-2018,11,23867,23822,8636,3369,59695,1422,712,624,2758,62453
05-12-2018,12,23751,23594,8925,3275,59546,1404,703,581,2688,62234
05-12-2018,13,23705,23752,8998,3366,59822,1424,725,573,2722,62544
05-12-2018,14,23670,23865,9150,3631,60317,1437,708,562,2707,63024
05-12-2018,15,23899,24146,9270,3713,61028,1409,765,536,2710,63738
05-12-2018,16,23926,24185,9398,4184,61692,1449,1032,520,3001,64693
05-12-2018,17,23837,24251,9358,4196,61642,1425,1006,534,2965,64607
05-12-2018,18,23885,24123,9340,3595,60943,1355,719,621,2695,63638
05-12-2018,19,22846,23859,8931,3969,59605,1275,717,417,2409,62014
05-12-2018,20,20873,23454,8796,4029,57154,1221,705,318,2244,59398
05-12-2018,21,19251,23268,8740,3797,55057,1177,483,282,1942,56999
05-12-2018,22,17931,22464,8532,3444,52372,1219,474,246,1939,54311
05-12-2018,23,15567,21216,8192,3306,48282,1057,480,226,1763,50045
06-12-2018,0,15260,19224,8056,2931,45471,861,487,239,1587,47058
06-12-2018,1,13931,18751,8038,3157,43876,838,484,253,1575,45451
06-12-2018,2,13539,18486,8033,3248,43308,864,478,280,1622,44930
06-12-2018,3,13360,18494,8096,3219,43169,866,478,292,1636,44805
06-12-2018,4,13604,18981,8262,2816,43665,863,481,321,1665,45330
06-12-2018,5,16100,20106,8534,3092,47832,960,611,341,1912,49744
06-12-2018,6,20983,22038,8824,3670,55514,1053,635,316,2004,57518
06-12-2018,7,23711,23198,9039,3912,59861,1081,701,289,2071,61932
06-12-2018,8,24027,23579,9124,3955,60683,1108,701,276,2085,62768
06-12-2018,9,24014,23503,9178,3900,60596,1068,703,409,2180,62776
06-12-2018,10,23818,23470,9243,3902,60433,1075,706,401,2182,62615
06-12-2018,11,23956,22988,9148,3986,60078,1044,702,337,2083,62161
06-12-2018,12,24300,22984,9032,3861,60177,1002,716,221,1939,62116
06-12-2018,13,24579,22800,9014,4030,60423,1000,719,211,1930,62353
06-12-2018,14,24972,22814,9031,4226,61044,995,721,221,1937,62981
06-12-2018,15,25542,23054,9140,4364,62100,1042,725,281,2048,64148
06-12-2018,16,25714,23050,9282,4398,62444,1130,723,427,2280,64724
06-12-2018,17,25028,22752,9181,4638,61600,1132,718,449,2299,63899
06-12-2018,18,24331,22500,9037,4783,60649,1115,719,396,2230,62879
06-12-2018,19,23248,22128,8860,4821,59056,1050,719,298,2067,61123
06-12-2018,20,22058,21309,8655,5231,57253,986,731,345,2062,59315
06-12-2018,21,19936,20468,8510,5083,54000,883,619,404,1906,55906
06-12-2018,22,18265,19195,8321,4714,50495,850,563,429,1842,52337
06-12-2018,23,15695,18094,8027,4538,46354,901,488,440,1829,48183
07-12-2018,0,13807,17866,7860,4348,43881,982,492,426,1900,45781
07-12-2018,1,12527,17727,7727,4285,42266,927,492,432,1851,44117
07-12-2018,2,12016,17765,7730,3857,41369,927,487,472,1886,43255
07-12-2018,3,12382,18137,7758,3452,41729,914,492,491,1897,43626
07-12-2018,4,12798,18654,7837,3400,42689,915,492,509,1916,44605
07-12-2018,5,14964,19341,8115,3090,45510,1267,503,604,2374,47884
07-12-2018,6,19161,21200,8673,3183,52218,1269,713,448,2430,54648
07-12-2018,7,22723,22043,9168,3715,57648,1286,720,397,2403,60051
07-12-2018,8,24008,22279,9451,3424,59162,1318,720,358,2396,61558
07-12-2018,9,23968,22246,9426,3036,58675,1311,718,342,2371,61046
07-12-2018,10,23907,22009,9179,3436,58530,1306,730,336,2372,60902
07-12-2018,11,23237,21363,9052,3970,57624,1314,727,314,2355,59979
07-12-2018,12,22782,21162,9247,4564,57756,1325,722,320,2367,60123
07-12-2018,13,21687,21232,9313,4713,56946,1321,724,322,2367,59313
07-12-2018,14,21020,21253,9337,5394,57004,1325,727,316,2368,59372
07-12-2018,15,20653,21343,9329,5935,57260,1337,723,314,2374,59634
07-12-2018,16,21259,21439,9373,6125,58196,1341,723,460,2524,60720
07-12-2018,17,21353,21451,9329,5912,58045,1339,708,456,2503,60548
07-12-2018,18,20621,21495,9091,5741,56949,1308,706,251,2265,59214
07-12-2018,19,18763,21314,8701,5518,54297,1290,721,272,2283,56580
07-12-2018,20,17009,20960,8289,5293,51550,1276,698,286,2260,53810
07-12-2018,21,16155,20189,8034,4928,49307,1104,486,299,1889,51196
07-12-2018,22,14694,19755,7928,4561,46939,844,475,325,1644,48583
07-12-2018,23,13845,19230,7734,3956,44763,783,476,333,1592,46355
08-12-2018,0,13145,17718,7622,4327,42812,748,463,376,1587,44399
08-12-2018,1,13055,17086,7612,4203,41957,735,420,414,1569,43526
08-12-2018,2,12390,17185,7609,3828,41012,719,401,444,1564,42576
08-12-2018,3,11831,17114,7622,3418,39985,713,405,461,1579,41564
08-12-2018,4,11654,17169,7655,3613,40091,701,411,457,1569,41660
08-12-2018,5,11870,17213,7682,3733,40498,708,457,438,1603,42101
08-12-2018,6,12471,18112,7755,3894,42231,703,483,412,1598,43829
08-12-2018,7,13435,18898,7936,4227,44496,702,483,394,1579,46075
08-12-2018,8,15208,19999,8092,4652,47952,732,483,399,1614,49566
08-12-2018,9,16616,20863,8158,4792,50429,817,480,490,1787,52216
08-12-2018,10,17095,21358,8192,5019,51664,797,488,561,1846,53510
08-12-2018,11,17116,21422,8283,5135,51957,786,496,568,1850,53807
08-12-2018,12,16826,21698,8343,5203,52071,774,504,577,1855,53926
08-12-2018,13,16410,21704,8398,5191,51703,790,505,529,1824,53527
08-12-2018,14,16394,22062,8514,5074,52043,827,501,471,1799,53842
08-12-2018,15,16875,22327,8603,5141,52946,847,501,458,1806,54752
08-12-2018,16,17078,22411,8676,5474,53639,815,623,439,1877,55516
08-12-2018,17,17146,22612,8708,5586,54053,781,500,485,1766,55819
08-12-2018,18,16448,22524,8622,5693,53286,745,503,524,1772,55058
08-12-2018,19,15537,21934,8413,5754,51636,731,509,555,1795,53431
08-12-2018,20,13973,20804,8346,5411,48535,714,509,559,1782,50317
08-12-2018,21,14153,19936,8283,5184,47557,706,506,561,1773,49330
08-12-2018,22,14059,19253,8194,4854,46360,734,469,549,1752,48112
08-12-2018,23,13913,18307,8154,4439,44813,746,431,549,1726,46539
09-12-2018,0,13283,17481,8092,3452,42309,719,433,554,1706,44015
09-12-2018,1,12417,17106,8094,3082,40699,720,434,558,1712,42411
09-12-2018,2,11693,16959,8053,2647,39354,710,432,549,1691,41045
09-12-2018,3,11448,16803,8083,2523,38858,711,429,551,1691,40549
09-12-2018,4,11393,16770,8090,2505,38759,720,434,538,1692,40451
09-12-2018,5,11308,16700,8055,2819,38883,721,434,523,1678,40561
09-12-2018,6,11594,17006,8112,3374,40088,709,433,524,1666,41754
09-12-2018,7,12357,18023,8219,3680,42280,688,430,514,1632,43912
09-12-2018,8,13027,19005,8475,4047,44556,708,514,484,1706,46262
09-12-2018,9,13786,19555,8594,4218,46153,718,492,464,1674,47827
09-12-2018,10,14742,19894,8716,4368,47720,724,483,477,1684,49404
09-12-2018,11,15454,19902,8800,4273,48429,703,482,484,1669,50098
09-12-2018,12,15519,19961,8890,4459,48830,693,478,474,1645,50475
09-12-2018,13,15363,20018,8907,4491,48781,680,477,475,1632,50413
09-12-2018,14,15181,20193,8956,4526,48856,696,478,466,1640,50496
09-12-2018,15,16042,20414,8960,4582,49998,686,483,453,1622,51620
09-12-2018,16,17520,20842,8989,4573,51926,674,757,426,1857,53783
09-12-2018,17,17487,20975,9006,4728,52196,673,790,386,1849,54045
09-12-2018,18,16831,20817,8908,4934,51490,658,613,339,1610,53100
09-12-2018,19,16271,20912,8820,5000,51004,633,473,296,1402,52406
09-12-2018,20,15141,20875,8535,4848,49399,609,470,254,1333,50732
09-12-2018,21,14677,20115,8311,4530,47634,654,464,227,1345,48979
09-12-2018,22,14316,19449,8117,4194,46076,648,469,231,1348,47424
09-12-2018,23,13803,18292,8010,4395,44499,653,390,219,1262,45761
10-12-2018,0,13183,17250,7914,4037,42383,676,424,227,1327,43710
10-12-2018,1,12544,16856,7763,3967,41131,631,386,233,1250,42381
10-12-2018,2,12115,17007,7637,4125,40884,626,385,224,1235,42119
10-12-2018,3,12220,17238,7640,4460,41559,611,396,230,1237,42796
10-12-2018,4,12463,17915,7887,4482,42747,647,452,233,1332,44079
10-12-2018,5,14034,18863,8237,5152,46286,751,464,248,1463,47749
10-12-2018,6,17626,21177,8784,5452,53039,767,613,250,1630,54669
10-12-2018,7,21664,22884,9087,5423,59058,794,680,399,1873,60931
10-12-2018,8,22798,22853,9020,5366,60035,763,676,434,1873,61908
10-12-2018,9,22111,22715,9052,5560,59437,741,690,417,1848,61285
10-12-2018,10,21272,22570,8631,5949,58421,772,697,261,1730,60151
10-12-2018,11,20350,22613,8476,6562,58001,780,698,252,1730,59731
10-12-2018,12,20009,22655,8739,6631,58033,782,754,381,1917,59950
10-12-2018,13,20226,22695,8766,6685,58374,814,838,365,2017,60391
10-12-2018,14,21170,22801,8917,5981,58868,774,986,371,2131,60999
10-12-2018,15,22413,22993,9003,5413,59822,774,1040,407,2221,62043
10-12-2018,16,22956,23126,9006,5207,60294,763,971,406,2140,62434
10-12-2018,17,22993,23250,8968,5295,60506,752,793,449,1994,62500
10-12-2018,18,21737,22984,8905,5490,59116,720,629,490,1839,60955
10-12-2018,19,20565,22628,8581,5108,56882,703,666,279,1648,58530
10-12-2018,20,18936,22170,8145,5377,54626,675,555,241,1471,56097
10-12-2018,21,17100,21535,7732,5570,51937,651,472,254,1377,53314
10-12-2018,22,15438,20950,7530,5289,49207,653,465,218,1336,50543
10-12-2018,23,13890,20004,7416,5025,46336,665,466,228,1359,47695
11-12-2018,0,13302,19005,7333,4430,44071,730,466,222,1418,45489
11-12-2018,1,12494,18678,7282,4512,42968,758,468,203,1429,44397
11-12-2018,2,11785,18532,7321,4582,42223,767,469,202,1438,43661
11-12-2018,3,11709,18625,7426,4684,42444,805,468,196,1469,43913
11-12-2018,4,12435,18988,7489,4428,43339,843,471,184,1498,44837
11-12-2018,5,14794,19725,7977,4454,46949,1128,595,182,1905,48854
11-12-2018,6,18141,21564,8565,4786,53057,1248,723,187,2158,55215
11-12-2018,7,21503,22814,8694,4537,57549,1334,799,382,2515,60064
11-12-2018,8,23125,23015,8738,4770,59649,1350,729,345,2424,62073
11-12-2018,9,23479,23174,8601,4516,59771,1376,785,346,2507,62278
11-12-2018,10,23914,23200,8445,4252,59813,1353,739,221,2313,62126
11-12-2018,11,23641,23223,8524,4528,59916,1374,707,218,2299,62215
11-12-2018,12,23350,23216,8841,4574,59980,1392,803,343,2538,62518
11-12-2018,13,23671,23367,8920,4744,60702,1403,814,363,2580,63282
11-12-2018,14,23985,23410,8997,4922,61314,1413,835,382,2630,63944
11-12-2018,15,24948,23349,9098,5063,62461,1449,988,376,2813,65274
11-12-2018,16,25237,23431,9103,5119,62891,1433,1071,351,2855,65746
11-12-2018,17,25366,23368,9097,5025,62856,1437,965,357,2759,65615
11-12-2018,18,24897,23088,8974,4799,61757,1452,855,333,2640,64397
11-12-2018,19,24428,22897,8805,4449,60580,1415,724,194,2333,62913
11-12-2018,20,23282,22711,8618,4204,58816,1426,710,140,2276,61092
11-12-2018,21,22481,21984,8508,3777,56749,1405,631,143,2179,58928
11-12-2018,22,21673,21037,8308,3493,54511,1417,611,146,2174,56685
11-12-2018,23,20519,20363,8079,3343,52304,1407,562,144,2113,54417
12-12-2018,0,19733,18810,7827,3003,49373,1384,617,141,2142,51515
12-12-2018,1,18692,18321,7646,2896,47555,1379,617,146,2142,49697
12-12-2018,2,18223,18191,7640,2781,46835,1261,626,151,2038,48873
12-12-2018,3,18250,18301,7763,2755,47070,1231,620,153,2004,49074
12-12-2018,4,18943,18388,8037,2811,48178,1372,643,163,2178,50356
12-12-2018,5,21649,19721,8518,3057,52945,1324,699,178,2201,55146
12-12-2018,6,24281,21795,8856,3483,58414,1369,1095,185,2649,61063
12-12-2018,7,25907,23102,9173,4020,62201,1409,1113,620,3142,65343
12-12-2018,8,26240,23482,9312,4176,63212,1434,1182,636,3252,66464
12-12-2018,9,26058,23385,9284,4129,62856,1404,1185,649,3238,66094
12-12-2018,10,26333,23315,9121,4019,62789,1412,1096,457,2965,65754
12-12-2018,11,26344,23286,9107,4034,62771,1441,1104,230,2775,65546
12-12-2018,12,26518,23398,9219,3980,63116,1446,1098,313,2857,65973
12-12-2018,13,26568,23329,9366,4000,63264,1456,1100,252,2808,66072
12-12-2018,14,26549,23309,9439,3906,63203,1422,1190,467,3079,66282
12-12-2018,15,26642,23464,9516,3895,63518,1440,1369,633,3442,66960
12-12-2018,16,26878,23654,9542,4059,64136,1355,1755,735,3845,67981
12-12-2018,17,26966,23563,9546,4204,64279,1348,1638,722,3708,67987
12-12-2018,18,26554,23274,9484,4192,63503,1302,1240,619,3161,66664
12-12-2018,19,26306,22748,9261,4091,62406,1275,1078,287,2640,65046
12-12-2018,20,24979,22245,9002,3892,60117,1240,1090,268,2598,62715
12-12-2018,21,24406,21120,8711,3605,57841,1301,748,259,2308,60149
12-12-2018,22,23403,20281,8630,3500,55815,1336,681,255,2272,58087
12-12-2018,23,21644,19181,8361,3173,52359,1325,686,235,2246,54605
13-12-2018,0,21428,18375,8221,3006,51031,1341,798,237,2376,53407
13-12-2018,1,20049,18116,8075,2807,49049,1342,804,241,2387,51436
13-12-2018,2,19287,18000,8039,2832,48159,1309,802,267,2378,50537
13-12-2018,3,19063,18130,8145,2792,48131,1283,803,262,2348,50479
13-12-2018,4,19288,18269,8216,2862,48635,1271,798,235,2304,50939
13-12-2018,5,21567,19028,8779,3219,52593,1314,831,243,2388,54981
13-12-2018,6,24689,21067,9391,3802,58949,1348,1010,231,2589,61538
13-12-2018,7,26307,23182,9774,4251,63514,1363,1190,340,2893,66407
13-12-2018,8,26219,23643,9929,4402,64195,1369,1364,448,3181,67376
13-12-2018,9,26018,23729,10038,4563,64349,1351,1247,411,3009,67358
13-12-2018,10,26113,23800,9863,4419,64195,1336,1100,220,2656,66851
13-12-2018,11,25874,23767,9736,4665,64043,1444,1023,196,2663,66706
13-12-2018,12,26069,23955,9935,4656,64615,1450,1188,238,2876,67491
13-12-2018,13,26186,23907,9889,4625,64608,1467,1194,213,2874,67482
13-12-2018,14,26215,24086,10005,4677,64983,1467,1338,226,3031,68014
13-12-2018,15,26288,24371,10172,4682,65513,1471,1345,433,3249,68762
13-12-2018,16,26610,24293,10130,4724,65757,1471,1340,473,3284,69041
13-12-2018,17,27010,24372,10019,4764,66165,1438,1253,322,3013,69178
13-12-2018,18,26649,24233,9798,4808,65488,1400,1247,481,3128,68616
13-12-2018,19,26055,23750,9614,4590,64009,1410,1084,257,2751,66760
13-12-2018,20,25306,22583,9472,4447,61808,1406,991,214,2611,64419
13-12-2018,21,25280,21453,9342,4225,60299,1413,672,209,2294,62593
13-12-2018,22,24006,20640,9133,3921,57701,1404,666,205,2275,59976
13-12-2018,23,22488,19826,8840,3643,54797,1382,664,204,2250,57047
14-12-2018,0,20789,19262,8717,3427,52194,1342,667,210,2219,54413
14-12-2018,1,20030,18859,8653,3213,50755,1263,662,212,2137,52892
14-12-2018,2,19575,18589,8540,3182,49886,1207,661,207,2075,51961
14-12-2018,3,20119,18956,8690,3086,50853,1264,661,204,2129,52982
14-12-2018,4,20646,18953,8850,3108,51557,1346,666,199,2211,53768
14-12-2018,5,23500,20171,9268,3190,56130,1345,702,197,2244,58374
14-12-2018,6,25805,22222,9748,3737,61513,1404,1122,229,2755,64268
14-12-2018,7,26767,23877,10113,4039,64798,1411,1294,489,3194,67992
14-12-2018,8,27513,24528,10332,4252,66627,1408,1315,695,3418,70045
14-12-2018,9,27117,24374,10245,4371,66107,1410,1565,668,3643,69750
14-12-2018,10,26899,24232,10069,4247,65449,1411,1573,684,3668,69117
14-12-2018,11,26869,24132,9988,4229,65219,1410,1504,497,3411,68630
14-12-2018,12,27041,24131,9792,4276,65240,1409,1657,482,3548,68788
14-12-2018,13,27166,24150,9543,4196,65056,1408,1571,477,3456,68512
14-12-2018,14,27041,24116,9703,4147,65007,1413,1483,462,3358,68365
14-12-2018,15,27324,24307,9890,4232,65754,1410,1647,486,3543,69297
14-12-2018,16,27277,24347,9901,4375,65901,1410,1640,625,3675,69576
14-12-2018,17,27167,24171,10068,4366,65771,1398,1461,640,3499,69270
14-12-2018,18,26832,23915,9943,4314,65004,1356,1203,645,3204,68208
14-12-2018,19,26215,23102,9748,4035,63102,1330,1156,458,2944,66046
14-12-2018,20,25370,21930,9401,3859,60559,1269,1009,197,2475,63034
14-12-2018,21,25365,21141,9266,3462,59236,1312,621,204,2137,61373
14-12-2018,22,24637,20099,9070,3260,57066,1324,621,192,2137,59203
14-12-2018,23,23089,19070,8891,3045,54095,1320,620,192,2132,56227
15-12-2018,0,23141,18185,8581,3170,53078,1191,703,191,2085,55163
15-12-2018,1,21497,17910,8488,2901,50797,1191,617,193,2001,52798
15-12-2018,2,20916,17985,8368,2916,50186,1135,616,191,1942,52128
15-12-2018,3,20891,17962,8301,2809,49964,1187,615,186,1988,51952
15-12-2018,4,20511,18071,8453,2751,49785,1003,615,193,1811,51596
15-12-2018,5,20759,18215,8555,2769,50298,1149,614,188,1951,52249
15-12-2018,6,21028,18897,8674,2867,51466,1160,618,189,1967,53433
15-12-2018,7,22463,20125,8911,3056,54556,1191,697,192,2080,56636
15-12-2018,8,24586,21203,9085,3294,58170,1172,757,189,2118,60288
15-12-2018,9,25239,21666,9236,3432,59573,1132,937,199,2268,61841
15-12-2018,10,25443,22157,9314,3709,60622,1166,996,200,2362,62984
15-12-2018,11,25496,22229,9258,3918,60901,1188,1103,189,2480,63381
15-12-2018,12,25533,22256,9240,4012,61042,1182,703,175,2060,63102
15-12-2018,13,25539,22278,9156,4072,61046,1161,696,183,2040,63086
15-12-2018,14,25713,22506,9097,4115,61433,1213,697,185,2095,63528
15-12-2018,15,25694,22666,9215,4094,61669,1232,705,199,2136,63805
15-12-2018,16,25191,22705,9172,4119,61189,1217,717,200,2134,63323
15-12-2018,17,25251,22773,9140,4481,61644,1216,699,234,2149,63793
15-12-2018,18,23877,22133,9000,4500,59509,1217,702,247,2166,61675
15-12-2018,19,22236,21571,8915,4467,57188,1192,703,232,2127,59315
15-12-2018,20,20773,20868,8732,4541,54913,945,701,215,1861,56774
15-12-2018,21,19131,20112,8620,4532,52395,779,701,216,1696,54091
15-12-2018,22,17483,19309,8579,4414,49785,777,699,216,1692,51477
15-12-2018,23,15615,19023,8444,4308,47391,779,699,227,1705,49096
16-12-2018,0,14523,18714,8382,4523,46142,727,641,256,1624,47766
16-12-2018,1,13760,18271,8125,4782,44939,718,642,255,1615,46554
16-12-2018,2,13537,18317,8180,4507,44542,724,636,273,1633,46175
16-12-2018,3,13475,18381,8144,4679,44679,734,634,300,1668,46347
16-12-2018,4,13388,18323,8140,4698,44549,738,636,315,1689,46238
16-12-2018,5,13602,18466,8180,4776,45024,737,638,319,1694,46718
16-12-2018,6,14304,19160,8224,4995,46685,763,643,319,1725,48410
16-12-2018,7,15620,19827,8372,4978,48796,768,647,334,1749,50545
16-12-2018,8,16810,20121,8555,4972,50458,883,647,332,1862,52320
16-12-2018,9,17866,21143,8815,5304,53128,948,644,335,1927,55055
16-12-2018,10,19209,21567,8992,5617,55384,976,639,358,1973,57357
16-12-2018,11,21131,21896,8889,5906,57821,1006,640,398,2044,59865
16-12-2018,12,21896,21969,8835,5563,58263,1031,642,434,2107,60370
16-12-2018,13,22370,22398,8744,5269,58784,1014,640,419,2073,60857
16-12-2018,14,23044,22590,8847,4809,59289,1018,642,418,2078,61367
16-12-2018,15,24324,23121,8858,4493,60796,1023,660,461,2144,62940
16-12-2018,16,24970,23559,9027,4255,61812,1026,648,465,2139,63951
16-12-2018,17,25347,23625,9020,4050,62042,1008,647,458,2113,64155
16-12-2018,18,25338,23309,9058,3856,61561,944,653,557,2154,63715
16-12-2018,19,24797,22929,9185,3652,60562,936,652,493,2081,62643
16-12-2018,20,23852,22455,9043,3413,58762,948,652,467,2067,60829
16-12-2018,21,23190,22148,8777,3254,57371,1042,649,444,2135,59506
16-12-2018,22,22112,21397,8706,3088,55304,1053,649,412,2114,57418
16-12-2018,23,20803,19959,8501,2960,52222,1065,647,367,2079,54301
17-12-2018,0,19304,18514,8433,2618,48868,1258,646,327,2231,51099
17-12-2018,1,18952,18143,8333,2448,47877,1282,643,312,2237,50114
17-12-2018,2,18620,18052,8289,2435,47395,1293,645,287,2225,49620
17-12-2018,3,17052,17931,8247,2288,45521,1300,647,267,2214,47735
17-12-2018,4,18050,18041,8547,2222,46862,1299,655,256,2210,49072
17-12-2018,5,21373,19241,9058,2394,52067,1325,670,232,2227,54294
17-12-2018,6,24918,22046,9533,2998,59495,1366,1037,229,2632,62127
17-12-2018,7,25847,23013,9711,3336,61909,1362,1168,273,2803,64712
17-12-2018,8,25807,23066,9878,3554,62304,1365,1447,478,3290,65594
17-12-2018,9,25517,23061,9903,3596,62078,1357,1579,666,3602,65680
17-12-2018,10,26170,23243,9750,3557,62720,1310,1358,638,3306,66026
17-12-2018,11,26420,23811,9667,3757,63655,1326,1446,622,3394,67049
17-12-2018,12,25954,23455,9667,3781,62857,1318,1186,611,3115,65972
17-12-2018,13,25916,23282,9609,3663,62470,1320,1187,620,3127,65597
17-12-2018,14,25859,22974,9674,3558,62066,1292,1411,429,3132,65198
17-12-2018,15,26441,23608,9712,3782,63544,1331,1506,485,3322,66866
17-12-2018,16,25946,23499,9756,3989,63190,1336,1630,601,3567,66757
17-12-2018,17,25421,22909,9524,3785,61638,1340,1631,599,3570,65208
17-12-2018,18,25489,23016,9636,3856,61996,1333,1633,597,3563,65559
17-12-2018,19,25806,23179,9567,3874,62425,1324,1190,449,2963,65388
17-12-2018,20,25062,22682,9220,3659,60623,1333,1036,153,2522,63145
17-12-2018,21,24441,22228,8794,3375,58840,1330,696,165,2191,61031
17-12-2018,22,23323,21096,8523,3126,56068,1337,656,165,2158,58226
17-12-2018,23,21170,19668,8311,2951,52101,1308,655,148,2111,54212
18-12-2018,0,18976,18594,8201,3093,48863,1273,654,147,2074,50937
18-12-2018,1,18064,18350,8147,3169,47731,1257,654,146,2057,49788
18-12-2018,2,17033,18203,8151,3155,46543,1125,654,145,1924,48467
18-12-2018,3,16480,18245,8148,3112,45984,1135,653,145,1933,47917
18-12-2018,4,17794,18360,8189,3086,47429,1152,653,147,1952,49381
18-12-2018,5,20808,19699,8474,3407,52387,1250,660,147,2057,54444
18-12-2018,6,24112,21681,9033,3694,58520,1298,1016,170,2484,61004
18-12-2018,7,25937,22846,9356,3901,62040,1286,1495,212,2993,65033
18-12-2018,8,26017,22983,9579,3876,62456,1316,1697,384,3397,65853
18-12-2018,9,25779,22871,9580,3907,62138,1317,1561,390,3268,65406
18-12-2018,10,26019,23070,9639,4010,62737,1334,1489,281,3104,65841
18-12-2018,11,26150,23020,9574,4151,62897,1312,1370,224,2906,65803
18-12-2018,12,26093,22868,9549,4242,62752,1332,1187,182,2701,65453
18-12-2018,13,26077,22958,9558,3977,62570,1319,1177,187,2683,65253
18-12-2018,14,26328,23244,9534,4012,63118,1303,1344,218,2865,65983
18-12-2018,15,26735,23454,9717,4184,64090,1336,1350,343,3029,67119
18-12-2018,16,26614,23467,9746,4375,64205,1316,1349,408,3073,67278
18-12-2018,17,26300,23360,9713,4548,63920,1286,1252,372,2910,66830
18-12-2018,18,25259,23209,9638,4707,62813,1242,1202,368,2812,65625
18-12-2018,19,23738,22763,9343,4583,60427,1222,886,189,2297,62724
18-12-2018,20,21941,21956,8947,4661,57506,1235,875,202,2312,59818
18-12-2018,21,20363,21689,8574,4564,55189,1204,694,200,2098,57287
18-12-2018,22,18774,20197,8264,4519,51753,1065,693,195,1953,53706
18-12-2018,23,16095,19006,8055,4463,47620,1035,694,199,1928,49548
19-12-2018,0,16133,18257,8031,4414,46834,1023,692,205,1920,48754
19-12-2018,1,15369,18030,7974,4698,46070,1044,692,212,1948,48018
19-12-2018,2,14900,18102,7931,4753,45686,1027,692,217,1936,47622
19-12-2018,3,14500,18176,7913,4596,45185,1003,694,235,1932,47117
19-12-2018,4,15031,18135,7924,4810,45900,1039,694,244,1977,47877
19-12-2018,5,17049,18834,8385,5416,49685,1133,696,253,2082,51767
19-12-2018,6,19263,21070,9064,5761,55159,1290,702,254,2246,57405
19-12-2018,7,21818,23024,9478,5826,60147,1299,748,291,2338,62485
19-12-2018,8,23680,23760,9526,5381,62347,1360,929,457,2746,65093
19-12-2018,9,23380,23647,9435,5367,61829,1270,986,448,2704,64533
19-12-2018,10,23430,23715,9275,5516,61935,1267,1024,292,2583,64518
19-12-2018,11,23366,23860,9263,5504,61993,1262,977,299,2538,64531
19-12-2018,12,23560,24048,9350,5195,62154,1262,919,297,2478,64632
19-12-2018,13,23648,24121,9363,5116,62249,1281,785,274,2340,64589
19-12-2018,14,24199,24326,9513,4760,62799,1288,780,272,2340,65139
19-12-2018,15,24938,24626,9696,4419,63679,1287,784,288,2359,66038
19-12-2018,16,25395,24637,9694,4510,64238,1290,881,451,2622,66860
19-12-2018,17,25376,24790,9702,4254,64124,1290,796,481,2567,66691
19-12-2018,18,24807,24796,9534,4039,63177,1268,687,331,2286,65463
19-12-2018,19,23793,24254,9342,3989,61378,1171,693,311,2175,63553
19-12-2018,20,22356,23922,9049,3929,59257,1219,721,291,2231,61488
19-12-2018,21,21062,23303,8791,3876,57032,1203,704,299,2206,59238
19-12-2018,22,19425,22220,8567,3680,53893,1184,704,310,2198,56091
19-12-2018,23,16964,20715,8247,3578,49503,1089,710,312,2111,51614
20-12-2018,0,14765,19623,8223,3387,45998,984,673,318,1975,47973
20-12-2018,1,13960,19386,8202,3220,44769,944,664,309,1917,46686
20-12-2018,2,14165,19224,8174,3298,44861,960,655,309,1924,46785
20-12-2018,3,13392,19398,8241,3134,44165,986,650,311,1947,46112
20-12-2018,4,13835,19501,8424,3264,45024,1028,648,310,1986,47010
20-12-2018,5,16501,20128,8647,3600,48877,1145,682,317,2144,51021
20-12-2018,6,20585,22584,9183,3878,56231,1279,708,341,2328,58559
20-12-2018,7,23551,24087,9592,4133,61363,1334,845,417,2596,63959
20-12-2018,8,24693,24409,9605,4188,62895,1440,953,598,2991,65886
20-12-2018,9,24356,24419,9550,4154,62478,1314,1010,586,2910,65388
20-12-2018,10,24271,24235,9367,4246,62120,1300,875,358,2533,64653
20-12-2018,11,24100,24130,9228,4353,61811,1302,841,340,2483,64294
20-12-2018,12,24065,24074,9435,4309,61883,1310,1053,317,2680,64563
20-12-2018,13,24156,24194,9419,4272,62041,1314,1105,316,2735,64776
20-12-2018,14,24136,24304,9551,4255,62247,1274,1302,319,2895,65142
20-12-2018,15,24724,24481,9624,4378,63207,1296,1303,433,3032,66239
20-12-2018,16,24408,24519,9626,4487,63040,1282,1255,510,3047,66087
20-12-2018,17,23755,24384,9636,4715,62490,1316,1164,492,2972,65462
20-12-2018,18,22884,24266,9567,4625,61342,1323,1100,319,2742,64084
20-12-2018,19,21986,24195,9263,4417,59862,1269,786,281,2336,62198
20-12-2018,20,19686,22954,8961,4246,55847,1158,693,209,2060,57907
20-12-2018,21,18069,22012,8703,3983,52767,1109,692,207,2008,54775
20-12-2018,22,16770,21034,8624,3890,50317,1011,687,202,1900,52217
20-12-2018,23,13956,19875,8389,3635,45856,1000,655,207,1862,47718
21-12-2018,0,12524,18614,8249,3533,42920,814,654,201,1669,44589
21-12-2018,1,12015,18181,8172,3589,41959,745,652,197,1594,43553
21-12-2018,2,11735,18115,8144,3620,41615,737,649,190,1576,43191
21-12-2018,3,11726,18189,8198,3542,41655,739,649,188,1576,43231
21-12-2018,4,12234,18267,8375,3644,42520,783,649,185,1617,44137
21-12-2018,5,14662,19141,8778,3602,46183,955,681,181,1817,48000
21-12-2018,6,17942,21348,9332,3770,52393,1176,684,178,2038,54431
21-12-2018,7,21271,23276,9810,4471,58827,1194,791,244,2229,61056
21-12-2018,8,22694,23740,9944,4732,61109,1167,784,261,2212,63321
21-12-2018,9,22755,23670,9860,4694,60978,1158,913,262,2333,63311
21-12-2018,10,22469,23443,9505,4769,60187,1156,932,290,2378,62565
21-12-2018,11,21879,23478,9471,4737,59564,1158,987,202,2347,61911
21-12-2018,12,21082,23391,9724,4889,59085,1138,964,202,2304,61389
21-12-2018,13,20487,22950,9932,5005,58375,1155,960,205,2320,60695
21-12-2018,14,19918,23031,10008,4906,57864,1136,827,207,2170,60034
21-12-2018,15,19779,22906,10056,5080,57823,1125,984,215,2324,60147
21-12-2018,16,20035,23095,9971,5179,58281,1170,981,258,2409,60690
21-12-2018,17,20187,23125,9996,5155,58463,1167,881,266,2314,60777
21-12-2018,18,20219,22774,9861,4964,57818,1150,748,262,2160,59978
21-12-2018,19,19068,22100,9546,4999,55715,1135,712,257,2104,57819
21-12-2018,20,17942,21333,9152,5072,53499,879,710,183,1772,55271
21-12-2018,21,16887,20793,8937,4758,51376,740,700,179,1619,52995
21-12-2018,22,15669,19506,8814,4284,48273,743,686,182,1611,49884
21-12-2018,23,14328,18857,8682,3938,45806,739,637,196,1572,47378
22-12-2018,0,14189,18354,8701,3602,44848,747,679,219,1645,46493
22-12-2018,1,13546,17781,8641,3396,43366,762,692,228,1682,45048
22-12-2018,2,12895,17499,8586,3226,42206,760,707,226,1693,43899
22-12-2018,3,12714,17623,8693,2929,41959,770,707,233,1710,43669
22-12-2018,4,12576,18046,8775,2967,42364,764,685,237,1686,44050
22-12-2018,5,12800,18227,8799,3049,42876,773,609,309,1691,44567
22-12-2018,6,13738,19185,8907,3098,44928,798,637,258,1693,46621
22-12-2018,7,15056,20134,8940,3149,47279,832,650,270,1752,49031
22-12-2018,8,17640,21062,9166,3163,51032,805,732,256,1793,52825
22-12-2018,9,19683,21694,9262,3174,53812,777,750,251,1778,55590
22-12-2018,10,20791,21756,9214,2914,54674,814,740,252,1806,56480
22-12-2018,11,21636,21957,9331,2788,55712,839,727,243,1809,57521
22-12-2018,12,21629,21959,9306,2732,55625,837,723,237,1797,57422
22-12-2018,13,20719,21487,9237,2877,54322,834,735,242,1811,56133
22-12-2018,14,20218,21323,9204,2697,53443,839,730,235,1804,55247
22-12-2018,15,21221,21715,9290,2679,54905,868,864,222,1954,56859
22-12-2018,16,22933,21842,9417,2818,57011,917,870,286,2073,59084
22-12-2018,17,23974,22195,9546,3052,58767,907,1067,266,2240,61007
22-12-2018,18,24374,22281,9592,3094,59341,909,1074,227,2210,61551
22-12-2018,19,22721,22176,9425,3080,57403,828,1009,234,2071,59474
22-12-2018,20,20501,21595,9291,2792,54180,794,719,254,1767,55947
22-12-2018,21,19014,20377,8993,2718,51102,797,708,273,1778,52880
22-12-2018,22,17875,19676,8758,2549,48858,731,698,268,1697,50555
22-12-2018,23,16558,18832,8628,2726,46745,748,683,257,1688,48433
23-12-2018,0,15901,17155,8440,2537,44034,891,529,272,1692,45726
23-12-2018,1,15178,16816,8297,2537,42828,904,520,260,1684,44512
23-12-2018,2,14814,16673,8238,2621,42346,907,519,255,1681,44027
23-12-2018,3,14204,16561,8263,2586,41615,907,513,278,1698,43313
23-12-2018,4,14126,16595,8204,2692,41617,910,540,293,1743,43360
23-12-2018,5,14658,16899,8355,2736,42648,901,509,277,1687,44335
23-12-2018,6,15225,18087,8589,2887,44788,898,518,256,1672,46460
23-12-2018,7,16249,19078,8644,3164,47137,912,519,273,1704,48841
23-12-2018,8,17194,19667,8689,3345,48895,876,525,271,1672,50567
23-12-2018,9,18533,20209,8774,3307,50824,847,529,253,1629,52453
23-12-2018,10,19622,20546,8896,3166,52231,915,531,218,1664,53895
23-12-2018,11,20151,21023,8964,2925,53063,903,530,199,1632,54695
23-12-2018,12,20335,21272,8866,2857,53332,913,530,182,1625,54957
23-12-2018,13,20101,21330,8843,3031,53306,919,516,172,1607,54913
23-12-2018,14,20324,21498,8796,2940,53560,896,510,176,1582,55142
23-12-2018,15,21527,21902,8887,2993,55309,883,554,155,1592,56901
23-12-2018,16,23458,22681,9111,3290,58542,890,558,168,1616,60158
23-12-2018,17,24435,22927,9255,3617,60236,930,648,171,1749,61985
23-12-2018,18,24536,23128,9191,3653,60509,920,647,172,1739,62248
23-12-2018,19,23698,22817,9113,3615,59245,932,558,164,1654,60899
23-12-2018,20,22351,21992,8951,3362,56655,914,507,164,1585,58240
23-12-2018,21,20304,20962,8845,2944,53055,829,509,170,1508,54563
23-12-2018,22,19727,20332,8728,2901,51689,831,508,172,1511,53200
23-12-2018,23,17194,18778,8560,2758,47290,793,508,179,1480,48770
24-12-2018,0,15606,17828,8397,2396,44229,687,509,179,1375,45604
24-12-2018,1,14216,17393,8414,2337,42360,674,510,179,1363,43723
24-12-2018,2,13195,17773,8544,2336,41848,697,513,186,1396,43244
24-12-2018,3,12790,17985,8580,2498,41855,734,509,205,1448,43303
24-12-2018,4,12610,18186,8707,2677,42180,741,508,210,1459,43639
24-12-2018,5,13970,19287,8931,2764,44954,740,508,233,1481,46435
24-12-2018,6,14788,21054,9208,2838,47889,747,510,263,1520,49409
24-12-2018,7,16372,22017,9510,3172,51072,754,515,229,1498,52570
24-12-2018,8,18456,23043,9597,3504,54600,739,512,261,1512,56112
24-12-2018,9,19963,23559,9691,3824,57037,730,512,316,1558,58595
24-12-2018,10,19183,23619,9645,4086,56532,737,598,287,1622,58154
24-12-2018,11,18916,23653,9579,4217,56365,698,524,274,1496,57861
24-12-2018,12,18463,23483,9518,4483,55948,714,522,275,1511,57459
24-12-2018,13,17619,22875,9446,4720,54661,705,518,302,1525,56186
24-12-2018,14,17783,22612,9458,4741,54593,670,514,326,1510,56103
24-12-2018,15,18770,23210,9454,4672,56107,702,511,313,1526,57633
24-12-2018,16,19290,23500,9464,4646,56900,686,586,289,1561,58461
24-12-2018,17,18258,23006,9370,4710,55345,672,510,282,1464,56809
24-12-2018,18,16241,22132,9230,4595,52198,599,510,284,1393,53591
24-12-2018,19,14454,21457,9240,4342,49493,598,509,261,1368,50861
24-12-2018,20,12708,21064,9039,4689,47501,598,508,219,1325,48826
24-12-2018,21,12329,20419,8865,5080,46692,625,507,206,1338,48030
24-12-2018,22,12239,19688,8705,5340,45972,652,504,198,1354,47326
24-12-2018,23,12334,18975,8540,5009,44859,619,519,177,1315,46174
25-12-2018,0,12657,18234,8346,4937,44176,636,482,163,1281,45457
25-12-2018,1,12239,17599,8208,4948,42993,690,432,162,1284,44277
25-12-2018,2,11979,17452,8037,4514,41981,624,436,160,1220,43201
25-12-2018,3,11292,17624,7922,4994,41831,660,433,162,1255,43086
25-12-2018,4,10831,18099,7932,4961,41823,676,434,173,1283,43106
25-12-2018,5,11418,18702,8412,4796,43328,732,501,184,1417,44745
25-12-2018,6,12242,19170,8736,4433,44579,721,500,203,1424,46003
25-12-2018,7,12503,19704,8863,4555,45626,755,486,223,1464,47090
25-12-2018,8,12276,19852,9053,5235,46417,746,472,234,1452,47869
25-12-2018,9,12887,20016,9054,5543,47500,733,463,263,1459,48959
25-12-2018,10,13466,19526,8792,5484,47267,744,439,274,1457,48724
25-12-2018,11,13335,19284,8920,5582,47123,734,458,228,1420,48543
25-12-2018,12,12957,19920,8994,5504,47374,727,457,223,1407,48781
25-12-2018,13,13335,20117,8980,5192,47625,708,457,240,1405,49030
25-12-2018,14,12818,20433,9080,5146,47478,737,445,237,1419,48897
25-12-2018,15,12417,21048,9236,5202,47904,754,446,226,1426,49330
25-12-2018,16,13047,21200,9238,5571,49055,787,444,226,1457,50512
25-12-2018,17,12952,21080,9124,5759,48915,808,442,254,1504,50419
25-12-2018,18,12438,20776,9048,5958,48219,832,441,245,1518,49737
25-12-2018,19,12522,20385,8710,5902,47519,828,444,281,1553,49072
25-12-2018,20,12340,19931,8630,5868,46769,841,441,325,1607,48376
25-12-2018,21,12343,19043,8561,5571,45517,818,403,324,1545,47062
25-12-2018,22,11866,18727,8407,5032,44033,821,402,333,1556,45589
25-12-2018,23,11508,17585,8105,5037,42235,804,407,385,1596,43831
26-12-2018,0,11551,17312,8058,4498,41417,810,403,392,1605,43022
26-12-2018,1,11164,17152,7990,3789,40096,791,399,391,1581,41677
26-12-2018,2,10878,17145,7927,3656,39607,813,395,388,1596,41203
26-12-2018,3,11040,17134,7917,3362,39454,808,395,404,1607,41061
26-12-2018,4,11110,17238,7906,3486,39741,790,395,414,1599,41340
26-12-2018,5,10768,17341,8046,4099,40252,821,397,398,1616,41868
26-12-2018,6,12340,17970,8321,4313,42943,809,414,414,1637,44580
26-12-2018,7,12966,18891,8475,4268,44600,864,464,381,1709,46309
26-12-2018,8,14119,20538,8639,3784,47080,875,472,353,1700,48780
26-12-2018,9,15240,21220,8850,3665,48976,954,479,380,1813,50789
26-12-2018,10,15654,21158,8781,3584,49177,935,475,416,1826,51003
26-12-2018,11,15760,21248,8786,3688,49484,902,481,446,1829,51313
26-12-2018,12,16096,21469,8933,4195,50693,891,511,481,1883,52576
26-12-2018,13,15648,21321,8911,4210,50089,871,508,477,1856,51945
26-12-2018,14,15840,21362,8933,4616,50751,884,474,440,1798,52549
26-12-2018,15,17225,21922,8919,4469,52537,852,505,416,1773,54310
26-12-2018,16,17907,22067,8864,4337,53177,895,600,393,1888,55065
26-12-2018,17,17149,22004,8884,4312,52350,873,692,394,1959,54309
26-12-2018,18,16358,21913,8753,4313,51338,839,500,380,1719,53057
26-12-2018,19,15077,21583,8611,4446,49716,764,462,333,1559,51275
26-12-2018,20,14386,21213,8393,4261,48253,771,459,339,1569,49822
26-12-2018,21,13593,20579,8269,4074,46514,737,461,329,1527,48041
26-12-2018,22,12655,20057,8090,4129,44932,666,463,327,1456,46388
26-12-2018,23,11949,18972,7935,4098,42955,667,462,300,1429,44384
27-12-2018,0,11787,17947,7853,4531,42117,659,457,255,1371,43488
27-12-2018,1,11525,17558,7768,4088,40939,659,456,248,1363,42302
27-12-2018,2,11719,17478,7739,4104,41040,668,458,241,1367,42407
27-12-2018,3,11124,17147,7660,4287,40219,665,459,247,1371,41590
27-12-2018,4,11465,16873,7764,4262,40364,662,461,256,1379,41743
27-12-2018,5,12397,18068,8041,4576,43083,632,460,230,1322,44405
27-12-2018,6,14314,20052,8221,4493,47080,682,461,236,1379,48459
27-12-2018,7,16794,21465,8524,4030,50812,697,549,236,1482,52294
27-12-2018,8,17612,22098,8724,4159,52596,746,549,229,1524,54120
27-12-2018,9,19062,22534,8775,4350,54723,783,550,399,1732,56455
27-12-2018,10,19565,22846,8646,4377,55434,721,525,410,1656,57090
27-12-2018,11,19225,22852,8617,4685,55379,776,524,387,1687,57066
27-12-2018,12,19143,22752,8655,4871,55421,765,524,221,1510,56931
27-12-2018,13,19111,22601,8732,4875,55319,764,523,234,1521,56840
27-12-2018,14,19390,22800,8845,4668,55704,768,523,228,1519,57223
27-12-2018,15,20038,22953,8891,4402,56284,767,667,224,1658,57942
27-12-2018,16,20579,23119,9002,4505,57205,777,869,392,2038,59243
27-12-2018,17,20736,23076,9109,4694,57616,779,869,387,2035,59651
27-12-2018,18,20405,23124,8892,4547,56968,789,741,291,1821,58789
27-12-2018,19,19418,22799,8606,4484,55307,771,677,210,1658,56965
27-12-2018,20,17481,22425,8499,4561,52966,747,539,233,1519,54485
27-12-2018,21,16187,21675,8457,4608,50928,727,473,275,1475,52403
27-12-2018,22,14510,20637,8256,4778,48181,732,454,332,1518,49699
27-12-2018,23,13480,19816,8056,4712,46064,685,454,341,1480,47544
28-12-2018,0,13496,17934,7959,4663,44053,686,456,342,1484,45537
28-12-2018,1,13526,17550,7834,4360,43270,626,455,323,1404,44674
28-12-2018,2,13395,17469,7855,4153,42873,631,455,284,1370,44243
28-12-2018,3,12759,17536,7870,3872,42036,632,456,256,1344,43380
28-12-2018,4,13060,18025,7721,3688,42494,643,454,259,1356,43850
28-12-2018,5,14477,18663,7706,3557,44402,739,456,280,1475,45877
28-12-2018,6,16880,20942,7989,3423,49233,780,457,292,1529,50762
28-12-2018,7,19888,22212,8395,3366,53861,764,546,316,1626,55487
28-12-2018,8,21280,22408,8676,3584,55949,746,548,346,1640,57589
28-12-2018,9,22174,22700,8794,3687,57356,757,547,385,1689,59045
28-12-2018,10,22246,22534,8680,3927,57388,747,566,439,1752,59140
28-12-2018,11,22707,22492,8639,3860,57697,761,553,434,1748,59445
28-12-2018,12,22819,22441,8716,3926,57902,788,552,376,1716,59618
28-12-2018,13,22601,22370,8818,3840,57628,765,574,308,1647,59275
28-12-2018,14,23125,22360,8906,3824,58217,769,614,255,1638,59855
28-12-2018,15,24017,22425,9170,3616,59228,802,845,259,1906,61134
28-12-2018,16,24792,22472,9194,3744,60202,820,1041,438,2299,62501
28-12-2018,17,25102,22445,9171,3760,60478,822,1060,454,2336,62814
28-12-2018,18,24483,22378,9129,3813,59804,813,1002,344,2159,61963
28-12-2018,19,23268,22171,8960,3765,58163,776,639,242,1657,59820
28-12-2018,20,21383,21989,8825,3690,55888,752,546,259,1557,57445
28-12-2018,21,19650,21635,8769,3607,53661,750,493,251,1494,55155
28-12-2018,22,17705,20913,8626,3807,51050,736,485,241,1462,52512
28-12-2018,23,15867,19892,8485,3831,48074,751,485,228,1464,49538
29-12-2018,0,15422,18362,8381,3859,46026,743,544,229,1516,47542
29-12-2018,1,13692,18178,8169,3762,43801,714,527,227,1468,45269
29-12-2018,2,12801,18173,8178,3899,43050,655,530,231,1416,44466
29-12-2018,3,12090,17879,8161,3743,41873,631,485,232,1348,43221
29-12-2018,4,12248,17973,8118,3678,42018,631,484,215,1330,43348
29-12-2018,5,12130,18223,8271,3541,42165,653,511,199,1363,43528
29-12-2018,6,12984,19282,8440,3568,44275,752,506,209,1467,45742
29-12-2018,7,14381,20187,8651,3610,46830,796,542,243,1581,48411
29-12-2018,8,16559,21523,9101,3127,50312,775,559,310,1644,51956
29-12-2018,9,18267,21985,9352,3361,52966,735,567,421,1723,54689
29-12-2018,10,17824,21881,9292,3795,52793,803,578,466,1847,54640
29-12-2018,11,17544,22074,9396,3776,52790,790,620,534,1944,54734
29-12-2018,12,17886,22063,9636,3679,53265,804,631,341,1776,55041
29-12-2018,13,17622,22249,9650,3607,53128,805,631,269,1705,54833
29-12-2018,14,16791,21762,9634,4313,52501,803,636,262,1701,54202
29-12-2018,15,16713,21855,9792,4381,52741,807,646,245,1698,54439
29-12-2018,16,17953,22053,9853,4427,54287,810,733,268,1811,56098
29-12-2018,17,19194,22152,9903,4576,55826,786,880,282,1948,57774
29-12-2018,18,18295,21623,9961,4272,54151,762,727,316,1805,55956
29-12-2018,19,16207,20997,9916,4186,51306,746,671,317,1734,53040
29-12-2018,20,15127,20452,9628,3922,49130,647,550,260,1457,50587
29-12-2018,21,14426,19686,9399,4038,47550,678,530,241,1449,48999
29-12-2018,22,13782,18994,9184,4099,46060,634,491,223,1348,47408
29-12-2018,23,13410,18051,8810,4058,44329,620,496,220,1336,45665
30-12-2018,0,12782,16670,8709,4005,42167,644,494,220,1358,43525
30-12-2018,1,12157,16211,8581,3985,40935,660,490,204,1354,42289
30-12-2018,2,11941,16068,8410,3844,40265,686,489,199,1374,41639
30-12-2018,3,11690,16011,8283,3902,39887,685,487,187,1359,41246
30-12-2018,4,11794,16008,8245,3901,39948,688,483,177,1348,41296
30-12-2018,5,11920,16371,8278,3420,39991,689,485,174,1348,41339
30-12-2018,6,12644,17466,8465,3554,42131,679,480,184,1343,43474
30-12-2018,7,12939,18374,8450,3865,43629,687,496,179,1362,44991
30-12-2018,8,13115,19029,8418,4244,44807,647,505,172,1324,46131
30-12-2018,9,13691,20008,8525,4335,46558,637,496,175,1308,47866
30-12-2018,10,14702,20830,8520,4627,48680,636,497,176,1309,49989
30-12-2018,11,15014,20950,8420,4910,49294,639,638,172,1449,50743
30-12-2018,12,14367,21062,8357,4885,48671,635,637,166,1438,50109
30-12-2018,13,13887,20920,8504,4587,47898,641,564,165,1370,49268
30-12-2018,14,14415,21076,8485,4238,48214,660,609,175,1444,49658
30-12-2018,15,16214,21677,8733,3768,50391,651,803,179,1633,52024
30-12-2018,16,18144,22468,9022,3449,53085,678,960,177,1815,54900
30-12-2018,17,20670,23050,8989,3551,56260,675,788,183,1646,57906
30-12-2018,18,20987,23095,8927,3447,56457,683,875,200,1758,58215
30-12-2018,19,20636,22984,9113,3182,55913,677,878,214,1769,57682
30-12-2018,20,19638,22554,9014,3033,54241,679,666,238,1583,55824
30-12-2018,21,18358,21494,9164,2821,51837,680,588,289,1557,53394
30-12-2018,22,17856,20679,9240,2709,50484,685,601,295,1581,52065
30-12-2018,23,16796,20018,9139,2669,48623,677,602,286,1565,50188
31-12-2018,0,15325,19231,9297,2639,46492,733,643,305,1681,48173
31-12-2018,1,14189,19026,9220,2650,45086,733,640,307,1680,46766
31-12-2018,2,13039,18833,9076,2595,43544,743,640,308,1691,45235
31-12-2018,3,11722,18280,9067,2532,41600,676,515,268,1459,43059
31-12-2018,4,11750,18277,9209,2687,41922,737,515,244,1496,43418
31-12-2018,5,12456,19697,9449,2994,44597,748,603,206,1557,46154
31-12-2018,6,13850,21591,9742,3278,48462,723,632,203,1558,50020
31-12-2018,7,15372,22874,9653,3422,51321,723,626,280,1629,52950
31-12-2018,8,15798,23351,9879,3563,52593,689,659,278,1626,54219
31-12-2018,9,16366,24055,9975,3681,54076,800,679,255,1734,55810
31-12-2018,10,17039,24529,10065,3891,55524,902,733,238,1873,57397
31-12-2018,11,17208,24958,10119,4055,56339,898,748,236,1882,58221
31-12-2018,12,16502,24574,10179,4414,55671,906,732,236,1874,57545
31-12-2018,13,16060,24598,10162,4859,55678,890,697,236,1823,57501
31-12-2018,14,15943,24885,10093,5236,56158,918,688,241,1847,58005
31-12-2018,15,16125,25214,10098,5534,56972,951,975,242,2168,59140
31-12-2018,16,16358,25032,10270,5894,57555,998,1023,249,2270,59825
31-12-2018,17,15491,24929,10163,5992,56576,943,949,256,2148,58724
31-12-2018,18,14717,24104,9983,6237,55043,965,706,283,1954,56997
31-12-2018,19,13885,22706,9737,5938,52267,1011,653,343,2007,54274
31-12-2018,20,12621,21344,9460,5714,49140,873,543,420,1836,50976
31-12-2018,21,12078,20200,9172,5158,46608,854,501,460,1815,48423
31-12-2018,22,11865,19450,8769,4773,44856,852,437,529,1818,46674
31-12-2018,23,11095,18911,8457,4676,43139,857,421,577,1855,44994
01-01-2019,0,11408,17979,8345,4344,42077,852,271,593,1716,43793
01-01-2019,1,12186,17632,8215,4544,42578,887,259,620,1766,44344
01-01-2019,2,12309,17256,8053,3823,41441,863,236,619,1718,43159
01-01-2019,3,11838,17271,7845,3689,40642,835,213,636,1684,42326
01-01-2019,4,11493,17488,7677,3576,40234,823,255,641,1719,41953
01-01-2019,5,11537,17548,7544,3599,40228,827,254,644,1725,41953
01-01-2019,6,12005,17716,7404,3834,40958,835,262,642,1739,42697
01-01-2019,7,12811,18089,7341,3893,42133,979,261,642,1882,44015
01-01-2019,8,12450,18042,7392,3955,41838,937,261,640,1838,43676
01-01-2019,9,12644,18178,7296,4223,42341,823,225,636,1684,44025
01-01-2019,10,13407,18741,7387,4399,43934,790,263,635,1688,45622
01-01-2019,11,13815,18916,7568,4754,45053,769,248,638,1655,46708
01-01-2019,12,13747,19191,7782,4786,45506,747,263,638,1648,47154
01-01-2019,13,13624,19214,7892,4605,45336,750,247,635,1632,46968
01-01-2019,14,13635,19857,8010,4729,46231,744,253,638,1635,47866
01-01-2019,15,14325,20227,8301,4760,47615,764,260,626,1650,49265
01-01-2019,16,14944,20874,8595,4896,49311,780,209,601,1590,50901
01-01-2019,17,15030,21198,8704,5122,50054,785,226,584,1595,51649
01-01-2019,18,14504,21055,8677,5198,49435,885,234,569,1688,51123
01-01-2019,19,13870,20576,8574,4812,47832,880,227,557,1664,49496
01-01-2019,20,13792,19654,8402,4568,46416,858,233,488,1579,47995
01-01-2019,21,13520,19228,8338,4132,45218,869,239,394,1502,46720
01-01-2019,22,13392,19215,8230,4056,44893,810,245,340,1395,46288
01-01-2019,23,13004,18675,7871,3790,43340,779,205,351,1335,44675
02-01-2019,0,13009,18377,7805,3593,42784,765,204,353,1322,44106
02-01-2019,1,12333,18189,7784,3558,41864,760,206,403,1369,43233
02-01-2019,2,12102,18087,7820,3375,41383,762,207,446,1415,42798
02-01-2019,3,11857,18162,7891,3368,41279,757,208,514,1479,42758
02-01-2019,4,12147,18836,8128,3406,42517,777,212,533,1522,44039
02-01-2019,5,12550,19494,8711,3715,44469,966,335,534,1835,46304
02-01-2019,6,13650,20680,9120,4521,47970,1009,341,569,1919,49889
02-01-2019,7,15142,22195,9276,5296,51909,1025,521,634,2180,54089
02-01-2019,8,16266,23243,9267,5629,54405,1065,514,658,2237,56642
02-01-2019,9,16463,23527,9293,5750,55034,1005,611,674,2290,57324
02-01-2019,10,16609,23518,9438,5713,55278,988,573,680,2241,57519
02-01-2019,11,16112,23321,9399,5661,54494,1022,568,684,2274,56768
02-01-2019,12,15490,23801,9421,5538,54251,1044,558,680,2282,56533
02-01-2019,13,16069,23726,9452,5310,54557,1044,566,678,2288,56845
02-01-2019,14,17448,24265,9611,4827,56151,1027,732,683,2442,58593
02-01-2019,15,20051,24480,9705,4355,58592,1108,736,730,2574,61166
02-01-2019,16,21102,24427,9874,4325,59728,1099,786,685,2570,62298
02-01-2019,17,22295,24658,10094,4444,61491,1108,966,703,2777,64268
02-01-2019,18,22128,24253,10053,4271,60704,1106,1024,719,2849,63553
02-01-2019,19,21459,23561,9926,4076,59022,1112,883,706,2701,61723
02-01-2019,20,20952,23193,9791,3758,57694,1110,729,708,2547,60241
02-01-2019,21,20141,22437,9629,3419,55627,1106,693,699,2498,58125
02-01-2019,22,19078,21055,9386,3385,52903,1116,693,676,2485,55388
02-01-2019,23,16243,19257,9175,3456,48132,1043,675,640,2358,50490
03-01-2019,0,15251,18046,9084,3400,45781,1050,673,686,2409,48190
03-01-2019,1,13990,17557,9017,3429,43994,1061,674,667,2402,46396
03-01-2019,2,13092,17069,8868,3615,42644,1072,673,650,2395,45039
03-01-2019,3,13372,16964,8770,3509,42616,1082,671,641,2394,45010
03-01-2019,4,14024,17325,8676,3436,43461,1084,670,649,2403,45864
03-01-2019,5,15423,18651,8857,3395,46327,1098,671,648,2417,48744
03-01-2019,6,18367,20623,9045,3619,51656,1094,671,675,2440,54096
03-01-2019,7,22249,22704,9254,3984,58192,1094,705,694,2493,60685
03-01-2019,8,23957,23636,9332,4007,60931,1077,722,875,2674,63605
03-01-2019,9,23918,23857,9374,3914,61065,1075,717,838,2630,63695
03-01-2019,10,23536,23884,9479,3793,60692,1071,736,850,2657,63349
03-01-2019,11,24175,23775,9808,3748,61507,1072,806,914,2792,64299
03-01-2019,12,24101,23690,10029,3518,61340,1068,797,853,2718,64058
03-01-2019,13,23833,23622,10320,3448,61222,1051,879,1014,2944,64166
03-01-2019,14,23622,23646,10528,3502,61299,1029,922,971,2922,64221
03-01-2019,15,23630,23530,10710,3525,61395,1016,1069,924,3009,64404
03-01-2019,16,23860,23799,10914,3713,62287,992,1162,932,3086,65373
03-01-2019,17,23988,23926,10918,3833,62665,976,1205,913,3094,65759
03-01-2019,18,23897,23869,10730,4012,62507,959,1098,938,2995,65502
03-01-2019,19,23680,23381,10565,4051,61676,960,840,766,2566,64242
03-01-2019,20,22757,23128,10247,4081,60212,964,729,585,2278,62490
03-01-2019,21,21556,22715,9906,4163,58342,967,664,464,2095,60437
03-01-2019,22,19655,22241,9463,4441,55801,963,636,389,1988,57789
03-01-2019,23,16228,20775,9002,4660,50664,940,646,335,1921,52585
04-01-2019,0,15436,19489,8756,4875,48557,978,650,319,1947,50504
04-01-2019,1,13641,18881,8490,4852,45865,968,654,280,1902,47767
04-01-2019,2,12807,18734,8370,5328,45238,964,652,257,1873,47111
04-01-2019,3,12830,18597,8355,5719,45501,984,652,243,1879,47380
04-01-2019,4,12743,18645,8294,5705,45387,1008,624,248,1880,47267
04-01-2019,5,13598,18991,8512,5327,46429,1039,605,273,1917,48346
04-01-2019,6,17162,21835,8932,5360,53291,1119,620,318,2057,55348
04-01-2019,7,20368,23174,9433,4768,57742,1194,644,460,2298,60040
04-01-2019,8,22212,23492,9557,4426,59688,1174,634,546,2354,62042
04-01-2019,9,21894,23482,9493,4540,59411,1152,653,545,2350,61761
04-01-2019,10,21649,23422,9357,4934,59363,1138,681,565,2384,61747
04-01-2019,11,20792,23205,9255,5012,58264,1098,756,525,2379,60643
04-01-2019,12,19472,22810,9180,5855,57316,1132,762,516,2410,59726
04-01-2019,13,18677,22655,9133,5916,56381,1130,771,529,2430,58811
04-01-2019,14,17580,22455,9128,5508,54672,1139,811,489,2439,57111
04-01-2019,15,18614,22725,9431,5411,56181,1130,840,494,2464,58645
04-01-2019,16,19930,22699,9432,5029,57091,1129,877,535,2541,59632
04-01-2019,17,20331,22725,9259,5285,57600,1134,835,532,2501,60101
04-01-2019,18,20019,22454,9169,5577,57221,1124,820,516,2460,59681
04-01-2019,19,18690,21848,9155,5418,55110,1127,717,435,2279,57389
04-01-2019,20,16402,21042,8757,5634,51835,1026,764,436,2226,54061
04-01-2019,21,15153,20070,8283,5549,49056,945,638,314,1897,50953
04-01-2019,22,14735,19004,8043,5287,47071,930,643,307,1880,48951
04-01-2019,23,13289,17582,7847,5189,43907,913,641,294,1848,45755
05-01-2019,0,13212,16613,7722,4946,42493,911,537,277,1725,44218
05-01-2019,1,12149,16304,7635,4701,40790,923,546,311,1780,42570
05-01-2019,2,11452,16220,7593,4400,39666,926,560,350,1836,41502
05-01-2019,3,11211,16176,7644,4081,39112,903,573,349,1825,40937
05-01-2019,4,11446,16313,7670,4021,39450,901,572,401,1874,41324
05-01-2019,5,12095,16435,7687,4087,40303,907,549,410,1866,42169
05-01-2019,6,12863,17094,7672,3901,41529,891,553,433,1877,43406
05-01-2019,7,13704,18315,7703,3991,43715,896,555,507,1958,45673
05-01-2019,8,15791,19084,7903,4053,46832,952,565,487,2004,48836
05-01-2019,9,17653,19651,7998,3763,49065,1003,569,506,2078,51143
05-01-2019,10,18316,20381,8087,3601,50385,996,619,572,2187,52572
05-01-2019,11,19060,20796,8267,3502,51625,977,627,576,2180,53805
05-01-2019,12,19857,20820,8424,3345,52446,974,630,576,2180,54626
05-01-2019,13,19651,20786,8226,3212,51877,972,626,576,2174,54051
05-01-2019,14,19979,20992,8405,2885,52261,969,620,515,2104,54365
05-01-2019,15,21389,21578,8496,2728,54192,968,671,560,2199,56391
05-01-2019,16,22994,21975,8899,2679,56548,949,1068,579,2596,59144
05-01-2019,17,23459,22165,8987,2786,57396,954,890,559,2403,59799
05-01-2019,18,23221,22367,8956,2762,57306,944,833,496,2273,59579
05-01-2019,19,22350,21741,8831,2737,55661,939,575,472,1986,57647
05-01-2019,20,20671,21151,8436,2546,52805,927,656,464,2047,54852
05-01-2019,21,19593,20398,8130,2498,50621,925,657,463,2045,52666
05-01-2019,22,17731,19606,7925,2406,47668,915,662,400,1977,49645
05-01-2019,23,16137,18059,7878,2224,44298,911,658,397,1966,46264
06-01-2019,0,15151,16725,7999,2079,41955,824,656,360,1840,43795
06-01-2019,1,14149,16325,8088,2047,40609,850,657,316,1823,42432
06-01-2019,2,13656,16312,8119,2063,40151,822,656,307,1785,41936
06-01-2019,3,13372,16234,8107,2126,39840,804,654,301,1759,41599
06-01-2019,4,12871,16346,8038,2073,39328,814,652,292,1758,41086
06-01-2019,5,13390,16509,8053,2150,40102,808,651,296,1755,41857
06-01-2019,6,13877,17153,8105,2104,41241,814,652,280,1746,42987
06-01-2019,7,14754,18516,8151,2323,43743,813,653,278,1744,45487
06-01-2019,8,16579,19379,8152,2500,46611,837,652,268,1757,48368
06-01-2019,9,19891,20830,8329,2854,51905,914,635,228,1777,53682
06-01-2019,10,20865,21584,8491,2923,53865,942,633,211,1786,55651
06-01-2019,11,21096,22006,8606,3167,54876,943,633,267,1843,56719
06-01-2019,12,20781,21876,8473,3569,54698,966,630,319,1915,56613
06-01-2019,13,20744,21978,8419,3586,54728,1055,623,213,1891,56619
06-01-2019,14,20146,21851,8454,3558,54008,1039,635,187,1861,55869
06-01-2019,15,20375,22067,8553,3588,54585,1123,633,191,1947,56532
06-01-2019,16,21721,22619,8640,3703,56684,1227,755,249,2231,58915
06-01-2019,17,22246,22424,8839,3852,57361,1204,845,252,2301,59662
06-01-2019,18,22091,22473,8621,3879,57063,1215,846,254,2315,59378
06-01-2019,19,21403,22384,8480,3822,56089,1230,810,251,2291,58380
06-01-2019,20,20539,22396,8353,3500,54790,1277,770,251,2298,57088
06-01-2019,21,19432,22019,8162,2975,52589,1270,679,200,2149,54738
06-01-2019,22,17501,21383,8205,2847,49935,1165,666,217,2048,51983
06-01-2019,23,15978,20022,8095,2821,46916,1045,668,219,1932,48848
07-01-2019,0,14082,18289,8276,2685,43333,1229,671,221,2121,45454
07-01-2019,1,13273,17971,8291,2694,42231,1273,661,229,2163,44394
07-01-2019,2,12673,17631,8158,2561,41023,1289,644,237,2170,43193
07-01-2019,3,12089,17495,8320,2653,40558,1303,632,244,2179,42737
07-01-2019,4,13018,17999,8416,2674,42107,1337,616,256,2209,44316
07-01-2019,5,16200,19086,8712,2847,46846,1392,593,266,2251,49097
07-01-2019,6,21165,21605,9140,3360,55271,1399,590,377,2366,57637
07-01-2019,7,23446,22731,9280,3316,58773,1385,828,391,2604,61377
07-01-2019,8,24211,22772,9492,3568,60043,1378,953,708,3039,63082
07-01-2019,9,24208,22862,9440,3638,60148,1354,1088,781,3223,63371
07-01-2019,10,24043,22719,9418,3989,60171,1341,973,611,2925,63096
07-01-2019,11,23413,22739,9340,4330,59822,1311,838,593,2742,62564
07-01-2019,12,23263,23079,9292,4038,59674,1298,819,504,2621,62295
07-01-2019,13,22781,23183,9271,4300,59536,1310,754,486,2550,62086
07-01-2019,14,22746,23297,9323,4509,59877,1033,688,595,2316,62193
07-01-2019,15,22462,23590,9232,5155,60439,998,726,639,2363,62802
07-01-2019,16,22264,23780,9460,5816,61320,980,870,513,2363,63683
07-01-2019,17,21883,23680,9384,6575,61523,1062,814,421,2297,63820
07-01-2019,18,20256,22970,9171,6610,59007,1210,697,363,2270,61277
07-01-2019,19,19008,22536,8889,6136,56571,1266,768,313,2347,58918
07-01-2019,20,17558,22211,8705,5949,54423,1263,567,298,2128,56551
07-01-2019,21,16311,21380,8500,5688,51879,1277,554,284,2115,53994
07-01-2019,22,14894,20390,8270,5166,48721,1236,527,289,2052,50773
07-01-2019,23,13069,18995,7858,5116,45039,1219,533,304,2056,47095
08-01-2019,0,12440,17944,7801,4944,43129,1040,581,342,1963,45092
08-01-2019,1,11899,17511,7592,4689,41691,1039,585,334,1958,43649
08-01-2019,2,11533,17354,7590,4701,41180,1072,581,350,2003,43183
08-01-2019,3,11830,17565,7559,4727,41681,1077,582,391,2050,43731
08-01-2019,4,12626,18158,7542,4663,42989,1079,583,422,2084,45073
08-01-2019,5,14001,18250,7822,5122,45194,1066,584,420,2070,47264
08-01-2019,6,17337,20573,8306,5605,51821,1160,581,453,2194,54015
08-01-2019,7,19203,22956,8872,6235,57267,1322,581,562,2465,59732
08-01-2019,8,20112,23464,8899,6426,58902,1318,713,531,2562,61464
08-01-2019,9,19778,23734,8721,6236,58471,1283,715,595,2593,61064
08-01-2019,10,19550,23899,8648,6147,58244,1302,723,576,2601,60845
08-01-2019,11,18740,23858,8710,6216,57525,1311,726,495,2532,60057
08-01-2019,12,17360,23567,8735,6363,56024,1298,726,480,2504,58528
08-01-2019,13,17376,23735,8770,6400,56283,1293,731,447,2471,58754
08-01-2019,14,17812,24167,8929,6381,57290,1288,725,521,2534,59824
08-01-2019,15,17791,24589,9024,6204,57610,1288,721,647,2656,60266
08-01-2019,16,18867,25201,9101,6633,59804,1287,736,602,2625,62429
08-01-2019,17,18882,25267,9067,6675,59890,1287,719,609,2615,62505
08-01-2019,18,17933,24880,9032,6524,58369,1280,715,419,2414,60783
08-01-2019,19,17104,24481,8790,6388,56763,1273,703,344,2320,59083
08-01-2019,20,16463,24321,8517,6193,55494,1165,702,330,2197,57691
08-01-2019,21,16185,23532,8287,5946,53950,1005,564,322,1891,55841
08-01-2019,22,14815,22684,7890,5493,50882,998,550,313,1861,52743
08-01-2019,23,13398,21379,7529,5288,47594,1004,553,294,1851,49445
09-01-2019,0,12210,20506,7412,4877,45007,1051,591,285,1927,46934
09-01-2019,1,11568,20356,7407,5065,44396,1042,590,276,1908,46304
09-01-2019,2,11296,20306,7445,5269,44315,1025,589,273,1887,46202
09-01-2019,3,10972,20280,7556,5415,44223,1014,588,267,1869,46092
09-01-2019,4,11353,20906,7863,5320,45441,1036,589,258,1883,47324
09-01-2019,5,13432,21798,8505,5456,49192,1147,588,262,1997,51189
09-01-2019,6,16134,23639,9330,6165,55268,1285,665,250,2200,57468
09-01-2019,7,18436,25218,9675,6541,59868,1286,937,245,2468,62336
09-01-2019,8,19109,25732,9808,6486,61137,1305,952,285,2542,63679
09-01-2019,9,18701,25610,9749,6601,60660,1275,958,276,2509,63169
09-01-2019,10,18955,25589,9748,6591,60883,1300,935,271,2506,63389
09-01-2019,11,18538,25274,9691,6699,60201,1271,1064,266,2601,62802
09-01-2019,12,17924,24551,9709,6708,58893,1261,1078,256,2595,61488
09-01-2019,13,18285,24456,9584,6665,58991,1271,1067,252,2590,61581
09-01-2019,14,18806,24652,9662,6629,59751,1267,1076,305,2648,62399
09-01-2019,15,20151,24971,9489,5871,60483,1276,1075,500,2851,63334
09-01-2019,16,21691,25391,9586,5628,62296,1282,1155,659,3096,65392
09-01-2019,17,22360,25363,9508,5420,62651,1327,1189,668,3184,65835
09-01-2019,18,22028,25017,9469,5075,61589,1338,1074,484,2896,64485
09-01-2019,19,21562,24647,9248,4243,59700,1333,1063,340,2736,62436
09-01-2019,20,20601,23983,8771,3825,57182,1320,1042,197,2559,59741
09-01-2019,21,20469,23197,8336,3407,55410,1321,686,202,2209,57619
09-01-2019,22,19516,22166,8078,3543,53304,1346,647,202,2195,55499
09-01-2019,23,17496,20543,7895,3187,49122,1365,650,196,2211,51333
10-01-2019,0,16900,18598,7991,2818,46306,1380,649,190,2219,48525
10-01-2019,1,16636,18297,7818,2635,45386,1380,648,185,2213,47599
10-01-2019,2,16081,18017,7827,2634,44562,1475,648,183,2306,46868
10-01-2019,3,16399,18173,7943,2587,45103,1529,646,180,2355,47458
10-01-2019,4,16585,19235,8170,2567,46557,1562,645,181,2388,48945
10-01-2019,5,18720,20546,8711,2636,50612,1589,646,180,2415,53027
10-01-2019,6,22942,22545,9346,3209,58041,1578,682,192,2452,60493
10-01-2019,7,24426,23620,9800,3508,61355,1575,1096,400,3071,64426
10-01-2019,8,24271,23701,10050,3257,61278,1570,1560,434,3564,64842
10-01-2019,9,24320,23909,9991,3279,61499,1573,1684,434,3691,65190
10-01-2019,10,24454,23970,9988,3346,61757,1565,1577,439,3581,65338
10-01-2019,11,24615,24054,10007,3403,62077,1565,1452,414,3431,65508
10-01-2019,12,24592,23947,10023,3429,61993,1565,1291,414,3270,65263
10-01-2019,13,24189,23977,10021,3569,61755,1560,1232,411,3203,64958
10-01-2019,14,23963,24099,10159,3679,61901,1555,1299,384,3238,65139
10-01-2019,15,24068,24294,10409,3643,62414,1570,1320,383,3273,65687
10-01-2019,16,24245,24482,10503,3852,63084,1472,1299,420,3191,66275
10-01-2019,17,24424,24169,10331,4040,62963,1524,1312,402,3238,66201
10-01-2019,18,23579,24182,10119,4223,62102,1598,1259,394,3251,65353
10-01-2019,19,22583,24129,9895,3907,60514,1619,1210,389,3218,63732
10-01-2019,20,21012,23915,9602,3897,58426,1637,1039,188,2864,61290
10-01-2019,21,19376,23596,9456,4004,56435,1660,668,203,2531,58966
10-01-2019,22,17335,22776,9150,4267,53530,1667,665,222,2554,56084
10-01-2019,23,15188,21503,8913,4515,50119,1691,673,241,2605,52724
11-01-2019,0,14000,20202,8655,4504,47360,1446,692,250,2388,49748
11-01-2019,1,12416,19913,8516,4940,45786,1383,692,261,2336,48122
11-01-2019,2,12126,20043,8501,4882,45552,1386,694,283,2363,47915
11-01-2019,3,12476,20020,8577,5021,46093,1393,697,277,2367,48460
11-01-2019,4,12307,20543,8667,5075,46593,1451,691,298,2440,49033
11-01-2019,5,13426,21316,8878,5385,49005,1473,697,336,2506,51511
11-01-2019,6,17082,23413,9461,5453,55411,1529,705,492,2726,58137
11-01-2019,7,20348,24237,9849,5932,60367,1514,706,611,2831,63198
11-01-2019,8,21662,24498,9909,6143,62212,1510,733,605,2848,65060
11-01-2019,9,21292,24516,9733,6244,61787,1470,759,620,2849,64636
11-01-2019,10,21366,24458,9672,6629,62127,1470,758,641,2869,64996
11-01-2019,11,20870,24352,9524,6545,61291,1492,737,642,2871,64162
11-01-2019,12,20026,24256,9480,6301,60062,1488,711,643,2842,62904
11-01-2019,13,18173,24099,9534,6441,58247,1494,704,609,2807,61054
11-01-2019,14,17578,24169,9688,6104,57540,1499,577,564,2640,60180
11-01-2019,15,17655,24305,9874,5823,57659,1508,576,513,2597,60256
11-01-2019,16,17960,24634,10041,5794,58429,1520,746,429,2695,61124
11-01-2019,17,19398,24813,10012,5427,59649,1526,744,410,2680,62329
11-01-2019,18,18307,24594,9760,5241,57903,1515,630,395,2540,60443
11-01-2019,19,17458,24445,9353,4835,56092,1532,597,359,2488,58580
11-01-2019,20,16292,23527,9132,4457,53408,1544,560,313,2417,55825
11-01-2019,21,15497,22689,9027,4357,51570,1533,540,359,2432,54002
11-01-2019,22,13971,21564,8899,4112,48546,1540,545,385,2470,51016
11-01-2019,23,12799,20304,8831,3788,45723,1463,550,394,2407,48130
12-01-2019,0,13403,19145,8879,3847,45275,1351,505,396,2252,47527
12-01-2019,1,13081,18768,8844,3918,44611,1258,477,412,2147,46758
12-01-2019,2,12768,18430,8722,4053,43972,1118,471,415,2004,45976
12-01-2019,3,12118,17805,8785,4080,42788,1099,470,465,2034,44822
12-01-2019,4,12355,17745,8804,4273,43177,1089,465,480,2034,45211
12-01-2019,5,12256,18341,8824,4521,43942,1137,466,482,2085,46027
12-01-2019,6,12466,19171,8911,4648,45196,1115,465,456,2036,47232
12-01-2019,7,13792,20381,9100,4898,48172,1305,477,447,2229,50401
12-01-2019,8,15007,21335,9258,4997,50598,1274,491,438,2203,52801
12-01-2019,9,16727,21550,9550,4894,52723,1283,491,445,2219,54942
12-01-2019,10,17086,22082,9597,5044,53810,1286,492,426,2204,56014
12-01-2019,11,16991,22041,9605,5274,53911,1255,492,405,2152,56063
12-01-2019,12,16789,21509,9426,5091,52815,1252,495,375,2122,54937
12-01-2019,13,16407,21515,9218,5141,52282,1250,494,343,2087,54369
12-01-2019,14,16477,21448,9127,5096,52149,1263,493,321,2077,54226
12-01-2019,15,17371,21715,9261,5229,53574,1265,492,313,2070,55644
12-01-2019,16,18661,22220,9284,5581,55747,1247,488,283,2018,57765
12-01-2019,17,19812,22409,9260,5349,56830,1255,487,283,2025,58855
12-01-2019,18,18682,22032,9045,5593,55353,1247,484,315,2046,57399
12-01-2019,19,17392,21529,8776,5470,53168,1212,486,307,2005,55173
12-01-2019,20,16041,20744,8636,4954,50376,1181,485,292,1958,52334
12-01-2019,21,15777,20120,8471,4715,49084,1183,483,266,1932,51016
12-01-2019,22,14702,19436,8387,4150,46678,1195,482,258,1935,48613
12-01-2019,23,13870,18651,8267,3994,44783,1195,483,239,1917,46700
13-01-2019,0,14517,17008,8253,3899,43677,1053,508,242,1803,45480
13-01-2019,1,13991,16740,8084,3814,42630,1043,509,244,1796,44426
13-01-2019,2,13290,16520,7960,3908,41678,1041,508,251,1800,43478
13-01-2019,3,13137,16583,7915,3963,41601,1041,507,252,1800,43401
13-01-2019,4,12829,17147,7826,4096,41898,1053,508,261,1822,43720
13-01-2019,5,12725,17885,7816,4374,42800,1067,510,237,1814,44614
13-01-2019,6,12704,18424,7888,4744,43762,1052,510,237,1799,45561
13-01-2019,7,13034,19112,7891,4726,44763,1061,508,246,1815,46578
13-01-2019,8,13607,19603,7974,4997,46181,1056,507,293,1856,48037
13-01-2019,9,13929,20159,8263,5370,47722,1049,500,335,1884,49606
13-01-2019,10,14940,20585,8385,5761,49672,1079,527,347,1953,51625
13-01-2019,11,15866,20704,8443,5906,50918,1066,524,369,1959,52877
13-01-2019,12,15755,20783,8426,5800,50765,1066,521,349,1936,52701
13-01-2019,13,15292,20782,8385,5762,50220,1053,525,317,1895,52115
13-01-2019,14,14727,20897,8420,5563,49608,1019,529,356,1904,51512
13-01-2019,15,15653,21428,8541,5542,51164,1029,530,369,1928,53092
13-01-2019,16,17191,22098,8609,5672,53570,1075,539,412,2026,55596
13-01-2019,17,17058,22589,8809,5950,54407,1085,522,462,2069,56476
13-01-2019,18,16429,22470,8761,5861,53521,1028,513,483,2024,55545
13-01-2019,19,16199,22418,8580,5553,52750,1023,524,490,2037,54787
13-01-2019,20,15082,21857,8373,5395,50707,1018,519,473,2010,52717
13-01-2019,21,14348,21175,8281,5277,49082,872,516,435,1823,50905
13-01-2019,22,14139,20310,8118,4948,47514,857,500,417,1774,49288
13-01-2019,23,14222,19517,8033,4173,45945,851,395,401,1647,47592
14-01-2019,0,13614,18911,7939,4548,45012,793,386,362,1541,46553
14-01-2019,1,13596,18919,7934,4387,44835,786,381,346,1513,46348
14-01-2019,2,13519,18954,7876,4375,44724,764,388,348,1500,46224
14-01-2019,3,13121,19368,7856,4529,44873,757,384,331,1472,46345
14-01-2019,4,12960,19909,8119,4938,45926,971,384,336,1691,47617
14-01-2019,5,14133,21174,8861,5184,49352,1159,530,341,2030,51382
14-01-2019,6,16153,24255,9491,6141,56041,1229,550,385,2164,58205
14-01-2019,7,20106,26047,9880,6318,62353,1241,544,428,2213,64566
14-01-2019,8,20773,26243,9867,6841,63726,1245,550,516,2311,66037
14-01-2019,9,19785,26605,9871,7131,63393,1316,717,579,2612,66005
14-01-2019,10,19485,26648,9699,7111,62942,1299,704,591,2594,65536
14-01-2019,11,18787,26581,9614,7055,62038,1286,726,576,2588,64626
14-01-2019,12,17932,26044,9535,7105,60618,1288,635,549,2472,63090
14-01-2019,13,17206,25676,9555,7095,59531,1305,641,552,2498,62029
14-01-2019,14,16805,25709,9695,7036,59245,1297,681,553,2531,61776
14-01-2019,15,17673,26197,9788,6948,60607,1306,761,510,2577,63184
14-01-2019,16,19536,26737,9859,6731,62863,1326,1033,485,2844,65707
14-01-2019,17,20122,26937,9792,6933,63784,1358,982,472,2812,66596
14-01-2019,18,19826,26358,9640,7102,62924,1311,854,475,2640,65564
14-01-2019,19,18854,25988,9289,7086,61218,1393,1041,471,2905,64123
14-01-2019,20,18110,25358,8996,6932,59397,1370,844,452,2666,62063
14-01-2019,21,16844,23335,8608,6536,55324,1140,585,380,2105,57429
14-01-2019,22,16141,22012,8373,6049,52576,1110,533,443,2086,54662
14-01-2019,23,14707,20545,8189,5562,49005,1060,436,439,1935,50940
15-01-2019,0,14276,19754,8182,5409,47620,1039,434,456,1929,49549
15-01-2019,1,13314,19256,8180,5086,45836,1010,429,370,1809,47645
15-01-2019,2,13075,19229,8238,5070,45614,1023,435,313,1771,47385
15-01-2019,3,12581,19432,8271,5091,45376,1017,519,346,1882,47258
15-01-2019,4,12713,20180,8536,5196,46625,1072,599,421,2092,48717
15-01-2019,5,14330,21585,8888,5226,50029,1268,600,492,2360,52389
15-01-2019,6,17938,24094,9354,5076,56462,1407,587,533,2527,58989
15-01-2019,7,21950,25311,9719,4837,61818,1415,595,730,2740,64558
15-01-2019,8,23866,25190,9880,4565,63500,1420,647,698,2765,66265
15-01-2019,9,23998,24615,10082,3930,62626,1421,807,733,2961,65587
15-01-2019,10,23768,24207,9890,4582,62447,1425,888,761,3074,65521
15-01-2019,11,23488,24120,9718,5162,62488,1403,770,801,2974,65462
15-01-2019,12,22128,23281,9663,5897,60970,1403,612,794,2809,63779
15-01-2019,13,21389,23098,9692,6272,60450,1418,640,706,2764,63214
15-01-2019,14,20998,23024,9697,6575,60294,1429,624,718,2771,63065
15-01-2019,15,20847,23230,9829,6550,60457,1448,704,691,2843,63300
15-01-2019,16,21742,23392,10058,6582,61775,1455,978,684,3117,64892
15-01-2019,17,22268,23480,10081,6444,62273,1459,1081,611,3151,65424
15-01-2019,18,21970,23568,9875,6162,61576,1444,964,545,2953,64529
15-01-2019,19,21396,23331,9549,5740,60018,1445,685,524,2654,62672
15-01-2019,20,20220,22845,9299,5314,57679,1442,606,360,2408,60087
15-01-2019,21,18762,22126,9133,5115,55135,1445,573,276,2294,57429
15-01-2019,22,16985,20953,8872,4913,51723,1440,573,275,2288,54011
15-01-2019,23,14830,20049,8539,4437,47856,1474,583,273,2330,50186
16-01-2019,0,14822,18319,8388,4469,45998,1472,581,262,2315,48313
16-01-2019,1,14611,17833,8292,4623,45360,1423,577,251,2251,47611
16-01-2019,2,14420,17551,8278,4544,44795,1414,571,257,2242,47037
16-01-2019,3,14766,17417,8301,4649,45133,1423,558,255,2236,47369
16-01-2019,4,15151,18204,8472,4937,46765,1434,564,249,2247,49012
16-01-2019,5,17345,18989,8966,5138,50439,1461,578,234,2273,52712
16-01-2019,6,20546,20936,9458,5651,56592,1481,715,255,2451,59043
16-01-2019,7,23550,23057,9645,5997,62249,1464,1198,267,2929,65178
16-01-2019,8,23636,23414,9697,6197,62945,1445,1131,397,2973,65918
16-01-2019,9,22556,23340,9818,6429,62144,1435,1172,386,2993,65137
16-01-2019,10,22334,23339,9743,6603,62019,1433,1143,369,2945,64964
16-01-2019,11,22208,23356,9619,6652,61836,1453,1139,362,2954,64790
16-01-2019,12,21865,23105,9464,6347,60781,1458,1135,410,3003,63784
16-01-2019,13,21233,23046,9342,6601,60224,1467,1225,422,3114,63338
16-01-2019,14,21695,23198,9409,6148,60449,1479,1162,441,3082,63531
16-01-2019,15,21831,23665,9422,5759,60678,1483,1146,484,3113,63791
16-01-2019,16,22799,24298,9726,6156,62980,1492,1262,525,3279,66259
16-01-2019,17,22098,24500,9819,6752,63169,1490,1140,482,3112,66281
16-01-2019,18,20820,24390,9731,6843,61783,1498,1031,474,3003,64786
16-01-2019,19,19785,24296,9534,6593,60208,1491,844,510,2845,63053
16-01-2019,20,18172,23702,9127,6276,57277,1509,843,571,2923,60200
16-01-2019,21,16694,22689,8625,6120,54128,1481,616,596,2693,56821
16-01-2019,22,15825,21242,8350,5631,51049,1479,600,620,2699,53748
16-01-2019,23,15537,19828,8138,5130,48635,1448,604,630,2682,51317
17-01-2019,0,15217,18604,8182,4804,46806,1345,614,636,2595,49401
17-01-2019,1,14258,18275,8212,4614,45359,1286,612,635,2533,47892
17-01-2019,2,14288,18337,8222,4375,45223,1299,609,621,2529,47752
17-01-2019,3,14437,18732,8283,4236,45688,1299,608,625,2532,48220
17-01-2019,4,15062,19178,8541,4333,47114,1346,600,628,2574,49688
17-01-2019,5,16704,20352,8884,4256,50196,1568,589,618,2775,52971
17-01-2019,6,20504,22388,9425,4157,56474,1634,597,620,2851,59325
17-01-2019,7,23522,24324,9813,4340,61999,1699,581,630,2910,64909
17-01-2019,8,23805,24639,9857,4506,62808,1682,598,638,2918,65726
17-01-2019,9,23590,24522,9809,4451,62371,1664,616,651,2931,65302
17-01-2019,10,24157,24553,9666,4500,62878,1681,619,643,2943,65821
17-01-2019,11,23782,24372,9668,4905,62729,1722,600,635,2957,65686
17-01-2019,12,23370,23991,9662,5009,62032,1714,601,642,2957,64989
17-01-2019,13,23027,23773,9708,5174,61682,1690,551,638,2879,64561
17-01-2019,14,23243,23871,9839,5181,62133,1697,600,631,2928,65061
17-01-2019,15,24141,24118,9945,4877,63082,1689,587,650,2926,66008
17-01-2019,16,25292,24807,10097,4994,65189,1685,647,617,2949,68138
17-01-2019,17,25362,24731,10122,5078,65293,1683,663,487,2833,68126
17-01-2019,18,24522,24635,10096,5133,64387,1680,622,503,2805,67192
17-01-2019,19,23491,24143,9803,5013,62450,1675,561,441,2677,65127
17-01-2019,20,21578,23088,9358,4944,58970,1650,480,417,2547,61517
17-01-2019,21,20358,21708,9130,4722,55920,1640,526,392,2558,58478
17-01-2019,22,18691,21066,8853,4295,52905,1640,507,387,2534,55439
17-01-2019,23,17596,20605,8715,4055,50970,1554,554,374,2482,53452
18-01-2019,0,17408,19929,8687,3710,49734,1614,550,393,2557,52291
18-01-2019,1,16737,19474,8642,3533,48386,1600,502,369,2471,50857
18-01-2019,2,16522,19457,8637,3346,47962,1592,398,327,2317,50279
18-01-2019,3,16503,19616,8599,3299,48017,1589,398,306,2293,50310
18-01-2019,4,17178,19906,8670,3244,48998,1604,394,325,2323,51321
18-01-2019,5,19498,20944,9195,3577,53214,1637,527,318,2482,55696
18-01-2019,6,23113,23633,9842,3647,60235,1642,617,406,2665,62900
18-01-2019,7,25852,25498,10097,3875,65323,1648,972,724,3344,68667
18-01-2019,8,25974,25263,9927,4164,65328,1611,1544,742,3897,69225
18-01-2019,9,25544,25170,9988,3941,64642,1619,1385,731,3735,68377
18-01-2019,10,25934,24978,9854,4240,65006,1628,1230,718,3576,68582
18-01-2019,11,25665,24832,9729,4169,64396,1613,1246,519,3378,67774
18-01-2019,12,25494,24776,9574,4234,64078,1615,1336,533,3484,67562
18-01-2019,13,25415,24778,9500,4265,63957,1481,1359,472,3312,67269
18-01-2019,14,25224,24771,9714,4298,64006,1477,1380,364,3221,67227
18-01-2019,15,25365,24897,9875,4292,64430,1473,1474,446,3393,67823
18-01-2019,16,25793,25311,10124,4334,65561,1486,1638,608,3732,69293
18-01-2019,17,25922,25146,10000,4625,65693,1461,1584,639,3684,69377
18-01-2019,18,25827,25170,9991,4520,65507,1420,1367,647,3434,68941
18-01-2019,19,25214,25034,9821,4289,64358,1413,971,460,2844,67202
18-01-2019,20,24072,24422,9266,3983,61743,1401,589,475,2465,64208
18-01-2019,21,23109,23525,9112,3702,59449,1402,604,475,2481,61930
18-01-2019,22,22389,22495,9045,2788,56715,1391,598,466,2455,59170
18-01-2019,23,20159,21152,8691,3100,53104,1386,594,470,2450,55554
19-01-2019,0,19545,19435,8755,3075,50810,1208,588,379,2175,52985
19-01-2019,1,18721,19088,8749,3137,49693,1212,577,352,2141,51834
19-01-2019,2,19048,19038,8783,3167,50037,1210,574,349,2133,52170
19-01-2019,3,17577,18754,8737,3062,48132,1172,576,376,2124,50256
19-01-2019,4,17098,18762,8784,2956,47601,1202,572,350,2124,49725
19-01-2019,5,16970,19204,8825,2945,47944,1208,572,338,2118,50062
19-01-2019,6,16842,20626,8832,2964,49263,1178,581,337,2096,51359
19-01-2019,7,18881,22339,9059,3175,53456,1192,596,340,2128,55584
19-01-2019,8,21484,23190,9259,3729,57663,1218,603,338,2159,59822
19-01-2019,9,23120,24085,9493,4069,60767,1253,617,321,2191,62958
19-01-2019,10,24024,24480,9587,4475,62567,1244,622,305,2171,64738
19-01-2019,11,22700,24066,9352,4540,60658,1273,596,304,2173,62831
19-01-2019,12,21521,23680,9135,3857,58193,1245,591,308,2144,60337
19-01-2019,13,20293,23639,9032,3715,56679,1184,585,326,2095,58774
19-01-2019,14,19350,23605,9078,3612,55646,1182,604,350,2136,57782
19-01-2019,15,21689,24197,9322,3611,58819,1297,617,421,2335,61154
19-01-2019,16,23918,25139,9848,4168,63075,1327,711,498,2536,65611
19-01-2019,17,24534,25254,9888,4506,64182,1403,1009,538,2950,67132
19-01-2019,18,24066,24981,9803,4409,63259,1385,649,545,2579,65838
19-01-2019,19,22725,24222,9467,4353,60766,1407,611,536,2554,63320
19-01-2019,20,20720,22858,9208,3644,56431,1408,604,556,2568,58999
19-01-2019,21,19074,21756,9315,3446,53591,1341,585,553,2479,56070
19-01-2019,22,17230,20486,9342,3436,50493,1310,616,573,2499,52992
19-01-2019,23,16307,19908,9141,3361,48717,1242,606,601,2449,51166
20-01-2019,0,16083,19185,9091,2978,47338,1262,693,591,2546,49884
20-01-2019,1,15393,18716,9059,2916,46084,1316,628,594,2538,48622
20-01-2019,2,15328,18454,9036,2803,45620,1272,615,594,2481,48101
20-01-2019,3,14986,18383,9056,2781,45206,1277,613,560,2450,47656
20-01-2019,4,15134,18385,9031,2748,45298,1274,615,529,2418,47716
20-01-2019,5,15135,18413,9103,2733,45385,1257,632,502,2391,47776
20-01-2019,6,15430,19298,9448,2742,46918,1338,634,493,2465,49383
20-01-2019,7,16596,19974,9700,2887,49158,1364,618,475,2457,51615
20-01-2019,8,17700,21061,9760,3157,51678,1374,633,427,2434,54112
20-01-2019,9,19495,22270,9866,3266,54897,1385,614,344,2343,57240
20-01-2019,10,20458,22391,9802,3364,56015,1401,598,255,2254,58269
20-01-2019,11,20811,22319,9777,3408,56315,1365,605,212,2182,58497
20-01-2019,12,20031,22304,9683,3458,55476,1352,599,225,2176,57652
20-01-2019,13,19629,22301,9656,3189,54774,1330,620,248,2198,56972
20-01-2019,14,19761,21864,9716,3155,54496,1327,628,241,2196,56692
20-01-2019,15,21501,22304,9874,3157,56837,1318,635,250,2203,59040
20-01-2019,16,24125,23424,10220,3786,61557,1324,696,248,2268,63825
20-01-2019,17,25248,24142,10583,4053,64027,1332,1098,270,2700,66727
20-01-2019,18,25166,24002,10572,4198,63937,1316,1135,276,2727,66664
20-01-2019,19,25356,23726,10453,4177,63713,1306,829,265,2400,66113
20-01-2019,20,24677,22932,10193,4157,61961,1331,692,267,2290,64251
20-01-2019,21,23510,21410,9873,3889,58685,1301,646,268,2215,60900
20-01-2019,22,22618,20240,9649,4097,56604,1317,616,269,2202,58806
20-01-2019,23,19986,18271,9478,4048,51784,1281,612,280,2173,53957
21-01-2019,0,19931,17366,9348,4244,50888,1492,641,288,2421,53309
21-01-2019,1,18169,16888,9118,4469,48643,1575,642,284,2501,51144
21-01-2019,2,17418,16892,9083,4611,48003,1594,641,283,2518,50521
21-01-2019,3,17705,17078,9016,4664,48463,1619,646,277,2542,51005
21-01-2019,4,18772,17433,9208,4745,50157,1657,698,311,2666,52823
21-01-2019,5,21333,18674,9550,4825,54381,1838,732,337,2907,57288
21-01-2019,6,24506,22343,10075,5477,62400,2013,1115,389,3517,65917
21-01-2019,7,26068,23853,10438,5643,66002,2006,1245,781,4032,70034
21-01-2019,8,26306,24030,10594,5859,66791,2017,1340,776,4133,70924
21-01-2019,9,26252,24116,10515,6008,66891,2020,1339,765,4124,71015
21-01-2019,10,26364,24262,10551,5990,67166,2030,1225,741,3996,71162
21-01-2019,11,25594,24220,10608,6222,66644,2020,1183,487,3690,70334
21-01-2019,12,25175,24140,10538,5842,65696,2026,1177,269,3472,69168
21-01-2019,13,25058,23919,10585,5443,65005,2032,1176,248,3456,68461
21-01-2019,14,25014,23746,10705,5345,64810,2026,1176,256,3458,68268
21-01-2019,15,25091,24019,10879,4980,64969,2019,1180,429,3628,68597
21-01-2019,16,25222,24026,11077,4711,65036,2033,1436,659,4128,69164
21-01-2019,17,25573,24090,11195,4967,65825,2044,1475,676,4195,70020
21-01-2019,18,25897,23974,10985,4268,65124,2041,1626,676,4343,69467
21-01-2019,19,25702,23915,10810,3869,64298,2024,1190,653,3867,68165
21-01-2019,20,25422,23532,10636,3531,63122,2026,1134,216,3376,66498
21-01-2019,21,24571,22702,10416,3166,60857,2020,838,199,3057,63914
21-01-2019,22,23591,21414,10127,2885,58018,1855,839,273,2967,60985
21-01-2019,23,21626,19422,9850,2508,53406,1834,834,201,2869,56275
22-01-2019,0,20848,17463,9867,2712,50889,1721,724,225,2670,53559
22-01-2019,1,20157,17186,9778,2785,49906,1737,676,222,2635,52541
22-01-2019,2,19467,17083,9686,2889,49126,1727,670,240,2637,51763
22-01-2019,3,18765,17022,9593,2907,48287,1735,666,232,2633,50920
22-01-2019,4,19716,17076,9619,2954,49363,1742,662,215,2619,51982
22-01-2019,5,21854,18311,10001,3081,53246,1744,675,276,2695,55941
22-01-2019,6,24476,21506,10604,3743,60328,1763,1133,358,3254,63582
22-01-2019,7,25868,23345,10708,4389,64309,1799,1287,640,3726,68035
22-01-2019,8,26220,23751,10760,4395,65126,1828,1572,656,4056,69182
22-01-2019,9,26146,23773,10740,4488,65148,1857,1508,630,3995,69143
22-01-2019,10,26147,23735,10784,4712,65378,1946,1312,455,3713,69091
22-01-2019,11,26075,23564,10865,4840,65345,1952,1334,300,3586,68931
22-01-2019,12,26049,23534,10931,4932,65448,1951,1168,324,3443,68891
22-01-2019,13,25784,23385,10829,5127,65125,1950,1165,250,3365,68490
22-01-2019,14,26021,23667,10889,5217,65794,1934,1167,324,3425,69219
22-01-2019,15,26263,23810,11049,5224,66348,1926,1176,334,3436,69784
22-01-2019,16,26393,23852,11107,5399,66750,1944,1318,545,3807,70557
22-01-2019,17,26292,23858,11124,5656,66930,1950,1332,595,3877,70807
22-01-2019,18,25684,23780,10817,5609,65891,1946,1316,361,3623,69514
22-01-2019,19,25212,23039,10379,5619,64250,1950,1051,347,3348,67598
22-01-2019,20,24445,21788,10007,4988,61229,1933,1037,306,3276,64505
22-01-2019,21,23348,20778,9715,4847,58690,1915,672,313,2900,61590
22-01-2019,22,22656,19322,9459,5017,56454,1927,666,293,2886,59340
22-01-2019,23,20136,18079,9117,5019,52351,1922,670,247,2839,55190
23-01-2019,0,20028,17412,9066,4412,50917,1852,694,229,2775,53692
23-01-2019,1,19382,17168,9047,4291,49889,1843,698,229,2770,52659
23-01-2019,2,18874,17189,9007,4181,49252,1799,695,224,2718,51970
23-01-2019,3,18523,17347,8990,4312,49172,1763,691,223,2677,51849
23-01-2019,4,19375,17482,8997,4300,50155,1870,689,210,2769,52924
23-01-2019,5,22069,18989,9409,4259,54726,1879,713,220,2812,57538
23-01-2019,6,24472,21702,9870,4562,60604,1961,1104,255,3320,63924
23-01-2019,7,25995,23866,10109,4939,64909,1991,1326,457,3774,68683
23-01-2019,8,25926,24254,10429,4819,65427,2006,1509,666,4181,69608
23-01-2019,9,26001,24283,10427,4692,65403,2013,1532,673,4218,69621
23-01-2019,10,26081,24417,10288,4649,65434,1998,1379,658,4035,69469
23-01-2019,11,26053,24209,10242,4673,65177,1990,1354,473,3817,68994
23-01-2019,12,25850,23969,10315,4565,64699,1983,1264,456,3703,68402
23-01-2019,13,26018,23939,10216,4354,64526,1998,1193,412,3603,68129
23-01-2019,14,26134,23840,10211,4197,64382,1991,1238,261,3490,67872
23-01-2019,15,26270,23949,10398,4183,64801,1986,1266,234,3486,68287
23-01-2019,16,27030,24681,10904,4373,66988,1976,1351,659,3986,70974
23-01-2019,17,26553,24756,10969,5001,67279,1967,1575,656,4198,71477
23-01-2019,18,25893,23369,10872,4800,64934,1973,1388,651,4012,68946
23-01-2019,19,25505,22800,10611,4182,63096,1948,1108,313,3369,66465
23-01-2019,20,25261,22107,10311,3857,61535,1909,1067,291,3267,64802
23-01-2019,21,24882,21727,9915,4001,60526,1905,709,285,2899,63425
23-01-2019,22,23982,19907,9767,3820,57477,1906,692,279,2877,60354
23-01-2019,23,22463,18588,9552,3863,54466,1893,692,254,2839,57305
24-01-2019,0,22137,18115,9457,3613,53321,1926,695,228,2849,56170
24-01-2019,1,21614,17750,9386,3457,52207,1887,692,218,2797,55004
24-01-2019,2,21103,17605,9457,3411,51575,1877,688,206,2771,54346
24-01-2019,3,20602,17672,9445,3301,51019,1889,686,201,2776,53795
24-01-2019,4,21631,18062,9582,3355,52631,1901,683,200,2784,55415
24-01-2019,5,23271,19129,9732,3474,55605,1923,694,202,2819,58424
24-01-2019,6,25135,22226,10289,3525,61176,1942,1167,283,3392,64568
24-01-2019,7,26224,24393,10645,4178,65441,1921,1394,652,3967,69408
24-01-2019,8,26642,24606,10820,4301,66369,1956,1726,877,4559,70928
24-01-2019,9,26678,24683,10787,4334,66483,1970,1818,665,4453,70936
24-01-2019,10,26810,24720,10848,4364,66742,1954,1575,665,4194,70936
24-01-2019,11,26262,24671,10765,4416,66115,1928,1572,687,4187,70302
24-01-2019,12,26027,24151,10643,4331,65152,1935,1446,463,3844,68996
24-01-2019,13,26064,23919,10623,4137,64743,1923,1365,241,3529,68272
24-01-2019,14,26142,23961,10563,3978,64644,1924,1362,225,3511,68155
24-01-2019,15,26364,23843,10545,3924,64675,1915,1363,229,3507,68182
24-01-2019,16,26555,24458,10750,3660,65423,1881,1426,639,3946,69369
24-01-2019,17,26435,24839,10821,3724,65818,1822,1685,658,4165,69983
24-01-2019,18,26111,24513,10770,3780,65173,1812,1617,662,4091,69264
24-01-2019,19,26210,24245,10577,3478,64510,1623,1255,431,3309,67819
24-01-2019,20,25788,23446,10360,3345,62939,1577,1079,300,2956,65895
24-01-2019,21,25375,23006,10042,3231,61654,1590,699,295,2584,64238
24-01-2019,22,24329,21364,9762,3146,58600,1588,684,290,2562,61162
24-01-2019,23,23381,19950,9520,2953,55805,1597,685,290,2572,58377
25-01-2019,0,22841,19029,9256,3246,54371,1511,686,309,2506,56877
25-01-2019,1,21655,18848,9128,3364,52995,1504,686,346,2536,55531
25-01-2019,2,21075,18300,9099,3292,51768,1502,688,386,2576,54344
25-01-2019,3,20356,17950,9072,3108,50486,1515,690,417,2622,53108
25-01-2019,4,20528,18224,9012,3283,51047,1506,684,412,2602,53649
25-01-2019,5,22810,19621,9366,3283,55081,1511,692,405,2608,57689
25-01-2019,6,24702,22321,9917,3468,60409,1588,1091,451,3130,63539
25-01-2019,7,25719,23590,10209,3623,63142,1599,1319,647,3565,66707
25-01-2019,8,26295,23948,10299,3785,64329,1588,1576,871,4035,68364
25-01-2019,9,26436,24007,10341,4001,64786,1636,1477,859,3972,68758
25-01-2019,10,26831,24034,10401,4258,65524,1675,1289,619,3583,69107
25-01-2019,11,26525,23854,10384,4407,65172,1586,1187,457,3230,68402
25-01-2019,12,26257,23714,10484,4379,64834,1617,1100,433,3150,67984
25-01-2019,13,26061,23458,10415,4406,64340,1584,1096,410,3090,67430
25-01-2019,14,25950,23422,10476,4496,64343,1607,1097,374,3078,67421
25-01-2019,15,25744,23444,10538,4600,64327,1621,1149,328,3098,67425
25-01-2019,16,26184,23615,10635,4715,65149,1641,1223,301,3165,68314
25-01-2019,17,26217,23816,10634,4870,65538,1645,1315,282,3242,68780
25-01-2019,18,25559,23549,10413,5049,64570,1629,1358,281,3268,67838
25-01-2019,19,23770,23058,10107,5082,62017,1562,1123,253,2938,64955
25-01-2019,20,21383,22230,9701,4805,58119,1542,718,235,2495,60614
25-01-2019,21,20011,21473,9365,4976,55826,1535,712,213,2460,58286
25-01-2019,22,19436,20549,9282,4775,54042,1519,695,202,2416,56458
25-01-2019,23,17910,18938,9189,4386,50423,1516,693,198,2407,52830
26-01-2019,0,17008,17649,9040,4156,47852,1206,695,196,2097,49949
26-01-2019,1,16698,17172,8921,4160,46950,1173,706,188,2067,49017
26-01-2019,2,16140,16691,8985,3885,45701,1151,705,188,2044,47745
26-01-2019,3,16249,16797,9038,3792,45876,1143,706,185,2034,47910
26-01-2019,4,16728,16892,9047,3790,46459,1142,705,186,2033,48492
26-01-2019,5,17131,17098,9222,3638,47087,1179,705,190,2074,49161
26-01-2019,6,17797,17868,9236,3669,48570,1265,704,191,2160,50730
26-01-2019,7,18935,19236,9345,3867,51384,1287,705,206,2198,53582
26-01-2019,8,20145,20219,9616,3864,53844,1272,686,193,2151,55995
26-01-2019,9,22419,21232,10244,4059,57955,1264,687,275,2226,60181
26-01-2019,10,23935,22022,10263,4333,60555,1320,704,322,2346,62901
26-01-2019,11,24187,22210,9796,4226,60418,1222,705,268,2195,62613
26-01-2019,12,23336,22155,9469,4136,59097,1260,703,208,2171,61268
26-01-2019,13,22535,21837,9248,4118,57739,1234,703,197,2134,59873
26-01-2019,14,21360,21516,9344,3594,55814,1224,691,200,2115,57929
26-01-2019,15,21459,21530,9743,3608,56339,1233,691,199,2123,58462
26-01-2019,16,22329,22179,10405,3734,58649,1256,692,256,2204,60853
26-01-2019,17,23569,22338,10546,4222,60676,1252,693,269,2214,62890
26-01-2019,18,23285,22122,10431,4688,60526,1252,694,236,2182,62708
26-01-2019,19,21003,21743,10033,4510,57291,1245,695,229,2169,59460
26-01-2019,20,19550,21220,9846,4536,55152,1236,694,254,2184,57336
26-01-2019,21,18265,20546,9537,4706,53055,1234,696,246,2176,55231
26-01-2019,22,17431,19763,9349,4829,51372,1233,695,233,2161,53533
26-01-2019,23,16402,18603,9269,4573,48848,1091,701,233,2025,50873
27-01-2019,0,16058,18073,9190,4410,47730,1049,700,228,1977,49707
27-01-2019,1,15845,17864,9132,4421,47263,913,700,222,1835,49098
27-01-2019,2,15637,17901,9067,4498,47102,858,699,222,1779,48881
27-01-2019,3,15522,18135,9069,4337,47062,842,699,240,1781,48843
27-01-2019,4,15659,18320,9045,4288,47313,867,699,255,1821,49134
27-01-2019,5,15685,18563,9164,4420,47833,990,697,276,1963,49796
27-01-2019,6,16326,19021,9069,4729,49145,1122,699,332,2153,51298
27-01-2019,7,16666,20087,8979,4942,50674,1178,696,400,2274,52948
27-01-2019,8,17135,21070,8900,5225,52330,1179,694,417,2290,54620
27-01-2019,9,17925,21833,8963,5366,54086,1188,695,395,2278,56364
27-01-2019,10,18917,22696,9118,5463,56194,1241,697,369,2307,58501
27-01-2019,11,18683,22722,9084,5496,55986,1250,696,395,2341,58327
27-01-2019,12,18322,22788,8885,5114,55111,1281,698,442,2421,57532
27-01-2019,13,18046,22782,8857,4787,54472,1268,703,498,2469,56941
27-01-2019,14,17921,22832,8901,4604,54257,1273,706,545,2524,56781
27-01-2019,15,18058,22711,9115,4479,54363,1275,711,576,2562,56925
27-01-2019,16,19593,23061,9447,4627,56729,1348,717,598,2663,59392
27-01-2019,17,20745,23029,9588,4773,58135,1362,726,603,2691,60826
27-01-2019,18,20567,22875,9589,4688,57719,1364,731,607,2702,60421
27-01-2019,19,20069,22838,9423,4432,56763,1365,734,591,2690,59453
27-01-2019,20,18824,22533,9134,4151,54643,1352,734,603,2689,57332
27-01-2019,21,17766,22030,9115,3950,52860,1335,735,604,2674,55534
27-01-2019,22,17019,21417,9140,3514,51091,1353,736,590,2679,53770
27-01-2019,23,16050,20339,9132,3323,48845,1339,736,558,2633,51478
28-01-2019,0,15903,19895,9123,3089,48011,1269,733,553,2555,50566
28-01-2019,1,15312,19652,9195,2944,47105,1199,733,538,2470,49575
28-01-2019,2,15038,19454,9322,2986,46800,1167,730,546,2443,49243
28-01-2019,3,15072,19497,9546,2909,47024,1207,729,535,2471,49495
28-01-2019,4,15834,19595,9822,3014,48266,1403,726,538,2667,50933
28-01-2019,5,17942,20276,10261,3485,51966,1635,741,537,2913,54879
28-01-2019,6,20440,22307,10721,3627,57097,1646,1200,551,3397,60494
28-01-2019,7,24434,24638,10978,4271,64320,1735,1273,575,3583,67903
28-01-2019,8,25040,24691,11110,4570,65411,1742,1211,546,3499,68910
28-01-2019,9,24411,24467,11151,4755,64784,1743,1284,515,3542,68326
28-01-2019,10,23957,24147,11115,4944,64164,1738,1305,508,3551,67715
28-01-2019,11,23706,23761,11085,5131,63684,1720,1270,479,3469,67153
28-01-2019,12,23259,23409,11053,5082,62802,1726,1262,458,3446,66248
28-01-2019,13,23270,23367,11078,4900,62617,1714,1262,435,3411,66028
28-01-2019,14,23648,23536,11113,4830,63126,1719,1260,427,3406,66532
28-01-2019,15,23768,23726,11097,4873,63464,1738,1332,413,3483,66947
28-01-2019,16,24302,23923,11138,4847,64212,1724,1334,407,3465,67677
28-01-2019,17,25202,23871,11113,4838,65025,1719,1346,415,3480,68505
28-01-2019,18,25003,23952,10917,5030,64903,1718,1331,408,3457,68360
28-01-2019,19,23543,23007,10489,4888,61927,1724,1105,388,3217,65144
28-01-2019,20,22090,22366,10151,4607,59214,1734,1086,360,3180,62394
28-01-2019,21,21143,22099,9999,4240,57479,1707,706,359,2772,60251
28-01-2019,22,19528,21042,9821,4219,54609,1694,701,346,2741,57350
28-01-2019,23,18223,18910,9555,4045,50735,1679,699,338,2716,53451
29-01-2019,0,16793,18330,9504,4256,48885,1550,699,351,2600,51485
29-01-2019,1,15998,18027,9421,4228,47674,1475,696,343,2514,50188
29-01-2019,2,15964,17997,9400,4095,47455,1471,695,318,2484,49939
29-01-2019,3,16205,18084,9523,3835,47645,1470,694,300,2464,50109
29-01-2019,4,17277,18173,9649,3736,48835,1480,695,281,2456,51291
29-01-2019,5,20240,19145,9975,3747,53107,1641,706,279,2626,55733
29-01-2019,6,23179,22206,10323,4045,59753,1649,1095,258,3002,62755
29-01-2019,7,25576,23968,10540,4128,64210,1649,1318,463,3430,67640
29-01-2019,8,25645,23945,10748,4066,64405,1658,1460,495,3613,68018
29-01-2019,9,26001,24122,10689,4108,64920,1671,1567,495,3733,68653
29-01-2019,10,25977,24094,10631,4138,64841,1673,1567,494,3734,68575
29-01-2019,11,25983,24075,10595,4255,64907,1662,1437,464,3563,68470
29-01-2019,12,26214,23835,10481,4305,64836,1663,1221,305,3189,68025
29-01-2019,13,25731,23592,10369,4411,64102,1649,1138,282,3069,67171
29-01-2019,14,25956,23581,10485,4129,64152,1642,1156,305,3103,67255
29-01-2019,15,26271,23745,10492,4001,64509,1645,1169,331,3145,67654
29-01-2019,16,26449,24131,10667,4039,65285,1657,1371,381,3409,68694
29-01-2019,17,26409,24153,10581,4352,65494,1646,1364,570,3580,69074
29-01-2019,18,26137,24080,10476,4261,64953,1647,1322,556,3525,68478
29-01-2019,19,25874,23942,10205,4127,64149,1638,1167,330,3135,67284
29-01-2019,20,25145,23546,9671,4174,62537,1657,1077,327,3061,65598
29-01-2019,21,23526,22395,9363,4125,59410,1654,703,333,2690,62100
29-01-2019,22,21198,20911,9174,4119,55403,1647,688,356,2691,58094
29-01-2019,23,19196,19236,8937,4170,51540,1653,686,368,2707,54247
30-01-2019,0,18491,18283,8784,3767,49325,1658,660,354,2672,51997
30-01-2019,1,18045,17975,8747,3665,48431,1673,642,351,2666,51097
30-01-2019,2,17940,18054,8729,3611,48333,1684,641,351,2676,51009
30-01-2019,3,17996,18086,8821,3631,48534,1695,640,338,2673,51207
30-01-2019,4,18978,18393,9007,3642,50020,1708,644,336,2688,52708
30-01-2019,5,21705,19763,9278,3827,54573,1699,661,295,2655,57228
30-01-2019,6,24504,22650,9703,3966,60823,1692,1076,272,3040,63863
30-01-2019,7,26894,24106,10081,4750,65831,1698,1382,484,3564,69395
30-01-2019,8,26854,24190,10129,4940,66113,1698,1472,480,3650,69763
30-01-2019,9,26469,24153,10031,4784,65438,1692,1638,646,3976,69414
30-01-2019,10,26577,24120,10025,5133,65856,1698,1390,436,3524,69380
30-01-2019,11,25778,23927,9933,4944,64583,1707,1265,431,3403,67986
30-01-2019,12,25263,23549,9914,5056,63782,1701,1096,409,3206,66988
30-01-2019,13,25096,23280,9845,5192,63414,1675,1051,414,3140,66554
30-01-2019,14,24924,23248,9820,5361,63351,1673,1092,404,3169,66520
30-01-2019,15,24641,23291,9891,5511,63335,1673,1194,415,3282,66617
30-01-2019,16,25584,23900,10060,5386,64929,1673,1294,413,3380,68309
30-01-2019,17,26371,24216,10088,5671,66346,1699,1479,416,3594,69940
30-01-2019,18,26154,24344,9943,5765,66206,1655,1466,293,3414,69620
30-01-2019,19,25251,23866,9396,5968,64480,1652,1086,219,2957,67437
30-01-2019,20,23123,22612,8890,5933,60558,1647,1033,227,2907,63465
30-01-2019,21,21748,22222,8772,5992,58734,1649,658,233,2540,61274
30-01-2019,22,19873,21241,8626,5822,55563,1653,652,248,2553,58116
30-01-2019,23,18043,19902,8523,5606,52073,1644,654,250,2548,54621
31-01-2019,0,17414,18741,8317,5541,50013,1383,693,258,2334,52347
31-01-2019,1,16584,18703,8314,5409,49009,1351,690,268,2309,51318
31-01-2019,2,16494,18612,8309,5387,48802,1385,689,271,2345,51147
31-01-2019,3,16600,18753,8395,5624,49370,1383,692,257,2332,51702
31-01-2019,4,17289,18842,8552,5416,50099,1390,693,255,2338,52437
31-01-2019,5,20652,20074,9012,5515,55255,1428,737,296,2461,57716
31-01-2019,6,24552,22750,9487,5798,62586,1593,1124,318,3035,65621
31-01-2019,7,26065,24332,9941,6021,66361,1624,1235,463,3322,69683
31-01-2019,8,26142,24602,9920,6145,66811,1625,1425,705,3755,70566
31-01-2019,9,26206,24705,9869,5955,66735,1609,1525,703,3837,70572
31-01-2019,10,26230,24949,9890,5867,66938,1613,1611,526,3750,70688
31-01-2019,11,25959,24715,9744,5856,66275,1614,1520,338,3472,69747
31-01-2019,12,25963,24718,9780,5716,66177,1616,1366,367,3349,69526
31-01-2019,13,25789,24333,9772,5748,65640,1610,1228,361,3199,68839
31-01-2019,14,26050,24098,9625,5673,65448,1607,1242,350,3199,68647
31-01-2019,15,26065,24301,9810,5569,65744,1602,1202,365,3169,68913
31-01-2019,16,26472,24586,9977,5266,66302,1600,1354,346,3300,69602
31-01-2019,17,27087,24960,10041,5162,67251,1605,1636,355,3596,70847
31-01-2019,18,26598,24528,9948,5117,66191,1623,1446,336,3405,69596
31-01-2019,19,25898,23959,9384,5070,64311,1622,1111,316,3049,67360
31-01-2019,20,24396,23240,9013,4885,61535,1601,1091,312,3004,64539
31-01-2019,21,22346,22183,8760,4370,57661,1591,728,325,2644,60305
31-01-2019,22,20091,21454,8646,4148,54340,1606,697,328,2631,56971
31-01-2019,23,18338,20089,8390,3960,50779,1607,699,323,2629,53408
01-02-2019,0,17407,18874,8259,3563,48104,1573,661,324,2558,50662
01-02-2019,1,16517,18668,8221,3294,46701,1585,662,317,2564,49265
01-02-2019,2,16139,18604,8120,3338,46202,1591,660,302,2553,48755
01-02-2019,3,16075,18631,8186,3435,46327,1587,656,292,2535,48862
01-02-2019,4,17053,18723,8403,3682,47861,1632,654,282,2568,50429
01-02-2019,5,19185,19733,8968,3930,51816,1693,671,273,2637,54453
01-02-2019,6,21624,21649,9618,4525,57416,1703,1084,263,3050,60466
01-02-2019,7,24335,23103,9857,5025,62320,1700,1109,305,3114,65434
01-02-2019,8,25542,23779,10000,5271,64593,1704,1365,320,3389,67982
01-02-2019,9,25700,24188,10017,5196,65102,1707,1316,362,3385,68487
01-02-2019,10,25543,24387,9893,5526,65351,1713,1414,290,3417,68768
01-02-2019,11,25552,24070,9682,5615,64920,1704,1081,244,3029,67949
01-02-2019,12,25280,23730,9569,5522,64102,1706,1102,245,3053,67155
01-02-2019,13,24923,23877,9588,5152,63542,1708,1077,272,3057,66599
01-02-2019,14,25119,24078,9895,4931,64021,1706,1103,324,3133,67154
01-02-2019,15,25149,24166,9957,5000,64271,1700,1089,339,3128,67399
01-02-2019,16,25705,24645,10070,5118,65539,1699,1134,351,3184,68723
01-02-2019,17,26324,25171,10222,5127,66843,1687,1226,351,3264,70107
01-02-2019,18,25859,24985,10056,4952,65851,1681,1192,362,3235,69086
01-02-2019,19,24958,24151,9745,4741,63594,1695,1055,315,3065,66659
01-02-2019,20,23176,23547,9405,4457,60585,1684,1048,326,3058,63643
01-02-2019,21,21714,22663,9302,4031,57711,1661,681,337,2679,60390
01-02-2019,22,19909,21649,9141,3874,54573,1659,643,380,2682,57255
01-02-2019,23,17647,20090,8823,3628,50188,1466,664,391,2521,52709
02-02-2019,0,16838,18852,8808,3452,47951,1235,658,388,2281,50232
02-02-2019,1,15440,18318,8645,3439,45843,1222,642,378,2242,48085
02-02-2019,2,14868,18086,8820,3502,45276,1217,643,409,2269,47545
02-02-2019,3,14769,17893,8976,3527,45165,1210,643,446,2299,47464
02-02-2019,4,14981,18047,9058,3489,45576,1179,649,454,2282,47858
02-02-2019,5,15417,18268,9090,3544,46319,1183,640,474,2297,48616
02-02-2019,6,15882,18784,9174,3612,47451,1241,660,494,2395,49846
02-02-2019,7,16950,19619,9304,3449,49324,1446,655,481,2582,51906
02-02-2019,8,19405,20866,9554,3729,53555,1470,645,505,2620,56175
02-02-2019,9,22704,22464,9811,3983,58961,1493,658,512,2663,61624
02-02-2019,10,24060,22948,9821,4060,60889,1503,665,522,2690,63579
02-02-2019,11,23886,23098,9835,4080,60900,1507,668,567,2742,63642
02-02-2019,12,23071,23171,9858,4013,60113,1517,672,577,2766,62879
02-02-2019,13,20629,22251,9758,3910,56548,1528,673,513,2714,59262
02-02-2019,14,18822,21679,9821,4094,54416,1540,666,497,2703,57119
02-02-2019,15,18895,21749,9919,4029,54594,1550,675,456,2681,57275
02-02-2019,16,21179,22463,10095,4021,57760,1547,686,482,2715,60475
02-02-2019,17,24040,23347,10318,4296,62001,1559,689,493,2741,64742
02-02-2019,18,24448,23402,10338,4283,62472,1553,898,516,2967,65439
02-02-2019,19,22461,22888,10180,4156,59684,1564,725,479,2768,62452
02-02-2019,20,19611,21944,9986,3845,55386,1563,705,491,2759,58145
02-02-2019,21,17491,20790,9716,3666,51663,1531,658,505,2694,54357
02-02-2019,22,16464,20119,9591,3703,49877,1511,668,521,2700,52577
02-02-2019,23,15147,19008,9604,3751,47510,1153,654,516,2323,49833
03-02-2019,0,14731,18357,9490,3671,46250,968,610,506,2084,48334
03-02-2019,1,14191,18378,9411,3771,45752,895,605,471,1971,47723
03-02-2019,2,13872,18211,9407,3784,45273,813,604,448,1865,47138
03-02-2019,3,13748,18293,9448,3745,45232,807,601,473,1881,47113
03-02-2019,4,13786,18319,9521,3820,45444,825,606,463,1894,47338
03-02-2019,5,13993,18552,9510,3815,45870,817,607,424,1848,47718
03-02-2019,6,14686,18930,9570,3917,47104,838,613,433,1884,48988
03-02-2019,7,15199,19581,9706,3796,48282,1013,618,433,2064,50346
03-02-2019,8,16091,20091,9829,3712,49724,1158,626,389,2173,51897
03-02-2019,9,17619,21019,9921,3679,52239,1164,619,364,2147,54386
03-02-2019,10,18572,21651,10048,3905,54178,1211,616,342,2169,56347
03-02-2019,11,19372,21893,10180,4086,55532,1247,672,301,2220,57752
03-02-2019,12,19024,22004,10112,4261,55402,1276,678,274,2228,57630
03-02-2019,13,18249,21532,10023,4192,53996,1320,696,237,2253,56249
03-02-2019,14,17853,21347,9996,4067,53264,1335,664,223,2222,55486
03-02-2019,15,17968,21251,10012,3892,53124,1376,659,208,2243,55367
03-02-2019,16,19801,22075,10137,3595,55609,1397,655,189,2241,57850
03-02-2019,17,22894,23357,10334,3752,60339,1390,653,200,2243,62582
03-02-2019,18,24034,23726,10385,3985,62133,1380,991,251,2622,64755
03-02-2019,19,23931,23431,10309,3750,61423,1355,926,230,2511,63934
03-02-2019,20,22583,22736,10232,3764,59316,1300,719,184,2203,61519
03-02-2019,21,19963,21453,9915,3728,55059,1314,652,198,2164,57223
03-02-2019,22,18075,20360,9607,3453,51494,1309,653,220,2182,53676
03-02-2019,23,16545,19399,9454,3327,48724,1262,652,222,2136,50860
04-02-2019,0,16570,18396,9454,3221,47643,1347,651,230,2228,49871
04-02-2019,1,16116,17852,9344,3374,46686,1382,651,239,2272,48958
04-02-2019,2,15863,17816,9291,3627,46597,1405,652,249,2306,48903
04-02-2019,3,15970,17742,9280,3809,46801,1396,651,248,2295,49096
04-02-2019,4,16896,18065,9338,3947,48246,1392,650,272,2314,50560
04-02-2019,5,18995,19370,9566,4292,52224,1418,662,304,2384,54608
04-02-2019,6,22271,21608,10019,4735,58632,1509,987,388,2884,61516
04-02-2019,7,24408,23172,10567,5369,63517,1512,1172,445,3129,66646
04-02-2019,8,24426,23530,10686,5846,64489,1522,1308,452,3282,67771
04-02-2019,9,24350,23612,10643,6144,64750,1516,1286,444,3246,67996
04-02-2019,10,23809,23605,10361,6535,64311,1512,1195,456,3163,67474
04-02-2019,11,22716,23123,10044,6843,62728,1473,1137,390,3000,65728
04-02-2019,12,22445,23029,9742,6762,61979,1460,1048,375,2883,64862
04-02-2019,13,22337,23115,9626,6693,61771,1464,1065,352,2881,64652
04-02-2019,14,22496,23275,9932,6487,62190,1460,1336,364,3160,65350
04-02-2019,15,22443,23414,10099,7003,62959,1479,1319,363,3161,66120
04-02-2019,16,22977,23941,10219,7064,64202,1496,1350,358,3204,67406
04-02-2019,17,23451,24519,10197,7200,65366,1509,1367,333,3209,68575
04-02-2019,18,22798,24301,10030,7356,64485,1536,1321,315,3172,67657
04-02-2019,19,21598,23408,9447,7181,61633,1610,1069,250,2929,64562
04-02-2019,20,20234,22726,9077,7043,59082,1637,1055,295,2987,62069
04-02-2019,21,19084,22139,8837,6824,56884,1681,681,361,2723,59607
04-02-2019,22,17022,20848,8410,6547,52827,1721,678,433,2832,55659
04-02-2019,23,15136,20023,8161,6029,49351,1687,684,454,2825,52176
05-02-2019,0,14774,19593,8110,6081,48557,1343,718,465,2526,51083
05-02-2019,1,14699,19257,8029,5942,47927,1217,726,469,2412,50339
05-02-2019,2,14128,18917,7915,5937,46896,1195,728,469,2392,49288
05-02-2019,3,14126,18801,7847,5953,46728,1196,732,474,2402,49130
05-02-2019,4,14991,18955,7969,5970,47887,1242,733,464,2439,50326
05-02-2019,5,16552,19912,8549,6211,51223,1520,732,469,2721,53944
05-02-2019,6,20074,22284,9270,6294,57922,1619,738,491,2848,60770
05-02-2019,7,23902,24315,9614,5884,63714,1635,735,546,2916,66630
05-02-2019,8,25058,24400,9783,5822,65062,1644,737,567,2948,68010
05-02-2019,9,24930,24358,9604,5802,64694,1625,735,596,2956,67650
05-02-2019,10,24881,24345,9486,5887,64599,1629,738,598,2965,67564
05-02-2019,11,24372,24153,9082,5912,63519,1646,738,603,2987,66506
05-02-2019,12,23841,23965,8956,5785,62547,1650,734,591,2975,65522
05-02-2019,13,23499,23812,8983,6224,62520,1650,736,578,2964,65484
05-02-2019,14,23715,23773,9410,6070,62969,1651,741,571,2963,65932
05-02-2019,15,23999,23897,9458,5750,63104,1648,755,565,2968,66072
05-02-2019,16,24770,24119,9829,5353,64072,1645,775,554,2974,67046
05-02-2019,17,25848,24746,9788,5455,65839,1640,998,545,3183,69022
05-02-2019,18,25768,24384,9738,5474,65363,1627,1013,563,3203,68566
05-02-2019,19,25001,24028,9187,4625,62840,1556,746,592,2894,65734
05-02-2019,20,23809,23739,8937,4290,60773,1537,742,541,2820,63593
05-02-2019,21,22287,23285,8619,3785,57977,1527,739,529,2795,60772
05-02-2019,22,18949,21608,8358,3625,52541,1506,720,549,2775,55316
05-02-2019,23,16716,20125,8153,3681,48675,1411,712,528,2651,51326
06-02-2019,0,16446,19059,8129,3507,47141,1130,714,512,2356,49497
06-02-2019,1,16284,18858,8023,3354,46518,997,709,487,2193,48711
06-02-2019,2,16546,18797,7997,3273,46615,961,703,470,2134,48749
06-02-2019,3,16772,18652,8092,3357,46872,961,712,419,2092,48964
06-02-2019,4,17570,18862,8457,3500,48390,1033,703,395,2131,50521
06-02-2019,5,19278,20117,9030,3711,52136,1418,702,395,2515,54651
06-02-2019,6,22271,22254,9489,4126,58141,1528,707,383,2618,60759
06-02-2019,7,25095,23972,9856,4780,63703,1545,709,683,2937,66640
06-02-2019,8,25942,24155,10050,5101,65247,1539,797,749,3085,68332
06-02-2019,9,25536,24063,10051,5363,65014,1524,937,724,3185,68199
06-02-2019,10,24742,23856,10032,5491,64122,1509,932,695,3136,67258
06-02-2019,11,24303,23861,9663,5837,63665,1489,746,501,2736,66401
06-02-2019,12,24073,23974,9461,5870,63378,1500,749,295,2544,65922
06-02-2019,13,23583,24140,9663,5569,62954,1490,739,277,2506,65460
06-02-2019,14,23837,24305,9924,5292,63360,1492,852,639,2983,66343
06-02-2019,15,24594,24471,10030,4729,63824,1494,896,625,3015,66839
06-02-2019,16,25512,24714,10125,4524,64875,1440,966,630,3036,67911
06-02-2019,17,26076,24764,10228,4711,65780,1489,1171,619,3279,69059
06-02-2019,18,25889,24769,10274,4589,65522,1475,1259,624,3358,68880
06-02-2019,19,25720,25011,10099,4225,65055,1469,844,454,2767,67822
06-02-2019,20,24282,24761,9704,3797,62544,1438,746,283,2467,65011
06-02-2019,21,20980,23164,9330,3612,57085,1476,729,280,2485,59570
06-02-2019,22,18416,21586,9061,3685,52748,1206,728,314,2248,54996
06-02-2019,23,16055,20322,8909,3466,48753,1067,724,370,2161,50914
07-02-2019,0,15513,19090,8639,3277,46520,903,743,398,2044,48564
07-02-2019,1,14746,18647,8592,3135,45120,879,718,396,1993,47113
07-02-2019,2,14614,18468,8642,3050,44774,884,716,414,2014,46788
07-02-2019,3,14621,18324,8661,3145,44749,881,715,432,2028,46777
07-02-2019,4,15672,18464,8862,3261,46257,878,753,411,2042,48299
07-02-2019,5,17535,19380,9373,3587,49875,967,784,390,2141,52016
07-02-2019,6,20161,21742,9969,3860,55732,1096,810,458,2364,58096
07-02-2019,7,23605,23082,10141,4558,61385,1117,904,428,2449,63834
07-02-2019,8,24266,23314,10204,5014,62799,1120,1100,390,2610,65409
07-02-2019,9,24197,23264,10053,5487,63001,1121,1156,370,2647,65648
07-02-2019,10,23415,23281,9884,5698,62278,1112,1142,359,2613,64891
07-02-2019,11,22723,23141,9447,5869,61181,1085,986,340,2411,63592
07-02-2019,12,21988,23117,9157,5744,60008,1059,997,319,2375,62383
07-02-2019,13,21851,22913,9300,6051,60116,1063,1125,298,2486,62602
07-02-2019,14,21523,22769,9498,6195,59985,1049,1255,305,2609,62594
07-02-2019,15,21415,22540,9519,6172,59648,1043,1233,325,2601,62249
07-02-2019,16,21542,22904,9589,6131,60166,1038,1327,387,2752,62918
07-02-2019,17,22939,23399,9676,6510,62526,1043,1455,468,2966,65492
07-02-2019,18,22734,23513,9421,6496,62164,1038,1463,516,3017,65181
07-02-2019,19,20596,22961,8848,6090,58495,1041,1057,513,2611,61106
07-02-2019,20,18885,22599,8552,5668,55704,949,885,472,2306,58010
07-02-2019,21,17030,21773,8187,5454,52445,920,763,416,2099,54544
07-02-2019,22,16083,20681,8028,5342,50134,921,726,441,2088,52222
07-02-2019,23,14417,19815,7968,5154,47354,874,732,454,2060,49414
08-02-2019,0,13999,19566,7665,5133,46364,783,768,434,1985,48349
08-02-2019,1,13500,19308,7583,5361,45753,779,735,413,1927,47680
08-02-2019,2,13462,19221,7600,5244,45527,827,616,414,1857,47384
08-02-2019,3,13311,19187,7659,4994,45151,816,613,393,1822,46973
08-02-2019,4,13630,19798,7872,4896,46197,830,735,386,1951,48148
08-02-2019,5,14745,21213,8572,5263,49793,860,798,360,2018,51811
08-02-2019,6,18158,22830,9237,5621,55844,910,1063,423,2396,58240
08-02-2019,7,22264,24557,9455,5258,61533,958,1122,449,2529,64062
08-02-2019,8,23348,24704,9637,5118,62807,990,1118,476,2584,65391
08-02-2019,9,23294,24683,9690,5041,62708,986,1123,512,2621,65329
08-02-2019,10,21483,23928,9548,5733,60693,996,1192,537,2725,63418
08-02-2019,11,19712,23481,9074,6114,58381,911,904,503,2318,60699
08-02-2019,12,18272,23096,8847,6081,56296,873,913,528,2314,58610
08-02-2019,13,17977,22976,8879,6057,55889,878,907,520,2305,58194
08-02-2019,14,18083,22993,9195,5954,56225,980,970,581,2531,58756
08-02-2019,15,17849,22856,9185,5983,55872,1003,955,573,2531,58403
08-02-2019,16,18303,22997,9349,6252,56902,1003,1056,545,2604,59506
08-02-2019,17,19829,23268,9413,6550,59060,1008,1058,524,2590,61650
08-02-2019,18,19954,23216,9209,6253,58634,1013,1053,519,2585,61219
08-02-2019,19,17706,22410,8659,6253,55027,915,916,507,2338,57365
08-02-2019,20,16342,21572,8073,5967,51954,907,911,434,2252,54206
08-02-2019,21,15065,20834,7673,5431,49003,888,819,422,2129,51132
08-02-2019,22,14736,20007,7684,4865,47291,881,774,418,2073,49364
08-02-2019,23,14053,18932,7544,4668,45198,900,701,427,2028,47226
09-02-2019,0,14524,17507,7474,4366,43871,885,485,442,1812,45683
09-02-2019,1,13616,17130,7447,4349,42543,889,485,427,1801,44344
09-02-2019,2,13372,17094,7396,4013,41873,880,483,445,1808,43681
09-02-2019,3,13180,17040,7337,4022,41580,911,483,477,1871,43451
09-02-2019,4,13264,17262,7319,4265,42111,915,482,519,1916,44027
09-02-2019,5,13624,17528,7370,4380,42903,915,485,523,1923,44826
09-02-2019,6,13741,18191,7398,4466,43796,954,488,525,1967,45763
09-02-2019,7,14258,18707,7483,4719,45167,956,490,581,2027,47194
09-02-2019,8,14832,19486,7692,5052,47063,969,493,601,2063,49126
09-02-2019,9,16904,20259,7837,5303,50303,964,530,603,2097,52400
09-02-2019,10,17556,20432,7954,5464,51406,960,526,622,2108,53514
09-02-2019,11,17365,20414,7849,5385,51014,955,531,613,2099,53113
09-02-2019,12,16910,20206,7777,5475,50370,942,533,593,2068,52438
09-02-2019,13,16383,20286,7774,5293,49735,937,536,605,2078,51813
09-02-2019,14,15520,20387,7826,5143,48876,938,536,593,2067,50943
09-02-2019,15,15287,20351,7988,5299,48925,932,533,629,2094,51019
09-02-2019,16,16628,20674,8329,5417,51048,949,667,612,2228,53276
09-02-2019,17,18352,21044,8605,5707,53707,977,815,590,2382,56089
09-02-2019,18,18145,21434,8778,5542,53898,969,767,606,2342,56240
09-02-2019,19,16456,21282,8620,5391,51749,971,529,565,2065,53814
09-02-2019,20,15262,20974,8466,5015,49715,978,505,580,2063,51778
09-02-2019,21,14737,19413,8259,4980,47389,960,504,563,2027,49416
09-02-2019,22,15050,18774,8258,4672,46754,903,503,577,1983,48737
09-02-2019,23,14281,18148,8117,4569,45115,877,505,611,1993,47108
10-02-2019,0,13413,17574,8119,4832,43940,861,509,636,2006,45946
10-02-2019,1,12660,17019,7979,4953,42611,891,508,627,2026,44637
10-02-2019,2,12241,16778,7872,4456,41346,907,508,617,2032,43378
10-02-2019,3,12090,16717,7838,4186,40830,904,509,608,2021,42851
10-02-2019,4,12120,16727,7837,4032,40717,890,510,599,1999,42716
10-02-2019,5,12263,17006,7927,3661,40857,899,510,577,1986,42843
10-02-2019,6,13116,17328,7997,3896,42336,908,510,601,2019,44355
10-02-2019,7,12949,17749,7979,4232,42910,908,509,615,2032,44942
10-02-2019,8,13440,18304,8085,4537,44365,915,508,593,2016,46381
10-02-2019,9,14649,19056,8099,4532,46337,900,505,640,2045,48382
10-02-2019,10,15364,19473,8020,4281,47138,883,513,607,2003,49141
10-02-2019,11,15494,19590,7981,4048,47113,883,523,531,1937,49050
10-02-2019,12,15684,19874,8182,3704,47447,890,523,501,1914,49361
10-02-2019,13,15351,19783,8216,3295,46646,877,520,499,1896,48542
10-02-2019,14,15106,19766,8349,3015,46237,860,514,519,1893,48130
10-02-2019,15,15466,19557,8353,2860,46236,837,504,521,1862,48098
10-02-2019,16,17042,19499,8511,2814,47866,824,495,577,1896,49762
10-02-2019,17,18452,19624,8685,2998,49759,839,636,637,2112,51871
10-02-2019,18,19311,19782,8793,3000,50886,867,673,659,2199,53085
10-02-2019,19,18481,19501,8759,3308,50049,886,739,654,2279,52328
10-02-2019,20,16584,19016,8509,3583,47693,859,505,612,1976,49669
10-02-2019,21,15645,18313,8283,3799,46040,839,498,627,1964,48004
10-02-2019,22,14781,17729,8008,3800,44319,805,502,634,1941,46260
10-02-2019,23,13962,17231,7856,3820,42870,815,489,626,1930,44800
11-02-2019,0,13273,16602,7700,3836,41410,817,481,609,1907,43317
11-02-2019,1,12620,16677,7602,3894,40794,814,473,605,1892,42686
11-02-2019,2,12360,16985,7508,3661,40513,804,472,589,1865,42378
11-02-2019,3,12351,17459,7536,3719,41065,773,484,556,1813,42878
11-02-2019,4,12573,17988,7653,4207,42421,796,484,529,1809,44230
11-02-2019,5,14206,19353,8173,4526,46258,885,589,486,1960,48218
11-02-2019,6,17183,21881,8597,5069,52732,881,880,463,2224,54956
11-02-2019,7,19825,23722,8967,5255,57769,886,969,463,2318,60087
11-02-2019,8,20682,24056,9031,5259,59027,887,1096,453,2436,61463
11-02-2019,9,19664,24500,9020,5787,58971,878,1110,411,2399,61370
11-02-2019,10,19166,24629,8997,5859,58651,864,1108,367,2339,60990
11-02-2019,11,18836,24698,8902,6089,58526,869,970,358,2197,60723
11-02-2019,12,18799,24490,8769,5846,57904,834,873,397,2104,60008
11-02-2019,13,18480,24326,9048,5897,57751,825,880,414,2119,59870
11-02-2019,14,18074,24294,8915,5825,57108,817,1017,430,2264,59372
11-02-2019,15,18314,24321,8845,5588,57069,799,1000,440,2239,59308
11-02-2019,16,18839,24566,8987,5372,57763,796,987,452,2235,59998
11-02-2019,17,20005,25414,9239,5567,60224,789,1008,468,2265,62489
11-02-2019,18,20172,25143,9229,5606,60151,795,978,591,2364,62515
11-02-2019,19,19870,24543,8797,5638,58847,782,704,627,2113,60960
11-02-2019,20,17724,23692,8336,5121,54872,731,503,607,1841,56713
11-02-2019,21,16567,22821,8114,4915,52416,727,504,623,1854,54270
11-02-2019,22,15410,21795,7947,4399,49553,735,503,616,1854,51407
11-02-2019,23,14070,20484,7971,4285,46809,769,501,611,1881,48690
12-02-2019,0,13726,19717,8135,4047,45626,808,503,625,1936,47562
12-02-2019,1,13376,19348,8143,4114,44981,834,503,598,1935,46916
12-02-2019,2,12899,19089,8076,4025,44088,818,502,601,1921,46009
12-02-2019,3,12991,19275,8146,3978,44390,815,500,578,1893,46283
12-02-2019,4,13481,20083,8323,3746,45634,814,503,602,1919,47553
12-02-2019,5,15449,21845,8813,3652,49758,831,590,591,2012,51770
12-02-2019,6,18668,24168,9408,3699,55944,866,594,609,2069,58013
12-02-2019,7,22962,25315,9881,3864,62022,944,826,679,2449,64471
12-02-2019,8,23650,24966,10100,3735,62451,961,880,654,2495,64946
12-02-2019,9,23998,24510,10072,3648,62226,952,882,818,2652,64878
12-02-2019,10,23924,24710,9841,3584,62058,960,890,822,2672,64730
12-02-2019,11,23524,24198,9520,3511,60753,916,738,690,2344,63097
12-02-2019,12,22655,23466,9161,3618,58900,889,593,702,2184,61084
12-02-2019,13,21731,23185,9058,3724,57699,841,609,665,2115,59814
12-02-2019,14,22329,23321,9323,3885,58857,897,667,650,2214,61071
12-02-2019,15,22667,23751,9461,4105,59985,898,743,597,2238,62223
12-02-2019,16,23079,24213,9802,4528,61621,852,839,574,2265,63886
12-02-2019,17,23478,24414,9969,4831,62694,885,1035,547,2467,65161
12-02-2019,18,23231,24074,9839,5218,62363,919,964,486,2369,64732
12-02-2019,19,21866,23895,9552,5046,60360,825,675,476,1976,62336
12-02-2019,20,18558,23166,9158,5330,56211,755,566,447,1768,57979
12-02-2019,21,16374,22169,8703,5278,52524,777,562,365,1704,54228
12-02-2019,22,15653,20651,8456,4806,49565,733,564,348,1645,51210
12-02-2019,23,13478,19228,8231,4694,45631,702,478,346,1526,47157
13-02-2019,0,13264,19418,8306,4704,45692,716,477,359,1552,47244
13-02-2019,1,12577,19008,8230,4607,44423,751,476,377,1604,46027
13-02-2019,2,12328,19133,8185,4337,43983,767,480,404,1651,45634
13-02-2019,3,12267,19196,8206,4267,43937,763,484,425,1672,45609
13-02-2019,4,12316,19761,8441,4256,44776,780,494,497,1771,46547
13-02-2019,5,12897,21437,8811,4233,47379,786,595,551,1932,49311
13-02-2019,6,15535,23730,9248,4590,53105,874,907,621,2402,55507
13-02-2019,7,18634,25152,9445,4949,58180,927,921,858,2706,60886
13-02-2019,8,18989,25169,9483,5027,58668,871,1021,889,2781,61449
13-02-2019,9,18165,25031,9304,5156,57657,862,1019,905,2786,60443
13-02-2019,10,17427,24736,9182,4795,56140,817,1016,1021,2854,58994
13-02-2019,11,16775,24394,8996,4789,54954,695,672,1047,2414,57368
13-02-2019,12,16060,23752,9058,4563,53432,778,642,953,2373,55805
13-02-2019,13,16051,23516,9003,4761,53331,795,613,909,2317,55648
13-02-2019,14,16802,23736,9170,4696,54404,790,621,895,2306,56710
13-02-2019,15,17561,23996,9247,4644,55449,704,606,859,2169,57618
13-02-2019,16,19304,24143,9341,4514,57301,821,667,822,2310,59611
13-02-2019,17,21111,24446,9728,4367,59653,843,758,843,2444,62097
13-02-2019,18,20916,24178,9462,4568,59126,857,768,983,2608,61734
13-02-2019,19,19830,24051,9051,4537,57471,777,616,600,1993,59464
13-02-2019,20,18793,23522,8763,4433,55511,765,623,540,1928,57439
13-02-2019,21,17133,22324,8415,3993,51864,824,625,483,1932,53796
13-02-2019,22,16320,21254,8239,3953,49767,848,616,449,1913,51680
13-02-2019,23,14313,19970,8058,3982,46322,837,524,439,1800,48122
14-02-2019,0,14043,18059,7871,3693,43666,839,515,435,1789,45455
14-02-2019,1,13720,17685,7706,3488,42598,810,518,427,1755,44353
14-02-2019,2,13684,17771,7656,3277,42387,811,521,429,1761,44148
14-02-2019,3,13452,17738,7646,3207,42044,821,517,415,1753,43797
14-02-2019,4,13944,18482,7974,3087,43488,827,516,382,1725,45213
14-02-2019,5,16106,20753,8539,3482,48880,830,526,348,1704,50584
14-02-2019,6,19021,23054,9013,3943,55031,894,1009,341,2244,57275
14-02-2019,7,20883,24071,9304,4086,58345,884,1147,608,2639,60984
14-02-2019,8,21211,24122,9350,4165,58849,853,1150,757,2760,61609
14-02-2019,9,21447,24280,9569,4022,59318,811,1142,519,2472,61790
14-02-2019,10,21508,24257,9757,4028,59550,794,983,309,2086,61636
14-02-2019,11,19832,24162,9579,4041,57614,762,679,350,1791,59405
14-02-2019,12,17657,23902,9483,3936,54978,726,661,411,1798,56776
14-02-2019,13,17353,23795,9400,3910,54457,767,593,410,1770,56227
14-02-2019,14,18652,24449,9563,3726,56389,891,739,365,1995,58384
14-02-2019,15,19675,24508,9699,3755,57638,869,768,334,1971,59609
14-02-2019,16,20269,24736,9834,3917,58756,935,783,377,2095,60851
14-02-2019,17,20832,24933,9972,4114,59853,982,779,587,2348,62201
14-02-2019,18,20559,24842,9995,4096,59494,995,804,609,2408,61902
14-02-2019,19,19714,24861,9731,3827,58133,863,711,445,2019,60152
14-02-2019,20,18261,24604,9489,3397,55751,834,534,471,1839,57590
14-02-2019,21,17309,24100,9355,3260,54025,855,529,467,1851,55876
14-02-2019,22,16183,22691,9267,3328,51471,879,526,494,1899,53370
14-02-2019,23,14708,21219,9023,3264,48213,870,524,498,1892,50105
15-02-2019,0,14411,19651,8819,3034,45917,865,549,525,1939,47856
15-02-2019,1,13389,19127,8712,2721,43949,818,568,565,1951,45900
15-02-2019,2,13061,19007,8654,2577,43299,844,519,540,1903,45202
15-02-2019,3,12908,18849,8620,2482,42859,875,517,510,1902,44761
15-02-2019,4,13409,19847,8761,2300,44317,847,565,470,1882,46199
15-02-2019,5,16115,22166,9123,2753,50157,840,566,421,1827,51984
15-02-2019,6,17919,24192,9514,3224,54850,866,871,513,2250,57100
15-02-2019,7,19430,25130,9748,3757,58065,962,1166,668,2796,60861
15-02-2019,8,20053,25198,9716,3907,58874,929,1195,781,2905,61779
15-02-2019,9,20219,24960,9466,3823,58467,918,1197,567,2682,61149
15-02-2019,10,20079,24976,9488,3868,58412,963,978,453,2394,60806
15-02-2019,11,18544,24392,9211,3331,55477,896,636,409,1941,57418
15-02-2019,12,16974,23656,9045,3323,52999,831,615,440,1886,54885
15-02-2019,13,16086,22982,8886,3478,51433,910,613,437,1960,53393
15-02-2019,14,16433,23062,8933,3457,51886,1012,605,420,2037,53923
15-02-2019,15,17702,23614,9052,3486,53855,955,599,433,1987,55842
15-02-2019,16,18870,24018,9373,3606,55867,983,672,433,2088,57955
15-02-2019,17,19742,24542,9693,3929,57905,974,792,451,2217,60122
15-02-2019,18,19756,24506,9692,4219,58174,950,892,474,2316,60490
15-02-2019,19,18501,24278,9038,4398,56214,776,613,460,1849,58063
15-02-2019,20,16397,23787,8542,4393,53119,755,593,438,1786,54905
15-02-2019,21,14838,22503,8020,4505,49868,744,560,421,1725,51593
15-02-2019,22,14305,21567,7713,4358,47942,734,564,410,1708,49650
15-02-2019,23,13049,19901,7584,4148,44681,720,426,398,1544,46225
16-02-2019,0,12570,18345,7529,4345,42790,717,252,371,1340,44130
16-02-2019,1,12043,18196,7627,4178,42045,726,252,388,1366,43411
16-02-2019,2,12022,18172,7829,4118,42141,755,254,374,1383,43524
16-02-2019,3,11915,18244,8130,3855,42145,767,253,358,1378,43523
16-02-2019,4,11826,18405,8271,3992,42495,767,255,342,1364,43859
16-02-2019,5,11804,18621,8394,4156,42976,779,256,370,1405,44381
16-02-2019,6,12281,18923,8470,4272,43947,781,266,369,1416,45363
16-02-2019,7,13284,19814,8714,4541,46353,811,410,392,1613,47966
16-02-2019,8,13866,20781,8703,4772,48122,813,418,423,1654,49776
16-02-2019,9,14061,21427,8639,4765,48893,801,428,390,1619,50512
16-02-2019,10,14344,21573,8506,4953,49376,804,441,373,1618,50994
16-02-2019,11,13951,21299,8465,5159,48875,802,454,390,1646,50521
16-02-2019,12,13801,20592,8431,5248,48074,816,279,413,1508,49582
16-02-2019,13,13649,20476,8442,4950,47518,830,280,417,1527,49045
16-02-2019,14,13747,20294,8476,4680,47197,829,275,449,1553,48750
16-02-2019,15,14008,20675,8623,4409,47715,829,273,484,1586,49301
16-02-2019,16,15207,21878,8893,4241,50219,828,478,545,1851,52070
16-02-2019,17,16878,23245,9150,4609,53884,812,788,641,2241,56125
16-02-2019,18,17648,23868,9211,4182,54910,845,811,645,2301,57211
16-02-2019,19,16572,23403,9257,4143,53375,821,780,646,2247,55622
16-02-2019,20,15485,22951,9221,4056,51712,817,574,623,2014,53726
16-02-2019,21,14824,21425,9038,3824,49112,794,496,606,1896,51008
16-02-2019,22,14052,19767,8959,3636,46414,791,290,635,1716,48130
16-02-2019,23,14002,18919,8921,3339,45180,784,265,616,1665,46845
17-02-2019,0,12645,17774,8686,2812,41917,797,256,584,1637,43554
17-02-2019,1,12476,17474,8642,2519,41112,784,252,517,1553,42665
17-02-2019,2,12314,17297,8649,2339,40599,823,246,464,1533,42132
17-02-2019,3,12160,17151,8674,2210,40195,839,245,430,1514,41709
17-02-2019,4,11924,16826,8634,2225,39610,832,243,403,1478,41088
17-02-2019,5,12022,16712,8675,2255,39664,832,241,378,1451,41115
17-02-2019,6,12305,16796,8858,2168,40126,830,238,339,1407,41533
17-02-2019,7,12872,17235,8974,2180,41261,816,238,352,1406,42667
17-02-2019,8,13445,18211,9011,2340,43006,813,302,328,1443,44449
17-02-2019,9,14473,19255,9004,2540,45272,781,319,326,1426,46698
17-02-2019,10,15130,19557,8842,2584,46112,777,530,312,1619,47731
17-02-2019,11,15399,19422,8650,2735,46206,777,657,291,1725,47931
17-02-2019,12,15359,19430,8414,2811,46014,778,621,284,1683,47697
17-02-2019,13,15459,19139,8199,2809,45606,770,560,284,1614,47220
17-02-2019,14,15584,19093,8071,2760,45507,753,483,264,1500,47007
17-02-2019,15,15619,19316,8037,2743,45715,749,482,261,1492,47207
17-02-2019,16,16974,19543,8249,2611,47378,743,674,261,1678,49056
17-02-2019,17,19206,20850,8725,2867,51648,754,930,292,1976,53624
17-02-2019,18,20478,21367,8603,3422,53870,769,901,280,1950,55820
17-02-2019,19,20034,21472,8447,3768,53722,769,778,277,1824,55546
17-02-2019,20,18145,20899,8279,3917,51240,748,729,281,1758,52998
17-02-2019,21,15717,20253,8103,3913,47986,740,412,256,1408,49394
17-02-2019,22,14984,19193,7948,3967,46093,718,543,255,1516,47609
17-02-2019,23,13480,17906,7923,3756,43065,712,327,202,1241,44306
18-02-2019,0,12517,17223,8103,3609,41454,692,313,216,1221,42675
18-02-2019,1,12047,17019,8387,3456,40908,683,243,219,1145,42053
18-02-2019,2,11939,17310,8633,3386,41269,682,240,212,1134,42403
18-02-2019,3,12076,17535,8742,3313,41667,688,257,209,1154,42821
18-02-2019,4,12665,18049,8987,3145,42847,695,435,211,1341,44188
18-02-2019,5,15585,19597,9472,3286,47942,724,683,229,1636,49578
18-02-2019,6,18788,22571,9927,3802,55090,810,696,274,1780,56870
18-02-2019,7,20135,23865,10073,3504,57577,844,1049,440,2333,59910
18-02-2019,8,20286,24412,10123,3606,58428,847,1025,468,2340,60768
18-02-2019,9,20282,24398,10129,3733,58542,858,992,276,2126,60668
18-02-2019,10,20433,24356,10036,3739,58564,842,948,287,2077,60641
18-02-2019,11,18975,24058,9624,3997,56656,773,697,317,1787,58443
18-02-2019,12,17424,23147,9281,3942,53794,763,674,359,1796,55590
18-02-2019,13,17231,22753,9221,4092,53297,801,697,373,1871,55168
18-02-2019,14,18677,23531,9434,3919,55562,871,734,442,2047,57609
18-02-2019,15,19364,23933,9619,3488,56403,919,695,375,1989,58392
18-02-2019,16,19960,24388,9673,3268,57289,908,700,396,2004,59293
18-02-2019,17,20529,24585,10042,3217,58374,949,749,505,2203,60577
18-02-2019,18,20416,24478,9920,3529,58343,962,843,505,2310,60653
18-02-2019,19,19210,24424,9719,3382,56736,878,721,503,2102,58838
18-02-2019,20,17732,23882,9073,3518,54205,862,723,562,2147,56352
18-02-2019,21,16129,22601,8574,3759,51063,850,682,502,2034,53097
18-02-2019,22,14618,20987,8279,3994,47879,838,400,492,1730,49609
18-02-2019,23,13226,19434,7841,3529,44032,833,267,467,1567,45599
19-02-2019,0,12771,18013,7782,3218,41784,824,262,445,1531,43315
19-02-2019,1,12737,17846,7837,3199,41618,822,259,454,1535,43153
19-02-2019,2,12556,17659,7940,3287,41443,791,259,477,1527,42970
19-02-2019,3,12064,17529,7965,3608,41167,774,255,485,1514,42681
19-02-2019,4,12042,17961,7957,3818,41777,778,345,479,1602,43379
19-02-2019,5,12903,19387,8411,4284,44985,827,693,443,1963,46948
19-02-2019,6,16561,21923,8888,4772,52145,870,701,469,2040,54185
19-02-2019,7,18770,23506,9294,4812,56382,916,759,441,2116,58498
19-02-2019,8,18609,23437,9268,5369,56684,951,762,420,2133,58817
19-02-2019,9,17431,23232,9176,6169,56008,938,755,408,2101,58109
19-02-2019,10,16530,22816,9150,5942,54438,931,758,380,2069,56507
19-02-2019,11,16179,22280,8665,5833,52955,852,732,376,1960,54915
19-02-2019,12,16286,22191,8397,5865,52738,855,720,412,1987,54725
19-02-2019,13,16407,22067,8450,6006,52931,876,722,445,2043,54974
19-02-2019,14,16897,22380,8867,6277,54421,867,725,544,2136,56557
19-02-2019,15,16965,22575,9008,6126,54676,864,649,605,2118,56794
19-02-2019,16,17313,22877,9080,6298,55568,837,714,651,2202,57770
19-02-2019,17,18854,24285,9396,5895,58431,861,757,703,2321,60752
19-02-2019,18,18697,24522,9233,5703,58156,903,733,705,2341,60497
19-02-2019,19,17391,24164,8546,5592,55694,848,653,696,2197,57891
19-02-2019,20,16215,23705,8174,5495,53589,800,721,688,2209,55798
19-02-2019,21,14950,22206,7891,5441,50487,782,685,631,2098,52585
19-02-2019,22,14335,20982,7543,5090,47950,783,382,633,1798,49748
19-02-2019,23,13411,20044,7366,4664,45485,762,284,635,1681,47166
20-02-2019,0,12940,19464,7515,4733,44651,773,281,641,1695,46346
20-02-2019,1,12674,19357,7631,4557,44220,772,282,643,1697,45917
20-02-2019,2,12640,19410,7792,4320,44162,780,280,647,1707,45869
20-02-2019,3,12654,19415,8009,4039,44117,798,303,646,1747,45864
20-02-2019,4,12729,20074,8525,4059,45388,808,312,649,1769,47157
20-02-2019,5,13691,21797,8929,3888,48304,809,713,643,2165,50469
20-02-2019,6,16807,24405,9455,4039,54706,814,875,634,2323,57029
20-02-2019,7,19321,25681,9766,3916,58684,842,833,675,2350,61034
20-02-2019,8,20402,25535,10085,3734,59757,920,856,663,2439,62196
20-02-2019,9,20189,25077,10232,3678,59175,975,979,665,2619,61794
20-02-2019,10,19929,24669,10276,3669,58544,899,901,674,2474,61018
20-02-2019,11,18681,24278,10103,3510,56572,929,866,674,2469,59041
20-02-2019,12,17669,23795,10117,3510,55091,891,865,680,2436,57527
20-02-2019,13,18032,23277,10129,3418,54856,941,867,649,2457,57313
20-02-2019,14,18815,22823,10140,3217,54995,915,885,646,2446,57441
20-02-2019,15,19549,22633,10385,3372,55941,911,880,681,2472,58413
20-02-2019,16,21112,22947,10624,3330,58014,968,885,626,2479,60493
20-02-2019,17,22340,23387,10743,3595,60065,1002,954,638,2594,62659
20-02-2019,18,22743,23081,10747,3586,60157,1003,913,546,2462,62619
20-02-2019,19,21299,22863,10498,3438,58097,1000,911,490,2401,60498
20-02-2019,20,20102,22500,10222,3479,56305,976,917,440,2333,58638
20-02-2019,21,18496,21840,9998,3862,54195,898,1032,416,2346,56541
20-02-2019,22,17138,20689,9739,4197,51762,891,1017,383,2291,54053
20-02-2019,23,15362,19216,9305,3908,47792,851,796,371,2018,49810
21-02-2019,0,14374,17933,9253,3449,45010,854,472,444,1770,46780
21-02-2019,1,13446,17653,9137,3425,43659,859,448,352,1659,45318
21-02-2019,2,13310,17563,8977,3562,43412,831,444,327,1602,45014
21-02-2019,3,13590,17712,8805,3627,43734,823,442,300,1565,45299
21-02-2019,4,14251,18477,8895,3640,45262,824,444,289,1557,46819
21-02-2019,5,15925,20413,9289,3805,49431,910,712,481,2103,51534
21-02-2019,6,19127,22417,9750,4482,55777,917,970,371,2258,58035
21-02-2019,7,21370,23534,9836,4538,59279,912,1147,567,2626,61905
21-02-2019,8,22278,23958,9777,4371,60385,899,1149,532,2580,62965
21-02-2019,9,21611,24164,9699,4677,60149,893,1257,466,2616,62765
21-02-2019,10,20519,24027,9531,4372,58449,842,1227,492,2561,61010
21-02-2019,11,20213,23864,9330,4158,57565,802,1026,306,2134,59699
21-02-2019,12,19510,23455,9075,4300,56339,771,995,307,2073,58412
21-02-2019,13,18982,23526,9125,4447,56081,794,994,298,2086,58167
21-02-2019,14,19160,23607,9535,4173,56475,848,1155,475,2478,58953
21-02-2019,15,19933,23589,9607,3967,57097,866,1187,351,2404,59501
21-02-2019,16,21037,23710,9670,3690,58108,871,1313,498,2682,60790
21-02-2019,17,23010,24265,9757,3822,60855,892,1319,604,2815,63670
21-02-2019,18,22909,23951,9748,4024,60632,904,1333,570,2807,63439
21-02-2019,19,22617,23870,9697,3844,60030,917,1160,402,2479,62509
21-02-2019,20,21283,23961,9321,3404,57970,906,982,427,2315,60285
21-02-2019,21,20074,23996,9130,2638,55839,787,976,399,2162,58001
21-02-2019,22,18910,23585,8935,2371,53803,723,982,403,2108,55911
21-02-2019,23,16525,21716,8669,2650,49561,747,718,390,1855,51416
22-02-2019,0,14762,20052,8546,2987,46346,717,613,405,1735,48081
22-02-2019,1,13966,19696,8495,3172,45328,716,545,387,1648,46976
22-02-2019,2,13655,19628,8471,2992,44746,727,549,378,1654,46400
22-02-2019,3,13725,19696,8643,2811,44875,717,566,344,1627,46502
22-02-2019,4,14812,20224,9024,2898,46957,722,736,338,1796,48753
22-02-2019,5,17310,21960,9722,3209,52202,807,1000,351,2158,54360
22-02-2019,6,21059,23847,10317,3563,58785,876,1053,384,2313,61098
22-02-2019,7,21680,24495,10511,4457,61144,880,1078,570,2528,63672
22-02-2019,8,22057,24671,10638,4587,61953,840,1231,769,2840,64793
22-02-2019,9,21916,24762,10619,4744,62042,820,1444,742,3006,65048
22-02-2019,10,21088,24609,10555,4860,61112,824,1300,743,2867,63979
22-02-2019,11,20385,24632,10241,4510,59769,817,1171,387,2375,62144
22-02-2019,12,19005,24465,9972,4404,57847,801,1145,389,2335,60182
22-02-2019,13,18745,24720,10025,3970,57460,704,1108,384,2196,59656
22-02-2019,14,19275,24742,10250,3743,58013,758,1118,407,2283,60296
22-02-2019,15,19155,24473,10217,3727,57571,753,1086,403,2242,59813
22-02-2019,16,19761,24576,10415,3434,58187,748,1105,377,2230,60417
22-02-2019,17,20765,24796,10618,3556,59735,813,1176,429,2418,62153
22-02-2019,18,21010,24645,10599,3471,59724,827,1165,430,2422,62146
22-02-2019,19,19567,24523,10286,3264,57641,780,1122,371,2273,59914
22-02-2019,20,17312,24549,9895,3414,55173,758,1117,297,2172,57345
22-02-2019,21,15824,24358,9356,3091,52630,765,881,275,1921,54551
22-02-2019,22,15318,23363,9214,3208,51102,777,717,243,1737,52839
22-02-2019,23,14350,21941,8855,3157,48303,806,443,228,1477,49780
23-02-2019,0,13664,20456,8600,2993,45712,828,314,260,1402,47114
23-02-2019,1,13072,19944,8422,2827,44264,863,314,223,1400,45664
23-02-2019,2,12779,19917,8318,2749,43764,872,325,244,1441,45205
23-02-2019,3,12777,19938,8252,2640,43608,848,327,268,1443,45051
23-02-2019,4,12573,19847,8259,2580,43260,872,329,300,1501,44761
23-02-2019,5,12675,20115,8420,2813,44023,890,336,338,1564,45587
23-02-2019,6,13127,20977,8716,2795,45614,896,336,452,1684,47298
23-02-2019,7,13900,22173,8918,3120,48112,955,350,515,1820,49932
23-02-2019,8,15233,23374,9101,3165,50873,947,474,445,1866,52739
23-02-2019,9,15302,23239,9029,3440,51012,957,637,455,2049,53061
23-02-2019,10,15113,22580,8908,3373,49973,968,568,504,2040,52013
23-02-2019,11,14647,21849,8741,3377,48615,942,563,544,2049,50664
23-02-2019,12,14349,21228,8595,3381,47552,955,578,572,2105,49657
23-02-2019,13,13917,20535,8631,3310,46394,948,613,676,2237,48631
23-02-2019,14,13987,20654,8708,3288,46636,881,602,677,2160,48796
23-02-2019,15,14169,21032,8826,2954,46982,922,626,656,2204,49186
23-02-2019,16,15261,22524,9132,2956,49874,947,756,614,2317,52191
23-02-2019,17,16826,23926,9488,2816,53056,950,755,586,2291,55347
23-02-2019,18,17178,24364,9277,2882,53702,918,754,556,2228,55930
23-02-2019,19,15980,23740,9058,3293,52070,897,752,566,2215,54285
23-02-2019,20,15062,23149,8755,3391,50359,871,739,435,2045,52404
23-02-2019,21,14263,22432,8268,3328,48292,817,406,377,1600,49892
23-02-2019,22,14031,21992,7990,3344,47356,827,397,326,1550,48906
23-02-2019,23,13449,20176,7836,3196,44657,776,278,303,1357,46014
24-02-2019,0,12695,18150,7754,3130,41729,711,276,298,1285,43014
24-02-2019,1,12654,17884,7688,3086,41311,740,277,291,1308,42619
24-02-2019,2,12491,17695,7750,3073,41009,750,275,296,1321,42330
24-02-2019,3,12231,17844,7687,3040,40803,727,275,290,1292,42095
24-02-2019,4,12611,18146,7629,2967,41352,710,280,281,1271,42623
24-02-2019,5,12651,18280,7832,2934,41696,751,280,288,1319,43015
24-02-2019,6,12228,18790,7972,2901,41891,736,280,256,1272,43163
24-02-2019,7,12502,19263,8121,2914,42801,755,282,249,1286,44087
24-02-2019,8,13341,20478,8264,2954,45038,748,282,363,1393,46431
24-02-2019,9,14241,21053,8187,3030,46513,764,282,299,1345,47858
24-02-2019,10,14423,20464,8058,3205,46150,778,284,315,1377,47527
24-02-2019,11,14291,20234,8152,3274,45950,805,332,352,1489,47439
24-02-2019,12,14355,20260,8196,2982,45794,817,331,366,1514,47308
24-02-2019,13,14061,19944,8394,2895,45295,822,323,405,1550,46845
24-02-2019,14,13913,19917,8485,2777,45092,859,302,428,1589,46681
24-02-2019,15,13949,19915,8514,2760,45138,851,292,475,1618,46756
24-02-2019,16,14437,20578,8703,2475,46194,827,288,503,1618,47812
24-02-2019,17,15797,23497,9103,2825,51222,846,535,505,1886,53108
24-02-2019,18,17075,24080,9311,2920,53384,858,727,491,2076,55460
24-02-2019,19,16759,24026,9332,2701,52821,837,658,479,1974,54795
24-02-2019,20,16339,23453,9318,2667,51777,829,455,408,1692,53469
24-02-2019,21,15902,22811,9236,2588,50537,854,358,394,1606,52143
24-02-2019,22,15292,21691,8915,2671,48569,871,286,384,1541,50110
24-02-2019,23,14536,20319,8646,2443,45946,864,284,339,1487,47433
25-02-2019,0,13471,19385,8479,2272,43608,901,293,279,1473,45081
25-02-2019,1,13215,18995,8397,2135,42741,890,299,286,1475,44216
25-02-2019,2,13170,18736,8413,2108,42428,912,303,326,1541,43969
25-02-2019,3,13160,18838,8456,2063,42517,928,296,386,1610,44127
25-02-2019,4,13102,19060,8545,2087,42794,930,293,361,1584,44378
25-02-2019,5,14645,21537,9114,2234,47530,916,344,358,1618,49148
25-02-2019,6,17889,23985,9632,2713,54220,925,737,373,2035,56255
25-02-2019,7,19952,24456,9714,3431,57553,1026,742,445,2213,59766
25-02-2019,8,20291,24279,9666,3523,57761,1036,756,444,2236,59997
25-02-2019,9,20226,24048,9489,3355,57117,1029,738,429,2196,59313
25-02-2019,10,19880,23868,9310,3557,56615,1034,735,396,2165,58780
25-02-2019,11,17682,23460,9135,3398,53676,967,734,404,2105,55781
25-02-2019,12,16121,22938,8987,3275,51323,954,738,484,2176,53499
25-02-2019,13,15895,22804,8963,3393,51056,929,730,560,2219,53275
25-02-2019,14,16324,23031,9047,3376,51777,965,740,529,2234,54011
25-02-2019,15,17351,23701,9159,3476,53688,971,723,521,2215,55903
25-02-2019,16,18483,23798,9136,3586,55004,972,739,493,2204,57208
25-02-2019,17,19759,24203,9159,3365,56487,1004,752,504,2260,58747
25-02-2019,18,19936,24386,9311,3647,57281,1015,1015,531,2561,59842
25-02-2019,19,18446,24298,8915,3461,55122,907,739,457,2103,57225
25-02-2019,20,17199,23993,8404,3305,52902,880,741,464,2085,54987
25-02-2019,21,16209,23277,8317,3494,51297,907,600,414,1921,53218
25-02-2019,22,15007,22195,8185,3419,48808,900,560,373,1833,50641
25-02-2019,23,13879,20850,7912,3070,45710,842,346,327,1515,47225
26-02-2019,0,13173,19424,7897,2667,43161,816,293,331,1440,44601
26-02-2019,1,12941,19033,7813,2574,42360,810,300,365,1475,43835
26-02-2019,2,12672,18907,7772,2397,41749,843,307,429,1579,43328
26-02-2019,3,12276,18640,7718,2273,40908,884,309,481,1674,42582
26-02-2019,4,12526,19027,7996,2123,41673,871,311,520,1702,43375
26-02-2019,5,14057,21347,8548,1883,45834,826,324,545,1695,47529
26-02-2019,6,18032,23301,8948,2320,52600,833,763,550,2146,54746
26-02-2019,7,19780,24129,9280,2887,56078,939,905,580,2424,58502
26-02-2019,8,20452,23574,9448,2855,56330,917,918,551,2386,58716
26-02-2019,9,20513,23153,9322,2598,55586,896,988,554,2438,58024
26-02-2019,10,20802,22971,9209,2698,55682,899,906,567,2372,58054
26-02-2019,11,18758,22466,8885,2579,52688,830,785,521,2136,54824
26-02-2019,12,17375,21644,8571,2629,50221,823,830,508,2161,52382
26-02-2019,13,17115,21007,8653,2702,49480,794,838,537,2169,51649
26-02-2019,14,17493,21493,8843,2741,50571,864,833,507,2204,52775
26-02-2019,15,18319,21385,8934,2626,51264,869,829,426,2124,53388
26-02-2019,16,19260,21683,8905,2490,52339,877,805,465,2147,54486
26-02-2019,17,19887,22313,9140,2615,53954,873,1061,872,2806,56760
26-02-2019,18,19954,22616,9219,2886,54676,849,1068,881,2798,57474
26-02-2019,19,18981,22785,9117,2783,53666,886,883,440,2209,55875
26-02-2019,20,17568,22796,9063,2631,52059,768,851,368,1987,54046
26-02-2019,21,16464,22702,9059,2573,50799,725,753,345,1823,52622
26-02-2019,22,15038,21746,9074,2445,48306,709,705,330,1744,50050
26-02-2019,23,14282,20067,8996,2483,45828,698,277,302,1277,47105
27-02-2019,0,13513,19447,8935,2456,44352,706,276,285,1267,45619
27-02-2019,1,12954,19097,8792,2571,43414,701,275,256,1232,44646
27-02-2019,2,12799,19080,8723,2533,43136,717,277,205,1199,44335
27-02-2019,3,12600,19113,8690,2532,42935,758,280,190,1228,44163
27-02-2019,4,13068,19752,8850,2709,44380,769,284,189,1242,45622
27-02-2019,5,14867,22110,9351,2787,49116,787,392,214,1393,50509
27-02-2019,6,17328,23758,9558,3337,53980,824,625,259,1708,55688
27-02-2019,7,19132,24459,9787,3655,57034,835,875,516,2226,59260
27-02-2019,8,19791,24509,9781,3778,57858,840,852,666,2358,60216
27-02-2019,9,19225,24357,9742,3843,57165,814,813,618,2245,59410
27-02-2019,10,18211,24506,9630,3844,56191,806,702,634,2142,58333
27-02-2019,11,16646,24045,9399,3477,53568,781,480,461,1722,55290
27-02-2019,12,15870,23156,9141,3637,51805,777,383,516,1676,53481
27-02-2019,13,15758,22963,9044,3708,51473,752,410,529,1691,53164
27-02-2019,14,15390,23516,9098,3724,51729,789,599,526,1914,53643
27-02-2019,15,15759,23937,9058,3386,52142,816,424,485,1725,53867
27-02-2019,16,17350,24672,9063,3564,54650,840,410,473,1723,56373
27-02-2019,17,18654,24951,9184,3640,56430,852,555,468,1875,58305
27-02-2019,18,18899,25376,9289,3709,57273,863,562,480,1905,59178
27-02-2019,19,17451,25289,9090,4009,55840,859,449,502,1810,57650
27-02-2019,20,16065,24204,8925,4313,53508,890,433,430,1753,55261
27-02-2019,21,15160,23207,8752,3855,50974,873,300,427,1600,52574
27-02-2019,22,13934,21419,8320,3765,47438,846,285,449,1580,49018
27-02-2019,23,12796,19880,7967,3535,44178,833,279,449,1561,45739
28-02-2019,0,12653,18673,7850,3767,42945,796,284,468,1548,44493
28-02-2019,1,11860,18209,7813,3662,41543,778,280,487,1545,43088
28-02-2019,2,11692,18216,7757,3609,41274,787,274,470,1531,42805
28-02-2019,3,11627,18298,7840,3573,41339,805,274,446,1525,42864
28-02-2019,4,11848,18953,8062,3508,42372,815,279,408,1502,43874
28-02-2019,5,12410,20099,8540,3676,44725,844,291,362,1497,46222
28-02-2019,6,15293,23560,9184,3865,51903,854,374,422,1650,53553
28-02-2019,7,18299,25604,9584,4067,57554,847,694,410,1951,59505
28-02-2019,8,19171,25550,9615,3631,57968,840,741,388,1969,59937
28-02-2019,9,17335,25180,9472,3499,55487,885,744,422,2051,57538
28-02-2019,10,16566,24676,9348,3064,53654,843,734,545,2122,55776
28-02-2019,11,15104,23837,9235,2847,51022,826,670,607,2103,53125
28-02-2019,12,14375,23116,9273,2679,49444,833,672,655,2160,51604
28-02-2019,13,14540,22655,9346,2625,49166,841,717,689,2247,51413
28-02-2019,14,15325,22573,9424,2563,49886,842,808,720,2370,52256
28-02-2019,15,15564,22611,9502,2490,50168,876,810,715,2401,52569
28-02-2019,16,16923,22760,9738,2622,52044,895,848,714,2457,54501
28-02-2019,17,20696,23678,9978,2652,57006,927,844,721,2492,59498
28-02-2019,18,22086,24040,10153,2806,59087,915,849,726,2490,61577
28-02-2019,19,21697,23582,9957,2884,58120,897,853,712,2462,60582
28-02-2019,20,20333,22949,9874,2637,55795,875,850,655,2380,58175
28-02-2019,21,18823,22535,9691,2268,53317,858,752,643,2253,55570
28-02-2019,22,17670,21000,9407,2121,50198,841,474,618,1933,52131
28-02-2019,23,15055,19396,9007,1831,45290,813,481,582,1876,47166
01-03-2019,0,13452,18176,8751,1754,42132,807,531,567,1905,44037
01-03-2019,1,12376,17891,8654,1914,40835,818,530,529,1877,42712
01-03-2019,2,12042,17799,8633,1905,40378,825,530,541,1896,42274
01-03-2019,3,12433,17867,8670,1969,40940,830,529,555,1914,42854
01-03-2019,4,13947,18098,8779,2016,42840,833,531,544,1908,44748
01-03-2019,5,16238,19840,9090,2097,47265,876,537,488,1901,49166
01-03-2019,6,20470,21901,9770,2760,54901,919,858,519,2296,57197
01-03-2019,7,22709,23010,9839,2950,58508,918,1084,842,2844,61352
01-03-2019,8,23415,23307,9859,3016,59596,912,1067,904,2883,62479
01-03-2019,9,23384,23311,9807,3116,59619,880,1118,959,2957,62576
01-03-2019,10,22893,23234,9702,3446,59277,875,1275,948,3098,62375
01-03-2019,11,22179,23007,9696,3323,58206,868,1293,722,2883,61089
01-03-2019,12,21686,22870,9726,3376,57658,863,1181,679,2723,60381
01-03-2019,13,21356,22662,9572,3386,56978,819,1115,671,2605,59583
01-03-2019,14,20647,22647,9673,3077,56043,832,992,649,2473,58516
01-03-2019,15,20695,22675,9728,2887,55984,820,929,616,2365,58349
01-03-2019,16,20962,22819,9833,2741,56354,811,915,538,2264,58618
01-03-2019,17,21858,23051,10054,2922,57884,838,1120,762,2720,60604
01-03-2019,18,22703,23357,10285,3054,59399,838,1215,741,2794,62193
01-03-2019,19,22320,23314,9750,3114,58500,809,889,540,2238,60738
01-03-2019,20,20834,23291,9568,2952,56645,712,838,309,1859,58504
01-03-2019,21,19953,23426,9424,2671,55474,710,672,240,1622,57096
01-03-2019,22,19097,22599,9222,2459,53379,711,595,221,1527,54906
01-03-2019,23,17373,21538,8966,2205,50084,731,597,206,1534,51618
02-03-2019,0,16203,20385,8727,1993,47308,747,589,197,1533,48841
02-03-2019,1,14838,19681,8506,1874,44900,780,589,191,1560,46460
02-03-2019,2,13569,19689,8443,1858,43561,793,590,188,1571,45132
02-03-2019,3,12702,19534,8421,1909,42566,796,598,199,1593,44159
02-03-2019,4,12824,19612,8492,1892,42820,829,601,215,1645,44465
02-03-2019,5,12828,20267,8633,2042,43768,830,694,235,1759,45527
02-03-2019,6,13568,21484,8882,2303,46237,822,876,263,1961,48198
02-03-2019,7,14961,22650,9163,2663,49438,806,919,324,2049,51487
02-03-2019,8,17280,24076,9512,3246,54113,805,911,315,2031,56144
02-03-2019,9,17818,24580,9743,3441,55582,849,937,350,2136,57718
02-03-2019,10,17777,24698,9609,3498,55582,834,929,418,2181,57763
02-03-2019,11,16848,23996,9401,3868,54113,872,934,465,2271,56384
02-03-2019,12,15696,23547,9592,3763,52599,875,934,504,2313,54912
02-03-2019,13,13935,22023,9548,3569,49077,917,936,535,2388,51465
02-03-2019,14,13162,20838,9364,3721,47084,896,938,517,2351,49435
02-03-2019,15,13476,20663,9370,3845,47354,944,944,500,2388,49742
02-03-2019,16,14518,21903,9476,4107,50004,937,941,490,2368,52372
02-03-2019,17,16695,22722,9898,4684,53998,911,949,484,2344,56342
02-03-2019,18,17811,22996,10030,4892,55731,917,938,543,2398,58129
02-03-2019,19,16281,22716,9771,4850,53617,908,909,591,2408,56025
02-03-2019,20,13964,20973,9229,4820,48987,876,822,578,2276,51263
02-03-2019,21,12945,19907,8840,4810,46501,851,796,581,2228,48729
02-03-2019,22,12555,18756,8681,4809,44800,833,634,573,2040,46840
02-03-2019,23,11989,17494,8546,4606,42636,830,563,495,1888,44524
03-03-2019,0,11664,16515,8516,4388,41083,771,390,476,1637,42720
03-03-2019,1,11653,16001,8434,4000,40089,734,372,478,1584,41673
03-03-2019,2,11479,16061,8478,3791,39809,725,374,488,1587,41396
03-03-2019,3,11510,16180,8399,3886,39974,737,370,470,1577,41551
03-03-2019,4,11904,16303,8454,4023,40685,732,372,490,1594,42279
03-03-2019,5,11685,16599,8455,3978,40718,694,368,492,1554,42272
03-03-2019,6,11590,17206,8484,3523,40803,686,368,487,1541,42344
03-03-2019,7,12531,18035,8308,3386,42260,667,398,470,1535,43795
03-03-2019,8,13286,19335,8257,3582,44459,667,425,465,1557,46016
03-03-2019,9,14043,20469,8211,3981,46703,660,528,472,1660,48363
03-03-2019,10,14263,21026,8139,4275,47702,669,551,463,1683,49385
03-03-2019,11,14246,21095,8090,4484,47915,678,639,449,1766,49681
03-03-2019,12,14286,20635,8096,4354,47372,686,657,442,1785,49157
03-03-2019,13,14089,20426,8069,4284,46867,688,670,440,1798,48665
03-03-2019,14,13343,19803,8083,4328,45557,696,714,508,1918,47475
03-03-2019,15,13228,19894,8187,3762,45070,700,727,578,2005,47075
03-03-2019,16,13194,20425,8367,3695,45682,710,783,628,2121,47803
03-03-2019,17,14178,21442,8593,3866,48079,705,777,652,2134,50213
03-03-2019,18,15401,22041,8755,3926,50125,713,777,649,2139,52264
03-03-2019,19,15611,21869,9018,3581,50078,720,761,631,2112,52190
03-03-2019,20,14766,21301,9076,3365,48508,733,757,598,2088,50596
03-03-2019,21,13954,20295,8840,3424,46514,719,755,572,2046,48560
03-03-2019,22,13445,19346,8618,3432,44843,725,659,527,1911,46754
03-03-2019,23,12935,18065,8582,3170,42753,716,550,461,1727,44480
04-03-2019,0,12869,17467,8586,2636,41557,746,334,405,1485,43042
04-03-2019,1,12759,16971,8539,2966,41236,750,330,367,1447,42683
04-03-2019,2,12087,16703,8474,3319,40584,739,324,362,1425,42009
04-03-2019,3,12406,17011,8412,3690,41521,729,317,339,1385,42906
04-03-2019,4,12787,17755,8582,3804,42927,727,311,323,1361,44288
04-03-2019,5,14148,19315,8908,4497,46869,737,672,311,1720,48589
04-03-2019,6,16503,21013,9344,4638,51498,788,961,270,2019,53517
04-03-2019,7,18296,23100,9551,4733,55681,813,966,668,2447,58128
04-03-2019,8,19753,23168,9489,4978,57387,812,1114,649,2575,59962
04-03-2019,9,20315,23209,9468,4786,57778,808,1131,706,2645,60423
04-03-2019,10,20280,23556,9381,4644,57861,816,1053,745,2614,60475
04-03-2019,11,19498,23371,9328,4615,56812,817,1225,568,2610,59422
04-03-2019,12,17992,23248,9434,5108,55783,819,1135,465,2419,58202
04-03-2019,13,17927,23270,9357,5490,56043,805,1298,460,2563,58606
04-03-2019,14,18357,23542,9218,5567,56684,817,1342,468,2627,59311
04-03-2019,15,18467,22568,9091,5327,55453,817,1292,496,2605,58058
04-03-2019,16,17726,23004,9195,4970,54897,825,1074,569,2468,57365
04-03-2019,17,18588,23506,9347,5003,56445,830,1123,631,2584,59029
04-03-2019,18,19369,23971,9360,5081,57783,829,1102,683,2614,60397
04-03-2019,19,18973,23919,8914,4930,56736,812,1106,665,2583,59319
04-03-2019,20,17243,23270,8562,4989,54064,784,650,616,2050,56114
04-03-2019,21,16066,22561,8314,4958,51900,771,607,561,1939,53839
04-03-2019,22,14771,21092,8210,4669,48743,779,511,510,1800,50543
04-03-2019,23,13840,19871,8157,4112,45982,793,504,541,1838,47820
05-03-2019,0,13031,18793,8321,3953,44097,795,500,570,1865,45962
05-03-2019,1,12564,18500,8488,3798,43351,772,503,597,1872,45223
05-03-2019,2,12298,18579,8754,3547,43179,764,505,633,1902,45081
05-03-2019,3,12306,18628,8905,3595,43436,762,504,661,1927,45363
05-03-2019,4,12932,19300,9319,3714,45266,772,500,668,1940,47206
05-03-2019,5,13560,20940,9817,4417,48735,809,501,669,1979,50714
05-03-2019,6,15458,22791,10124,5024,53398,813,547,669,2029,55427
05-03-2019,7,18927,24589,10369,5167,59052,846,592,714,2152,61204
05-03-2019,8,20091,24753,10402,5616,60862,906,492,717,2115,62977
05-03-2019,9,20138,24244,10239,5533,60156,944,694,688,2326,62482
05-03-2019,10,20328,23908,9991,5619,59846,964,698,680,2342,62188
05-03-2019,11,19743,23376,9932,5654,58706,971,631,652,2254,60960
05-03-2019,12,18964,22919,9804,5507,57195,986,627,609,2222,59417
05-03-2019,13,18638,22760,9755,5608,56760,984,623,635,2242,59002
05-03-2019,14,18921,22674,9784,5376,56755,992,648,577,2217,58972
05-03-2019,15,19491,22421,9631,5133,56674,972,762,518,2252,58926
05-03-2019,16,21274,22504,9755,4693,58226,986,1006,462,2454,60680
05-03-2019,17,22903,22631,9947,4404,59885,1010,1144,421,2575,62460
05-03-2019,18,23768,23043,10180,4067,61056,1100,1293,599,2992,64048
05-03-2019,19,23595,22861,10036,3794,60286,1136,1102,397,2635,62921
05-03-2019,20,22980,22929,9670,3495,59075,1006,834,378,2218,61293
05-03-2019,21,21591,22670,9436,3276,56973,887,630,310,1827,58800
05-03-2019,22,18994,22222,9183,3227,53628,835,511,294,1640,55268
05-03-2019,23,16452,20424,9187,2813,48875,796,510,282,1588,50463
06-03-2019,0,15427,18660,9274,2676,46036,766,734,268,1768,47804
06-03-2019,1,14922,18583,9194,2706,45405,762,737,254,1753,47158
06-03-2019,2,14494,18694,9183,2902,45274,774,714,253,1741,47015
06-03-2019,3,14580,18819,9336,3003,45739,751,734,253,1738,47477
06-03-2019,4,16075,19323,9720,3235,48352,718,737,231,1686,50038
06-03-2019,5,17988,20733,10223,3436,52381,725,906,290,1921,54302
06-03-2019,6,19813,22388,10648,3796,56646,785,1259,213,2257,58903
06-03-2019,7,22094,23232,10674,4409,60411,855,1319,420,2594,63005
06-03-2019,8,23005,23087,10620,4614,61326,876,1366,554,2796,64122
06-03-2019,9,23387,22969,10597,4696,61649,871,1326,327,2524,64173
06-03-2019,10,22904,22842,10370,4772,60888,886,1309,300,2495,63383
06-03-2019,11,22188,22813,10125,4846,59972,904,1302,304,2510,62482
06-03-2019,12,20910,22580,10075,5052,58617,936,1300,309,2545,61162
06-03-2019,13,20227,22620,9964,5438,58249,906,1325,240,2471,60720
06-03-2019,14,20145,22909,9920,5393,58366,897,1323,233,2453,60819
06-03-2019,15,19878,22865,9861,5502,58106,894,1169,223,2286,60392
06-03-2019,16,19734,22927,9850,5759,58271,917,1215,213,2345,60616
06-03-2019,17,20175,23136,10099,5924,59336,958,1200,284,2442,61778
06-03-2019,18,20335,23686,10155,5825,60001,963,1192,387,2542,62543
06-03-2019,19,19305,23539,9674,5634,58152,924,1065,365,2354,60506
06-03-2019,20,17756,23254,9453,5348,55811,925,831,349,2105,57916
06-03-2019,21,15756,22779,9193,5168,52896,931,807,364,2102,54998
06-03-2019,22,14703,21006,8873,4942,49525,937,798,389,2124,51649
06-03-2019,23,14034,19501,8702,4578,46816,790,802,443,2035,48851
07-03-2019,0,12974,18508,8558,4303,44345,909,492,482,1883,46228
07-03-2019,1,12557,17894,8476,4416,43342,928,492,527,1947,45289
07-03-2019,2,12448,17602,8419,4323,42793,900,491,559,1950,44743
07-03-2019,3,12377,17741,8478,4059,42655,950,495,556,2001,44656
07-03-2019,4,12518,18544,8654,4040,43755,980,498,566,2044,45799
07-03-2019,5,14322,20105,8870,4200,47496,985,893,575,2453,49949
07-03-2019,6,17196,21355,9249,4324,52124,1002,1000,573,2575,54699
07-03-2019,7,20479,22539,9465,4397,56881,1042,1001,643,2686,59567
07-03-2019,8,21764,22582,9481,4499,58327,1063,1102,676,2841,61168
07-03-2019,9,21560,22469,9295,4263,57585,1079,1177,622,2878,60463
07-03-2019,10,20858,22421,8996,4420,56695,1037,1263,610,2910,59605
07-03-2019,11,20168,22393,9000,4612,56174,1022,1213,576,2811,58985
07-03-2019,12,19209,22233,8853,5140,55435,1062,1206,651,2919,58354
07-03-2019,13,18290,22056,8792,5825,54963,1065,1207,553,2825,57788
07-03-2019,14,17490,22170,8871,6317,54848,1073,1209,570,2852,57700
07-03-2019,15,16789,22292,8753,6650,54485,1084,1221,529,2834,57319
07-03-2019,16,16478,22795,8752,6494,54520,1057,1320,528,2905,57425
07-03-2019,17,17366,23202,9055,6556,56180,1087,1319,597,3003,59183
07-03-2019,18,17601,23607,9158,6495,56862,1100,1329,605,3034,59896
07-03-2019,19,17181,23417,8746,6518,55863,1066,1093,521,2680,58543
07-03-2019,20,14739,22748,8595,6055,52139,1057,921,555,2533,54672
07-03-2019,21,13952,21574,8448,5824,49797,980,606,576,2162,51959
07-03-2019,22,13260,20338,8075,5701,47375,982,536,506,2024,49399
07-03-2019,23,12656,18853,7798,5294,44601,974,517,441,1932,46533
08-03-2019,0,12494,18405,7769,4734,43402,875,281,338,1494,44896
08-03-2019,1,12211,18288,7780,4528,42807,813,260,248,1321,44128
08-03-2019,2,12004,18164,7850,4287,42305,825,256,276,1357,43662
08-03-2019,3,11981,18330,7880,4346,42536,833,253,374,1460,43996
08-03-2019,4,12058,18587,8017,4732,43395,843,267,463,1573,44968
08-03-2019,5,12646,19355,8338,5200,45539,999,487,543,2029,47568
08-03-2019,6,13957,21328,8784,5748,49817,992,721,588,2301,52118
08-03-2019,7,15727,23210,9093,6309,54340,993,843,654,2490,56830
08-03-2019,8,16548,23595,9092,6474,55710,969,906,686,2561,58271
08-03-2019,9,16345,23330,8973,6689,55337,942,898,700,2540,57877
08-03-2019,10,16126,23300,8921,6840,55188,943,903,732,2578,57766
08-03-2019,11,15589,23031,8813,6828,54261,957,916,734,2607,56868
08-03-2019,12,14824,22825,8606,6886,53142,944,931,742,2617,55759
08-03-2019,13,14168,22563,8547,6698,51975,956,949,733,2638,54613
08-03-2019,14,13773,22295,8559,6542,51170,978,948,689,2615,53785
08-03-2019,15,13613,22174,8559,6399,50744,1007,852,693,2552,53296
08-03-2019,16,14157,22770,8602,6205,51734,968,865,685,2518,54252
08-03-2019,17,15254,25365,8971,5527,55117,1019,933,716,2668,57785
08-03-2019,18,16625,26324,9180,5641,57771,1020,994,708,2722,60493
08-03-2019,19,16792,26071,8971,5536,57372,1018,962,638,2618,59990
08-03-2019,20,16014,25183,8681,4950,54828,994,715,646,2355,57183
08-03-2019,21,14643,23791,8415,4616,51465,998,450,642,2090,53555
08-03-2019,22,13452,22048,8025,4613,48138,1015,404,650,2069,50207
08-03-2019,23,13195,20260,7743,4337,45536,923,281,641,1845,47381
09-03-2019,0,12768,18856,7602,4075,43301,1012,341,640,1993,45294
09-03-2019,1,12717,18588,7543,4008,42856,1016,360,623,1999,44855
09-03-2019,2,12462,18283,7584,4142,42470,946,361,633,1940,44410
09-03-2019,3,12251,17998,7618,4258,42125,1007,362,620,1989,44114
09-03-2019,4,12285,18093,7721,4509,42609,1037,414,591,2042,44651
09-03-2019,5,12449,18414,8045,4698,43606,1045,424,570,2039,45645
09-03-2019,6,12830,18603,8149,4845,44428,1049,727,524,2300,46728
09-03-2019,7,13386,19404,8418,5262,46469,1037,723,514,2274,48743
09-03-2019,8,14148,20698,8539,5637,49020,1023,720,501,2244,51264
09-03-2019,9,15116,21493,8715,5956,51279,1020,712,478,2210,53489
09-03-2019,10,15424,21563,8726,6322,52036,1012,723,493,2228,54264
09-03-2019,11,14469,21112,8658,6341,50580,989,909,563,2461,53041
09-03-2019,12,13818,20482,8489,6193,48982,930,956,559,2445,51427
09-03-2019,13,13895,20068,8506,6234,48705,945,866,541,2352,51057
09-03-2019,14,14000,19965,8595,5605,48165,940,820,532,2292,50457
09-03-2019,15,14002,19948,8581,5809,48339,900,728,586,2214,50553
09-03-2019,16,14217,20840,8575,5595,49228,901,723,585,2209,51437
09-03-2019,17,14903,21912,8690,5520,51025,918,729,605,2252,53277
09-03-2019,18,15811,23290,8794,5518,53414,898,741,630,2269,55683
09-03-2019,19,15733,22286,8671,5623,52315,923,748,647,2318,54633
09-03-2019,20,15158,20870,8390,5760,50178,925,710,648,2283,52461
09-03-2019,21,15395,19941,8129,5590,49055,923,360,629,1912,50967
09-03-2019,22,15054,19381,7789,5395,47619,894,353,590,1837,49456
09-03-2019,23,14501,18709,7672,5119,46001,789,274,580,1643,47644
10-03-2019,0,14140,18129,7647,4696,44611,751,358,577,1686,46297
10-03-2019,1,14308,17980,7520,4350,44159,723,275,546,1544,45703
10-03-2019,2,14230,17910,7454,4088,43683,731,275,534,1540,45223
10-03-2019,3,14005,18081,7521,4201,43809,738,278,557,1573,45382
10-03-2019,4,14010,17993,7566,4355,43925,764,343,606,1713,45638
10-03-2019,5,13704,18311,7673,4305,43992,883,414,635,1932,45924
10-03-2019,6,13400,18563,7682,4170,43815,870,426,637,1933,45748
10-03-2019,7,13320,18882,7833,4431,44467,865,645,636,2146,46613
10-03-2019,8,13710,19979,7853,4509,46050,891,898,589,2378,48428
10-03-2019,9,14200,20462,7823,4500,46985,904,1078,543,2525,49510
10-03-2019,10,13669,20591,7799,4635,46695,926,1087,494,2507,49202
10-03-2019,11,13598,21100,7831,4522,47051,911,1149,461,2521,49572
10-03-2019,12,13303,21273,7781,4143,46500,899,1087,434,2420,48920
10-03-2019,13,12965,21331,7883,3937,46115,859,1087,471,2417,48532
10-03-2019,14,13094,21570,7950,3575,46190,854,1089,494,2437,48627
10-03-2019,15,13002,21406,8005,3345,45759,858,1095,545,2498,48257
10-03-2019,16,13023,22050,8364,3300,46737,867,1149,547,2563,49300
10-03-2019,17,13965,23434,8865,3222,49486,903,1129,513,2545,52031
10-03-2019,18,15445,24063,9231,3075,51817,859,1171,494,2524,54341
10-03-2019,19,15018,24050,9267,3293,51627,867,1185,343,2395,54022
10-03-2019,20,13828,23869,9176,3292,50165,876,1187,279,2342,52507
10-03-2019,21,13615,23071,9073,3104,48865,864,1099,221,2184,51049
10-03-2019,22,13477,22657,8902,2522,47557,845,1047,206,2098,49655
10-03-2019,23,12911,21083,8671,2447,45113,847,972,194,2013,47126
11-03-2019,0,12702,20210,8646,2422,43979,849,546,204,1599,45578
11-03-2019,1,12182,19620,8598,2381,42780,845,524,217,1586,44366
11-03-2019,2,12320,19645,8698,2286,42950,836,511,264,1611,44561
11-03-2019,3,12240,19934,8860,2333,43368,849,511,315,1675,45043
11-03-2019,4,12501,21296,9070,2561,45430,868,541,348,1757,47187
11-03-2019,5,14603,22977,9348,2646,49572,862,656,390,1908,51480
11-03-2019,6,18047,24270,9619,2697,54632,863,822,450,2135,56767
11-03-2019,7,21382,25187,9935,2686,59190,866,1192,645,2703,61893
11-03-2019,8,22067,25217,10041,3083,60409,872,1290,721,2883,63292
11-03-2019,9,21560,25174,9854,2804,59393,900,1286,773,2959,62352
11-03-2019,10,21029,25234,9676,2879,58819,909,1201,769,2879,61698
11-03-2019,11,19459,24871,9375,3119,56826,918,1204,721,2843,59669
11-03-2019,12,18556,24352,9306,3093,55308,918,1211,542,2671,57979
11-03-2019,13,17618,24198,9411,3134,54362,907,1195,573,2675,57037
11-03-2019,14,16871,24107,9414,3240,53633,895,1183,587,2665,56298
11-03-2019,15,16130,24006,9510,3334,52980,923,1184,585,2692,55672
11-03-2019,16,16694,24062,9653,3392,53801,907,1160,575,2642,56443
11-03-2019,17,18887,25188,9957,3275,57307,901,1211,719,2831,60138
11-03-2019,18,21611,25998,10195,3035,60840,904,1317,671,2892,63732
11-03-2019,19,21572,25740,10043,3007,60362,892,1331,589,2812,63174
11-03-2019,20,20290,25306,9887,2903,58386,916,1239,365,2520,60906
11-03-2019,21,19255,24975,9742,2855,56826,902,1143,327,2372,59198
11-03-2019,22,18451,24462,9537,2815,55265,894,700,296,1890,57155
11-03-2019,23,15207,22871,9236,3106,50419,883,691,288,1862,52281
12-03-2019,0,13194,20631,9202,2941,45969,853,612,331,1796,47765
12-03-2019,1,12548,19973,9239,3108,44869,853,611,352,1816,46685
12-03-2019,2,12605,19835,9218,3048,44707,857,621,358,1836,46543
12-03-2019,3,12620,20144,9285,2979,45028,843,713,342,1898,46926
12-03-2019,4,13666,20772,9439,3107,46983,850,726,383,1959,48942
12-03-2019,5,16098,21890,9663,3408,51059,944,1009,375,2328,53387
12-03-2019,6,19763,23168,9693,3837,56461,940,1156,419,2515,58976
12-03-2019,7,23304,23637,9778,4552,61272,941,1308,618,2867,64139
12-03-2019,8,23677,23337,9585,4819,61418,918,1324,673,2915,64333
12-03-2019,9,22227,22969,9217,4889,59302,928,1366,709,3003,62305
12-03-2019,10,21366,22720,9087,5446,58621,917,1390,603,2910,61531
12-03-2019,11,19923,22520,9125,5966,57535,907,1395,606,2908,60443
12-03-2019,12,19104,22285,8990,6114,56493,912,1366,573,2851,59344
12-03-2019,13,18731,22228,8907,6118,55985,913,1347,540,2800,58785
12-03-2019,14,18292,22318,8808,6377,55796,910,1371,508,2789,58585
12-03-2019,15,18023,22748,8737,6539,56047,915,1374,456,2745,58792
12-03-2019,16,17654,23107,8830,6541,56132,919,1405,346,2670,58802
12-03-2019,17,17626,23544,9091,6763,57024,919,1487,478,2884,59908
12-03-2019,18,18028,24167,9201,6992,58388,929,1554,476,2959,61347
12-03-2019,19,17290,24653,8957,6811,57711,860,1420,272,2552,60263
12-03-2019,20,15961,24263,8751,6587,55563,844,1018,229,2091,57654
12-03-2019,21,14675,23120,8526,6308,52630,841,913,225,1979,54609
12-03-2019,22,13492,21723,8289,5927,49431,832,622,238,1692,51123
12-03-2019,23,12912,20428,8096,5328,46764,830,616,247,1693,48457
13-03-2019,0,12277,20100,7973,4807,45156,832,664,290,1786,46942
13-03-2019,1,12174,19883,8040,4548,44645,721,661,310,1692,46337
13-03-2019,2,11882,19841,8132,4592,44448,644,679,336,1659,46107
13-03-2019,3,11518,19675,8380,4562,44135,647,681,386,1714,45849
13-03-2019,4,11823,20194,8820,4665,45502,780,764,450,1994,47496
13-03-2019,5,12672,21707,9452,5165,48997,840,977,460,2277,51274
13-03-2019,6,14328,23971,9811,5649,53760,837,1280,589,2706,56466
13-03-2019,7,16688,24926,9902,6119,57636,841,1254,715,2810,60446
13-03-2019,8,17803,25007,9721,6339,58871,842,1223,941,3006,61877
13-03-2019,9,17672,25017,9441,6394,58524,875,1271,915,3061,61585
13-03-2019,10,16938,25055,9148,6467,57608,888,1254,725,2867,60475
13-03-2019,11,16661,25284,9074,6612,57631,885,1224,771,2880,60511
13-03-2019,12,15850,24845,8999,6626,56318,893,1249,788,2930,59248
13-03-2019,13,15543,24769,9105,6656,56074,898,1262,699,2859,58933
13-03-2019,14,15095,24695,9119,6402,55310,896,1259,577,2732,58042
13-03-2019,15,15128,24769,9232,6097,55225,904,1258,522,2684,57909
13-03-2019,16,15670,24643,9266,5617,55197,919,1240,485,2644,57841
13-03-2019,17,16694,24565,9467,5364,56091,935,1247,517,2699,58790
13-03-2019,18,17388,24735,9735,5090,56949,946,1266,574,2786,59735
13-03-2019,19,16508,24265,9567,4999,55340,925,1235,620,2780,58120
13-03-2019,20,14561,23256,9536,5060,52415,936,1226,431,2593,55008
13-03-2019,21,13883,22296,9416,4969,50565,907,886,432,2225,52790
13-03-2019,22,13268,20314,9188,4709,47480,892,851,443,2186,49666
13-03-2019,23,12641,19207,9061,4868,45776,872,601,463,1936,47712
14-03-2019,0,12421,17884,8864,4963,44132,838,661,472,1971,46103
14-03-2019,1,12182,17254,8731,4815,42983,751,587,469,1807,44790
14-03-2019,2,11897,17104,8714,4565,42281,739,605,489,1833,44114
14-03-2019,3,11824,17234,8716,4451,42226,773,704,486,1963,44189
14-03-2019,4,11787,17823,8869,4445,42926,908,785,505,2198,45124
14-03-2019,5,12484,19889,9197,4872,46442,939,896,483,2318,48760
14-03-2019,6,14515,21792,9663,4988,50958,926,1162,487,2575,53533
14-03-2019,7,18235,23110,9921,5011,56276,946,1263,560,2769,59045
14-03-2019,8,19698,23159,10010,5049,57916,945,1273,623,2841,60757
14-03-2019,9,19416,23141,9885,5338,57779,941,1270,603,2814,60593
14-03-2019,10,19321,23148,9697,5244,57411,915,1257,586,2758,60169
14-03-2019,11,18340,22888,9584,5546,56358,927,1263,591,2781,59139
14-03-2019,12,17906,22647,9442,5472,55466,926,1252,574,2752,58218
14-03-2019,13,17372,22600,9335,4991,54296,928,1247,565,2740,57036
14-03-2019,14,17215,22463,9375,4541,53595,923,1264,592,2779,56374
14-03-2019,15,17409,22374,9430,4252,53464,922,1265,530,2717,56181
14-03-2019,16,17700,22593,9368,3913,53573,945,1251,490,2686,56259
14-03-2019,17,18801,22817,9435,3875,54928,940,1253,481,2674,57602
14-03-2019,18,19844,23459,9614,3798,56715,932,1252,518,2702,59417
14-03-2019,19,19341,23292,9434,3602,55668,933,1254,480,2667,58335
14-03-2019,20,17629,22668,9083,3418,52799,923,1286,423,2632,55431
14-03-2019,21,16098,22117,8894,3351,50460,906,1144,456,2506,52966
14-03-2019,22,14669,20960,8628,3269,47525,903,1055,457,2415,49940
14-03-2019,23,12835,19516,8477,3343,44171,891,729,407,2027,46198
15-03-2019,0,12052,17763,8318,3827,41960,908,566,382,1856,43816
15-03-2019,1,11912,17163,8216,3767,41059,902,526,360,1788,42847
15-03-2019,2,11923,17092,8171,3473,40660,898,525,364,1787,42447
15-03-2019,3,12222,17222,8194,3308,40946,885,526,360,1771,42717
15-03-2019,4,12915,17705,8258,3305,42183,895,688,357,1940,44123
15-03-2019,5,14319,19735,8479,3481,46015,875,918,362,2155,48170
15-03-2019,6,16812,21113,8807,3701,50433,876,1230,379,2485,52918
15-03-2019,7,19801,22659,9102,3719,55280,884,1228,573,2685,57965
15-03-2019,8,20411,22850,9158,3926,56346,893,1317,591,2801,59147
15-03-2019,9,19868,22655,9014,3987,55523,893,1249,504,2646,58169
15-03-2019,10,19429,22517,8815,4188,54950,895,1380,497,2772,57722
15-03-2019,11,19012,22279,8592,4386,54267,901,1300,567,2768,57035
15-03-2019,12,18730,22349,8590,4401,54071,935,1226,596,2757,56828
15-03-2019,13,18100,22101,8486,4526,53214,908,1230,588,2726,55940
15-03-2019,14,17183,21708,8501,4827,52219,927,1234,526,2687,54906
15-03-2019,15,16759,21735,8358,5027,51879,923,1233,541,2697,54576
15-03-2019,16,16849,21604,8462,5154,52070,910,1324,560,2794,54864
15-03-2019,17,17716,22251,8677,5167,53810,931,1412,588,2931,56741
15-03-2019,18,18244,22386,8874,5183,54689,928,1407,583,2918,57607
15-03-2019,19,17112,22071,8408,5147,52738,917,1237,499,2653,55391
15-03-2019,20,15387,21124,8171,4959,49641,920,1229,331,2480,52121
15-03-2019,21,14254,20064,7996,4719,47033,912,895,326,2133,49166
15-03-2019,22,13055,18894,7608,4753,44309,911,787,343,2041,46350
15-03-2019,23,12728,18056,7578,4210,42574,914,692,396,2002,44576
16-03-2019,0,12505,16977,7437,4095,41014,906,406,417,1729,42743
16-03-2019,1,12296,16470,7318,4152,40237,893,399,356,1648,41885
16-03-2019,2,11983,16342,7261,4256,39843,880,397,283,1560,41403
16-03-2019,3,11606,16430,7247,4061,39345,873,395,240,1508,40853
16-03-2019,4,11734,16703,7224,4331,39992,868,440,211,1519,41511
16-03-2019,5,11952,17011,7373,4262,40599,861,627,211,1699,42298
16-03-2019,6,12186,17258,7414,4199,41057,859,887,224,1970,43027
16-03-2019,7,12774,17974,7532,4376,42657,852,899,265,2016,44673
16-03-2019,8,13352,19245,7527,4414,44538,844,983,457,2284,46822
16-03-2019,9,13870,20360,7515,4412,46158,841,991,549,2381,48539
16-03-2019,10,14089,20379,7628,4392,46487,841,1002,604,2447,48934
16-03-2019,11,13877,20619,7591,3929,46017,840,1001,602,2443,48460
16-03-2019,12,13445,20675,7569,3721,45410,852,998,559,2409,47819
16-03-2019,13,13336,20105,7460,3599,44498,842,999,565,2406,46904
16-03-2019,14,13165,19943,7537,3508,44154,853,1000,539,2392,46546
16-03-2019,15,13193,20248,7733,3737,44910,849,999,437,2285,47195
16-03-2019,16,13761,20443,7861,4209,46275,844,993,449,2286,48561
16-03-2019,17,14664,20597,7929,4830,48021,854,992,418,2264,50285
16-03-2019,18,15831,20728,8050,5201,49811,854,993,340,2187,51998
16-03-2019,19,15012,20667,8173,5332,49185,847,996,338,2181,51366
16-03-2019,20,13749,20012,7921,5273,46955,844,989,253,2086,49041
16-03-2019,21,12970,19538,7645,5424,45577,845,984,263,2092,47669
16-03-2019,22,12628,18645,7377,5132,43781,835,926,251,2012,45793
16-03-2019,23,11829,17535,7156,4929,41450,834,545,234,1613,43063
17-03-2019,0,11755,16628,7011,4560,39953,830,533,247,1610,41563
17-03-2019,1,11405,16366,6954,4447,39173,810,529,248,1587,40760
17-03-2019,2,11338,16238,6894,4440,38910,811,528,262,1601,40511
17-03-2019,3,11286,16362,6823,4216,38688,806,537,291,1634,40322
17-03-2019,4,11479,16730,6896,4485,39591,802,633,331,1766,41357
17-03-2019,5,11553,16795,6836,4293,39479,812,831,362,2005,41484
17-03-2019,6,11714,16923,6951,4229,39816,716,884,413,2013,41829
17-03-2019,7,11911,17488,6999,4337,40736,821,988,480,2289,43025
17-03-2019,8,12581,18780,7036,4568,42965,851,1082,485,2418,45383
17-03-2019,9,13026,19827,7227,5006,45086,856,1071,538,2465,47551
17-03-2019,10,13121,20234,7379,5339,46072,865,1073,517,2455,48527
17-03-2019,11,12988,20065,7340,5285,45679,882,1076,494,2452,48131
17-03-2019,12,12757,19783,7377,5008,44926,871,1082,500,2453,47379
17-03-2019,13,12820,19717,7368,5235,45141,878,1084,459,2421,47562
17-03-2019,14,12536,19562,7373,4887,44358,909,1091,451,2451,46809
17-03-2019,15,12405,19665,7532,4927,44529,934,1094,430,2458,46987
17-03-2019,16,12733,20002,7758,5671,46166,1003,1092,449,2544,48710
17-03-2019,17,13470,20940,7984,6051,48447,1025,1095,501,2621,51068
17-03-2019,18,13985,21940,8334,6289,50548,1028,1093,501,2622,53170
17-03-2019,19,14853,21821,8441,6463,51578,1021,1078,497,2596,54174
17-03-2019,20,14507,20872,8235,6322,49935,984,1072,494,2550,52485
17-03-2019,21,13831,19853,8155,6235,48076,965,1013,434,2412,50488
17-03-2019,22,13204,19047,8061,6114,46426,944,634,316,1894,48320
17-03-2019,23,12634,18176,7924,5874,44608,820,593,277,1690,46298
18-03-2019,0,11958,17237,7969,5131,,815,540,300,1655,
18-03-2019,1,11680,17015,7919,4623,41237,820,542,390,1752,42989
18-03-2019,2,11774,16713,7849,4715,41052,815,540,387,1742,42794
18-03-2019,3,11731,16643,7772,4856,41001,813,538,391,1742,42743
18-03-2019,4,11846,17585,7908,4796,42135,939,634,381,1954,44089
18-03-2019,5,13469,19448,8319,4867,46105,929,670,394,1993,48098
18-03-2019,6,16497,21476,8358,4990,51321,937,803,417,2157,53478
18-03-2019,7,20378,23497,8453,4814,57141,977,908,526,2411,59552
18-03-2019,8,19049,23078,8432,5580,56140,989,1054,738,2781,58921
18-03-2019,9,17282,22854,8405,6323,54865,1022,1040,763,2825,57690
18-03-2019,10,17028,22887,8311,5927,54153,1026,1012,816,2854,57007
18-03-2019,11,16078,22447,8220,5783,52530,1020,1095,679,2794,55324
18-03-2019,12,16107,22594,8091,5693,52486,1026,1129,656,2811,55297
18-03-2019,13,16004,22396,8010,5582,51994,1035,1114,639,2788,54782
18-03-2019,14,15794,22337,7912,5501,51546,1052,1125,662,2839,54385
18-03-2019,15,15980,22659,7930,5401,51971,1054,1128,704,2886,54857
18-03-2019,16,15971,22572,7881,5162,51585,1051,1131,706,2888,54473
18-03-2019,17,17825,22998,8011,5201,54034,1074,1134,830,3038,57072
18-03-2019,18,19957,23728,8108,5010,56805,1079,1211,900,3190,59995
18-03-2019,19,20394,24086,7990,4059,56530,990,879,769,2638,59168
18-03-2019,20,19038,23572,7773,3972,54355,978,862,664,2504,56859
18-03-2019,21,16957,23099,7665,4247,51967,989,855,611,2455,54422
18-03-2019,22,14808,21977,7374,3769,47927,970,795,537,2302,50229
18-03-2019,23,13293,19786,7006,3287,43372,978,699,537,2214,45586
19-03-2019,0,12505,18674,6978,2933,41091,958,783,514,2255,43346
19-03-2019,1,12174,18453,7009,2724,40360,949,782,496,2227,42587
19-03-2019,2,12094,18335,6956,2889,40276,940,780,457,2177,42453
19-03-2019,3,12287,18457,7089,2651,40484,930,787,423,2140,42624
19-03-2019,4,12930,18806,7344,2579,41659,919,773,429,2121,43780
19-03-2019,5,14947,20033,7915,2565,45462,902,820,426,2148,47610
19-03-2019,6,19435,22317,8266,2959,52977,979,976,451,2406,55383
19-03-2019,7,21102,22785,8602,3369,55858,984,1143,818,2945,58803
19-03-2019,8,21155,22369,8802,3544,55870,953,1244,785,2982,58852
19-03-2019,9,20683,21635,8716,3343,54377,943,1075,638,2656,57033
19-03-2019,10,19982,21061,8297,3297,52638,927,1081,626,2634,55272
19-03-2019,11,19073,20706,8191,3344,51314,905,1233,564,2702,54016
19-03-2019,12,18579,20408,8031,3318,50336,908,1259,588,2755,53091
19-03-2019,13,18243,20166,8037,3322,49769,880,1227,567,2674,52443
19-03-2019,14,17277,19884,7994,3310,48466,893,1223,533,2649,51115
19-03-2019,15,17610,19866,8062,3205,48744,909,1234,483,2626,51370
19-03-2019,16,19606,19986,8162,3038,50792,901,1218,446,2565,53357
19-03-2019,17,21879,20505,8489,3048,53919,948,1238,599,2785,56704
19-03-2019,18,22721,20926,8637,3331,55615,969,1368,776,3113,58728
19-03-2019,19,22819,21266,8674,3541,56301,955,1414,767,3136,59437
19-03-2019,20,21857,20979,8223,3531,54591,942,1228,381,2551,57142
19-03-2019,21,20018,20950,7825,3342,52134,929,962,337,2228,54362
19-03-2019,22,17656,20811,7612,3434,49514,891,966,263,2120,51634
19-03-2019,23,14381,19783,7441,3484,45091,887,848,260,1995,47086
20-03-2019,0,12805,18435,7389,3521,42152,879,618,249,1746,43898
20-03-2019,1,11617,18154,7332,3709,40813,884,616,266,1766,42579
20-03-2019,2,11062,18221,7290,3900,40473,897,617,265,1779,42252
20-03-2019,3,11021,18484,7494,4153,41152,882,617,261,1760,42912
20-03-2019,4,11721,18782,7791,4413,42708,900,619,259,1778,44486
20-03-2019,5,13396,20086,8294,4633,46410,897,633,404,1934,48344
20-03-2019,6,16644,22081,8685,5052,52463,880,909,403,2192,54655
20-03-2019,7,19515,23947,8978,4378,56819,912,897,416,2225,59044
20-03-2019,8,19283,23805,9024,4458,56571,948,898,405,2251,58822
20-03-2019,9,17439,23307,8632,4544,53923,946,914,361,2221,56144
20-03-2019,10,16708,23066,8702,4487,52964,977,1015,453,2445,55409
20-03-2019,11,16016,22696,8521,4551,51784,970,938,513,2421,54205
20-03-2019,12,15156,22366,8339,4544,50406,957,940,595,2492,52898
20-03-2019,13,14737,22202,8320,4375,49635,972,1006,618,2596,52231
20-03-2019,14,14434,22031,8302,4161,48929,946,1219,616,2781,51710
20-03-2019,15,14849,21980,8284,4135,49249,965,1258,613,2836,52085
20-03-2019,16,16671,22457,8399,4003,51531,925,1038,627,2590,54121
20-03-2019,17,19208,23166,8639,3734,54748,985,1035,640,2660,57408
20-03-2019,18,21118,23433,8882,3869,57303,991,1117,743,2851,60154
20-03-2019,19,20541,23194,8776,3784,56295,944,1109,676,2729,59024
20-03-2019,20,19005,22802,8633,3648,54087,904,1003,639,2546,56633
20-03-2019,21,17417,22226,8545,3359,51547,858,891,596,2345,53892
20-03-2019,22,15199,21154,8390,3250,47994,872,809,477,2158,50152
20-03-2019,23,13034,19277,8027,3161,43498,863,682,378,1923,45421
21-03-2019,0,11193,17552,7768,3270,39784,860,843,312,2015,41799
21-03-2019,1,10671,17090,7600,3580,38941,865,850,281,1996,40937
21-03-2019,2,10537,16841,7500,3781,38658,739,850,273,1862,40520
21-03-2019,3,10498,16871,7510,4010,38890,697,849,254,1800,40690
21-03-2019,4,10669,17240,7610,4260,39780,778,846,241,1865,41645
21-03-2019,5,12390,18681,7913,4553,43538,816,985,243,2044,45582
21-03-2019,6,15632,21101,8374,4524,49631,808,1041,348,2197,51828
21-03-2019,7,18244,22908,8716,4553,54421,820,1214,392,2426,56847
21-03-2019,8,18384,23179,8736,4783,55082,825,1222,546,2593,57675
21-03-2019,9,15833,23115,8454,5389,52794,826,1224,440,2490,55284
21-03-2019,10,13965,22874,8436,5283,50559,834,1147,471,2452,53011
21-03-2019,11,13202,22522,8329,5312,49366,869,1063,471,2403,51769
21-03-2019,12,12911,22304,8374,5297,48886,872,1077,464,2413,51299
21-03-2019,13,12513,22279,8289,5153,48235,853,970,564,2387,50622
21-03-2019,14,12522,22388,8432,5076,48420,849,975,608,2432,50852
21-03-2019,15,12666,22419,8513,4931,48529,849,972,610,2431,50960
21-03-2019,16,13930,22575,8709,4568,49783,851,969,702,2522,52305
21-03-2019,17,16020,23694,9069,4514,53297,861,967,686,2514,55811
21-03-2019,18,17666,24101,9159,4482,55409,875,984,681,2540,57949
21-03-2019,19,17718,23965,9171,4127,54982,859,982,672,2513,57495
21-03-2019,20,16943,23226,9087,3695,52952,869,982,656,2507,55459
21-03-2019,21,15989,22205,9126,3581,50902,848,966,589,2403,53305
21-03-2019,22,14966,20471,8759,3201,47398,898,927,601,2426,49824
21-03-2019,23,13566,18921,8500,2413,43398,935,905,592,2432,45830
22-03-2019,0,12147,18265,8584,2014,41011,969,735,533,2237,43248
22-03-2019,1,11492,17848,8635,1826,39803,980,731,473,2184,41987
22-03-2019,2,11666,17615,8666,1611,39558,986,721,455,2162,41720
22-03-2019,3,11719,17547,8839,1486,39592,979,720,405,2104,41696
22-03-2019,4,12918,17890,9094,1468,41370,981,734,312,2027,43397
22-03-2019,5,15555,18635,9538,1642,45370,988,1115,360,2463,47833
22-03-2019,6,19852,20976,9900,2631,53359,988,1148,420,2556,55915
22-03-2019,7,22202,21748,10054,2964,56968,973,1151,599,2723,59691
22-03-2019,8,21995,21493,9746,3290,56523,962,1149,706,2817,59340
22-03-2019,9,21127,21206,9354,3304,54991,909,1142,428,2479,57470
22-03-2019,10,19342,20699,8947,3052,52040,932,1127,461,2520,54560
22-03-2019,11,17356,20549,8591,2932,49429,923,1132,440,2495,51924
22-03-2019,12,16231,20946,8279,3189,48646,889,1131,465,2485,51131
22-03-2019,13,15149,20817,8148,3278,47392,938,1124,392,2454,49846
22-03-2019,14,14898,20944,8039,3275,47157,965,1129,375,2469,49626
22-03-2019,15,14609,21457,7838,3413,47317,951,1126,387,2464,49781
22-03-2019,16,15376,22321,8118,3622,49436,919,1126,340,2385,51821
22-03-2019,17,17435,23118,8858,4012,53424,895,1128,307,2330,55754
22-03-2019,18,18468,23416,9540,4396,55820,874,1144,302,2320,58140
22-03-2019,19,17087,23503,9515,4312,54418,851,1145,293,2289,56707
22-03-2019,20,15609,22893,9350,4108,51961,803,1089,271,2163,54124
22-03-2019,21,13918,21853,9092,4132,48995,800,906,197,1903,50898
22-03-2019,22,12995,21041,8788,4050,46875,793,749,192,1734,48609
22-03-2019,23,11862,20129,8682,3985,44657,657,540,200,1397,46054
23-03-2019,0,11177,19197,8670,3809,42852,659,506,236,1401,44253
23-03-2019,1,11049,18571,8718,3915,42254,671,496,286,1453,43707
23-03-2019,2,11011,18323,8669,3651,41655,679,415,348,1442,43097
23-03-2019,3,11027,18163,8706,3461,41358,726,424,417,1567,42925
23-03-2019,4,11054,18113,8757,3172,41095,785,407,427,1619,42714
23-03-2019,5,11202,18482,8860,3082,41627,811,545,488,1844,43471
23-03-2019,6,11430,18630,8877,3129,42065,829,860,530,2219,44284
23-03-2019,7,12662,19425,9005,3203,44295,930,946,539,2415,46710
23-03-2019,8,13567,20911,9121,3310,46908,946,950,479,2375,49283
23-03-2019,9,13572,21302,9122,3578,47574,971,946,467,2384,49958
23-03-2019,10,13150,20099,8877,3904,46030,964,956,476,2396,48426
23-03-2019,11,12804,19327,8668,4331,45131,897,880,516,2293,47424
23-03-2019,12,12540,19329,8650,4704,45223,865,877,540,2282,47505
23-03-2019,13,12643,19185,8300,4884,45012,859,881,481,2221,47233
23-03-2019,14,12379,19130,8336,4950,44796,854,881,409,2144,46940
23-03-2019,15,12091,19385,8548,4947,44974,840,873,376,2089,47063
23-03-2019,16,12470,19832,8760,4748,45811,869,878,408,2155,47966
23-03-2019,17,12940,21395,8936,4669,47939,961,953,456,2370,50309
23-03-2019,18,14539,22838,9165,4604,51149,948,948,491,2387,53536
23-03-2019,19,15380,23242,9285,4304,52211,937,948,500,2385,54596
23-03-2019,20,14752,22175,9443,4006,50377,917,959,492,2368,52745
23-03-2019,21,13544,21073,9290,3710,47616,813,701,463,1977,49593
23-03-2019,22,13092,20286,9075,3520,45973,849,510,453,1812,47785
23-03-2019,23,12647,19635,8870,3440,44591,852,447,452,1751,46342
24-03-2019,0,11763,18294,8617,3284,41959,820,410,470,1700,43659
24-03-2019,1,10787,17977,8449,3085,40300,823,407,479,1709,42009
24-03-2019,2,10577,17895,8505,2821,39799,835,426,439,1700,41499
24-03-2019,3,10767,17801,8578,2678,39827,829,513,444,1786,41613
24-03-2019,4,10819,17931,8679,2611,40042,822,621,446,1889,41931
24-03-2019,5,10887,18102,8692,2611,40294,819,670,439,1928,42222
24-03-2019,6,10762,18177,8751,2688,40378,807,801,422,2030,42408
24-03-2019,7,11233,18552,8792,2839,41415,809,808,454,2071,43486
24-03-2019,8,11627,18986,8880,2951,42443,825,813,427,2065,44508
24-03-2019,9,11728,19135,8845,3353,43061,830,904,397,2131,45192
24-03-2019,10,11663,18668,8646,3865,42843,843,823,447,2113,44956
24-03-2019,11,11577,18667,8505,4190,42939,846,741,434,2021,44960
24-03-2019,12,11491,18610,8432,4672,43205,851,758,389,1998,45203
24-03-2019,13,11410,18211,8282,4937,42842,854,876,350,2080,44922
24-03-2019,14,11514,17741,8139,4835,42231,843,878,354,2075,44306
24-03-2019,15,11972,17868,8087,4841,42769,818,878,334,2030,44799
24-03-2019,16,12282,18355,8280,4790,43707,804,881,310,1995,45702
24-03-2019,17,12233,19330,8745,4895,45202,789,1080,328,2197,47399
24-03-2019,18,13951,21400,9073,5187,49610,791,1160,454,2405,52015
24-03-2019,19,15419,22352,9159,5304,52235,786,1170,433,2389,54624
24-03-2019,20,13693,21502,9075,5052,49322,773,1171,342,2286,51608
24-03-2019,21,12797,19668,8714,4758,45937,780,1165,352,2297,48234
24-03-2019,22,12668,18585,8289,4503,44046,751,1116,315,2182,46228
24-03-2019,23,12032,17703,8035,3976,41747,737,807,319,1863,43610
25-03-2019,0,11233,16901,7901,3681,39715,752,527,288,1567,41282
25-03-2019,1,10989,16699,7769,3478,38936,720,423,266,1409,40345
25-03-2019,2,11077,16610,7661,3523,38870,708,425,261,1394,40264
25-03-2019,3,11227,16838,7754,3411,39232,702,434,267,1403,40635
25-03-2019,4,11222,17475,8005,3474,40174,694,651,245,1590,41764
25-03-2019,5,12490,18782,8480,3656,43408,763,942,267,1972,45380
25-03-2019,6,14878,20689,8789,3801,48158,825,1037,316,2178,50336
25-03-2019,7,17750,21854,8862,4164,52629,812,1121,318,2251,54880
25-03-2019,8,18299,22309,8839,4489,53936,815,1309,302,2426,56362
25-03-2019,9,17402,21808,8585,4585,52381,819,1435,301,2555,54936
25-03-2019,10,16420,21601,8557,4824,51402,811,1459,309,2579,53981
25-03-2019,11,15845,21451,8554,4825,50675,799,1434,293,2526,53201
25-03-2019,12,15189,21340,8720,4831,50081,827,1467,311,2605,52686
25-03-2019,13,14721,21079,8772,4818,49390,835,1452,288,2575,51965
25-03-2019,14,14371,20810,8626,4484,48292,842,1471,313,2626,50918
25-03-2019,15,14462,20878,8472,4059,47872,897,1356,371,2624,50496
25-03-2019,16,15160,20772,8391,3604,47928,912,1207,423,2542,50470
25-03-2019,17,16623,21281,8315,3530,49751,906,1264,410,2580,52331
25-03-2019,18,18658,21892,8543,3507,52598,902,1285,611,2798,55396
25-03-2019,19,19407,21907,8502,3988,53806,910,1261,454,2625,56431
25-03-2019,20,18173,21524,8386,4020,52105,880,1041,432,2353,54458
25-03-2019,21,15909,20605,8036,4132,48683,917,975,436,2328,51011
25-03-2019,22,15106,19973,7891,4361,47331,875,898,438,2211,49542
25-03-2019,23,13117,18552,7511,4314,43494,883,587,349,1819,45313
26-03-2019,0,12633,17946,7280,4375,42234,691,588,363,1642,43876
26-03-2019,1,12335,17797,7219,4487,41839,670,418,381,1469,43308
26-03-2019,2,12172,17987,7313,4681,42152,664,413,383,1460,43612
26-03-2019,3,12115,18169,7422,4688,42396,677,419,386,1482,43878
26-03-2019,4,12370,18255,7584,4874,43084,694,514,386,1594,44678
26-03-2019,5,13043,19143,8182,5022,45390,771,811,436,2018,47408
26-03-2019,6,15168,21276,8563,5341,50348,805,1095,495,2395,52743
26-03-2019,7,18251,23198,8562,5108,55120,823,1159,692,2674,57794
26-03-2019,8,18092,22929,8412,5812,55246,891,1164,651,2706,57952
26-03-2019,9,16864,22264,8235,5749,53112,773,1248,663,2684,55796
26-03-2019,10,17007,21475,8106,5590,52177,790,1260,508,2558,54735
26-03-2019,11,16484,21103,8097,5251,50935,831,1404,523,2758,53693
26-03-2019,12,15908,20675,8174,4715,49471,841,1494,563,2898,52369
26-03-2019,13,15660,20305,8178,4383,48527,824,1505,611,2940,51467
26-03-2019,14,15753,20250,8067,4026,48096,785,1496,615,2896,50992
26-03-2019,15,15898,20172,8219,3561,47851,820,1480,599,2899,50750
26-03-2019,16,16488,20308,8198,3261,48254,797,1488,570,2855,51109
26-03-2019,17,17910,20737,8332,3206,50184,796,1490,724,3010,53194
26-03-2019,18,19458,21242,8606,3423,52729,845,1615,717,3177,55906
26-03-2019,19,20009,21583,8687,3388,53667,845,1583,693,3121,56788
26-03-2019,20,19449,21185,8460,3488,52583,832,1477,720,3029,55612
26-03-2019,21,18656,21087,8070,3448,51261,826,1397,439,2662,53923
26-03-2019,22,16432,20575,8034,3547,48587,808,1128,375,2311,50898
26-03-2019,23,13630,19079,7680,3471,43859,819,762,353,1934,45793
27-03-2019,0,12136,18116,7371,3531,41155,806,778,337,1921,43076
27-03-2019,1,11600,17794,7412,3730,40537,803,676,335,1814,42351
27-03-2019,2,11308,17526,7464,3811,40109,774,676,294,1744,41853
27-03-2019,3,11717,17983,7790,3811,41302,759,674,256,1689,42991
27-03-2019,4,11902,18265,8137,3896,42202,759,773,267,1799,44001
27-03-2019,5,13218,19736,8732,4135,45820,791,993,274,2058,47878
27-03-2019,6,16276,21713,9166,4944,52099,797,1311,324,2432,54531
27-03-2019,7,18968,22479,9382,5346,56174,838,1466,518,2822,58996
27-03-2019,8,19389,22846,9312,5367,56916,931,1543,492,2966,59882
27-03-2019,9,18930,22487,9184,5259,55861,790,1564,465,2819,58680
27-03-2019,10,18014,21957,9031,4894,53895,779,1527,367,2673,56568
27-03-2019,11,16399,21675,8765,5158,51997,764,1559,362,2685,54682
27-03-2019,12,15563,21730,8544,4866,50703,791,1467,414,2672,53375
27-03-2019,13,14802,21173,8465,4702,49143,785,1474,352,2611,51754
27-03-2019,14,14412,20504,8314,4697,47927,812,1473,317,2602,50529
27-03-2019,15,14604,20556,8377,4590,48127,784,1416,292,2492,50619
27-03-2019,16,15448,20691,8526,4528,49192,790,1356,315,2461,51653
27-03-2019,17,17500,21183,8619,4556,51857,807,1363,326,2496,54353
27-03-2019,18,18842,21411,8707,4476,53436,814,1614,584,3012,56448
27-03-2019,19,19282,21433,8620,4722,54056,810,1217,479,2506,56562
27-03-2019,20,18418,21423,8457,4262,52560,807,1208,324,2339,54899
27-03-2019,21,16583,21002,8225,3876,49685,815,1115,226,2156,51841
27-03-2019,22,15300,20181,8008,3604,47093,835,1037,250,2122,49215
27-03-2019,23,12938,18813,7634,3362,42748,819,767,199,1785,44533
28-03-2019,0,12823,17981,7338,3171,41314,744,880,196,1820,43134
28-03-2019,1,12161,17809,7146,3153,40269,689,825,195,1709,41978
28-03-2019,2,11955,17989,7248,3036,40228,767,826,199,1792,42020
28-03-2019,3,11799,18394,7690,2921,40806,723,720,208,1651,42457
28-03-2019,4,11871,18957,7950,2920,41699,680,994,199,1873,43572
28-03-2019,5,13647,20411,8568,2906,45533,767,1343,219,2329,47862
28-03-2019,6,16195,22288,8911,3286,50681,791,1429,449,2669,53350
28-03-2019,7,18397,23080,8981,3585,54044,814,1501,521,2836,56880
28-03-2019,8,18654,23048,9082,3482,54265,829,1572,476,2877,57142
28-03-2019,9,18134,22668,8927,3478,53207,836,1548,467,2851,56058
28-03-2019,10,17798,22543,8905,3617,52862,846,1543,385,2774,55636
28-03-2019,11,17345,22478,8700,3742,52265,848,1533,303,2684,54949
28-03-2019,12,16612,22339,8478,3783,51212,865,1500,294,2659,53871
28-03-2019,13,15871,22180,8352,3796,50199,854,1484,270,2608,52807
28-03-2019,14,15685,22218,8366,3860,50131,867,1242,278,2387,52518
28-03-2019,15,15416,22614,8425,3909,50363,887,1201,292,2380,52743
28-03-2019,16,15823,22955,8449,3796,51024,882,1229,268,2379,53403
28-03-2019,17,15833,23080,8591,3710,51214,869,1250,290,2409,53623
28-03-2019,18,15957,23309,8889,3624,51780,910,1264,416,2590,54370
28-03-2019,19,16176,23276,8678,3806,51938,931,1238,380,2549,54487
28-03-2019,20,15907,22062,8367,3709,50045,796,1105,394,2295,52340
28-03-2019,21,15699,21241,8076,3684,48701,771,964,376,2111,50812
28-03-2019,22,14476,20307,7988,3830,46602,749,722,395,1866,48468
28-03-2019,23,13136,19481,7815,3616,44048,762,619,432,1813,45861
29-03-2019,0,11926,18394,7655,3614,41589,757,215,460,1432,43021
29-03-2019,1,10672,18206,7571,3561,40009,720,185,484,1389,41398
29-03-2019,2,10285,18140,7576,3625,39625,715,202,466,1383,41008
29-03-2019,3,10714,18573,7683,3589,40561,786,229,458,1473,42034
29-03-2019,4,11102,18753,7633,4008,41497,768,206,463,1437,42934
29-03-2019,5,12204,19937,7834,4518,44493,793,701,451,1945,46438
29-03-2019,6,14590,21908,8210,4954,49664,772,1112,532,2416,52080
29-03-2019,7,16245,23461,8470,5313,53488,879,1250,569,2698,56186
29-03-2019,8,16172,23759,8367,5711,54011,918,1224,631,2773,56784
29-03-2019,9,15299,23579,8127,6083,53087,868,1231,666,2765,55852
29-03-2019,10,14099,23343,8065,6154,51661,873,1184,682,2739,54400
29-03-2019,11,13213,22588,7821,5927,49549,843,1124,708,2675,52224
29-03-2019,12,13192,21937,7885,5765,48778,862,1125,713,2700,51478
29-03-2019,13,13015,21630,7934,5634,48212,842,1142,728,2712,50924
29-03-2019,14,12980,21643,7958,5441,48022,830,1057,715,2602,50624
29-03-2019,15,13237,21601,8053,5202,48096,817,1040,698,2555,50651
29-03-2019,16,13912,21896,8177,4886,48872,814,1038,685,2537,51409
29-03-2019,17,14588,22467,8237,4626,49917,790,1056,673,2519,52436
29-03-2019,18,14866,23409,8449,4243,50968,797,1255,687,2739,53707
29-03-2019,19,14770,23268,8550,4104,50691,779,1173,679,2631,53322
29-03-2019,20,14075,22168,8334,3907,48484,757,1043,596,2396,50880
29-03-2019,21,14041,21448,8214,3565,47268,734,789,636,2159,49427
29-03-2019,22,13590,20355,7857,3412,45216,746,651,589,1986,47202
29-03-2019,23,12558,19552,7620,3169,42900,764,532,526,1822,44722
30-03-2019,0,12102,19182,7590,2914,41788,779,251,536,1566,43354
30-03-2019,1,11703,19046,7580,2638,40967,772,250,511,1533,42500
30-03-2019,2,11429,19121,7603,2380,40534,762,250,472,1484,42018
30-03-2019,3,11455,19190,7810,2233,40688,744,253,433,1430,42118
30-03-2019,4,11475,19215,7906,2226,40822,754,244,466,1464,42286
30-03-2019,5,11409,19090,7721,2274,40494,749,368,453,1570,42064
30-03-2019,6,11672,18898,7734,2375,40679,779,634,434,1847,42526
30-03-2019,7,12175,19278,7782,2531,41765,765,742,506,2013,43778
30-03-2019,8,12589,19609,7909,2825,42934,716,728,529,1973,44907
30-03-2019,9,12414,19375,7892,3215,42897,687,891,565,2143,45040
30-03-2019,10,12357,18614,7855,3445,42272,687,880,538,2105,44377
30-03-2019,11,12141,18339,7624,3742,41845,681,884,603,2168,44013
30-03-2019,12,12225,17970,7549,4086,41831,687,838,599,2124,43955
30-03-2019,13,12199,17565,7382,4070,41216,682,817,576,2075,43291
30-03-2019,14,12266,17410,7441,3820,40936,682,858,565,2105,43041
30-03-2019,15,12445,17944,7502,3843,41734,670,868,526,2064,43798
30-03-2019,16,12749,18769,7657,3982,43158,658,957,435,2050,45208
30-03-2019,17,13753,21445,8023,4182,47403,697,1112,450,2259,49662
30-03-2019,18,14754,22306,8065,4391,49516,723,1104,454,2281,51797
30-03-2019,19,15032,22283,8068,4581,49964,746,1106,478,2330,52294
30-03-2019,20,14602,21209,7804,4451,48066,774,1104,527,2405,50471
30-03-2019,21,14185,20574,7475,4267,46501,787,1018,490,2295,48796
30-03-2019,22,13810,19583,7277,4214,44883,741,673,494,1908,46791
30-03-2019,23,12779,18617,6947,4187,42532,749,336,512,1597,44129
31-03-2019,0,12759,17812,7011,4134,41716,784,254,542,1580,43296
31-03-2019,1,12029,17522,6952,4074,40579,763,294,570,1627,42206
31-03-2019,2,,,,,,762,,,,
31-03-2019,3,12475,17791,6829,4233,41328,783,294,589,1666,42994
31-03-2019,4,12125,17881,6798,4195,40999,780,276,592,1648,42647
31-03-2019,5,12056,17935,6956,3966,40915,809,466,588,1863,42778
31-03-2019,6,11639,18070,7016,4190,40917,792,470,541,1803,42720
31-03-2019,7,11417,18631,7143,4336,41528,756,468,564,1788,43316
31-03-2019,8,11651,19361,7035,4795,42841,731,710,574,2015,44856
31-03-2019,9,11778,19090,6838,5417,43123,778,900,633,2311,45434
31-03-2019,10,11705,18877,6839,5468,42889,824,982,641,2447,45336
31-03-2019,11,11716,18933,6930,5059,42638,749,975,676,2400,45038
31-03-2019,12,11906,18720,6960,4850,42438,758,977,729,2464,44902
31-03-2019,13,11281,18239,6789,4419,40728,758,885,724,2367,43095
31-03-2019,14,11430,18198,6747,3985,40359,776,866,671,2313,42672
31-03-2019,15,11452,17953,6609,3710,39724,769,852,647,2268,41992
31-03-2019,16,11520,18036,6697,3409,39662,783,846,611,2240,41902
31-03-2019,17,11829,18487,7023,3137,40478,793,965,578,2336,42814
31-03-2019,18,12000,20377,7323,2813,42513,794,970,511,2275,44788
31-03-2019,19,14307,22327,7747,2544,46925,801,959,541,2301,49226
31-03-2019,20,15813,23211,8113,2358,49495,826,963,407,2196,51691
31-03-2019,21,14660,22668,8212,2234,47773,824,967,403,2194,49967
31-03-2019,22,14192,22233,8140,2151,46716,843,846,322,2011,48727
31-03-2019,23,12966,20856,7978,1895,43693,793,644,309,1746,45439
01-04-2019,0,11762,18705,7916,1471,39854,755,540,288,1583,41437
01-04-2019,1,11731,18110,7912,1222,38975,762,534,290,1586,40561
01-04-2019,2,11818,17779,7855,1154,38606,761,534,334,1629,40235
01-04-2019,3,11852,17853,7847,1154,38705,748,536,374,1658,40363
01-04-2019,4,11951,18688,7835,1180,39655,744,597,397,1738,41393
01-04-2019,5,14218,20503,8369,1482,44572,865,811,412,2088,46660
01-04-2019,6,19433,22531,8801,1886,52651,918,1163,817,2898,55549
01-04-2019,7,22141,22997,8930,2280,56349,1083,1281,675,3039,59388
01-04-2019,8,22120,22799,8700,2456,56075,1085,1291,531,2907,58982
01-04-2019,9,21005,22942,8568,2474,54988,942,1212,661,2815,57803
01-04-2019,10,18928,22830,8393,2561,52713,945,1259,537,2741,55454
01-04-2019,11,16925,22285,8405,2672,50288,944,1067,631,2642,52930
01-04-2019,12,15024,21758,8342,2771,47897,947,1079,684,2710,50607
01-04-2019,13,14594,21729,8375,2739,47438,977,1083,549,2609,50047
01-04-2019,14,13754,21270,8287,2801,46112,828,1009,344,2181,48293
01-04-2019,15,13449,21186,8296,2782,45714,840,1018,351,2209,47923
01-04-2019,16,13982,21454,8278,2622,46337,952,1045,487,2484,48821
01-04-2019,17,15056,21755,8405,2541,47758,943,1003,472,2418,50176
01-04-2019,18,17605,22551,8496,2710,51364,958,907,579,2444,53808
01-04-2019,19,18688,22926,8730,2949,53294,975,1037,914,2926,56220
01-04-2019,20,18423,22855,8824,3086,53189,914,971,523,2408,55597
01-04-2019,21,16001,22108,8740,3177,50026,848,935,246,2029,52055
01-04-2019,22,13689,21138,8456,3222,46506,812,924,225,1961,48467
01-04-2019,23,12507,19474,8054,3377,43413,719,762,228,1709,45122
02-04-2019,0,11742,17429,7758,3351,40281,691,231,224,1146,41427
02-04-2019,1,11264,17171,7552,3466,39452,695,224,248,1167,40619
02-04-2019,2,10833,17034,7503,3656,39027,704,229,309,1242,40269
02-04-2019,3,11014,17319,7434,3750,39518,710,234,342,1286,40804
02-04-2019,4,11101,17663,7494,3910,40167,716,237,369,1322,41489
02-04-2019,5,11586,19029,7973,4161,42747,735,566,398,1699,44446
02-04-2019,6,15100,21573,8771,4250,49694,867,843,428,2138,51832
02-04-2019,7,18642,22554,9034,4055,54285,862,1111,639,2612,56897
02-04-2019,8,19331,22775,8581,4379,55066,899,1219,576,2694,57760
02-04-2019,9,17488,22692,7795,5517,53493,899,1214,528,2641,56134
02-04-2019,10,15345,22355,7712,5606,51017,845,1093,568,2506,53523
02-04-2019,11,14016,21636,7888,5686,49226,814,1027,596,2437,51663
02-04-2019,12,14081,21279,7849,5766,48976,786,928,643,2357,51333
02-04-2019,13,13736,21000,7809,5770,48314,763,902,702,2367,50681
02-04-2019,14,13012,20397,7819,5480,46710,704,814,521,2039,48749
02-04-2019,15,12584,20309,7979,5368,46240,711,856,577,2144,48384
02-04-2019,16,12737,20349,7922,5365,46375,820,848,821,2489,48864
02-04-2019,17,12925,20855,8080,5542,47403,809,921,660,2390,49793
02-04-2019,18,14245,22176,8283,4629,49332,838,924,740,2502,51834
02-04-2019,19,15252,22423,8651,4463,50789,822,948,724,2494,53283
02-04-2019,20,15044,22410,8585,4507,50547,865,851,582,2298,52845
02-04-2019,21,14057,21314,8390,4288,48049,835,809,568,2212,50261
02-04-2019,22,13026,19756,8119,3685,44586,752,666,588,2006,46592
02-04-2019,23,12431,18463,7868,3459,42222,755,580,598,1933,44155
03-04-2019,0,11998,17613,7683,3263,40556,757,275,595,1627,42183
03-04-2019,1,11649,17138,7718,3471,39977,782,266,587,1635,41612
03-04-2019,2,11398,17171,7720,3800,40090,795,272,583,1650,41740
03-04-2019,3,11671,17319,7773,3598,40361,817,269,603,1689,42050
03-04-2019,4,11953,18109,8016,3326,41405,817,277,615,1709,43114
03-04-2019,5,13490,19523,8345,3247,44607,861,571,619,2051,46658
03-04-2019,6,18137,21166,8682,3259,51243,950,893,655,2498,53741
03-04-2019,7,20416,22056,8781,2947,54201,930,1037,698,2665,56866
03-04-2019,8,21138,22207,8661,2873,54880,915,1149,691,2755,57635
03-04-2019,9,20781,21881,8353,3197,54211,887,1097,712,2696,56907
03-04-2019,10,20730,21444,8165,2997,53336,897,1006,734,2637,55973
03-04-2019,11,20342,20871,7883,2939,52036,940,1116,727,2783,54819
03-04-2019,12,19389,20443,7848,2534,50214,917,1112,736,2765,52979
03-04-2019,13,18749,20444,7957,2505,49655,923,1032,720,2675,52330
03-04-2019,14,18141,20417,7981,2476,49014,918,908,684,2510,51524
03-04-2019,15,17688,20494,7985,2581,48749,910,919,717,2546,51295
03-04-2019,16,17969,20843,7946,2671,49431,904,899,719,2522,51953
03-04-2019,17,18594,21131,8012,2815,50551,899,898,662,2459,53010
03-04-2019,18,18607,21146,8002,3112,50867,887,905,612,2404,53271
03-04-2019,19,18732,21458,8067,3659,51918,912,986,587,2485,54403
03-04-2019,20,18244,21481,8153,3784,51661,936,809,561,2306,53967
03-04-2019,21,16693,20859,8261,3325,49137,963,803,539,2305,51442
03-04-2019,22,14351,19348,7989,3141,44829,920,671,569,2160,46989
03-04-2019,23,12542,17977,7811,2927,41258,834,617,585,2036,43294
04-04-2019,0,11954,16916,7608,2915,39392,839,337,586,1762,41154
04-04-2019,1,11891,16454,7578,2995,38918,828,257,581,1666,40584
04-04-2019,2,11825,16369,7532,3000,38725,814,261,594,1669,40394
04-04-2019,3,11795,16479,7453,3088,38814,795,264,600,1659,40473
04-04-2019,4,12044,17121,7597,3256,40018,783,340,601,1724,41742
04-04-2019,5,13797,18405,7957,3350,43510,875,753,636,2264,45774
04-04-2019,6,17645,20251,8378,3741,50015,906,1074,627,2607,52622
04-04-2019,7,20195,21202,8452,4000,53848,883,1125,653,2661,56509
04-04-2019,8,20420,21826,8485,4172,54903,895,1144,617,2656,57559
04-04-2019,9,19957,21215,8264,4068,53505,657,1447,667,2771,56276
04-04-2019,10,20087,20735,8012,4028,52863,678,1476,746,2900,55763
04-04-2019,11,19782,20191,7786,4148,51908,781,1254,745,2780,54688
04-04-2019,12,19392,20111,7602,4191,51297,751,1287,737,2775,54072
04-04-2019,13,18629,19989,7552,4065,50235,722,1217,716,2655,52890
04-04-2019,14,17175,19694,7464,3881,48216,753,1111,671,2535,50751
04-04-2019,15,16274,19562,7438,3692,46968,738,1024,657,2419,49387
04-04-2019,16,16978,20036,7461,3555,48031,735,1010,632,2377,50408
04-04-2019,17,17924,20067,7355,3599,48945,715,1022,655,2392,51337
04-04-2019,18,18641,20260,7376,3621,49899,707,1075,568,2350,52249
04-04-2019,19,18729,20548,7578,3528,50384,727,1203,575,2505,52889
04-04-2019,20,17687,20296,7426,3630,49038,718,1205,525,2448,51486
04-04-2019,21,16555,20191,7421,3414,47581,728,1058,522,2308,49889
04-04-2019,22,14938,19861,7354,3187,45341,750,879,539,2168,47509
04-04-2019,23,13128,18595,7048,2792,41562,689,735,544,1968,43530
05-04-2019,0,11866,17420,6853,2520,38659,702,340,537,1579,40238
05-04-2019,1,11429,16897,6817,2497,37639,705,343,521,1569,39208
05-04-2019,2,11341,16648,6782,2347,37117,686,324,526,1536,38653
05-04-2019,3,11241,16607,6816,2245,36911,668,321,530,1519,38430
05-04-2019,4,12415,17216,7042,2408,39080,659,350,546,1555,40635
05-04-2019,5,14873,18663,7518,2808,43862,655,625,535,1815,45677
05-04-2019,6,17884,21179,7975,3392,50430,653,943,534,2130,52560
05-04-2019,7,20213,21919,8195,3636,53965,666,1139,518,2323,56288
05-04-2019,8,20906,21755,8228,3737,54627,642,1244,441,2327,56954
05-04-2019,9,20462,21523,8011,3793,53789,674,1229,413,2316,56105
05-04-2019,10,19756,21337,7822,3735,52650,693,1232,469,2394,55044
05-04-2019,11,18635,21082,7710,3850,51278,683,1135,551,2369,53647
05-04-2019,12,17724,20822,7694,4084,50324,672,1159,556,2387,52711
05-04-2019,13,17098,20318,7505,4162,49084,631,1232,513,2376,51460
05-04-2019,14,16296,19819,7173,4166,47454,686,1139,476,2301,49755
05-04-2019,15,15532,19828,7134,4025,46519,692,1151,472,2315,48834
05-04-2019,16,16137,20752,7494,3920,48304,684,1191,474,2349,50653
05-04-2019,17,17206,21178,7511,3862,49756,672,1157,492,2321,52077
05-04-2019,18,17434,20951,7553,3932,49871,701,991,500,2192,52063
05-04-2019,19,17521,21097,7697,3733,50047,701,904,542,2147,52194
05-04-2019,20,17017,20795,7397,3765,48974,701,739,567,2007,50981
05-04-2019,21,17000,19086,7446,3575,47106,725,738,544,2007,49113
05-04-2019,22,15714,18724,7569,3398,45407,765,587,546,1898,47305
05-04-2019,23,14605,18259,7420,3197,43483,768,336,545,1649,45132
06-04-2019,0,14095,17066,7295,2827,41286,775,337,541,1653,42939
06-04-2019,1,13360,16510,7248,2598,39715,764,335,548,1647,41362
06-04-2019,2,12295,16258,7218,2344,38115,800,335,537,1672,39787
06-04-2019,3,11890,15656,7362,2018,36925,749,339,542,1630,38555
06-04-2019,4,11877,15781,7380,1935,36973,790,344,547,1681,38654
06-04-2019,5,12280,16262,7648,2007,38196,754,483,539,1776,39972
06-04-2019,6,13629,16889,7610,2071,40199,741,785,538,2064,42263
06-04-2019,7,14699,17847,7721,2373,42642,733,817,510,2060,44702
06-04-2019,8,16124,19021,7824,2374,45344,696,883,516,2095,47439
06-04-2019,9,16644,19698,7306,2341,45989,703,964,516,2183,48172
06-04-2019,10,16105,19617,7282,2254,45258,753,948,455,2156,47414
06-04-2019,11,14363,18994,7132,2305,42796,717,1082,466,2265,45061
06-04-2019,12,12813,18211,7047,2383,40454,704,1128,460,2292,42746
06-04-2019,13,12544,17855,6957,2310,39666,704,784,474,1962,41628
06-04-2019,14,12229,17624,6859,2418,39131,707,652,474,1833,40964
06-04-2019,15,12258,17629,6822,2445,39154,694,638,438,1770,40924
06-04-2019,16,12235,17875,6798,2432,39340,698,640,442,1780,41120
06-04-2019,17,13135,18153,6936,2250,40473,729,642,385,1756,42229
06-04-2019,18,14474,18909,7081,2209,42672,770,688,407,1865,44537
06-04-2019,19,15341,19124,7315,2206,43986,774,654,426,1854,45840
06-04-2019,20,15699,19377,7457,1960,44493,808,588,503,1899,46392
06-04-2019,21,14709,18374,7591,2388,43061,819,630,527,1976,45037
06-04-2019,22,13337,17215,7547,2191,40290,794,621,477,1892,42182
06-04-2019,23,12646,15896,7396,1836,37775,855,334,442,1631,39406
07-04-2019,0,11977,15013,7456,1540,35987,902,320,423,1645,37632
07-04-2019,1,11398,14625,7256,1516,34796,895,322,419,1636,36432
07-04-2019,2,11034,14516,7144,1405,34099,858,318,403,1579,35678
07-04-2019,3,10985,14625,6990,1199,33798,876,314,386,1576,35374
07-04-2019,4,11257,15157,6982,1159,34555,873,315,374,1562,36117
07-04-2019,5,11236,15443,7050,1154,34884,858,450,367,1675,36559
07-04-2019,6,11260,16076,7012,1172,35518,860,577,368,1805,37323
07-04-2019,7,12523,17202,7122,1309,38156,807,582,364,1753,39909
07-04-2019,8,13717,18256,7271,1621,40866,795,575,315,1685,42551
07-04-2019,9,13899,18500,7175,1734,41308,801,575,280,1656,42964
07-04-2019,10,12944,18347,7040,1669,40001,828,576,277,1681,41682
07-04-2019,11,12625,18375,6865,1691,39557,835,517,259,1611,41168
07-04-2019,12,12331,18244,6934,1601,39112,794,512,294,1600,40712
07-04-2019,13,11997,18219,6949,1588,38752,781,596,245,1622,40374
07-04-2019,14,11584,18124,6981,1618,38308,773,604,244,1621,39929
07-04-2019,15,11372,17988,7048,1604,38011,774,609,240,1623,39634
07-04-2019,16,11554,18166,7104,1610,38433,767,718,224,1709,40142
07-04-2019,17,12086,18723,7134,1792,39736,786,819,258,1863,41599
07-04-2019,18,14064,20318,7413,1982,43778,794,899,261,1954,45732
07-04-2019,19,15448,20871,7693,2191,46204,790,888,270,1948,48152
07-04-2019,20,15741,21154,7851,2425,47171,795,899,297,1991,49162
07-04-2019,21,15521,21084,7787,2534,46926,828,931,321,2080,49006
07-04-2019,22,14532,20415,7706,2654,45307,815,942,268,2025,47332
07-04-2019,23,13830,19808,7709,2473,43820,826,545,284,1655,45475
08-04-2019,0,12237,19039,7658,2343,41278,738,299,281,1318,42596
08-04-2019,1,11548,18833,7715,2351,40448,736,298,256,1290,41738
08-04-2019,2,11163,18721,7712,2302,39898,708,301,225,1234,41132
08-04-2019,3,11015,18721,7772,2379,39888,693,302,226,1221,41109
08-04-2019,4,11124,18938,7888,2555,40505,678,305,229,1212,41717
08-04-2019,5,13624,20093,8372,3001,45090,764,526,229,1519,46609
08-04-2019,6,17134,21764,8648,3384,50930,840,814,261,1915,52845
08-04-2019,7,19376,23088,8802,3280,54547,856,1184,269,2309,56856
08-04-2019,8,19961,23041,8775,3190,54967,878,1208,273,2359,57326
08-04-2019,9,19141,22925,8752,3449,54267,898,1234,298,2430,56697
08-04-2019,10,18721,22826,8780,3318,53645,900,1201,312,2413,56058
08-04-2019,11,17815,22689,8723,3401,52628,956,1202,318,2476,55104
08-04-2019,12,16925,22044,8763,3512,51243,892,1122,338,2352,53595
08-04-2019,13,15870,21550,8633,3558,49612,841,1111,367,2319,51931
08-04-2019,14,14334,21126,8559,3572,47592,840,1121,356,2317,49909
08-04-2019,15,13876,21138,8665,3503,47183,829,1042,365,2236,49419
08-04-2019,16,14983,21443,8882,3064,48372,844,1034,391,2269,50641
08-04-2019,17,16264,21748,8874,2519,49404,854,1037,399,2290,51694
08-04-2019,18,17223,21898,8975,2521,50617,852,1024,424,2300,52917
08-04-2019,19,17650,21979,9104,2113,50846,835,997,397,2229,53075
08-04-2019,20,17293,21884,8998,1913,50089,848,971,380,2199,52288
08-04-2019,21,16225,21589,8976,1856,48647,837,901,352,2090,50737
08-04-2019,22,14160,20377,8844,2428,45807,845,687,330,1862,47669
08-04-2019,23,12090,19566,8484,2244,42384,796,328,303,1427,43811
09-04-2019,0,11785,19014,8363,2207,41370,774,251,292,1317,42687
09-04-2019,1,11423,18465,8236,2368,40491,776,253,330,1359,41850
09-04-2019,2,11256,18329,8209,2472,40267,772,253,326,1351,41618
09-04-2019,3,11196,18251,8189,2542,40178,778,254,316,1348,41526
09-04-2019,4,11297,18789,8243,2626,40955,763,260,307,1330,42285
09-04-2019,5,12612,19963,8606,2784,43965,780,487,309,1576,45541
09-04-2019,6,17125,22155,8769,3217,51266,773,1118,372,2263,53529
09-04-2019,7,20452,23235,9024,3290,56001,812,1362,391,2565,58566
09-04-2019,8,20933,23053,9228,3460,56674,869,1439,448,2756,59430
09-04-2019,9,19968,22955,9075,3758,55757,901,1273,436,2610,58367
09-04-2019,10,19385,22744,8925,3985,55039,867,1267,443,2577,57616
09-04-2019,11,17739,22401,8856,3959,52957,862,1187,411,2460,55417
09-04-2019,12,16495,21804,8869,3798,50967,819,1148,409,2376,53343
09-04-2019,13,15466,21481,8899,3705,49552,787,1150,399,2336,51888
09-04-2019,14,14155,20930,8781,3588,47454,773,1156,403,2332,49786
09-04-2019,15,13982,20880,8708,3557,47127,769,1158,400,2327,49454
09-04-2019,16,14593,21326,8761,3523,48203,824,1062,414,2300,50503
09-04-2019,17,15546,21576,8731,3650,49503,837,1060,377,2274,51777
09-04-2019,18,17242,21715,8795,3855,51609,880,1004,332,2216,53825
09-04-2019,19,18623,22040,8885,2917,52466,848,993,324,2165,54631
09-04-2019,20,18075,22048,8929,2440,51492,837,898,306,2041,53533
09-04-2019,21,16424,21283,8750,2643,49100,834,901,266,2001,51101
09-04-2019,22,14532,20221,8500,2830,46084,800,682,273,1755,47839
09-04-2019,23,12681,19409,8242,2492,42823,792,318,271,1381,44204
10-04-2019,0,12350,18173,8038,2340,40901,783,315,262,1360,42261
10-04-2019,1,11935,17642,7992,2310,39880,777,311,254,1342,41222
10-04-2019,2,11709,17574,7995,2217,39495,784,305,253,1342,40837
10-04-2019,3,11762,17649,8034,2225,39671,815,302,247,1364,41035
10-04-2019,4,11995,18044,8175,2327,40540,900,306,243,1449,41989
10-04-2019,5,14032,19300,8652,2548,44531,969,427,238,1634,46165
10-04-2019,6,18067,21958,8973,3008,52008,959,938,304,2201,54209
10-04-2019,7,21358,22933,9303,3687,57282,972,1256,337,2565,59847
10-04-2019,8,21960,23293,9416,3810,58479,971,1277,464,2712,61191
10-04-2019,9,20849,22614,9132,3864,56460,952,1208,293,2453,58913
10-04-2019,10,19494,22083,8783,3820,54181,963,1104,243,2310,56491
10-04-2019,11,18765,21941,8552,3781,53040,953,1189,213,2355,55395
10-04-2019,12,17861,21528,8612,3836,51838,963,1134,216,2313,54151
10-04-2019,13,17667,21019,8686,3630,51004,961,1159,221,2341,53345
10-04-2019,14,16482,20506,8733,3439,49160,932,969,220,2121,51281
10-04-2019,15,16521,20496,8687,3172,48876,940,945,245,2130,51006
10-04-2019,16,17624,20641,8678,3071,50012,932,981,264,2177,52189
10-04-2019,17,18349,20797,8696,3008,50852,921,974,270,2165,53017
10-04-2019,18,19404,20788,8745,2960,51897,897,1055,285,2237,54134
10-04-2019,19,20026,20740,8745,2936,52447,921,1204,286,2411,54858
10-04-2019,20,19965,20843,8879,2787,52474,919,1052,272,2243,54717
10-04-2019,21,18070,20309,8795,2472,49646,813,845,212,1870,51516
10-04-2019,22,16511,18986,8572,2276,46344,814,598,211,1623,47967
10-04-2019,23,15198,18004,8388,2211,43802,818,314,211,1343,45145
11-04-2019,0,13571,17451,8302,2076,41402,834,302,215,1351,42753
11-04-2019,1,13099,16850,8219,2170,40338,828,300,208,1336,41674
11-04-2019,2,13186,16832,8166,2071,40257,871,301,209,1381,41638
11-04-2019,3,13276,16867,8151,2050,40344,884,301,212,1397,41741
11-04-2019,4,13700,17371,8210,2067,41347,877,301,217,1395,42742
11-04-2019,5,15273,18622,8434,2253,44581,875,388,218,1481,46062
11-04-2019,6,19946,20429,8834,2783,51993,892,628,261,1781,53774
11-04-2019,7,21824,21243,8912,3184,55163,951,1341,494,2786,57949
11-04-2019,8,21968,21113,8889,3406,55376,963,1372,498,2833,58209
11-04-2019,9,20852,20885,8815,3307,53860,951,1382,384,2717,56577
11-04-2019,10,20311,20630,8693,3179,52814,938,1164,274,2376,55190
11-04-2019,11,19131,20205,8565,3183,51085,939,978,270,2187,53272
11-04-2019,12,19202,19761,8659,3044,50668,912,957,239,2108,52776
11-04-2019,13,19138,19569,8485,3070,50261,902,853,258,2013,52274
11-04-2019,14,17530,19319,8152,2964,47964,930,825,244,1999,49963
11-04-2019,15,17186,19353,8089,2846,47476,923,816,242,1981,49457
11-04-2019,16,17963,19375,8075,2754,48167,918,816,274,2008,50175
11-04-2019,17,18388,19518,8102,2712,48720,900,826,336,2062,50782
11-04-2019,18,20045,19924,8303,2598,50872,878,827,326,2031,52903
11-04-2019,19,20721,20222,8454,2641,52039,927,991,370,2288,54327
11-04-2019,20,20980,20274,8415,2734,52404,921,1009,312,2242,54646
11-04-2019,21,20222,20068,8408,2633,51331,860,790,292,1942,53273
11-04-2019,22,18834,19165,8191,2582,48772,848,615,290,1753,50525
11-04-2019,23,16803,17979,7760,2596,45138,811,328,309,1448,46586
12-04-2019,0,15057,16841,7639,2408,41945,828,314,289,1431,43376
12-04-2019,1,14554,16460,7694,2671,41380,842,325,291,1458,42838
12-04-2019,2,14356,16305,7595,2609,40865,834,329,304,1467,42332
12-04-2019,3,14658,16407,7604,2650,41318,824,358,263,1445,42763
12-04-2019,4,15488,16870,7640,2681,42681,835,352,261,1448,44129
12-04-2019,5,17304,18083,8216,2780,46381,823,466,273,1562,47943
12-04-2019,6,20601,20206,8909,3091,52807,889,1101,293,2283,55090
12-04-2019,7,22319,20995,9000,3621,55936,893,1389,512,2794,58730
12-04-2019,8,21976,20652,8855,3843,55327,899,1761,486,3146,58473
12-04-2019,9,21223,20438,8615,3734,54012,902,1771,534,3207,57219
12-04-2019,10,20921,20347,8381,3629,53279,908,1782,596,3286,56565
12-04-2019,11,19072,20073,8278,3645,51069,887,1765,443,3095,54164
12-04-2019,12,18634,19785,8357,3457,50236,893,1761,393,3047,53283
12-04-2019,13,17515,19342,8234,3430,48521,883,1742,393,3018,51539
12-04-2019,14,15731,18618,7698,3259,45307,818,1463,364,2645,47952
12-04-2019,15,15284,18351,7569,3254,44459,814,1418,361,2593,47052
12-04-2019,16,15827,18479,7890,3321,45517,851,1499,377,2727,48244
12-04-2019,17,16801,18906,7949,3248,46906,844,1514,378,2736,49642
12-04-2019,18,18043,19445,8018,3165,48671,870,1624,395,2889,51560
12-04-2019,19,18951,19854,8235,2951,49991,893,1612,431,2936,52927
12-04-2019,20,19259,19660,7995,2717,49631,827,1516,386,2729,52360
12-04-2019,21,18772,19599,7829,2835,49033,838,929,380,2147,51180
12-04-2019,22,18201,18837,7715,2779,47534,819,702,358,1879,49413
12-04-2019,23,16372,17635,7326,2702,44035,827,565,337,1729,45764
13-04-2019,0,14933,17170,7066,2473,41642,852,871,338,2061,43703
13-04-2019,1,13443,16705,6977,2749,39873,856,873,354,2083,41956
13-04-2019,2,12871,16672,6935,2611,39089,853,877,372,2102,41191
13-04-2019,3,12306,16656,6858,2449,38270,844,882,377,2103,40373
13-04-2019,4,12574,16803,6807,2610,38793,851,883,347,2081,40874
13-04-2019,5,12703,17062,6833,2730,39329,844,862,373,2079,41408
13-04-2019,6,13553,17686,7130,3047,41415,842,1071,347,2260,43675
13-04-2019,7,15249,18230,7359,3222,44061,837,1349,336,2522,46583
13-04-2019,8,17018,18478,7387,3394,46278,833,1136,329,2298,48576
13-04-2019,9,16489,18487,7231,3614,45820,815,1087,423,2325,48145
13-04-2019,10,14208,17928,7018,4028,43183,794,1086,432,2312,45495
13-04-2019,11,12979,17633,6893,4441,41945,804,1001,421,2226,44171
13-04-2019,12,12611,17586,6871,4546,41615,832,713,408,1953,43568
13-04-2019,13,12121,17435,6836,4515,40909,833,711,380,1924,42833
13-04-2019,14,11798,17226,6743,4406,40172,851,716,356,1923,42095
13-04-2019,15,11473,17099,6819,4357,39748,857,727,351,1935,41683
13-04-2019,16,11702,17030,6843,4293,39869,843,726,343,1912,41781
13-04-2019,17,12479,17446,7021,4377,41323,846,731,339,1916,43239
13-04-2019,18,13768,17844,7096,4183,42891,851,766,347,1964,44855
13-04-2019,19,15102,18336,7288,3895,44621,843,903,383,2129,46750
13-04-2019,20,15673,18728,7540,3847,45788,854,936,419,2209,47997
13-04-2019,21,14386,18467,7568,3618,44040,866,1015,455,2336,46376
13-04-2019,22,12858,17598,7397,3436,41289,864,838,469,2171,43460
13-04-2019,23,11667,17078,6995,3264,39004,849,668,462,1979,40983
14-04-2019,0,10919,16286,6913,3407,37525,730,339,462,1531,39056
14-04-2019,1,10699,16110,6837,3291,36936,708,328,482,1518,38454
14-04-2019,2,10919,15998,6848,3280,37045,678,328,494,1500,38545
14-04-2019,3,10922,16110,6849,3277,37159,676,329,493,1498,38657
14-04-2019,4,10956,16320,6884,3281,37441,685,331,484,1500,38941
14-04-2019,5,11109,16716,6928,3033,37787,690,331,453,1474,39261
14-04-2019,6,11138,16891,6951,3177,38157,688,327,410,1425,39582
14-04-2019,7,11466,17273,7149,3452,39341,735,454,313,1502,40843
14-04-2019,8,12321,17697,7180,3791,40990,808,458,307,1573,42563
14-04-2019,9,12656,17780,6960,4560,41956,855,392,330,1577,43533
14-04-2019,10,12228,17425,7097,4921,41671,867,393,410,1670,43341
14-04-2019,11,12085,17350,7157,4864,41458,871,431,383,1685,43143
14-04-2019,12,12028,17448,7073,4588,41137,852,442,371,1665,42802
14-04-2019,13,11604,17247,6879,4368,40099,819,472,365,1656,41755
14-04-2019,14,11363,17112,6793,4184,39453,845,469,368,1682,41135
14-04-2019,15,11509,16886,6835,3903,39134,850,456,377,1683,40817
14-04-2019,16,11411,16994,6891,3630,38924,862,469,373,1704,40628
14-04-2019,17,11594,17675,7068,3509,39846,854,478,370,1702,41548
14-04-2019,18,12739,18210,7241,3409,41600,852,632,356,1840,43440
14-04-2019,19,14964,18347,7436,3367,44113,880,716,369,1965,46078
14-04-2019,20,16045,18497,7619,3125,45286,878,735,439,2052,47338
14-04-2019,21,15261,18269,7763,3305,44598,876,728,489,2093,46691
14-04-2019,22,14346,18192,7617,2993,43148,870,588,460,1918,45066
14-04-2019,23,12907,17828,7364,2947,41047,873,263,443,1579,42626
15-04-2019,0,12620,16542,7127,2751,39040,865,316,448,1629,40669
15-04-2019,1,11817,16287,7124,2676,37904,856,320,453,1629,39533
15-04-2019,2,11584,16232,7115,2747,37678,859,323,454,1636,39314
15-04-2019,3,11848,16351,7100,2653,37951,853,366,419,1638,39589
15-04-2019,4,12706,16632,7339,2631,39309,844,370,392,1606,40915
15-04-2019,5,15647,17694,7781,2777,43900,832,383,383,1598,45498
15-04-2019,6,19847,19948,7933,3018,50747,825,1011,373,2209,52956
15-04-2019,7,21773,20670,8184,3122,53749,817,1198,356,2371,56120
15-04-2019,8,21783,20512,8159,3175,53630,824,1266,461,2551,56181
15-04-2019,9,20170,20319,7963,3856,52309,859,1252,421,2532,54841
15-04-2019,10,17823,19630,7761,4254,49469,866,1186,344,2396,51865
15-04-2019,11,16026,19132,7641,4626,47424,868,1155,377,2400,49824
15-04-2019,12,15446,18922,7571,4600,46538,869,1087,323,2279,48817
15-04-2019,13,15019,18692,7378,4564,45654,878,1071,328,2277,47931
15-04-2019,14,14158,18304,7024,4376,43863,857,992,316,2165,46028
15-04-2019,15,13828,18052,7043,4202,43127,841,993,325,2159,45286
15-04-2019,16,14157,18045,7082,4083,43366,839,992,365,2196,45562
15-04-2019,17,14770,18192,7163,3742,43868,833,895,411,2139,46007
15-04-2019,18,17055,18928,7291,3855,47129,838,874,432,2144,49273
15-04-2019,19,18628,19172,7296,3175,48272,843,972,362,2177,50449
15-04-2019,20,18641,18883,7188,3013,47725,820,985,277,2082,49807
15-04-2019,21,16899,18371,7090,3597,45956,818,724,278,1820,47776
15-04-2019,22,14065,17325,7011,3275,41675,840,631,292,1763,43438
15-04-2019,23,12538,16789,6857,3145,39331,852,631,280,1763,41094
16-04-2019,0,11970,15827,6774,3064,37635,857,401,260,1518,39153
16-04-2019,1,11374,15460,6673,3169,36677,861,397,273,1531,38208
16-04-2019,2,11454,15514,6718,3019,36705,859,391,262,1512,38217
16-04-2019,3,11922,15668,6702,2932,37226,832,387,247,1466,38692
16-04-2019,4,12551,16044,6786,2881,38263,841,399,227,1467,39730
16-04-2019,5,14098,17316,6963,2918,41297,840,608,230,1678,42975
16-04-2019,6,18016,19142,7427,3432,48017,845,998,276,2119,50136
16-04-2019,7,20686,19958,7682,3398,51724,833,1296,352,2481,54205
16-04-2019,8,20675,20045,7807,3884,52411,841,1293,505,2639,55050
16-04-2019,9,18766,19751,7619,4388,50526,823,1275,460,2558,53084
16-04-2019,10,16365,19286,7329,4658,47638,832,1242,376,2450,50088
16-04-2019,11,15580,19029,7196,4725,46530,844,1280,262,2386,48916
16-04-2019,12,15068,19085,7083,4587,45823,848,1193,264,2305,48128
16-04-2019,13,14960,18670,6961,4592,45183,843,1117,262,2222,47405
16-04-2019,14,14154,18391,6700,4658,43904,843,922,274,2039,45943
16-04-2019,15,13895,18061,6618,4677,43252,855,910,297,2062,45314
16-04-2019,16,13761,18173,6774,4642,43351,838,902,318,2058,45409
16-04-2019,17,15625,18691,6802,4772,45890,838,913,288,2039,47929
16-04-2019,18,17526,19092,6961,4195,47774,849,964,311,2124,49898
16-04-2019,19,18376,19341,6983,3398,48097,849,986,324,2159,50256
16-04-2019,20,18481,19241,6609,3415,47745,877,828,414,2119,49864
16-04-2019,21,17396,18751,6580,3792,46519,891,646,486,2023,48542
16-04-2019,22,14143,17742,6412,4096,42393,873,657,466,1996,44389
16-04-2019,23,11178,16696,6268,3911,38055,851,561,463,1875,39930
17-04-2019,0,11733,16327,6350,3924,38334,854,437,465,1756,40090
17-04-2019,1,11415,15803,6323,3946,37487,847,459,458,1764,39251
17-04-2019,2,11476,15998,6380,3774,37627,815,441,456,1712,39339
17-04-2019,3,11728,16409,6484,3588,38209,820,459,446,1725,39934
17-04-2019,4,12565,16759,6714,3512,39550,828,455,418,1701,41251
17-04-2019,5,14344,17801,7058,3548,42752,832,563,397,1792,44544
17-04-2019,6,17754,19121,7491,3850,48217,843,1133,387,2363,50580
17-04-2019,7,19488,19807,7807,3965,51068,825,1298,385,2508,53576
17-04-2019,8,20227,19799,7750,3739,51514,837,1363,318,2518,54032
17-04-2019,9,19400,19813,7539,3966,50717,843,1212,301,2356,53073
17-04-2019,10,18450,19550,7349,4095,49446,838,1195,321,2354,51800
17-04-2019,11,16905,19151,7174,3603,46833,824,1203,322,2349,49182
17-04-2019,12,15516,18397,7152,3660,44724,825,1155,303,2283,47007
17-04-2019,13,14424,18006,6936,4069,43435,847,1106,291,2244,45679
17-04-2019,14,13584,17748,6441,4053,41826,819,966,285,2070,43896
17-04-2019,15,13378,17657,6454,3889,41379,837,960,277,2074,43453
17-04-2019,16,13646,17829,6708,3485,41668,851,965,269,2085,43753
17-04-2019,17,14074,17863,6746,3156,41838,836,968,256,2060,43898
17-04-2019,18,15719,18395,7036,3314,44463,841,962,354,2157,46620
17-04-2019,19,16553,18505,7109,3153,45321,859,938,384,2181,47502
17-04-2019,20,17124,18306,6802,2901,45133,845,830,330,2005,47138
17-04-2019,21,15522,18087,6666,2977,43251,842,722,329,1893,45144
17-04-2019,22,13286,16906,6597,2658,39447,839,659,364,1862,41309
17-04-2019,23,11383,16288,6437,2615,36724,821,438,357,1616,38340
18-04-2019,0,10602,15200,6291,2526,34619,822,398,364,1584,36203
18-04-2019,1,10223,14784,6278,2526,33812,800,380,337,1517,35329
18-04-2019,2,10245,14833,6243,2445,33766,801,424,294,1519,35285
18-04-2019,3,10655,14945,6242,2419,34260,817,421,277,1515,35775
18-04-2019,4,11284,15734,6504,2274,35794,819,422,252,1493,37287
18-04-2019,5,12939,16904,6769,2389,38999,808,653,230,1691,40690
18-04-2019,6,15434,18350,7207,2828,43821,811,1326,234,2371,46192
18-04-2019,7,17213,19129,7448,2985,46775,824,1340,284,2448,49223
18-04-2019,8,17678,19262,7620,2630,47189,833,1338,283,2454,49643
18-04-2019,9,17011,19110,7292,2832,46243,847,1337,275,2459,48702
18-04-2019,10,15122,18531,6915,2860,43428,843,1347,288,2478,45906
18-04-2019,11,13315,17791,6906,2914,40926,847,1344,250,2441,43367
18-04-2019,12,12444,17426,7059,3118,40048,847,1182,255,2284,42332
18-04-2019,13,11882,17301,6920,3247,39350,792,1006,256,2054,41404
18-04-2019,14,11402,16755,6410,3211,37778,771,905,291,1967,39745
18-04-2019,15,11272,16775,6271,3132,37451,772,936,327,2035,39486
18-04-2019,16,11346,16953,6589,2972,37861,790,957,331,2078,39939
18-04-2019,17,11991,17014,6726,2679,38411,798,956,319,2073,40484
18-04-2019,18,13449,17709,6625,2679,40462,780,886,357,2023,42485
18-04-2019,19,15140,18130,6754,2338,42362,797,954,336,2087,44449
18-04-2019,20,15325,18205,6710,1969,42209,809,787,344,1940,44149
18-04-2019,21,13971,17619,6770,2338,40697,806,627,371,1804,42501
18-04-2019,22,12408,17061,6719,2426,38614,791,630,373,1794,40408
18-04-2019,23,10203,15730,6663,2168,34763,789,411,396,1596,36359
19-04-2019,0,8803,14725,6831,2097,32458,710,361,387,1458,33916
19-04-2019,1,8721,14417,6839,1986,31964,690,358,364,1412,33376
19-04-2019,2,8697,14409,6795,1906,31809,695,354,355,1404,33213
19-04-2019,3,8779,14624,6781,1912,32097,700,353,334,1387,33484
19-04-2019,4,8857,15133,6725,1903,32617,712,352,304,1368,33985
19-04-2019,5,9043,15947,6896,1956,33842,724,358,271,1353,35195
19-04-2019,6,9737,17379,6882,2094,36093,773,434,234,1441,37534
19-04-2019,7,10698,18092,6817,2336,37944,779,605,257,1641,39585
19-04-2019,8,11501,18535,6746,2455,39237,776,822,334,1932,41169
19-04-2019,9,11614,18385,6628,2437,39065,781,827,273,1881,40946
19-04-2019,10,11071,18238,6527,2572,38409,800,978,262,2040,40449
19-04-2019,11,10816,17860,6481,2754,37912,807,886,249,1942,39854
19-04-2019,12,10762,17790,6363,2720,37635,809,883,249,1941,39576
19-04-2019,13,10390,17689,6203,2485,36767,807,784,276,1867,38634
19-04-2019,14,10119,17071,6220,2385,35794,811,661,278,1750,37544
19-04-2019,15,10058,17005,6311,2237,35612,799,664,307,1770,37382
19-04-2019,16,10615,17428,6349,2009,36401,812,645,361,1818,38219
19-04-2019,17,10680,17506,6415,1877,36479,813,634,368,1815,38294
19-04-2019,18,10973,17731,6554,1718,36977,834,507,323,1664,38641
19-04-2019,19,11391,17809,6667,1647,37513,836,526,293,1655,39168
19-04-2019,20,11020,17648,6433,1607,36709,838,492,330,1660,38369
19-04-2019,21,11892,18128,6550,1543,38115,816,343,385,1544,39659
19-04-2019,22,11400,17827,6459,1453,37139,806,305,404,1515,38654
19-04-2019,23,9653,16647,6263,1149,33712,814,170,377,1361,35073
20-04-2019,0,9695,15622,6354,1183,32855,833,168,310,1311,34166
20-04-2019,1,9228,15083,6152,1098,31561,823,165,263,1251,32812
20-04-2019,2,9095,15017,6037,1043,31192,777,165,270,1212,32404
20-04-2019,3,9178,15031,6046,952,31207,789,169,282,1240,32447
20-04-2019,4,9419,15107,6077,999,31601,802,168,281,1251,32852
20-04-2019,5,9123,15717,5998,996,31834,750,170,296,1216,33050
20-04-2019,6,9394,16277,6077,970,32719,732,170,302,1204,33923
20-04-2019,7,9845,17149,6097,1136,34227,748,165,273,1186,35413
20-04-2019,8,10556,17800,6166,1330,35853,758,233,254,1245,37098
20-04-2019,9,10837,17832,6204,1575,36446,778,205,304,1287,37733
20-04-2019,10,10808,17715,6093,1773,36391,798,228,322,1348,37739
20-04-2019,11,10408,17358,6085,1836,35687,801,233,382,1416,37103
20-04-2019,12,10081,17011,6066,1859,35017,790,293,374,1457,36474
20-04-2019,13,9937,16675,6008,1756,34377,793,305,342,1440,35817
20-04-2019,14,9687,16349,6056,1748,33840,783,336,324,1443,35283
20-04-2019,15,9727,16334,5978,1730,33770,746,302,319,1367,35137
20-04-2019,16,9929,16382,5977,1743,34029,776,336,307,1419,35448
20-04-2019,17,10642,16804,6004,1582,35032,799,332,326,1457,36489
20-04-2019,18,11535,17543,5988,1607,36673,792,407,332,1531,38204
20-04-2019,19,12150,18023,6182,1480,37836,780,470,306,1556,39392
20-04-2019,20,11989,18388,6454,1346,38177,777,470,330,1577,39754
20-04-2019,21,11257,17999,6490,1290,37037,776,381,328,1485,38522
20-04-2019,22,10439,16906,6618,1108,35072,773,330,290,1393,36465
20-04-2019,23,9595,16022,6685,1043,33346,765,179,275,1219,34565
21-04-2019,0,8694,15171,6740,924,31529,726,160,250,1136,32665
21-04-2019,1,8277,14872,6822,895,30866,723,160,243,1126,31992
21-04-2019,2,8168,14605,6994,834,30601,740,158,277,1175,31776
21-04-2019,3,8131,14638,7061,816,30647,750,159,282,1191,31838
21-04-2019,4,8245,14615,7161,845,30866,756,162,264,1182,32048
21-04-2019,5,8162,14654,7164,865,30846,748,304,243,1295,32141
21-04-2019,6,8065,14887,7065,955,30973,742,308,229,1279,32252
21-04-2019,7,8492,15740,6871,1110,32212,732,349,226,1307,33519
21-04-2019,8,9288,16464,6925,1242,33918,741,493,214,1448,35366
21-04-2019,9,10080,16615,7009,1437,35140,804,513,261,1578,36718
21-04-2019,10,9912,16538,7030,1674,35155,794,497,266,1557,36712
21-04-2019,11,9573,16274,7013,1787,34649,786,533,267,1586,36235
21-04-2019,12,9274,16291,7080,1796,34441,785,587,284,1656,36097
21-04-2019,13,9271,15758,7100,1865,33993,745,560,329,1634,35627
21-04-2019,14,9228,15425,7095,1861,33610,748,535,367,1650,35260
21-04-2019,15,8867,15393,7030,1763,33052,740,535,397,1672,34724
21-04-2019,16,8865,15486,7139,1710,33202,733,481,404,1618,34820
21-04-2019,17,9401,16037,7170,1521,34129,724,544,420,1688,35817
21-04-2019,18,10486,17047,7378,1414,36326,779,721,385,1885,38211
21-04-2019,19,11758,18097,7632,1566,39054,744,867,314,1925,40979
21-04-2019,20,12015,18164,7681,1653,39513,744,924,489,2157,41670
21-04-2019,21,11372,18092,7551,1434,38450,766,926,286,1978,40428
21-04-2019,22,9643,16692,7327,1283,34946,767,819,356,1942,36888
21-04-2019,23,8565,15774,7153,1282,32775,725,413,407,1545,34320
22-04-2019,0,8011,14568,6914,1251,,721,171,398,1290,
22-04-2019,1,7835,14076,6733,1230,29873,751,196,328,1275,31148
22-04-2019,2,7813,14016,6616,1341,29788,787,169,283,1239,31027
22-04-2019,3,7768,14036,6503,1457,29765,813,158,312,1283,31048
22-04-2019,4,7853,14254,6442,1605,30155,824,159,368,1351,31506
22-04-2019,5,7937,14466,6440,1880,30724,820,255,369,1444,32168
22-04-2019,6,8489,15078,6524,2196,32287,795,415,346,1556,33843
22-04-2019,7,9439,15831,6298,2495,34064,769,487,371,1627,35691
22-04-2019,8,10150,16217,6406,2705,35478,804,749,318,1871,37349
22-04-2019,9,10440,17135,6476,2653,36703,766,761,358,1885,38588
22-04-2019,10,10425,17130,6415,2906,36875,751,665,430,1846,38721
22-04-2019,11,10291,16814,6360,3218,36685,742,657,443,1842,38527
22-04-2019,12,10054,16407,6362,3425,36248,748,699,462,1909,38157
22-04-2019,13,9949,15877,6326,3605,35757,754,601,441,1796,37553
22-04-2019,14,8882,15162,6208,3860,34112,738,549,403,1690,35802
22-04-2019,15,8957,15008,6234,3964,34164,736,586,366,1688,35852
22-04-2019,16,9383,15306,6234,3787,34711,733,699,326,1758,36469
22-04-2019,17,9891,15774,6455,3883,36003,722,586,303,1611,37614
22-04-2019,18,10031,16077,6540,4036,36684,713,529,301,1543,38227
22-04-2019,19,10107,16481,6686,4095,37371,710,595,297,1602,38973
22-04-2019,20,9808,16461,6658,3905,36832,707,551,311,1569,38401
22-04-2019,21,9704,16207,6693,3841,36447,707,331,362,1400,37847
22-04-2019,22,9158,15239,6734,3642,34773,698,329,379,1406,36179
22-04-2019,23,9283,14815,6717,2879,33693,703,319,380,1402,35095
23-04-2019,0,8800,14822,6784,3117,33523,711,164,378,1253,34776
23-04-2019,1,8312,14577,6843,2733,32466,712,165,363,1240,33706
23-04-2019,2,8008,14526,6872,2725,32131,731,165,337,1233,33364
23-04-2019,3,8153,14653,6901,2529,32236,748,162,334,1244,33480
23-04-2019,4,8278,14881,6973,2746,32879,703,162,351,1216,34095
23-04-2019,5,8730,15897,7221,3331,35179,530,330,358,1218,36397
23-04-2019,6,10395,17027,7466,3742,38629,649,383,330,1362,39991
23-04-2019,7,13104,18349,7433,3998,42885,769,463,369,1601,44486
23-04-2019,8,13858,18702,7383,4403,44346,793,678,464,1935,46281
23-04-2019,9,13382,18427,7271,5003,44085,739,771,498,2008,46093
23-04-2019,10,12629,18290,7140,5072,43132,735,773,590,2098,45230
23-04-2019,11,12027,17761,7131,5405,42324,741,735,707,2183,44507
23-04-2019,12,11674,17523,7218,4679,41094,730,769,722,2221,43315
23-04-2019,13,11587,18038,7238,4594,41458,730,741,692,2163,43621
23-04-2019,14,11098,17387,7191,4833,40509,732,638,564,1934,42443
23-04-2019,15,10943,17391,7156,5001,40492,740,635,545,1920,42412
23-04-2019,16,11203,17713,7273,4839,41028,731,634,604,1969,42997
23-04-2019,17,11209,17619,7199,4855,40884,722,541,686,1949,42833
23-04-2019,18,11771,17863,7297,4873,41803,718,547,627,1892,43695
23-04-2019,19,11991,18446,7331,4426,42195,731,550,629,1910,44105
23-04-2019,20,11756,18225,7322,4324,41627,735,575,455,1765,43392
23-04-2019,21,11603,17675,7267,3880,40427,719,363,470,1552,41979
23-04-2019,22,11356,17007,7079,3643,39085,716,174,520,1410,40495
23-04-2019,23,10301,15962,6799,3113,36175,737,175,534,1446,37621
24-04-2019,0,9897,15329,6707,3176,35109,763,176,521,1460,36569
24-04-2019,1,9759,14991,6595,3209,34554,763,177,540,1480,36034
24-04-2019,2,9348,14866,6496,3266,33975,766,178,540,1484,35459
24-04-2019,3,9275,14941,6479,3241,33935,759,181,549,1489,35424
24-04-2019,4,9381,15369,6428,3358,34536,748,185,554,1487,36023
24-04-2019,5,9568,16660,6635,3697,36560,748,274,565,1587,38147
24-04-2019,6,11279,18324,6973,3931,40506,751,582,550,1883,42389
24-04-2019,7,14081,19905,7021,3666,44674,806,799,693,2298,46972
24-04-2019,8,14747,20067,6887,3796,45497,803,771,720,2294,47791
24-04-2019,9,13524,19547,6839,4650,44560,808,750,819,2377,46937
24-04-2019,10,12620,19102,6790,4810,43321,801,585,917,2303,45624
24-04-2019,11,11760,18877,6794,4789,42220,757,577,931,2265,44485
24-04-2019,12,11155,18645,6851,4842,41494,748,572,943,2263,43757
24-04-2019,13,10858,18385,6866,4793,40902,761,569,923,2253,43155
24-04-2019,14,10592,18221,6656,4690,40159,767,490,910,2167,42326
24-04-2019,15,10953,18263,6671,4686,40573,757,502,925,2184,42757
24-04-2019,16,11258,18793,6679,4663,41394,756,585,892,2233,43627
24-04-2019,17,12146,19311,6622,4251,42330,791,760,718,2269,44599
24-04-2019,18,13320,19743,6545,4192,43799,815,759,628,2202,46001
24-04-2019,19,13692,19669,6523,3630,43513,812,748,657,2217,45730
24-04-2019,20,13300,19037,6471,3328,42137,781,712,682,2175,44312
24-04-2019,21,12826,18721,6348,3312,41209,785,374,519,1678,42887
24-04-2019,22,11148,18000,6210,3374,38734,757,196,431,1384,40118
24-04-2019,23,10075,16767,6051,3190,36084,773,192,421,1386,37470
25-04-2019,0,9414,16060,6132,2931,34538,799,198,459,1456,35994
25-04-2019,1,8962,15485,6163,2757,33368,798,168,480,1446,34814
25-04-2019,2,8678,15205,6025,2829,32738,802,157,483,1442,34180
25-04-2019,3,8968,15838,6184,3074,34064,793,155,480,1428,35492
25-04-2019,4,9204,15863,6354,3232,34655,769,156,490,1415,36070
25-04-2019,5,10807,16614,6685,2714,36819,762,163,478,1403,38222
25-04-2019,6,14909,18527,6960,2808,43205,776,390,442,1608,44813
25-04-2019,7,17300,19000,7090,3175,46566,791,449,643,1883,48449
25-04-2019,8,17867,19244,7014,2876,47001,792,639,612,2043,49044
25-04-2019,9,17041,19112,6937,2594,45685,790,806,618,2214,47899
25-04-2019,10,15232,17939,6957,2412,42538,789,881,642,2312,44850
25-04-2019,11,14594,17817,6907,2378,41695,796,885,658,2339,44034
25-04-2019,12,14095,17813,6973,2484,41365,806,861,646,2313,43678
25-04-2019,13,13938,18022,6793,2355,41108,779,1021,615,2415,43523
25-04-2019,14,13450,18222,6583,2116,40371,771,1028,593,2392,42763
25-04-2019,15,13901,18181,6571,1966,40619,777,893,606,2276,42895
25-04-2019,16,13708,18455,6672,1914,40750,776,695,577,2048,42798
25-04-2019,17,15539,18969,6764,2028,43301,792,622,556,1970,45271
25-04-2019,18,16192,19476,6732,2308,44709,807,521,530,1858,46567
25-04-2019,19,16182,19347,6770,2463,44763,805,590,542,1937,46700
25-04-2019,20,15284,19247,6785,2572,43889,809,601,586,1996,45885
25-04-2019,21,15065,18888,6717,2571,43241,804,548,412,1764,45005
25-04-2019,22,13836,17785,6663,2558,40842,820,234,433,1487,42329
25-04-2019,23,11179,17120,6502,2473,37275,769,194,390,1353,38628
26-04-2019,0,10474,16561,6151,2467,35652,765,183,348,1296,36948
26-04-2019,1,10099,15856,5963,2450,34368,741,181,328,1250,35618
26-04-2019,2,10010,15863,5867,2339,34078,766,184,306,1256,35334
26-04-2019,3,10095,16015,5864,2303,34277,736,188,288,1212,35489
26-04-2019,4,10985,16643,6162,2202,35991,753,187,275,1215,37206
26-04-2019,5,12160,17074,6699,2116,38051,750,198,278,1226,39277
26-04-2019,6,15764,18437,7238,2908,44348,803,316,353,1472,45820
26-04-2019,7,17505,19044,7433,3020,47004,789,676,341,1806,48810
26-04-2019,8,18033,19296,7447,3100,47878,748,718,507,1973,49851
26-04-2019,9,17715,19145,7456,3188,47505,756,797,520,2073,49578
26-04-2019,10,17661,19084,7398,2871,47013,761,797,560,2118,49131
26-04-2019,11,17401,19001,7320,2720,46441,769,754,636,2159,48600
26-04-2019,12,16565,18970,7292,2384,45211,766,707,618,2091,47302
26-04-2019,13,15128,18724,7178,1820,42851,773,693,581,2047,44898
26-04-2019,14,14078,17904,6947,1573,40502,780,521,493,1794,42296
26-04-2019,15,14082,18180,6786,1578,40626,807,515,495,1817,42443
26-04-2019,16,14332,18685,6955,1703,41677,791,573,429,1793,43470
26-04-2019,17,15514,19137,6881,1973,43504,822,612,298,1732,45236
26-04-2019,18,15783,19046,6907,2013,43749,838,391,459,1688,45437
26-04-2019,19,15929,19047,6901,2139,44016,900,282,471,1653,45669
26-04-2019,20,15131,18760,6824,2156,42872,893,196,516,1605,44477
26-04-2019,21,14755,18390,6758,2019,41922,851,194,403,1448,43370
26-04-2019,22,13534,17264,6518,1827,39144,851,193,434,1478,40622
26-04-2019,23,11342,16603,6495,1746,36187,798,194,417,1409,37596
27-04-2019,0,10141,16263,6532,1654,34590,636,163,424,1223,35813
27-04-2019,1,9321,16140,6602,1650,33713,610,159,372,1141,34854
27-04-2019,2,8914,15924,6630,1570,33037,613,152,339,1104,34141
27-04-2019,3,8885,15965,6550,1494,32896,595,148,322,1065,33961
27-04-2019,4,8740,16040,6603,1376,32760,613,146,307,1066,33826
27-04-2019,5,8326,15992,6761,1319,32397,641,143,311,1095,33492
27-04-2019,6,8366,16061,6804,1188,32419,635,207,302,1144,33563
27-04-2019,7,10155,16537,6898,1332,34923,618,411,268,1297,36220
27-04-2019,8,11363,17202,6889,1487,36941,644,570,366,1580,38521
27-04-2019,9,11974,17182,6931,1522,37609,677,659,302,1638,39247
27-04-2019,10,11701,17326,7013,1548,37587,676,596,359,1631,39218
27-04-2019,11,11054,17223,7077,1696,37051,662,577,332,1571,38622
27-04-2019,12,10798,17077,7103,1892,36869,649,556,297,1502,38371
27-04-2019,13,10874,17297,7136,1962,37270,645,557,267,1469,38739
27-04-2019,14,10714,17200,7143,1939,36997,649,428,252,1329,38326
27-04-2019,15,10655,17063,7091,1850,36660,648,361,246,1255,37915
27-04-2019,16,10603,17375,7123,1738,36840,646,355,233,1234,38074
27-04-2019,17,11746,17891,7402,1598,38637,658,378,231,1267,39904
27-04-2019,18,12635,18515,7554,1411,40114,671,417,248,1336,41450
27-04-2019,19,13314,18495,7497,1350,40657,654,326,272,1252,41909
27-04-2019,20,13019,18676,7627,1150,40472,701,167,313,1181,41653
27-04-2019,21,12273,18654,7636,1005,39568,735,156,343,1234,40802
27-04-2019,22,11094,18260,7558,997,37909,769,161,308,1238,39147
27-04-2019,23,10542,17796,7517,1032,36888,758,180,279,1217,38105
28-04-2019,0,10298,16237,7466,1136,35139,774,165,258,1197,36336
28-04-2019,1,10085,16161,7489,866,34602,751,156,259,1166,35768
28-04-2019,2,9518,15582,7463,856,33419,741,157,276,1174,34593
28-04-2019,3,9164,15646,7383,858,33052,731,155,275,1161,34213
28-04-2019,4,9225,15485,7286,907,32903,730,151,261,1142,34045
28-04-2019,5,8949,15354,7116,957,32376,739,151,263,1153,33529
28-04-2019,6,8978,15946,6942,989,32854,740,330,236,1306,34160
28-04-2019,7,9449,16682,6929,1156,34216,733,341,232,1306,35522
28-04-2019,8,10624,17748,6896,1210,36478,731,343,238,1312,37790
28-04-2019,9,12094,18217,6902,1254,38466,742,425,290,1457,39923
28-04-2019,10,12188,18376,6846,1449,38859,744,430,279,1453,40312
28-04-2019,11,12285,18276,6779,1530,38869,751,431,303,1485,40354
28-04-2019,12,11818,18290,6703,1614,38425,753,432,333,1518,39943
28-04-2019,13,11050,18168,6597,1648,37463,746,486,381,1613,39076
28-04-2019,14,10654,17979,6564,1694,36890,740,567,394,1701,38591
28-04-2019,15,10796,18169,6577,1662,37202,755,576,385,1716,38918
28-04-2019,16,11176,18216,6597,1667,37656,740,673,361,1774,39430
28-04-2019,17,11850,18217,6661,1641,38370,730,675,354,1759,40129
28-04-2019,18,13625,18454,6769,1874,40721,719,673,378,1770,42491
28-04-2019,19,14480,18614,6790,1870,41754,712,659,410,1781,43535
28-04-2019,20,14700,18976,6896,1784,42357,694,495,455,1644,44001
28-04-2019,21,14909,19237,6932,1726,42803,703,483,494,1680,44483
28-04-2019,22,14391,18573,6880,1708,41553,690,399,486,1575,43128
28-04-2019,23,13638,18288,6818,1420,40164,675,224,489,1388,41552
29-04-2019,0,12036,17482,6970,1176,37664,667,161,504,1332,38996
29-04-2019,1,11520,17240,7098,1148,37008,665,158,493,1316,38324
29-04-2019,2,11325,17254,7241,1203,37023,659,184,496,1339,38362
29-04-2019,3,11066,17129,7401,1182,36777,646,180,506,1332,38109
29-04-2019,4,10614,17380,7335,1349,36679,638,181,509,1328,38007
29-04-2019,5,11297,17846,7548,1443,38134,638,193,494,1325,39459
29-04-2019,6,14051,19511,7926,1802,43289,650,835,430,1915,45204
29-04-2019,7,16606,19851,7814,1922,46194,658,1109,518,2285,48479
29-04-2019,8,17009,19491,7758,2173,46431,669,1115,509,2293,48724
29-04-2019,9,16591,19241,7616,2422,45870,676,1100,507,2283,48153
29-04-2019,10,15902,19151,7733,2490,45276,660,1082,598,2340,47616
29-04-2019,11,15565,19167,7764,2558,45055,649,1007,667,2323,47378
29-04-2019,12,15296,19132,7651,2804,44884,668,1070,603,2341,47225
29-04-2019,13,14884,18961,7559,2965,44369,657,1009,566,2232,46601
29-04-2019,14,13912,18446,7331,2546,42236,667,886,534,2087,44323
29-04-2019,15,13515,18018,7259,2705,41496,672,781,518,1971,43467
29-04-2019,16,13625,17842,7313,2734,41514,669,778,543,1990,43504
29-04-2019,17,14905,18347,7337,2711,43301,663,786,533,1982,45283
29-04-2019,18,14960,18474,7307,2574,43317,654,788,525,1967,45284
29-04-2019,19,14707,18793,7305,2327,43133,663,800,533,1996,45129
29-04-2019,20,13873,18823,7121,2253,42070,686,836,357,1879,43949
29-04-2019,21,13675,18782,7150,2198,41806,682,571,416,1669,43475
29-04-2019,22,13058,18555,7048,2189,40850,652,401,444,1497,42347
29-04-2019,23,11688,17749,6973,1811,38222,649,395,441,1485,39707
30-04-2019,0,10730,16872,6884,1400,35886,652,389,418,1459,37345
30-04-2019,1,10334,16454,6798,1506,35093,650,388,406,1444,36537
30-04-2019,2,10065,16552,6689,1401,34707,646,386,412,1444,36151
30-04-2019,3,9965,16461,6716,1310,34454,647,388,411,1446,35900
30-04-2019,4,10036,16550,6876,1356,34818,634,403,380,1417,36235
30-04-2019,5,10254,16694,7076,1272,35297,627,445,358,1430,36727
30-04-2019,6,13470,17209,7443,1743,39866,638,964,501,2103,41969
30-04-2019,7,15114,18124,7569,2211,43018,675,1022,452,2149,45167
30-04-2019,8,15960,18457,7655,2406,44479,678,1154,423,2255,46734
30-04-2019,9,16301,18152,7568,2601,44622,681,1333,463,2477,47099
30-04-2019,10,16310,17975,7541,2696,44521,684,1312,489,2485,47006
30-04-2019,11,15829,17902,7644,2768,44145,687,1295,521,2503,46648
30-04-2019,12,15142,17734,7606,2783,43266,691,1221,509,2421,45687
30-04-2019,13,14483,17138,7519,3032,42173,692,1206,504,2402,44575
30-04-2019,14,13249,16977,7231,2980,40438,703,1003,468,2174,42612
30-04-2019,15,12762,17058,7138,2912,39868,705,916,487,2108,41976
30-04-2019,16,12951,17127,7167,2825,40069,699,788,490,1977,42046
30-04-2019,17,14454,17274,7313,2625,41664,694,775,486,1955,43619
30-04-2019,18,14572,17200,7267,2784,41823,671,765,494,1930,43753
30-04-2019,19,14055,17181,7217,2731,41185,681,769,468,1918,43103
30-04-2019,20,12881,16797,7252,2703,39634,681,841,482,2004,41638
30-04-2019,21,12663,16871,7315,2531,39381,684,612,510,1806,41187
30-04-2019,22,12185,16867,7311,2491,38855,648,611,345,1604,40459
30-04-2019,23,11559,16096,7055,2600,37309,624,386,342,1352,38661
01-05-2019,0,10028,15792,7071,2983,35875,631,137,339,1107,36982
01-05-2019,1,9594,15803,7171,2939,35507,622,246,323,1191,36698
01-05-2019,2,9215,15572,7072,3086,34946,624,268,294,1186,36132
01-05-2019,3,8715,15482,7098,3070,34363,618,261,257,1136,35499
01-05-2019,4,8817,15572,7150,3361,34899,617,197,227,1041,35940
01-05-2019,5,8517,15323,7049,3547,34435,619,189,204,1012,35447
01-05-2019,6,8804,15270,6845,3689,34608,608,161,273,1042,35650
01-05-2019,7,9366,15882,6836,3892,35975,623,379,275,1277,37252
01-05-2019,8,10813,17009,6929,4049,38801,630,382,315,1327,40128
01-05-2019,9,11320,16997,7118,4276,39712,631,459,241,1331,41043
01-05-2019,10,11941,17263,6965,4597,40768,642,524,248,1414,42182
01-05-2019,11,11868,17489,6894,4892,41143,651,502,233,1386,42529
01-05-2019,12,11831,17219,6890,4844,40783,663,518,242,1423,42206
01-05-2019,13,11298,16579,6847,5007,39731,667,450,263,1380,41111
01-05-2019,14,11152,16564,6915,4692,39323,675,416,293,1384,40707
01-05-2019,15,11091,16474,6923,5053,39542,675,392,345,1412,40954
01-05-2019,16,11017,16639,7004,5453,40113,670,368,341,1379,41492
01-05-2019,17,11209,17030,7080,5490,40807,667,372,312,1351,42158
01-05-2019,18,11284,17303,7104,5632,41324,682,421,287,1390,42714
01-05-2019,19,11471,17817,7177,5485,41951,671,452,292,1415,43366
01-05-2019,20,11836,17829,6975,5369,42008,673,561,330,1564,43572
01-05-2019,21,11545,17813,6660,5512,41530,694,277,361,1332,42862
01-05-2019,22,10928,17430,6439,5296,40093,710,155,386,1251,41344
01-05-2019,23,10768,17087,6382,5257,39494,665,186,393,1244,40738
02-05-2019,0,10120,16451,6138,5200,37908,645,163,440,1248,39156
02-05-2019,1,9911,16175,6100,5015,37202,648,149,455,1252,38454
02-05-2019,2,9843,16034,6118,4838,36833,622,142,476,1240,38073
02-05-2019,3,9546,16191,6203,4455,36394,614,136,505,1255,37649
02-05-2019,4,9717,16350,6246,4566,36879,614,138,559,1311,38190
02-05-2019,5,9915,17579,6520,4524,38538,609,142,567,1318,39856
02-05-2019,6,11687,18887,7107,4742,42425,602,187,661,1450,43875
02-05-2019,7,13160,20594,7442,4967,46162,604,390,812,1806,47968
02-05-2019,8,13873,20921,7376,5223,47393,612,455,780,1847,49240
02-05-2019,9,13491,20827,7347,5544,47210,612,473,805,1890,49100
02-05-2019,10,13196,20951,7484,5532,47163,628,407,864,1899,49062
02-05-2019,11,12804,20720,7573,6115,47212,625,305,803,1733,48945
02-05-2019,12,12811,20682,7674,6038,47206,627,315,655,1597,48803
02-05-2019,13,12736,20287,7695,6031,46750,682,265,661,1608,48358
02-05-2019,14,12567,20183,7705,5932,46387,689,252,660,1601,47988
02-05-2019,15,12373,20043,7724,5980,46120,715,244,664,1623,47743
02-05-2019,16,12754,20035,7796,5882,46468,734,182,656,1572,48040
02-05-2019,17,12992,20276,7864,6240,47372,756,173,646,1575,48947
02-05-2019,18,13478,19875,7862,6090,47306,767,231,641,1639,48945
02-05-2019,19,13459,19480,7890,5699,46527,780,408,799,1987,48514
02-05-2019,20,13898,19176,7888,5374,46338,761,410,731,1902,48240
02-05-2019,21,14115,18916,8057,4959,46048,757,400,695,1852,47900
02-05-2019,22,13811,18399,8016,4759,44986,753,309,446,1508,46494
02-05-2019,23,12685,17324,7734,4339,42083,712,193,413,1318,43401
03-05-2019,0,11340,16776,7643,4093,39851,699,273,380,1352,41203
03-05-2019,1,10933,16535,7700,4014,39181,684,220,338,1242,40423
03-05-2019,2,10764,16613,7740,3830,38948,722,156,338,1216,40164
03-05-2019,3,10512,16634,7721,3692,38560,716,157,332,1205,39765
03-05-2019,4,11009,16913,7793,3632,39348,722,154,318,1194,40542
03-05-2019,5,11865,17186,8081,3514,40648,719,198,302,1219,41867
03-05-2019,6,14526,18823,8283,3629,45260,720,466,489,1675,46935
03-05-2019,7,16651,19284,8235,4631,48802,757,635,518,1910,50712
03-05-2019,8,17128,19121,8182,5064,49496,762,781,611,2154,51650
03-05-2019,9,16398,19324,8254,5274,49250,740,823,635,2198,51448
03-05-2019,10,15762,19529,8214,5286,48793,726,731,668,2125,50918
03-05-2019,11,14976,19750,8213,5456,48394,784,690,619,2093,50487
03-05-2019,12,14566,19566,8234,5512,47877,736,634,632,2002,49879
03-05-2019,13,13292,19314,8186,5570,46363,739,623,606,1968,48331
03-05-2019,14,12731,18816,8095,5814,45456,736,465,581,1782,47238
03-05-2019,15,12008,18696,7967,5673,44344,716,449,375,1540,45884
03-05-2019,16,11767,18868,7934,5548,44119,713,462,340,1515,45634
03-05-2019,17,12833,18770,7906,5393,44903,696,491,493,1680,46583
03-05-2019,18,13881,18911,7814,4879,45485,680,456,435,1571,47056
03-05-2019,19,14389,18482,7678,4515,45065,688,457,422,1567,46632
03-05-2019,20,14644,18445,7603,4294,44987,651,417,457,1525,46512
03-05-2019,21,15045,18304,7487,4125,44961,641,300,446,1387,46348
03-05-2019,22,14519,17635,7400,3797,43350,653,282,422,1357,44707
03-05-2019,23,13736,16919,7290,4015,41959,650,371,238,1259,43218
04-05-2019,0,11971,16300,7117,3826,39214,631,213,268,1112,40326
04-05-2019,1,11178,15997,6912,3438,37525,612,247,252,1111,38636
04-05-2019,2,10450,15861,6784,3549,36645,611,233,246,1090,37735
04-05-2019,3,9720,15898,6701,3329,35647,614,225,258,1097,36744
04-05-2019,4,9814,15841,6595,3218,35467,611,191,311,1113,36580
04-05-2019,5,9748,15698,6464,3167,35077,583,205,343,1131,36208
04-05-2019,6,10651,15786,6416,3347,36201,586,270,323,1179,37380
04-05-2019,7,12197,16212,6425,3958,38791,609,318,343,1270,40061
04-05-2019,8,14176,17032,6418,4209,41835,638,648,366,1652,43487
04-05-2019,9,14922,17077,6622,4258,42879,662,749,440,1851,44730
04-05-2019,10,13750,17170,6656,4384,41961,683,758,465,1906,43867
04-05-2019,11,12992,17106,6631,4393,41123,698,762,443,1903,43026
04-05-2019,12,12255,17152,6574,3939,39921,702,769,421,1892,41813
04-05-2019,13,11804,17113,6586,4354,39858,692,738,465,1895,41753
04-05-2019,14,11735,17147,6586,3869,39338,646,327,436,1409,40747
04-05-2019,15,11539,17207,6583,3721,39050,627,363,389,1379,40429
04-05-2019,16,11650,17237,6538,3588,39012,641,404,323,1368,40380
04-05-2019,17,12317,17214,6710,3300,39541,672,392,258,1322,40863
04-05-2019,18,13038,17204,6640,3138,40019,615,381,228,1224,41243
04-05-2019,19,14409,17700,6422,2495,41028,628,354,227,1209,42237
04-05-2019,20,15000,17653,6452,2152,41257,649,302,222,1173,42430
04-05-2019,21,15557,17912,6552,2027,42049,636,192,201,1029,43078
04-05-2019,22,15799,17569,6741,2058,42167,615,194,196,1005,43172
04-05-2019,23,14305,16821,6773,2060,39960,611,186,195,992,40952
05-05-2019,0,12667,16045,6735,2040,37488,625,198,193,1016,38504
05-05-2019,1,11895,15618,6654,2068,36236,605,187,197,989,37225
05-05-2019,2,11130,15542,6639,1968,35280,588,189,189,966,36246
05-05-2019,3,10885,15262,6596,2079,34822,581,194,185,960,35782
05-05-2019,4,10506,15154,6570,2188,34418,572,199,182,953,35371
05-05-2019,5,10634,15149,6552,2242,34576,575,201,179,955,35531
05-05-2019,6,10351,15037,6399,2325,34112,564,240,178,982,35094
05-05-2019,7,11033,15174,6470,2587,35265,584,370,179,1133,36398
05-05-2019,8,11672,15668,6658,2871,36871,593,377,183,1153,38024
05-05-2019,9,11923,15836,6719,3372,37851,569,370,207,1146,38997
05-05-2019,10,12302,15762,6752,3733,38549,584,357,224,1165,39714
05-05-2019,11,12124,15832,6740,3903,38599,589,355,244,1188,39787
05-05-2019,12,11900,15489,6637,4197,38223,612,355,262,1229,39452
05-05-2019,13,11643,15525,6597,4459,38225,612,348,290,1250,39475
05-05-2019,14,11526,15640,6601,4671,38438,611,345,310,1266,39704
05-05-2019,15,11568,15900,6628,4720,38816,613,347,321,1281,40097
05-05-2019,16,11607,15935,6604,4874,39020,607,364,306,1277,40297
05-05-2019,17,11959,16107,6454,4871,39392,602,365,298,1265,40657
05-05-2019,18,11802,16251,6416,4679,39148,601,669,273,1543,40691
05-05-2019,19,12545,16333,6444,4595,39918,626,709,243,1578,41496
05-05-2019,20,13284,16591,6498,4588,40961,685,665,229,1579,42540
05-05-2019,21,13507,16805,6554,4534,41402,724,551,227,1502,42904
05-05-2019,22,13336,16733,6564,4475,41108,762,552,239,1553,42661
05-05-2019,23,12159,16092,6546,4188,38985,660,217,226,1103,40088
06-05-2019,0,11115,15177,6501,4025,36818,659,201,194,1054,37872
06-05-2019,1,10604,14920,6448,3959,35932,655,199,184,1038,36970
06-05-2019,2,10540,14918,6475,3914,35847,665,218,180,1063,36910
06-05-2019,3,10554,14896,6515,3919,35885,667,203,188,1058,36943
06-05-2019,4,10518,15062,6532,3933,36047,678,215,194,1087,37134
06-05-2019,5,12268,15682,6908,4139,38997,721,284,200,1205,40202
06-05-2019,6,16023,17768,7261,4253,45306,749,496,441,1686,46992
06-05-2019,7,18864,19317,7221,3702,49105,744,546,436,1726,50831
06-05-2019,8,18292,19036,7258,4136,48723,773,1255,427,2455,51178
06-05-2019,9,17388,18669,7274,4602,47932,795,1241,461,2497,50429
06-05-2019,10,17080,18572,7241,4670,47562,794,1260,485,2539,50101
06-05-2019,11,16732,18398,7188,5273,47591,793,1192,487,2472,50063
06-05-2019,12,16367,18621,7216,5492,47694,786,994,515,2295,49989
06-05-2019,13,15895,18681,7328,5990,47894,775,828,526,2129,50023
06-05-2019,14,15121,18193,7020,5638,45972,732,767,251,1750,47722
06-05-2019,15,14395,17815,6776,5554,44541,723,767,262,1752,46293
06-05-2019,16,14682,17963,6730,5488,44864,727,762,256,1745,46609
06-05-2019,17,15455,18144,6906,5826,46332,722,781,258,1761,48093
06-05-2019,18,15898,18121,7105,5641,46766,734,839,491,2064,48830
06-05-2019,19,16141,18155,7138,5456,46891,732,865,480,2077,48968
06-05-2019,20,15871,17692,6973,5082,45620,711,703,256,1670,47290
06-05-2019,21,15989,17689,7158,4704,45541,745,283,243,1271,46812
06-05-2019,22,14741,17380,7339,4943,44403,747,194,245,1186,45589
06-05-2019,23,12999,16788,7454,4830,42073,746,188,239,1173,43246
07-05-2019,0,11969,16100,7438,4413,39921,746,191,258,1195,41116
07-05-2019,1,11072,15550,7452,4676,38751,707,191,285,1183,39934
07-05-2019,2,10898,15264,7424,4580,38166,708,195,315,1218,39384
07-05-2019,3,10923,15267,7395,4615,38198,702,193,325,1220,39418
07-05-2019,4,11246,15603,7298,4435,38582,728,214,312,1254,39836
07-05-2019,5,13284,16593,7385,4576,41838,785,220,331,1336,43174
07-05-2019,6,17290,18702,7402,4666,48061,799,320,292,1411,49472
07-05-2019,7,19233,19211,7339,5069,50852,902,518,482,1902,52754
07-05-2019,8,18790,19269,7307,5421,50786,1002,691,579,2272,53058
07-05-2019,9,18081,19102,7420,5201,49805,712,778,643,2133,51938
07-05-2019,10,17743,19315,7495,5366,49919,635,609,687,1931,51850
07-05-2019,11,17342,19174,7527,5347,49390,682,374,746,1802,51192
07-05-2019,12,17175,19146,7410,5340,49072,787,367,718,1872,50944
07-05-2019,13,16911,19037,7437,5283,48669,771,361,751,1883,50552
07-05-2019,14,16244,18732,7352,5321,47651,795,355,546,1696,49347
07-05-2019,15,15368,18427,7291,4991,46077,804,351,545,1700,47777
07-05-2019,16,15327,18377,7256,4825,45783,792,328,526,1646,47429
07-05-2019,17,16399,18405,7223,4681,46710,809,346,463,1618,48328
07-05-2019,18,17516,18291,7149,4217,47174,813,357,497,1667,48841
07-05-2019,19,17889,18290,7202,3803,47185,823,359,422,1604,48789
07-05-2019,20,17803,17891,7139,3522,46356,800,379,270,1449,47805
07-05-2019,21,17743,17416,7007,3294,45462,802,322,274,1398,46860
07-05-2019,22,16842,17195,6971,3135,44144,813,238,290,1341,45485
07-05-2019,23,15286,16754,6821,2446,41307,814,207,297,1318,42625
08-05-2019,0,13847,15859,6763,1880,38349,824,195,292,1311,39660
08-05-2019,1,12083,15123,6679,1462,35346,819,195,282,1296,36642
08-05-2019,2,11276,15244,6840,1458,34818,791,238,268,1297,36115
08-05-2019,3,11223,15324,7140,1489,35176,813,197,255,1265,36441
08-05-2019,4,11384,15540,7303,1380,35607,824,206,264,1294,36901
08-05-2019,5,12838,15772,7452,1405,37467,803,247,347,1397,38864
08-05-2019,6,16887,18129,7518,1681,44214,785,365,302,1452,45666
08-05-2019,7,19469,18793,7709,2058,48029,828,501,269,1598,49627
08-05-2019,8,19508,18725,7917,2192,48343,919,584,281,1784,50127
08-05-2019,9,18102,18455,7885,2236,46678,834,704,336,1874,48552
08-05-2019,10,16605,18508,7914,2302,45329,900,772,304,1976,47305
08-05-2019,11,15967,18447,7774,2602,44792,885,778,302,1965,46757
08-05-2019,12,14715,18101,7768,2719,43303,815,748,273,1836,45139
08-05-2019,13,14170,18164,7882,2647,42862,826,616,263,1705,44567
08-05-2019,14,13133,18306,7966,2555,41960,826,447,233,1506,43466
08-05-2019,15,12328,18150,7940,2651,41070,792,417,229,1438,42508
08-05-2019,16,12071,18083,7832,2887,40873,793,341,222,1356,42229
08-05-2019,17,12496,18288,7773,3354,41911,794,331,229,1354,43265
08-05-2019,18,13154,18419,7755,3376,42703,779,375,214,1368,44071
08-05-2019,19,13981,18176,7672,3434,43262,775,358,193,1326,44588
08-05-2019,20,14083,17809,7590,3389,42871,768,242,215,1225,44096
08-05-2019,21,13583,17739,7571,3408,42302,765,200,272,1237,43539
08-05-2019,22,13233,17176,7452,3515,41377,705,193,319,1217,42594
08-05-2019,23,11793,16465,7205,3723,39187,719,191,367,1277,40464
09-05-2019,0,10957,15851,7087,3637,37533,712,190,406,1308,38841
09-05-2019,1,10691,15605,7036,3183,36516,718,190,449,1357,37873
09-05-2019,2,10748,15702,6907,3052,36408,727,192,473,1392,37800
09-05-2019,3,10578,15576,6784,2733,35670,760,207,477,1444,37114
09-05-2019,4,10689,16032,6821,2569,36111,806,225,471,1502,37613
09-05-2019,5,11649,16487,6750,2397,37283,808,243,497,1548,38831
09-05-2019,6,14422,17943,6683,2557,41606,833,279,472,1584,43190
09-05-2019,7,17127,19101,6713,2769,45710,816,372,401,1589,47299
09-05-2019,8,17627,19455,6745,2813,46641,823,698,472,1993,48634
09-05-2019,9,17420,19613,6753,2801,46588,811,661,603,2075,48663
09-05-2019,10,17167,19925,6605,2980,46678,815,655,615,2085,48763
09-05-2019,11,16730,20073,6477,3138,46418,788,718,567,2073,48491
09-05-2019,12,16572,19968,6423,3139,46103,818,730,542,2090,48193
09-05-2019,13,16129,20028,6383,3136,45676,842,769,516,2127,47803
09-05-2019,14,16174,19766,6375,2993,45309,856,728,489,2073,47382
09-05-2019,15,16000,19473,6402,3026,44901,871,709,467,2047,46948
09-05-2019,16,15964,19450,6397,3106,44919,897,757,419,2073,46992
09-05-2019,17,16054,19414,6435,2976,44878,906,782,377,2065,46943
09-05-2019,18,15969,19251,6447,2653,44321,894,861,331,2086,46407
09-05-2019,19,16217,19162,6573,2258,44211,860,915,279,2054,46265
09-05-2019,20,16289,18260,6707,2112,43367,851,573,308,1732,45099
09-05-2019,21,15960,17761,6906,2241,42868,872,371,386,1629,44497
09-05-2019,22,15183,16946,6984,2182,41295,877,358,436,1671,42966
09-05-2019,23,13783,16116,6943,2006,38849,816,353,445,1614,40463
10-05-2019,0,12044,15547,6887,1831,36310,794,354,438,1586,37896
10-05-2019,1,10808,15130,6814,1833,34584,794,352,380,1526,36110
10-05-2019,2,9972,14835,6801,1845,33451,783,355,306,1444,34895
10-05-2019,3,9499,14762,6836,1605,32702,751,355,299,1405,34107
10-05-2019,4,10117,14943,6963,1575,33598,745,352,310,1407,35005
10-05-2019,5,11676,15807,7097,1677,36259,738,362,308,1408,37667
10-05-2019,6,14793,17347,6847,1984,40971,783,455,302,1540,42511
10-05-2019,7,17718,18761,6697,2621,45798,778,781,466,2025,47823
10-05-2019,8,18716,18456,6797,3016,46985,777,862,462,2101,49086
10-05-2019,9,18246,18372,6808,3128,46555,777,963,501,2241,48796
10-05-2019,10,17644,18331,6892,3212,46078,828,1006,282,2116,48194
10-05-2019,11,16869,18150,6848,3132,44999,778,873,487,2138,47137
10-05-2019,12,15878,18029,6923,3106,43937,766,914,500,2180,46117
10-05-2019,13,14952,18058,6811,3300,43124,772,1022,433,2227,45351
10-05-2019,14,13861,17957,6782,3517,42119,774,918,425,2117,44236
10-05-2019,15,13085,17770,6705,3648,41209,776,861,435,2072,43281
10-05-2019,16,13476,18057,6629,3872,42035,777,789,409,1975,44010
10-05-2019,17,14847,18499,6645,4423,44415,768,368,267,1403,45818
10-05-2019,18,15388,18049,6629,4321,44388,770,358,185,1313,45701
10-05-2019,19,15591,18005,6557,3999,44152,774,517,180,1471,45623
10-05-2019,20,15315,17907,6407,3753,43381,786,665,178,1629,45010
10-05-2019,21,15468,17912,6357,3419,43155,794,254,177,1225,44380
10-05-2019,22,15331,17343,6257,3302,42234,776,165,177,1118,43352
10-05-2019,23,13967,16357,6127,3151,39603,786,163,177,1126,40729
11-05-2019,0,13080,15336,6105,2792,37314,761,163,241,1165,38479
11-05-2019,1,11239,14827,5995,2341,34402,716,164,179,1059,35461
11-05-2019,2,10025,14643,5947,2141,32757,719,164,181,1064,33821
11-05-2019,3,9961,14497,5930,2093,32482,717,163,179,1059,33541
11-05-2019,4,9604,14270,5863,2056,31792,711,162,176,1049,32841
11-05-2019,5,9642,14951,5802,2020,32417,712,169,175,1056,33473
11-05-2019,6,9835,15558,5878,2042,33314,706,269,175,1150,34464
11-05-2019,7,10554,16101,5869,2320,34843,711,271,178,1160,36003
11-05-2019,8,11973,16718,5967,2871,37529,751,459,187,1397,38926
11-05-2019,9,12717,16843,5955,3139,38654,750,591,192,1533,40187
11-05-2019,10,12828,16639,5928,3218,38614,768,491,196,1455,40069
11-05-2019,11,12148,16463,5879,3256,37746,775,347,202,1324,39070
11-05-2019,12,11322,16547,5796,3417,37085,787,334,236,1357,38442
11-05-2019,13,10680,16445,5716,3587,36428,752,332,288,1372,37800
11-05-2019,14,10403,16171,5690,3732,35996,762,362,328,1452,37448
11-05-2019,15,10179,15897,5736,4047,35859,789,425,349,1563,37422
11-05-2019,16,10425,16292,5791,4255,36764,756,432,330,1518,38282
11-05-2019,17,10636,16666,5879,4351,37532,780,432,320,1532,39064
11-05-2019,18,10776,16649,5888,4286,37598,781,432,300,1513,39111
11-05-2019,19,10545,16654,6021,4194,37414,771,432,261,1464,38878
11-05-2019,20,10447,16810,6183,3962,37402,780,329,230,1339,38741
11-05-2019,21,11121,16899,6444,3744,38209,756,229,227,1212,39421
11-05-2019,22,11706,16491,6607,3660,38466,757,171,217,1145,39611
11-05-2019,23,11267,16213,6610,3730,37820,769,169,211,1149,38969
12-05-2019,0,10524,15683,6664,3990,36863,678,136,194,1008,37871
12-05-2019,1,10215,15699,6658,3784,36355,649,135,199,983,37338
12-05-2019,2,9751,15495,6566,3732,35544,661,134,190,985,36529
12-05-2019,3,9036,15099,6423,3809,34368,639,135,195,969,35337
12-05-2019,4,9137,15376,6381,3669,34565,639,141,208,988,35553
12-05-2019,5,9195,15664,6355,3569,34785,645,142,208,995,35780
12-05-2019,6,9479,15997,6417,3520,35414,653,138,201,992,36406
12-05-2019,7,9774,16303,6448,3650,36176,665,139,191,995,37171
12-05-2019,8,10020,16773,6576,3869,37239,659,291,196,1146,38385
12-05-2019,9,10468,17074,6699,3989,38231,664,290,204,1158,39389
12-05-2019,10,10645,17054,6760,3931,38391,657,274,226,1157,39548
12-05-2019,11,10251,16932,6811,3982,37978,668,278,236,1182,39160
12-05-2019,12,10223,17038,6787,4121,38168,662,279,245,1186,39354
12-05-2019,13,10414,16634,6818,3665,37531,657,147,247,1051,38582
12-05-2019,14,10390,16438,6854,3215,36898,649,133,243,1025,37923
12-05-2019,15,10237,16353,6851,3178,36619,647,137,230,1014,37633
12-05-2019,16,10326,16484,6828,3280,36920,627,136,235,998,37918
12-05-2019,17,10349,16748,6943,3777,37818,640,215,255,1110,38928
12-05-2019,18,10694,17023,7043,3954,38715,641,273,284,1198,39913
12-05-2019,19,10801,17172,7161,3837,38971,662,460,329,1451,40422
12-05-2019,20,11348,17115,7248,3456,39167,663,600,310,1573,40740
12-05-2019,21,11905,17192,7325,3051,39474,661,611,301,1573,41047
12-05-2019,22,12254,17157,7227,2875,39514,673,305,298,1276,40790
12-05-2019,23,11238,17034,7116,2800,38188,687,291,272,1250,39438
13-05-2019,0,10615,15759,6960,2870,,598,203,268,1069,
13-05-2019,1,10213,15749,6961,2682,35604,598,186,251,1035,36639
13-05-2019,2,9955,15852,6991,2612,35409,601,133,274,1008,36417
13-05-2019,3,9759,15935,6953,2602,35250,596,132,277,1005,36255
13-05-2019,4,9791,15838,6938,2597,35165,608,134,252,994,36159
13-05-2019,5,10821,16323,7053,2656,36854,704,157,253,1114,37968
13-05-2019,6,13837,18650,7293,2921,42699,767,288,380,1435,44134
13-05-2019,7,16408,19741,7647,3244,47040,777,632,429,1838,48878
13-05-2019,8,17146,19807,7672,3577,48205,771,727,497,1995,50200
13-05-2019,9,15680,19432,7708,3782,46603,761,685,506,1952,48555
13-05-2019,10,14492,19269,7692,3636,45091,754,758,525,2037,47128
13-05-2019,11,13606,19144,7590,3736,44075,755,759,518,2032,46107
13-05-2019,12,12971,18831,7521,3852,43176,772,789,479,2040,45216
13-05-2019,13,12779,18745,7488,3938,42950,752,710,475,1937,44887
13-05-2019,14,12646,18519,7123,3819,42108,491,656,440,1587,43695
13-05-2019,15,12511,18383,6996,3557,41448,501,614,444,1559,43007
13-05-2019,16,12487,18385,7161,3441,41473,509,705,261,1475,42948
13-05-2019,17,12990,18441,7285,3125,41841,564,639,451,1654,43495
13-05-2019,18,13450,18458,7326,3180,42414,570,539,430,1539,43953
13-05-2019,19,14692,18504,7258,3032,43488,563,543,549,1655,45143
13-05-2019,20,15535,18402,6950,2712,43601,574,390,337,1301,44902
13-05-2019,21,15806,18422,6796,2146,43171,560,377,363,1300,44471
13-05-2019,22,15462,17793,6699,2003,41955,558,223,276,1057,43012
13-05-2019,23,13240,16460,6560,1533,37794,568,202,280,1050,38844
14-05-2019,0,11674,15329,6481,1261,34743,571,202,309,1082,35825
14-05-2019,1,10615,15231,6501,1153,33502,598,240,329,1167,34669
14-05-2019,2,10345,15100,6575,1106,33127,624,282,316,1222,34349
14-05-2019,3,10431,15014,6581,1028,33055,606,374,325,1305,34360
14-05-2019,4,10816,15086,6511,951,33362,675,383,326,1384,34746
14-05-2019,5,12469,15827,6677,1022,35996,694,393,304,1391,37387
14-05-2019,6,15734,17370,6743,1644,41492,688,872,360,1920,43412
14-05-2019,7,17679,17905,7003,2113,44699,688,1010,535,2233,46932
14-05-2019,8,18084,17845,7023,2211,45164,693,1048,553,2294,47458
14-05-2019,9,17027,17683,6992,1945,43647,710,1007,514,2231,45878
14-05-2019,10,16028,17437,6933,2041,42439,730,1019,581,2330,44769
14-05-2019,11,15413,17416,6922,2076,41827,739,1008,605,2352,44179
14-05-2019,12,15074,17432,6947,2121,41574,739,813,553,2105,43679
14-05-2019,13,14749,17363,6875,2150,41137,771,769,472,2012,43149
14-05-2019,14,14076,17209,6800,1993,40078,731,594,359,1684,41762
14-05-2019,15,13487,17183,6783,1910,39363,711,585,357,1653,41016
14-05-2019,16,13278,17262,6693,1941,39175,693,587,323,1603,40778
14-05-2019,17,13952,17186,6550,1909,39597,689,587,318,1594,41191
14-05-2019,18,15153,17183,6572,1771,40678,723,762,339,1824,42502
14-05-2019,19,16168,17400,6605,1896,42071,709,768,325,1802,43873
14-05-2019,20,16340,16816,6510,1876,41544,731,555,311,1597,43141
14-05-2019,21,16139,16763,6435,1598,40935,788,386,292,1466,42401
14-05-2019,22,15141,15900,6456,1456,38953,745,384,282,1411,40364
14-05-2019,23,12616,14909,6456,881,34862,758,377,285,1420,36282
15-05-2019,0,11383,14287,6335,853,32858,697,375,306,1378,34236
15-05-2019,1,10555,13945,6287,909,31697,697,374,323,1394,33091
15-05-2019,2,10234,13926,6210,1064,31435,672,375,309,1356,32791
15-05-2019,3,10267,14126,6213,1082,31688,660,376,313,1349,33037
15-05-2019,4,10392,14275,6064,1012,31742,651,383,318,1352,33094
15-05-2019,5,11850,14623,6209,1101,33782,648,396,324,1368,35150
15-05-2019,6,15510,16143,6360,1756,39770,641,908,392,1941,41711
15-05-2019,7,17876,17260,6491,2184,43811,642,1011,601,2254,46065
15-05-2019,8,18165,17231,6580,2345,44322,643,1134,766,2543,46865
15-05-2019,9,17555,17058,6447,2068,43127,647,1085,870,2602,45729
15-05-2019,10,16869,16890,6393,2297,42449,640,1117,659,2416,44865
15-05-2019,11,15630,16897,6420,2575,41523,610,1089,650,2349,43872
15-05-2019,12,15242,16963,6532,1890,40627,620,1057,630,2307,42934
15-05-2019,13,15154,16902,6543,1743,40342,638,1034,446,2118,42460
15-05-2019,14,14783,16558,6240,1807,39389,645,660,445,1750,41139
15-05-2019,15,14262,16189,6025,1836,38314,631,697,450,1778,40092
15-05-2019,16,13871,16132,5978,1810,37792,569,696,455,1720,39512
15-05-2019,17,14591,16393,5917,1708,38610,579,707,455,1741,40351
15-05-2019,18,15404,16331,6056,1573,39364,565,905,431,1901,41265
15-05-2019,19,16068,16425,6188,1475,40154,560,822,470,1852,42006
15-05-2019,20,15765,16312,5965,1636,39678,563,688,440,1691,41369
15-05-2019,21,14604,16445,5907,1491,38449,586,423,464,1473,39922
15-05-2019,22,13265,15926,5856,1492,36539,588,415,476,1479,38018
15-05-2019,23,10897,14887,5764,1367,32915,608,407,474,1489,34404
16-05-2019,0,10109,14872,5753,1343,32078,588,399,486,1473,33551
16-05-2019,1,9783,14522,5752,1319,31377,593,399,504,1496,32873
16-05-2019,2,9699,14386,5806,1271,31163,613,407,524,1544,32707
16-05-2019,3,9550,14355,5912,1341,31158,676,412,525,1613,32771
16-05-2019,4,9659,14643,5954,1563,31819,687,414,530,1631,33450
16-05-2019,5,10621,15013,6086,1761,33481,674,594,522,1790,35271
16-05-2019,6,13775,17194,6247,1982,39199,653,770,497,1920,41119
16-05-2019,7,16355,17754,6381,2308,42799,652,951,637,2240,45039
16-05-2019,8,17419,18080,6461,2900,44861,656,1193,607,2456,47317
16-05-2019,9,17029,17572,6340,3432,44375,656,1077,629,2362,46737
16-05-2019,10,16269,17403,6355,3667,43695,645,927,506,2078,45773
16-05-2019,11,15441,17354,6314,3571,42681,632,941,529,2102,44783
16-05-2019,12,14420,17397,6328,3695,41840,642,963,533,2138,43978
16-05-2019,13,13523,16950,6159,3955,40587,652,929,544,2125,42712
16-05-2019,14,12647,16563,5973,3920,39102,656,716,547,1919,41021
16-05-2019,15,12361,16310,5898,3956,38525,652,718,535,1905,40430
16-05-2019,16,12509,17095,5947,3932,39485,639,730,543,1912,41397
16-05-2019,17,13063,17605,5965,3860,40493,640,730,497,1867,42360
16-05-2019,18,13183,17493,5946,3682,40304,627,762,488,1877,42181
16-05-2019,19,13598,17686,6012,2965,40262,619,774,425,1818,42080
16-05-2019,20,13474,17337,6002,2891,39705,625,645,407,1677,41382
16-05-2019,21,12899,16973,5991,3086,38949,649,417,399,1465,40414
16-05-2019,22,11896,16459,6043,3243,37641,655,415,417,1487,39128
16-05-2019,23,9982,15956,5963,3395,35297,660,526,415,1601,36898
17-05-2019,0,9330,15058,5910,3419,33716,670,454,414,1538,35254
17-05-2019,1,8632,14624,5912,3226,32394,665,246,418,1329,33723
17-05-2019,2,8497,14484,5954,2973,31909,666,247,459,1372,33281
17-05-2019,3,8427,14378,5890,3027,31723,680,274,450,1404,33127
17-05-2019,4,8561,14961,5811,3127,32460,678,329,446,1453,33913
17-05-2019,5,9265,15116,6037,3233,33650,646,586,467,1699,35349
17-05-2019,6,11977,16887,6291,3260,38417,647,770,561,1978,40395
17-05-2019,7,13403,17652,6319,3345,40720,685,1112,684,2481,43201
17-05-2019,8,13973,17925,6349,3314,41561,700,1154,701,2555,44116
17-05-2019,9,13890,18216,6360,3510,41976,677,1120,703,2500,44476
17-05-2019,10,13556,18388,6267,3652,41862,662,1079,676,2417,44279
17-05-2019,11,12815,18278,6176,3685,40955,677,1086,660,2423,43378
17-05-2019,12,12377,18003,6193,3692,40266,674,1067,618,2359,42625
17-05-2019,13,12181,17775,6133,3603,39694,689,949,475,2113,41807
17-05-2019,14,11298,17484,5985,3478,38245,679,741,421,1841,40086
17-05-2019,15,10927,17614,5955,3517,38016,715,673,403,1791,39807
17-05-2019,16,11306,17394,5961,3578,38241,701,665,415,1781,40022
17-05-2019,17,12191,17753,6000,3603,39549,688,680,413,1781,41330
17-05-2019,18,12670,17687,6090,3450,39897,699,939,390,2028,41925
17-05-2019,19,13075,17855,6020,3233,40183,662,933,397,1992,42175
17-05-2019,20,13325,17430,5851,3007,39614,653,720,371,1744,41358
17-05-2019,21,13483,17124,5713,2791,39111,683,526,376,1585,40696
17-05-2019,22,13015,16994,5675,2546,38231,685,357,391,1433,39664
17-05-2019,23,12437,16224,5688,2247,36597,559,265,357,1181,37778
18-05-2019,0,11104,15077,5640,1672,33493,509,273,327,1109,34602
18-05-2019,1,10070,14657,5533,1415,31675,507,183,327,1017,32692
18-05-2019,2,9276,14494,5479,1308,30556,509,174,349,1032,31588
18-05-2019,3,9005,14327,5370,1194,29895,493,207,364,1064,30959
18-05-2019,4,9141,14311,5268,1053,29774,496,205,296,997,30771
18-05-2019,5,9124,14199,5237,988,29547,472,304,310,1086,30633
18-05-2019,6,9285,14483,5270,1122,30159,458,431,321,1210,31369
18-05-2019,7,10230,15134,5315,1175,31853,478,670,275,1423,33276
18-05-2019,8,11584,15869,5342,1351,34145,502,773,259,1534,35679
18-05-2019,9,11955,16296,5367,1387,35006,510,750,305,1565,36571
18-05-2019,10,11779,16128,5395,1569,34870,508,832,354,1694,36564
18-05-2019,11,11386,15931,5437,1750,34505,538,734,238,1510,36015
18-05-2019,12,11236,15656,5360,1920,34171,527,727,234,1488,35659
18-05-2019,13,10841,15633,5395,2142,34011,523,658,260,1441,35452
18-05-2019,14,10571,15435,5355,2252,33612,493,658,314,1465,35077
18-05-2019,15,10276,15218,5405,2434,33334,505,640,284,1429,34763
18-05-2019,16,10301,15006,5558,2523,33389,535,650,246,1431,34820
18-05-2019,17,11423,15482,5585,2530,35020,509,777,202,1488,36508
18-05-2019,18,13030,16127,5709,2489,37356,497,753,180,1430,38786
18-05-2019,19,13683,16156,5510,2211,37560,325,834,227,1386,38946
18-05-2019,20,13864,16175,5461,1863,37365,403,746,259,1408,38773
18-05-2019,21,13832,16066,5485,1866,37247,523,336,291,1150,38397
18-05-2019,22,13431,15688,5568,1754,36441,522,280,379,1181,37622
18-05-2019,23,12800,15165,5539,1803,35306,543,266,414,1223,36529
19-05-2019,0,11501,14635,5483,1745,33366,539,307,482,1328,34694
19-05-2019,1,9980,13588,5468,1591,30629,536,309,329,1174,31803
19-05-2019,2,9261,13073,5396,1382,29113,538,305,321,1164,30277
19-05-2019,3,8695,12833,5411,1313,28251,542,300,361,1203,29454
19-05-2019,4,8665,12931,5495,1371,28463,529,413,364,1306,29769
19-05-2019,5,8606,13030,5495,1348,28481,521,537,367,1425,29906
19-05-2019,6,8849,12981,5467,1268,28565,494,646,320,1460,30025
19-05-2019,7,9677,13361,5401,1275,29716,462,683,272,1417,31133
19-05-2019,8,10456,13723,5388,1354,30922,438,692,289,1419,32341
19-05-2019,9,11134,13891,5388,1476,31890,491,701,283,1475,33365
19-05-2019,10,11362,14290,5426,1588,32666,507,684,301,1492,34158
19-05-2019,11,11981,14771,5537,1759,34048,513,609,291,1413,35461
19-05-2019,12,11965,14831,5511,1812,34121,520,544,343,1407,35528
19-05-2019,13,11466,14733,5473,1877,33549,510,529,376,1415,34964
19-05-2019,14,11291,14656,5464,1913,33324,477,467,373,1317,34641
19-05-2019,15,11372,14708,5432,1895,33407,471,466,361,1298,34705
19-05-2019,16,11608,14898,5465,1904,33876,465,472,355,1292,35168
19-05-2019,17,11850,15242,5488,1785,34366,488,479,338,1305,35671
19-05-2019,18,12484,15624,5521,1761,35390,471,625,357,1453,36843
19-05-2019,19,14168,16284,5720,1656,37828,486,744,436,1666,39494
19-05-2019,20,14464,16433,5755,1510,38163,499,781,387,1667,39830
19-05-2019,21,14236,16543,5863,1565,38207,527,758,419,1704,39911
19-05-2019,22,14208,16304,5819,1779,38110,526,759,406,1691,39801
19-05-2019,23,12624,15553,5880,1403,35461,530,300,393,1223,36684
20-05-2019,0,10879,13970,5922,1127,31899,537,343,383,1263,33162
20-05-2019,1,9757,13303,5902,955,29917,548,339,388,1275,31192
20-05-2019,2,9560,13348,5821,872,29602,533,346,404,1283,30885
20-05-2019,3,9630,13538,5752,841,29762,520,365,428,1313,31075
20-05-2019,4,9795,13582,5788,766,29932,505,362,403,1270,31202
20-05-2019,5,11133,13979,5883,777,31772,500,523,391,1414,33186
20-05-2019,6,15474,15682,6077,1297,38531,523,941,397,1861,40392
20-05-2019,7,16846,16558,6093,1462,40960,507,1029,622,2158,43118
20-05-2019,8,17806,16991,6257,1414,42468,510,1048,620,2178,44646
20-05-2019,9,17928,16924,6204,1630,42687,550,1199,608,2357,45044
20-05-2019,10,17909,17000,6134,2103,43146,556,1207,637,2400,45546
20-05-2019,11,17607,16859,6141,2285,42893,563,1202,662,2427,45320
20-05-2019,12,17754,17035,6109,2330,43228,566,1096,699,2361,45589
20-05-2019,13,17700,16993,6116,2258,43068,559,1039,758,2356,45424
20-05-2019,14,17469,16883,5983,2148,42483,573,944,709,2226,44709
20-05-2019,15,17453,16764,5842,2073,42132,535,928,554,2017,44149
20-05-2019,16,17353,16706,5843,2094,41997,534,923,539,1996,43993
20-05-2019,17,17716,16881,5965,2037,42600,568,1040,703,2311,44911
20-05-2019,18,17395,16793,5923,1963,42074,556,1057,721,2334,44408
20-05-2019,19,17325,16768,5960,1934,41989,578,1061,689,2328,44317
20-05-2019,20,16979,16449,5774,1910,41112,532,1042,493,2067,43179
20-05-2019,21,16549,16229,5627,1849,40254,572,704,408,1684,41938
20-05-2019,22,15612,15981,5656,1626,38876,588,621,265,1474,40350
20-05-2019,23,12494,14634,5571,1330,34029,557,562,289,1408,35437
21-05-2019,0,10824,14167,5405,1384,31779,558,474,278,1310,33089
21-05-2019,1,10200,13641,5288,1536,30666,581,462,311,1354,32020
21-05-2019,2,9828,13270,5225,1386,29709,577,373,368,1318,31027
21-05-2019,3,9573,13216,5180,1445,29412,550,375,415,1340,30752
21-05-2019,4,9809,13394,5169,1399,29772,527,467,401,1395,31167
21-05-2019,5,10461,13872,5385,1300,31017,509,648,366,1523,32540
21-05-2019,6,13873,16209,5761,1351,37196,538,811,342,1691,38887
21-05-2019,7,16468,17057,5922,1471,40918,564,1049,500,2113,43031
21-05-2019,8,17078,17206,6037,1514,41835,559,1159,523,2241,44076
21-05-2019,9,17142,17543,6045,1630,42359,561,1365,515,2441,44800
21-05-2019,10,17105,17537,6008,1792,42443,563,1241,505,2309,44752
21-05-2019,11,17023,17346,5962,2124,42457,560,1164,508,2232,44689
21-05-2019,12,16885,17359,5958,2228,42431,563,1083,541,2187,44618
21-05-2019,13,16918,16955,5958,1926,41759,571,1050,561,2182,43941
21-05-2019,14,16668,16764,5933,1951,41316,546,956,521,2023,43339
21-05-2019,15,16106,16885,5859,1641,40492,521,889,523,1933,42425
21-05-2019,16,15190,16712,5749,1615,39266,509,749,540,1798,41064
21-05-2019,17,15688,17124,5819,1747,40379,505,870,354,1729,42108
21-05-2019,18,16175,17450,6003,1778,41404,508,1084,353,1945,43349
21-05-2019,19,16186,17244,6029,1627,41087,543,1063,262,1868,42955
21-05-2019,20,15496,17109,5800,1403,39809,541,1066,226,1833,41642
21-05-2019,21,14722,16934,5597,1280,38534,537,951,299,1787,40321
21-05-2019,22,13395,16025,5672,1221,36314,523,624,277,1424,37738
21-05-2019,23,10828,14363,5601,1450,32243,528,550,242,1320,33563
22-05-2019,0,10109,13950,5461,1809,31330,526,379,254,1159,32489
22-05-2019,1,9893,13730,5405,1977,31003,523,388,256,1167,32170
22-05-2019,2,9437,13460,5366,2060,30325,523,388,267,1178,31503
22-05-2019,3,9335,13462,5320,2136,30254,523,388,275,1186,31440
22-05-2019,4,9432,13148,5347,2176,30104,524,389,252,1165,31269
22-05-2019,5,9881,13562,5569,2349,31361,516,404,242,1162,32523
22-05-2019,6,12693,15283,5879,2605,36461,553,779,226,1558,38019
22-05-2019,7,15908,16477,6078,2653,41116,572,1003,416,1991,43107
22-05-2019,8,16979,16735,6090,2594,42400,569,1303,434,2306,44706
22-05-2019,9,16970,16682,6124,2576,42353,569,1321,465,2355,44708
22-05-2019,10,16779,16539,6215,3013,42546,580,1321,444,2345,44891
22-05-2019,11,16299,16524,6131,3256,42209,583,1314,474,2371,44580
22-05-2019,12,15574,16588,6165,3217,41545,588,1289,433,2310,43855
22-05-2019,13,15305,16094,6236,3299,40936,584,1270,414,2268,43204
22-05-2019,14,14388,15301,5949,3450,39090,531,1203,435,2169,41259
22-05-2019,15,13650,14893,5898,3575,38017,536,1123,435,2094,40111
22-05-2019,16,13794,15163,5944,3743,38646,534,1009,495,2038,40684
22-05-2019,17,14657,15952,5991,3653,40252,529,889,382,1800,42052
22-05-2019,18,15900,16849,6183,3155,42088,522,976,366,1864,43952
22-05-2019,19,16635,17352,6170,2882,43039,517,955,366,1838,44877
22-05-2019,20,16166,17238,6076,2851,42332,511,942,194,1647,43979
22-05-2019,21,16092,17097,6119,2494,41804,513,931,183,1627,43431
22-05-2019,22,15344,16739,6088,2296,40469,512,861,189,1562,42031
22-05-2019,23,14137,15990,6015,2000,38142,509,656,196,1361,39503
23-05-2019,0,11848,15750,5924,2225,35746,512,528,208,1248,36994
23-05-2019,1,11388,15441,5909,1913,34652,505,524,221,1250,35902
23-05-2019,2,10899,15067,5782,1828,33574,508,500,224,1232,34806
23-05-2019,3,10772,14973,5670,1706,33122,510,476,208,1194,34316
23-05-2019,4,10858,14944,5602,1901,33304,514,475,186,1175,34479
23-05-2019,5,11595,15458,5682,1796,34531,530,553,178,1261,35792
23-05-2019,6,14660,17299,6050,1896,39905,573,1057,200,1830,41735
23-05-2019,7,16676,17997,6263,2411,43348,621,1269,339,2229,45577
23-05-2019,8,16628,18209,6226,2666,43729,626,1339,449,2414,46143
23-05-2019,9,15656,17718,6240,3037,42652,644,1418,489,2551,45203
23-05-2019,10,14551,16680,6210,3332,40774,631,1278,460,2369,43143
23-05-2019,11,14480,16189,5998,3649,40317,631,1267,510,2408,42725
23-05-2019,12,14326,15831,6001,3707,39865,638,1202,510,2350,42215
23-05-2019,13,14412,15886,5918,3732,39948,626,1217,519,2362,42310
23-05-2019,14,14374,16307,5809,3641,40132,631,1220,377,2228,42360
23-05-2019,15,14749,16642,5595,3539,40526,569,1151,292,2012,42538
23-05-2019,16,15128,17118,5543,3327,41118,571,1074,264,1909,43027
23-05-2019,17,16655,17872,5772,3069,43370,599,1183,246,2028,45398
23-05-2019,18,17041,18381,5943,2870,44235,590,1218,244,2052,46287
23-05-2019,19,17139,18085,6071,2699,43994,629,1215,237,2081,46075
23-05-2019,20,16793,18039,5902,2599,43334,603,1142,239,1984,45318
23-05-2019,21,16720,17336,5929,2484,42471,581,958,247,1786,44257
23-05-2019,22,15970,16806,5942,2367,41086,577,934,250,1761,42847
23-05-2019,23,14926,16101,5943,2329,39300,545,530,240,1315,40615
24-05-2019,0,13218,15420,5881,2358,36879,544,509,218,1271,38150
24-05-2019,1,11740,14543,5901,2506,34691,541,505,202,1248,35939
24-05-2019,2,11638,14537,5925,2587,34687,530,506,196,1232,35919
24-05-2019,3,11363,14727,5911,2821,34824,534,505,188,1227,36051
24-05-2019,4,11529,14611,5858,3118,35116,531,507,189,1227,36343
24-05-2019,5,12476,15485,6228,3147,37335,520,536,183,1239,38574
24-05-2019,6,15216,17598,6648,3257,42719,557,1008,365,1930,44649
24-05-2019,7,17093,18106,6784,3036,45019,572,1233,428,2233,47252
24-05-2019,8,17807,18295,6810,3564,46475,573,1297,434,2304,48779
24-05-2019,9,17372,18466,6822,3830,46490,563,1290,414,2267,48757
24-05-2019,10,16332,18537,6803,3944,45617,573,1196,425,2194,47811
24-05-2019,11,14823,17873,6717,4249,43664,575,1247,430,2252,45916
24-05-2019,12,13524,17152,6621,4434,41732,582,1285,449,2316,44048
24-05-2019,13,12265,16897,6623,4634,40420,577,1210,495,2282,42702
24-05-2019,14,12099,16558,6348,4605,39610,526,1167,503,2196,41806
24-05-2019,15,12166,16677,6134,4583,39559,473,1162,274,1909,41468
24-05-2019,16,12473,16590,6132,4546,39742,465,1122,245,1832,41574
24-05-2019,17,13629,17260,6225,4293,41407,460,1201,229,1890,43297
24-05-2019,18,15628,17977,6403,3388,43397,520,1201,290,2011,45408
24-05-2019,19,16067,18173,6360,3016,43615,546,1184,269,1999,45614
24-05-2019,20,15807,17940,6015,2913,42677,455,928,186,1569,44246
24-05-2019,21,15248,17563,5829,2866,41507,467,851,179,1497,43004
24-05-2019,22,14865,17398,5817,2769,40849,468,594,173,1235,42084
24-05-2019,23,13939,16894,5727,2713,39273,500,489,175,1164,40437
25-05-2019,0,13325,15863,5637,2664,37490,521,175,199,895,38385
25-05-2019,1,11903,15310,5555,2651,35420,508,157,230,895,36315
25-05-2019,2,10690,14735,5486,2522,33432,525,159,282,966,34398
25-05-2019,3,10416,14535,5435,2489,32875,509,164,334,1007,33882
25-05-2019,4,10322,14571,5452,2479,32825,512,158,355,1025,33850
25-05-2019,5,10285,14628,5491,2384,32787,517,155,339,1011,33798
25-05-2019,6,10711,15386,5545,2318,33960,501,241,285,1027,34987
25-05-2019,7,11127,16005,5620,2354,35107,485,475,239,1199,36306
25-05-2019,8,12932,16913,5700,2636,38183,485,533,287,1305,39488
25-05-2019,9,13118,17005,5740,3016,38880,493,537,319,1349,40229
25-05-2019,10,12091,16547,5715,3335,37688,508,499,366,1373,39061
25-05-2019,11,11887,16325,5661,3501,37374,517,512,420,1449,38823
25-05-2019,12,11799,16006,5747,3650,37202,531,455,462,1448,38650
25-05-2019,13,11021,15544,5805,3755,36124,532,403,473,1408,37532
25-05-2019,14,10411,15329,5781,3978,35498,448,406,480,1334,36832
25-05-2019,15,10219,15087,5730,4222,35259,551,406,468,1425,36684
25-05-2019,16,10382,15312,5721,4261,35676,549,453,451,1453,37129
25-05-2019,17,10858,15734,5750,4291,36633,551,490,392,1433,38066
25-05-2019,18,12588,16827,5873,4195,39485,551,550,348,1449,40934
25-05-2019,19,13401,17451,5861,3883,40596,558,497,304,1359,41955
25-05-2019,20,13150,17626,5869,3683,40329,548,468,276,1292,41621
25-05-2019,21,13071,17709,5794,3447,40020,550,354,240,1144,41164
25-05-2019,22,12753,17496,5698,3497,39444,540,196,213,949,40393
25-05-2019,23,11724,17139,5618,3470,37951,500,155,214,869,38820
26-05-2019,0,10131,16376,5599,3425,35533,492,156,243,891,36424
26-05-2019,1,9243,15856,5518,3331,33950,493,157,240,890,34840
26-05-2019,2,9140,15845,5520,3254,33760,486,159,249,894,34654
26-05-2019,3,8740,15390,5385,3245,32759,460,166,279,905,33664
26-05-2019,4,8452,15213,5281,3140,32084,469,163,280,912,32996
26-05-2019,5,7971,15147,5237,3095,31451,458,163,283,904,32355
26-05-2019,6,8032,15006,5298,3027,31362,471,337,304,1112,32474
26-05-2019,7,8239,15359,5297,2870,31766,501,511,310,1322,33088
26-05-2019,8,8659,15764,5407,2631,32463,516,612,378,1506,33969
26-05-2019,9,9064,16179,5587,2717,33547,528,715,449,1692,35239
26-05-2019,10,9540,16610,5680,2875,34705,556,639,503,1698,36403
26-05-2019,11,9675,16855,5746,2962,35238,574,636,553,1763,37001
26-05-2019,12,9577,17019,5734,3004,35332,594,626,568,1788,37120
26-05-2019,13,9436,16932,5620,3013,35001,595,621,543,1759,36760
26-05-2019,14,9598,16909,5603,2540,34650,593,623,565,1781,36431
26-05-2019,15,9738,16955,5647,2147,34486,626,619,500,1745,36231
26-05-2019,16,10582,17193,5709,1633,35116,612,549,486,1647,36763
26-05-2019,17,11249,17246,5813,1362,35671,610,555,472,1637,37308
26-05-2019,18,11768,17292,5903,1050,36014,539,563,477,1579,37593
26-05-2019,19,12158,17259,5784,1143,36343,594,353,513,1460,37803
26-05-2019,20,11684,16986,5779,1273,35722,590,375,528,1493,37215
26-05-2019,21,11152,16788,5920,1666,35526,597,286,531,1414,36940
26-05-2019,22,10722,16374,5951,1935,34982,608,185,500,1293,36275
26-05-2019,23,9776,15962,6080,1932,33751,620,171,488,1279,35030
27-05-2019,0,8817,15380,6057,2148,32403,617,160,433,1210,33613
27-05-2019,1,8683,15200,5989,2184,32056,585,156,360,1101,33157
27-05-2019,2,8521,15196,5978,2069,31765,570,153,311,1034,32799
27-05-2019,3,8580,15216,5982,1982,31761,579,182,254,1015,32776
27-05-2019,4,8621,15418,6007,2032,32077,557,286,211,1054,33131
27-05-2019,5,9162,15482,6235,2358,33235,548,344,208,1100,34335
27-05-2019,6,12495,17032,6718,2543,38788,576,698,239,1513,40301
27-05-2019,7,16044,18901,6945,2823,44713,586,871,495,1952,46665
27-05-2019,8,17204,19143,7001,2942,46292,560,914,543,2017,48309
27-05-2019,9,16339,19267,6907,3135,45648,554,932,589,2075,47723
27-05-2019,10,15283,18805,6995,3930,45014,555,887,596,2038,47052
27-05-2019,11,14824,18425,6996,4196,44442,551,904,650,2105,46547
27-05-2019,12,13737,18210,6968,4496,43412,540,884,618,2042,45454
27-05-2019,13,13329,18189,6975,4628,43123,536,910,547,1993,45116
27-05-2019,14,13144,18319,6797,4752,43012,495,790,431,1716,44728
27-05-2019,15,12802,18163,6759,4600,42325,499,634,457,1590,43915
27-05-2019,16,13249,18293,6771,4574,42889,488,614,465,1567,44456
27-05-2019,17,14559,19048,6834,4243,44685,510,848,416,1774,46459
27-05-2019,18,15655,19375,6812,3860,45702,531,818,503,1852,47554
27-05-2019,19,15793,19397,6728,3508,45427,554,802,455,1811,47238
27-05-2019,20,15682,19395,6631,2852,44560,532,634,246,1412,45972
27-05-2019,21,15601,19128,6418,2458,43606,535,415,228,1178,44784
27-05-2019,22,15153,18558,6354,2135,42200,493,315,217,1025,43225
27-05-2019,23,13388,17740,6247,2231,39606,502,314,207,1023,40629
28-05-2019,0,11501,16848,6298,2450,37097,511,311,207,1029,38126
28-05-2019,1,10635,16332,6170,2592,35729,507,314,199,1020,36749
28-05-2019,2,10476,16173,6154,2539,35343,497,312,214,1023,36366
28-05-2019,3,10332,16104,6164,2476,35075,438,318,215,971,36046
28-05-2019,4,10502,16196,6290,2468,35455,431,317,206,954,36409
28-05-2019,5,11712,17207,6677,2513,38110,448,329,210,987,39097
28-05-2019,6,15162,18776,7115,2720,43773,487,758,251,1496,45269
28-05-2019,7,16384,19868,7164,3307,46723,500,726,541,1767,48490
28-05-2019,8,16919,20119,7274,3703,48015,502,1004,573,2079,50094
28-05-2019,9,16506,19967,7313,3787,47574,503,1245,548,2296,49870
28-05-2019,10,16729,20099,7357,3339,47523,520,1069,515,2104,49627
28-05-2019,11,15954,19798,7359,3633,46743,600,915,455,1970,48713
28-05-2019,12,15656,19656,7370,3460,46143,611,915,657,2183,48326
28-05-2019,13,15589,19591,7265,3541,45987,609,894,589,2092,48079
28-05-2019,14,15250,19441,7025,3601,45318,533,652,215,1400,46718
28-05-2019,15,14285,18905,6928,3768,43885,514,675,218,1407,45292
28-05-2019,16,14507,19052,6923,4111,44593,505,640,246,1391,45984
28-05-2019,17,15016,19476,6944,4292,45729,496,656,222,1374,47103
28-05-2019,18,14936,19433,7224,4235,45829,488,801,291,1580,47409
28-05-2019,19,14875,19565,7302,4022,45763,486,876,224,1586,47349
28-05-2019,20,14781,19443,6978,3873,45075,460,738,305,1503,46578
28-05-2019,21,14728,18874,6772,3846,44221,463,708,257,1428,45649
28-05-2019,22,13645,18457,6693,3755,42551,476,339,201,1016,43567
28-05-2019,23,11426,17493,6651,3620,39190,469,313,214,996,40186
29-05-2019,0,10450,16999,6589,3437,37477,467,312,226,1005,38482
29-05-2019,1,9826,16595,6495,3025,35939,468,310,261,1039,36978
29-05-2019,2,9547,16687,6533,2946,35714,371,389,254,1014,36728
29-05-2019,3,9539,16815,6553,2760,35667,475,311,236,1022,36689
29-05-2019,4,9980,17180,6582,2673,36415,480,313,210,1003,37418
29-05-2019,5,10876,17657,6792,2568,37894,469,317,207,993,38887
29-05-2019,6,14002,19270,7164,2580,43018,475,474,284,1233,44251
29-05-2019,7,16223,20525,7343,2591,46683,492,776,453,1721,48404
29-05-2019,8,16013,20406,7402,2964,46786,511,935,467,1913,48699
29-05-2019,9,15868,20444,7490,3003,46806,523,924,482,1929,48735
29-05-2019,10,15949,20779,7452,2805,46986,530,1011,486,2027,49013
29-05-2019,11,15574,20926,7518,2592,46609,535,904,516,1955,48564
29-05-2019,12,15646,20676,7593,2545,46462,549,854,513,1916,48378
29-05-2019,13,15127,20624,7452,2557,45759,540,777,573,1890,47649
29-05-2019,14,14722,20349,7297,2290,44661,557,756,598,1911,46572
29-05-2019,15,14251,19872,7168,2158,43449,575,699,609,1883,45332
29-05-2019,16,14522,19802,7214,2034,43572,452,700,551,1703,45275
29-05-2019,17,14951,20577,7408,2145,45082,427,771,575,1773,46855
29-05-2019,18,15197,20625,7378,2103,45304,429,828,390,1647,46951
29-05-2019,19,14897,20254,7568,1822,44542,389,826,445,1660,46202
29-05-2019,20,14538,19467,7731,1640,43378,362,784,475,1621,44999
29-05-2019,21,14053,19474,7784,1559,42870,358,499,339,1196,44066
29-05-2019,22,13517,18947,7798,1853,42117,361,359,274,994,43111
29-05-2019,23,12226,18296,7619,2144,40283,359,313,265,937,41220
30-05-2019,0,10700,17582,7641,2402,38325,344,311,242,897,39222
30-05-2019,1,9694,16887,7753,2302,36636,341,309,219,869,37505
30-05-2019,2,8998,16476,7692,2899,36065,369,310,190,869,36934
30-05-2019,3,8414,16070,7610,3011,35105,397,309,178,884,35989
30-05-2019,4,8512,16148,7527,3263,35450,396,312,171,879,36329
30-05-2019,5,8750,16625,7517,3596,36489,390,321,168,879,37368
30-05-2019,6,8930,17201,7393,3942,37467,379,483,221,1083,38550
30-05-2019,7,9833,17961,7319,3910,39021,440,712,414,1566,40587
30-05-2019,8,9847,17878,7336,4478,39541,421,758,390,1569,41110
30-05-2019,9,10262,17973,7564,4633,40433,420,887,408,1715,42148
30-05-2019,10,10595,18103,7689,4730,41119,425,950,432,1807,42926
30-05-2019,11,10908,18297,7758,4766,41729,453,884,408,1745,43474
30-05-2019,12,11308,17993,7659,4651,41614,463,815,411,1689,43303
30-05-2019,13,10814,17190,7609,4261,39872,464,801,420,1685,41557
30-05-2019,14,10409,17292,7586,4350,39639,459,570,443,1472,41111
30-05-2019,15,10646,18037,7585,4421,40688,459,564,392,1415,42103
30-05-2019,16,10643,19319,7594,3866,41422,462,619,403,1484,42906
30-05-2019,17,10394,20121,7579,3897,41990,453,685,384,1522,43512
30-05-2019,18,10816,20236,7568,4301,42922,444,721,372,1537,44459
30-05-2019,19,11715,20281,7577,4020,43592,451,773,372,1596,45188
30-05-2019,20,11966,19630,7574,3166,42335,458,768,367,1593,43928
30-05-2019,21,12567,19434,7476,2437,41914,477,700,200,1377,43291
30-05-2019,22,13088,19161,7357,2085,41692,489,410,222,1121,42813
30-05-2019,23,11932,18700,7405,1724,39760,500,309,265,1074,40834
31-05-2019,0,10555,17760,7334,1914,37565,549,144,319,1012,38577
31-05-2019,1,9673,17028,7440,1727,35867,581,156,380,1117,36984
31-05-2019,2,9268,17003,7497,1474,35242,581,155,436,1172,36414
31-05-2019,3,8916,16728,7400,1465,34509,588,155,473,1216,35725
31-05-2019,4,8829,16392,7464,1422,34108,599,149,465,1213,35321
31-05-2019,5,9622,17106,7716,1644,36088,579,314,416,1309,37397
31-05-2019,6,11770,18556,7934,1601,39860,544,509,379,1432,41292
31-05-2019,7,14001,19334,8054,1682,43071,532,658,559,1749,44820
31-05-2019,8,15752,19708,8124,1870,45455,529,809,564,1902,47357
31-05-2019,9,15440,19650,8184,1854,45129,529,716,546,1791,46920
31-05-2019,10,13980,19668,8063,1739,43452,519,647,546,1712,45164
31-05-2019,11,12817,19398,8029,1730,41975,496,656,535,1687,43662
31-05-2019,12,11954,19315,7969,1729,40967,489,928,537,1954,42921
31-05-2019,13,10755,19254,7925,1641,39574,498,870,513,1881,41455
31-05-2019,14,11064,19414,8007,1677,40162,528,718,488,1734,41896
31-05-2019,15,10686,19188,7997,1707,39579,500,631,441,1572,41151
31-05-2019,16,11134,18890,7881,1568,39473,476,573,445,1494,40967
31-05-2019,17,12654,19330,7898,1331,41213,466,699,452,1617,42830
31-05-2019,18,14217,19269,7843,1376,42706,464,725,460,1649,44355
31-05-2019,19,15010,18880,7777,1522,43191,431,729,465,1625,44816
31-05-2019,20,14028,18848,7571,1586,42033,422,704,436,1562,43595
31-05-2019,21,13233,18508,7674,1387,40803,455,483,220,1158,41961
31-05-2019,22,12765,18550,7688,1322,40325,438,329,190,957,41282
31-05-2019,23,12581,17748,7502,1453,39284,444,307,173,924,40208
01-06-2019,0,11448,17105,7356,1479,37390,434,161,157,752,38142
01-06-2019,1,10145,16839,7346,1630,35961,424,155,154,733,36694
01-06-2019,2,9325,16505,7323,1875,35029,431,161,155,747,35776
01-06-2019,3,8745,16290,7266,2126,34428,430,159,155,744,35172
01-06-2019,4,8633,16198,7079,2156,34066,430,159,150,739,34805
01-06-2019,5,8884,16487,7040,2414,34825,417,160,150,727,35552
01-06-2019,6,9039,16587,7166,2823,35616,393,173,156,722,36338
01-06-2019,7,9581,16763,7213,3394,36952,380,177,170,727,37679
01-06-2019,8,9511,17086,7258,3730,37585,379,399,389,1167,38752
01-06-2019,9,9762,17439,7313,3924,38437,400,408,383,1191,39628
01-06-2019,10,9907,17716,7347,4185,39155,417,370,405,1192,40347
01-06-2019,11,9778,17828,7417,4012,39035,436,468,409,1313,40348
01-06-2019,12,9588,17994,7443,3818,38844,460,568,440,1468,40312
01-06-2019,13,9388,17982,7434,3903,38708,485,498,319,1302,40010
01-06-2019,14,9454,18151,7362,4126,39093,510,385,335,1230,40323
01-06-2019,15,9125,18025,7294,4082,38527,520,381,325,1226,39753
01-06-2019,16,9534,18367,7242,4033,39178,504,385,276,1165,40343
01-06-2019,17,10325,18563,7397,3723,40009,456,423,238,1117,41126
01-06-2019,18,11647,18588,7165,3235,40637,461,395,213,1069,41706
01-06-2019,19,12684,18639,6931,2710,40965,464,348,216,1028,41993
01-06-2019,20,12989,18445,6794,2171,40397,459,353,212,1024,41421
01-06-2019,21,13256,18374,6696,1900,40226,482,292,230,1004,41230
01-06-2019,22,13214,18176,6648,1814,39851,480,253,274,1007,40858
01-06-2019,23,11964,17491,6509,1617,37581,499,174,317,990,38571
02-06-2019,0,10680,17128,6309,1392,35511,487,149,357,993,36504
02-06-2019,1,9656,16965,6243,1266,34130,468,143,388,999,35129
02-06-2019,2,8834,16500,6239,1165,32738,445,128,403,976,33714
02-06-2019,3,8686,16293,6238,946,32163,423,122,421,966,33129
02-06-2019,4,8303,15826,6042,865,31036,428,121,386,935,31971
02-06-2019,5,8545,15993,5970,734,31243,423,129,330,882,32125
02-06-2019,6,8584,16477,5967,753,31781,440,165,307,912,32693
02-06-2019,7,8610,16997,6103,806,32517,452,179,301,932,33449
02-06-2019,8,8708,17085,6291,1022,33107,442,258,408,1108,34215
02-06-2019,9,9149,17419,6401,1343,34313,434,261,604,1299,35612
02-06-2019,10,9492,17363,6460,1552,34868,425,300,640,1365,36233
02-06-2019,11,9093,17308,6530,1907,34839,428,346,641,1415,36254
02-06-2019,12,8828,17107,6622,2194,34752,438,337,497,1272,36024
02-06-2019,13,8684,16547,6661,2466,34360,433,353,488,1274,35634
02-06-2019,14,8840,16266,6709,2706,34522,438,355,414,1207,35729
02-06-2019,15,8763,16257,6485,2786,34293,444,302,394,1140,35433
02-06-2019,16,9175,16453,6161,2796,34585,430,409,348,1187,35772
02-06-2019,17,10308,17062,6005,2706,36080,407,435,351,1193,37273
02-06-2019,18,12204,17319,6039,2525,38088,380,427,285,1092,39180
02-06-2019,19,14946,17783,6035,2548,41312,390,426,349,1165,42477
02-06-2019,20,15358,17752,5945,2726,41783,410,417,249,1076,42859
02-06-2019,21,13963,17620,6075,2894,40553,407,328,307,1042,41595
02-06-2019,22,12377,17673,6171,2614,38835,418,177,177,772,39607
02-06-2019,23,10136,17118,5887,3208,36351,422,163,173,758,37109
03-06-2019,0,9014,16477,5725,2904,34119,401,133,175,709,34828
03-06-2019,1,9171,16441,5712,2812,34137,402,125,172,699,34836
03-06-2019,2,8977,16199,5616,3206,33998,395,152,173,720,34718
03-06-2019,3,8603,15969,5585,3057,33215,409,182,179,770,33985
03-06-2019,4,8984,16660,5617,2574,33836,414,266,204,884,34720
03-06-2019,5,10215,17327,5927,2421,35890,477,398,228,1103,36993
03-06-2019,6,13864,18574,6354,2037,40830,534,672,413,1619,42449
03-06-2019,7,16068,19288,6603,2134,44094,561,878,411,1850,45944
03-06-2019,8,16840,19034,6680,2279,44833,513,897,452,1862,46695
03-06-2019,9,16961,18826,6644,2147,44578,528,1244,436,2208,46786
03-06-2019,10,16529,18876,6610,2052,44068,563,1268,469,2300,46368
03-06-2019,11,16839,18758,6637,2020,44254,581,1256,472,2309,46563
03-06-2019,12,16349,18737,6697,2061,43842,583,1162,481,2226,46068
03-06-2019,13,15860,18839,6742,2128,43570,591,1123,487,2201,45771
03-06-2019,14,15267,18890,6853,1700,42711,608,1124,495,2227,44938
03-06-2019,15,15084,18679,6806,1892,42460,593,1009,279,1881,44341
03-06-2019,16,15306,18694,6694,2117,42810,603,847,274,1724,44534
03-06-2019,17,16061,18834,6794,2083,43770,594,910,307,1811,45581
03-06-2019,18,16716,18570,7058,2223,44567,620,1097,246,1963,46530
03-06-2019,19,16435,18778,7158,2139,44510,646,1047,300,1993,46503
03-06-2019,20,15323,18114,7005,2092,42534,717,738,403,1858,44392
03-06-2019,21,14691,17843,6761,1887,41181,746,497,371,1614,42795
03-06-2019,22,14179,17816,6818,1647,40461,744,409,436,1589,42050
03-06-2019,23,13379,17144,6676,1206,38405,742,334,474,1550,39955
04-06-2019,0,12201,16762,6452,967,36381,769,340,509,1618,37999
04-06-2019,1,11668,16248,6290,1150,35354,760,338,461,1559,36913
04-06-2019,2,11047,15991,6282,839,34159,755,336,431,1522,35681
04-06-2019,3,10720,15901,6173,760,33553,715,332,404,1451,35004
04-06-2019,4,11141,16046,6089,639,33915,719,333,389,1441,35356
04-06-2019,5,11887,16896,6434,694,35912,734,341,378,1453,37365
04-06-2019,6,14566,17906,6735,1248,40455,743,423,312,1478,41933
04-06-2019,7,15967,18136,6842,1622,42566,697,917,483,2097,44663
04-06-2019,8,16810,18190,6766,1664,43431,696,1078,517,2291,45722
04-06-2019,9,16719,18058,6824,1849,43451,664,1159,514,2337,45788
04-06-2019,10,16525,18319,7017,1676,43537,654,998,490,2142,45679
04-06-2019,11,15974,18460,7084,1535,43053,642,925,491,2058,45111
04-06-2019,12,15515,17829,7123,1352,41819,661,915,500,2076,43895
04-06-2019,13,14741,17795,7064,1451,41051,844,862,538,2244,43295
04-06-2019,14,14492,17775,6971,1384,40623,824,830,593,2247,42870
04-06-2019,15,13929,17863,6714,1368,39875,814,609,670,2093,41968
04-06-2019,16,14377,18539,6589,1358,40865,731,659,484,1874,42739
04-06-2019,17,15351,18527,6581,1365,41823,744,659,521,1924,43747
04-06-2019,18,15038,18379,6634,1764,41814,592,870,518,1980,43794
04-06-2019,19,14911,18546,6580,1887,41924,702,880,538,2120,44044
04-06-2019,20,14336,18174,6246,2222,40978,593,705,649,1947,42925
04-06-2019,21,13115,17749,6063,1849,38777,666,520,628,1814,40591
04-06-2019,22,12288,17521,5853,1997,37659,595,397,609,1601,39260
04-06-2019,23,11017,17052,5836,1888,35794,788,457,389,1634,37428
05-06-2019,0,10369,16669,5858,2244,35141,574,337,328,1239,36380
05-06-2019,1,9913,16242,5764,2284,34202,543,316,346,1205,35407
05-06-2019,2,9641,15886,5734,2724,33986,572,317,363,1252,35238
05-06-2019,3,9367,15730,5723,2886,33705,581,315,335,1231,34936
05-06-2019,4,9024,16109,5601,2784,33518,553,314,282,1149,34667
05-06-2019,5,9918,16607,5691,2693,34911,595,400,249,1244,36155
05-06-2019,6,12905,17530,6108,2776,39320,637,1013,222,1872,41192
05-06-2019,7,15486,18355,6299,2747,42887,657,1135,396,2188,45075
05-06-2019,8,16694,18524,6316,2482,44018,667,1145,452,2264,46282
05-06-2019,9,16903,18490,6432,2314,44139,659,1179,481,2319,46458
05-06-2019,10,17024,18740,6560,2293,44619,662,1308,440,2410,47029
05-06-2019,11,17036,18866,6564,2237,44706,659,1213,463,2335,47041
05-06-2019,12,16832,18897,6550,2102,44381,663,1180,483,2326,46707
05-06-2019,13,16181,19105,6540,1858,43685,655,1184,495,2334,46019
05-06-2019,14,15746,19101,6436,1716,42999,639,1089,485,2213,45212
05-06-2019,15,16036,18818,6216,1533,42603,649,862,590,2101,44704
05-06-2019,16,15756,18908,6089,1295,42047,639,851,477,1967,44014
05-06-2019,17,15739,19008,6328,1247,42322,655,1100,629,2384,44706
05-06-2019,18,15357,18982,6283,1250,41873,642,1068,448,2158,44031
05-06-2019,19,15122,19172,6273,1328,41895,649,1030,485,2164,44059
05-06-2019,20,14553,18901,5998,1420,40873,684,1092,346,2122,42995
05-06-2019,21,13570,18923,5753,1293,39539,628,670,700,1998,41537
05-06-2019,22,12696,19022,5792,1579,39088,662,465,525,1652,40740
05-06-2019,23,11147,18127,5761,1710,36746,605,484,406,1495,38241
06-06-2019,0,9715,16488,5782,1783,33768,605,316,371,1292,35060
06-06-2019,1,8867,15630,5776,2157,32429,586,306,367,1259,33688
06-06-2019,2,8583,15386,5767,2576,32313,585,303,338,1226,33539
06-06-2019,3,8494,15127,5831,2136,31587,594,308,326,1228,32815
06-06-2019,4,8664,15263,5780,2179,31886,593,325,338,1256,33142
06-06-2019,5,9147,16053,5729,2047,32978,594,395,339,1328,34306
06-06-2019,6,11445,17001,6074,2249,36769,658,802,379,1839,38608
06-06-2019,7,13557,17489,6202,2307,39556,661,1027,486,2174,41730
06-06-2019,8,14116,17969,6318,2171,40575,653,1314,494,2461,43036
06-06-2019,9,14754,18291,6423,2577,42045,657,1331,550,2538,44583
06-06-2019,10,14143,18665,6479,2920,42207,651,1283,606,2540,44747
06-06-2019,11,13735,18864,6525,3174,42298,660,1284,616,2560,44858
06-06-2019,12,13140,18757,6508,3499,41904,662,1171,623,2456,44360
06-06-2019,13,13093,18701,6531,3178,41504,653,1145,633,2431,43935
06-06-2019,14,12869,18746,6533,3381,41529,639,1163,643,2445,43974
06-06-2019,15,12802,18679,6428,3168,41077,585,1036,503,2124,43201
06-06-2019,16,12957,18802,6309,2696,40766,596,964,507,2067,42833
06-06-2019,17,13663,19011,6398,2514,41587,577,959,533,2069,43656
06-06-2019,18,14501,19369,6292,2246,42408,570,935,381,1886,44294
06-06-2019,19,14790,19248,6028,2529,42595,501,963,393,1857,44452
06-06-2019,20,14045,18928,5654,2326,40953,418,976,358,1752,42705
06-06-2019,21,13679,18837,5406,2057,39979,369,772,314,1455,41434
06-06-2019,22,13492,18552,5386,1773,39204,403,609,351,1363,40567
06-06-2019,23,12954,18094,5373,1561,37982,470,397,337,1204,39186
07-06-2019,0,12217,17536,5388,1407,36550,542,343,358,1243,37793
07-06-2019,1,11642,16844,5426,1299,35211,569,310,365,1244,36455
07-06-2019,2,11264,16574,5460,1341,34639,579,300,343,1222,35861
07-06-2019,3,10872,16476,5509,1300,34158,557,302,334,1193,35351
07-06-2019,4,10376,16852,5662,1171,34062,574,313,350,1237,35299
07-06-2019,5,11305,17273,5999,1059,35635,625,521,298,1444,37079
07-06-2019,6,13002,18122,6187,966,38277,700,1001,257,1958,40235
07-06-2019,7,14784,18421,6183,944,40334,738,1014,421,2173,42507
07-06-2019,8,15509,18876,6336,976,41699,708,1188,456,2352,44051
07-06-2019,9,15480,18601,6320,1094,41494,721,1222,443,2386,43880
07-06-2019,10,15188,18764,6230,1158,41341,683,1104,478,2265,43606
07-06-2019,11,15013,18916,6347,1266,41542,652,1180,477,2309,43851
07-06-2019,12,14351,18980,6312,1247,40892,668,1136,514,2318,43210
07-06-2019,13,13129,19135,6347,940,39550,665,1099,461,2225,41775
07-06-2019,14,12452,18934,6549,1357,39292,744,973,452,2169,41461
07-06-2019,15,12375,19108,6403,1258,39145,717,975,272,1964,41109
07-06-2019,16,13034,19199,6111,1071,39414,659,984,265,1908,41322
07-06-2019,17,13800,19092,6400,1023,40315,722,969,261,1952,42267
07-06-2019,18,13384,18990,6398,1040,39812,724,911,392,2027,41839
07-06-2019,19,13627,19011,6179,1130,39947,740,971,480,2191,42138
07-06-2019,20,13296,18797,5924,1155,39171,441,861,451,1753,40924
07-06-2019,21,12812,18346,5770,885,37813,413,632,277,1322,39135
07-06-2019,22,12100,18109,5807,1367,37385,335,527,222,1084,38469
07-06-2019,23,11350,17625,5848,1727,36550,331,362,241,934,37484
08-06-2019,0,10567,16127,5694,2069,34457,362,160,249,771,35228
08-06-2019,1,9400,15591,5601,2389,32982,348,153,286,787,33769
08-06-2019,2,8813,15259,5479,2472,32025,334,152,291,777,32802
08-06-2019,3,8640,14970,5417,2344,31372,332,154,272,758,32130
08-06-2019,4,8282,14661,5245,2559,30747,327,158,266,751,31498
08-06-2019,5,8422,14706,5369,2500,30998,324,149,241,714,31712
08-06-2019,6,8859,15210,5504,2495,32067,314,516,254,1084,33151
08-06-2019,7,9220,15616,5820,2715,33370,306,552,233,1091,34461
08-06-2019,8,9691,15987,5787,3286,34750,326,793,249,1368,36118
08-06-2019,9,10476,16367,5875,3871,36590,333,818,275,1426,38016
08-06-2019,10,10015,16188,5968,4027,36199,337,813,306,1456,37655
08-06-2019,11,9751,16671,5767,4189,36379,345,821,294,1460,37839
08-06-2019,12,9488,16669,5653,4482,36292,341,601,285,1227,37519
08-06-2019,13,9213,16574,5576,4530,35893,344,592,290,1226,37119
08-06-2019,14,8960,16289,5602,4226,35078,345,543,290,1178,36256
08-06-2019,15,9215,16192,5660,4128,35195,341,543,298,1182,36377
08-06-2019,16,9609,16413,5647,4095,35764,359,546,253,1158,36922
08-06-2019,17,9638,16800,5624,4085,36148,349,547,220,1116,37264
08-06-2019,18,10146,17272,5591,4568,37577,329,532,268,1129,38706
08-06-2019,19,11104,17202,5524,4458,38287,328,470,394,1192,39479
08-06-2019,20,11197,17034,5472,4410,38115,326,511,339,1176,39291
08-06-2019,21,10920,17224,5601,4257,38003,332,195,286,813,38816
08-06-2019,22,10427,16935,5776,4319,37458,361,191,294,846,38304
08-06-2019,23,9949,16809,5708,4347,36814,373,158,332,863,37677
09-06-2019,0,9413,16575,5568,3826,35383,351,187,331,869,36252
09-06-2019,1,8673,15994,5416,3977,34062,334,145,363,842,34904
09-06-2019,2,8345,15607,5332,4020,33304,339,143,336,818,34122
09-06-2019,3,8241,14995,5163,4081,32480,339,144,319,802,33282
09-06-2019,4,7802,14863,4923,4208,31796,337,146,280,763,32559
09-06-2019,5,7978,15124,4850,4126,32080,328,170,244,742,32822
09-06-2019,6,8402,15742,5010,4406,33559,335,186,219,740,34299
09-06-2019,7,9011,16788,5114,4560,35474,336,173,207,716,36190
09-06-2019,8,9642,17704,5296,4743,37385,361,216,231,808,38193
09-06-2019,9,9562,18091,5577,4799,38029,370,187,253,810,38839
09-06-2019,10,9565,18324,5796,4781,38465,386,231,259,876,39341
09-06-2019,11,9295,18552,5818,4362,38029,364,265,264,893,38922
09-06-2019,12,9259,18930,6031,4207,38426,357,262,282,901,39327
09-06-2019,13,9522,18955,6294,4024,38795,381,260,281,922,39717
09-06-2019,14,9445,19258,6391,3617,38711,413,260,280,953,39664
09-06-2019,15,10167,19273,6524,3263,39228,415,263,283,961,40189
09-06-2019,16,11093,19339,6557,2896,39887,435,227,283,945,40832
09-06-2019,17,11945,19388,6564,2563,40461,443,293,245,981,41442
09-06-2019,18,12697,19388,6553,2153,40793,426,317,193,936,41729
09-06-2019,19,12858,19202,6452,1613,40125,412,421,178,1011,41136
09-06-2019,20,12723,18887,6441,1146,39198,406,394,160,960,40158
09-06-2019,21,12645,18656,6486,922,38710,409,243,161,813,39523
09-06-2019,22,12618,18114,6546,874,38152,400,158,162,720,38872
09-06-2019,23,12394,17669,6549,822,37434,409,155,169,733,38167
10-06-2019,0,11161,16402,6196,630,34390,412,153,182,747,35137
10-06-2019,1,10201,15921,5994,612,32730,391,151,185,727,33457
10-06-2019,2,9752,15884,5956,731,32325,392,150,183,725,33050
10-06-2019,3,9715,15717,5856,744,32033,376,150,184,710,32743
10-06-2019,4,9830,15960,5804,733,32326,370,174,199,743,33069
10-06-2019,5,10207,17266,6114,873,34461,351,178,229,758,35219
10-06-2019,6,10911,18712,6412,1068,37104,328,302,267,897,38001
10-06-2019,7,11944,18774,6559,1197,38474,328,513,427,1268,39742
10-06-2019,8,13216,19420,6746,1372,40754,330,932,405,1667,42421
10-06-2019,9,13160,19386,6768,1555,40868,340,1173,405,1918,42786
10-06-2019,10,13077,19878,6780,1667,41402,354,1202,433,1989,43391
10-06-2019,11,12952,19780,6829,1637,41196,364,1248,456,2068,43264
10-06-2019,12,12342,19489,6749,1862,40443,355,1245,472,2072,42515
10-06-2019,13,11152,19537,6729,1896,39313,351,1241,466,2058,41371
10-06-2019,14,11025,19438,6708,2068,39240,338,1109,450,1897,41137
10-06-2019,15,11714,19566,6680,2233,40195,336,981,451,1768,41963
10-06-2019,16,12364,19589,6626,2395,40974,324,927,428,1679,42653
10-06-2019,17,13417,19843,6573,2522,42356,311,961,422,1694,44050
10-06-2019,18,14184,19796,6353,2663,42998,302,933,423,1658,44656
10-06-2019,19,14205,19632,6166,2548,42550,299,927,498,1724,44274
10-06-2019,20,13809,19408,5991,2364,41571,301,772,552,1625,43196
10-06-2019,21,13343,19178,5918,2412,40850,299,567,432,1298,42148
10-06-2019,22,12738,18700,5819,2672,39928,301,320,465,1086,41014
10-06-2019,23,12020,18421,5768,2828,39036,301,324,463,1088,40124
11-06-2019,0,10905,17702,5628,2802,37037,304,317,420,1041,38078
11-06-2019,1,10028,17601,5692,2703,36024,311,313,382,1006,37030
11-06-2019,2,9949,17437,5532,2732,35649,302,317,310,929,36578
11-06-2019,3,9528,17320,5477,2874,35200,305,326,274,905,36105
11-06-2019,4,9616,17734,5453,2859,35663,313,329,295,937,36600
11-06-2019,5,10725,18467,5816,2831,37838,324,336,312,972,38810
11-06-2019,6,13692,18956,6066,2786,41502,329,457,327,1113,42615
11-06-2019,7,15908,19540,6365,2465,44278,343,604,508,1455,45733
11-06-2019,8,16429,19978,6370,2169,44945,355,1061,460,1876,46821
11-06-2019,9,16272,20100,6484,2401,45257,349,1226,459,2034,47291
11-06-2019,10,15989,20089,6563,2900,45542,352,1164,482,1998,47540
11-06-2019,11,15883,20011,6634,3021,45547,351,1163,518,2032,47579
11-06-2019,12,15919,19992,6664,3039,45613,360,1330,540,2230,47843
11-06-2019,13,15918,20198,6632,2866,45614,359,1273,530,2162,47776
11-06-2019,14,16269,20185,6545,2583,45582,358,1026,559,1943,47525
11-06-2019,15,15630,20155,6303,2339,44428,376,970,556,1902,46330
11-06-2019,16,15192,20161,6236,2140,43729,382,959,544,1885,45614
11-06-2019,17,15307,20154,6290,1971,43722,366,975,507,1848,45570
11-06-2019,18,15051,19962,6436,1818,43264,366,973,414,1753,45017
11-06-2019,19,14932,19965,6450,1708,43056,366,1004,389,1759,44815
11-06-2019,20,14285,19871,6206,1562,41923,362,980,200,1542,43465
11-06-2019,21,13979,19627,6173,1350,41129,360,609,212,1181,42310
11-06-2019,22,13547,19186,6156,1358,40248,356,335,246,937,41185
11-06-2019,23,12350,18922,6266,1455,38994,340,388,277,1005,39999
12-06-2019,0,11696,17879,6156,1265,36997,350,368,294,1012,38009
12-06-2019,1,10909,17525,6174,1116,35724,344,310,296,950,36674
12-06-2019,2,10703,17463,6230,1101,35498,339,312,276,927,36425
12-06-2019,3,10627,17363,6201,1066,35258,387,310,240,937,36195
12-06-2019,4,10854,17821,6135,979,35789,417,309,225,951,36740
12-06-2019,5,11665,18755,6139,1225,37784,428,312,220,960,38744
12-06-2019,6,13469,19587,6121,1177,40356,418,337,200,955,41311
12-06-2019,7,15095,20124,6202,1352,42772,423,623,386,1432,44204
12-06-2019,8,15865,20509,6314,1560,44248,432,791,394,1617,45865
12-06-2019,9,15750,20458,6285,2002,44494,440,868,400,1708,46202
12-06-2019,10,15820,20822,6293,2044,44979,451,895,409,1755,46734
12-06-2019,11,15982,20841,6265,2065,45155,454,893,429,1776,46931
12-06-2019,12,16020,20849,6265,2502,45638,465,916,445,1826,47464
12-06-2019,13,16255,20940,6288,2474,45958,483,726,470,1679,47637
12-06-2019,14,15946,20722,6315,2447,45429,494,633,478,1605,47034
12-06-2019,15,15385,20572,6282,2165,44404,506,614,475,1595,45999
12-06-2019,16,15195,20602,6231,2340,44368,475,629,470,1574,45942
12-06-2019,17,15255,20715,6158,2273,44401,469,613,437,1519,45920
12-06-2019,18,14955,20432,6086,1813,43287,460,458,402,1320,44607
12-06-2019,19,15155,20300,6047,1498,43001,453,405,397,1255,44256
12-06-2019,20,14735,19989,5995,1522,42241,422,323,442,1187,43428
12-06-2019,21,15003,19887,6112,1511,42515,448,486,350,1284,43799
12-06-2019,22,14094,19195,6273,1536,41099,433,326,325,1084,42183
12-06-2019,23,12864,18857,6437,1551,39709,433,363,364,1160,40869
13-06-2019,0,11173,18002,6467,1780,37421,432,321,375,1128,38549
13-06-2019,1,10507,17619,6514,2112,36751,412,311,400,1123,37874
13-06-2019,2,9874,17321,6477,2324,35997,422,312,405,1139,37136
13-06-2019,3,9809,17057,6557,2101,35523,408,312,393,1113,36636
13-06-2019,4,10052,17289,6603,1932,35876,417,316,377,1110,36986
13-06-2019,5,11459,17898,6674,1756,37787,436,324,374,1134,38921
13-06-2019,6,14336,18691,6532,1546,41105,416,522,327,1265,42370
13-06-2019,7,16472,19304,6731,1574,44082,435,758,472,1665,45747
13-06-2019,8,16686,19301,6789,2038,44815,456,1241,470,2167,46982
13-06-2019,9,16551,19321,6923,1926,44721,456,1215,498,2169,46890
13-06-2019,10,15283,18996,6896,2268,43444,441,1211,539,2191,45635
13-06-2019,11,14388,19107,6914,2539,42949,429,1307,624,2360,45309
13-06-2019,12,13955,18775,6986,2994,42711,393,1354,576,2323,45034
13-06-2019,13,13574,18788,6870,3572,42803,395,1457,499,2351,45154
13-06-2019,14,14045,18598,6902,3291,42837,394,1310,519,2223,45060
13-06-2019,15,14665,18578,6719,3274,43237,376,1208,559,2143,45380
13-06-2019,16,14586,18609,6672,2946,42813,359,1005,606,1970,44783
13-06-2019,17,15709,18578,6693,2832,43812,361,1005,504,1870,45682
13-06-2019,18,16250,18343,6576,2035,43205,350,994,462,1806,45011
13-06-2019,19,16587,18474,6557,1223,42841,368,997,445,1810,44651
13-06-2019,20,15790,18155,6454,808,41208,353,991,423,1767,42975
13-06-2019,21,15698,17871,6333,771,40674,348,972,435,1755,42429
13-06-2019,22,15242,17764,6340,814,40162,335,848,169,1352,41514
13-06-2019,23,14073,17338,6243,1018,38673,317,697,170,1184,39857
14-06-2019,0,13346,16876,6184,1533,37938,315,333,169,817,38755
14-06-2019,1,12190,16185,6072,1989,36436,328,302,161,791,37227
14-06-2019,2,11170,16147,6116,1882,35316,320,322,165,807,36123
14-06-2019,3,10922,15885,6082,1692,34581,331,306,194,831,35412
14-06-2019,4,11156,16100,6116,1438,34810,355,305,172,832,35642
14-06-2019,5,13003,16664,6205,1312,37185,352,309,170,831,38016
14-06-2019,6,15287,17386,6311,1148,40133,362,622,167,1151,41284
14-06-2019,7,16860,17945,6599,1235,42639,442,648,378,1468,44107
14-06-2019,8,17094,18209,6706,1604,43614,475,1020,396,1891,45505
14-06-2019,9,16901,18303,6711,1811,43725,486,1137,333,1956,45681
14-06-2019,10,16862,18330,6638,1981,43812,495,1159,388,2042,45854
14-06-2019,11,17110,18574,6696,1882,44263,496,1061,424,1981,46244
14-06-2019,12,17143,18302,6727,1990,44162,494,1162,433,2089,46251
14-06-2019,13,16583,18117,6738,2081,43518,515,1046,429,1990,45508
14-06-2019,14,16372,18052,6697,1552,42675,531,987,435,1953,44628
14-06-2019,15,16299,18004,6518,1236,42057,542,833,419,1794,43851
14-06-2019,16,15655,17875,6428,1207,41166,559,666,402,1627,42793
14-06-2019,17,15647,18006,6438,1264,41355,576,825,401,1802,43157
14-06-2019,18,15885,17731,6453,1397,41466,565,801,382,1748,43214
14-06-2019,19,15410,17658,6411,1253,40732,552,957,184,1693,42425
14-06-2019,20,14683,17266,6315,935,39199,438,852,188,1478,40677
14-06-2019,21,14267,17144,6231,1008,38650,342,497,201,1040,39690
14-06-2019,22,13645,16990,6082,1030,37747,327,306,203,836,38583
14-06-2019,23,12923,16823,6001,885,36632,325,297,198,820,37452
15-06-2019,0,12128,16159,5958,1179,35425,340,275,198,813,36238
15-06-2019,1,11419,16105,6008,1171,34703,327,274,206,807,35510
15-06-2019,2,10787,16116,6078,1063,34043,321,273,199,793,34836
15-06-2019,3,10431,16021,6107,970,33530,325,274,194,793,34323
15-06-2019,4,10309,15799,6031,1045,33185,328,275,200,803,33988
15-06-2019,5,10259,15790,6029,1239,33315,333,276,212,821,34136
15-06-2019,6,10390,16198,6031,1497,34116,330,284,188,802,34918
15-06-2019,7,10875,16784,6088,1711,35458,324,456,175,955,36413
15-06-2019,8,12276,17344,6196,1596,37413,326,584,198,1108,38521
15-06-2019,9,13086,17831,6199,1581,38697,338,586,270,1194,39891
15-06-2019,10,12541,17708,6088,1791,38128,340,643,285,1268,39396
15-06-2019,11,11228,17391,6045,2113,36777,342,654,358,1354,38131
15-06-2019,12,10803,17376,6096,2456,36733,339,745,272,1356,38089
15-06-2019,13,11229,17486,6114,2892,37722,343,690,384,1417,39139
15-06-2019,14,11151,17317,6102,3124,37694,339,587,288,1214,38908
15-06-2019,15,10973,17264,6077,3460,37772,331,585,237,1153,38925
15-06-2019,16,10304,16997,6016,2883,36201,337,574,234,1145,37346
15-06-2019,17,11249,17433,6132,2721,37535,325,537,233,1095,38630
15-06-2019,18,12375,17970,6128,2318,38790,307,426,245,978,39768
15-06-2019,19,12497,18025,6086,1996,38605,285,443,265,993,39598
15-06-2019,20,12104,17892,6111,1651,37756,255,403,316,974,38730
15-06-2019,21,11789,17723,6235,1715,37462,255,292,424,971,38433
15-06-2019,22,11601,17358,6329,1507,36794,253,280,470,1003,37797
15-06-2019,23,11324,16757,6336,1790,36207,248,284,502,1034,37241
16-06-2019,0,10828,16061,6318,2028,35236,241,281,528,1050,36286
16-06-2019,1,9905,15477,6292,1867,33542,237,279,491,1007,34549
16-06-2019,2,9700,15294,6254,1949,33198,271,277,396,944,34142
16-06-2019,3,9484,15088,6105,1876,32553,275,282,320,877,33430
16-06-2019,4,9414,14882,6056,1753,32105,275,289,487,1051,33156
16-06-2019,5,9264,15154,6095,1725,32239,279,296,503,1078,33317
16-06-2019,6,9466,15608,6111,1813,32998,283,282,434,999,33997
16-06-2019,7,10175,15970,6169,1954,34269,283,281,305,869,35138
16-06-2019,8,10511,16127,6272,2151,35062,285,286,231,802,35864
16-06-2019,9,10523,16495,6371,2505,35894,283,337,200,820,36714
16-06-2019,10,10907,16953,6447,2645,36953,289,493,204,986,37939
16-06-2019,11,11041,16964,6449,2540,36993,293,490,214,997,37990
16-06-2019,12,10588,16854,6422,2310,36174,306,505,211,1022,37196
16-06-2019,13,10506,16964,6412,2208,36090,315,526,204,1045,37135
16-06-2019,14,11077,17088,6350,2110,36624,321,505,216,1042,37666
16-06-2019,15,11066,16989,6281,2210,36547,305,557,276,1138,37685
16-06-2019,16,11193,17221,6201,2141,36756,293,561,298,1152,37908
16-06-2019,17,12740,17778,6185,1893,38598,284,579,296,1159,39757
16-06-2019,18,13176,17729,6074,1461,38440,284,661,279,1224,39664
16-06-2019,19,13643,18000,6035,1086,38763,286,506,270,1062,39825
16-06-2019,20,13650,17970,5977,1027,38623,288,505,249,1042,39665
16-06-2019,21,13393,17754,5969,837,37953,298,386,268,952,38905
16-06-2019,22,13013,17282,6102,721,37119,300,271,282,853,37972
16-06-2019,23,12131,17103,5991,648,35873,299,269,273,841,36714
17-06-2019,0,10784,16316,5835,654,33590,301,269,250,820,34410
17-06-2019,1,10307,16033,5667,711,32720,301,267,231,799,33519
17-06-2019,2,10020,15953,5686,806,32467,305,265,233,803,33270
17-06-2019,3,9866,15748,5760,948,32322,307,268,243,818,33140
17-06-2019,4,9838,15937,5752,960,32488,296,267,248,811,33299
17-06-2019,5,11041,16559,5966,938,34505,292,269,264,825,35330
17-06-2019,6,14144,17941,6098,857,39041,305,763,251,1319,40360
17-06-2019,7,16048,18899,6375,1388,42710,317,852,458,1627,44337
17-06-2019,8,16334,19139,6390,1918,43781,329,947,449,1725,45506
17-06-2019,9,16097,19094,6528,2239,43958,343,1014,461,1818,45776
17-06-2019,10,15884,19086,6535,2420,43927,339,1009,462,1810,45737
17-06-2019,11,15793,19195,6643,2587,44218,344,1023,459,1826,46044
17-06-2019,12,15652,19448,6601,2935,44637,357,1049,477,1883,46520
17-06-2019,13,15602,19582,6591,2980,44756,359,1005,542,1906,46662
17-06-2019,14,15408,19718,6630,2785,44541,373,866,564,1803,46344
17-06-2019,15,14978,19772,6506,2507,43763,370,695,413,1478,45241
17-06-2019,16,14586,19512,6457,2047,42604,378,614,403,1395,43999
17-06-2019,17,14860,19624,6431,1723,42638,383,578,382,1343,43981
17-06-2019,18,14917,19485,6400,1474,42275,383,661,337,1381,43656
17-06-2019,19,14604,19141,6389,1187,41322,399,570,311,1280,42602
17-06-2019,20,13861,18836,6337,915,39949,396,459,258,1113,41062
17-06-2019,21,13186,18602,6287,747,38822,383,281,227,891,39713
17-06-2019,22,12642,18143,5963,875,37624,390,274,214,878,38502
17-06-2019,23,12334,17811,5684,1084,36913,382,281,207,870,37783
18-06-2019,0,11318,16961,5434,1415,35128,379,396,209,984,36112
18-06-2019,1,10816,16355,5258,1615,34044,369,413,210,992,35036
18-06-2019,2,10301,16216,5253,1815,33588,369,435,203,1007,34595
18-06-2019,3,9950,15998,5289,1853,33090,375,415,194,984,34074
18-06-2019,4,9615,16433,5331,1896,33274,376,434,194,1004,34278
18-06-2019,5,10760,17090,5414,1867,35131,368,448,189,1005,36136
18-06-2019,6,13310,18250,5838,1818,39218,384,1010,179,1573,40791
18-06-2019,7,15397,19030,6226,1790,42442,400,1040,359,1799,44241
18-06-2019,8,16029,19061,6292,1837,43219,416,1032,399,1847,45066
18-06-2019,9,15908,19268,6394,1838,43408,414,1171,387,1972,45380
18-06-2019,10,16310,19622,6476,1942,44351,398,1172,414,1984,46335
18-06-2019,11,16171,19822,6505,1868,44365,390,1139,418,1947,46312
18-06-2019,12,15549,19830,6551,1776,43706,405,1365,420,2190,45896
18-06-2019,13,15139,19917,6626,1819,43501,412,1283,422,2117,45618
18-06-2019,14,15026,19880,6581,1801,43289,412,1278,410,2100,45389
18-06-2019,15,14311,19780,6583,1795,42469,408,1131,414,1953,44422
18-06-2019,16,13722,19538,6562,1708,41530,396,891,269,1556,43086
18-06-2019,17,13877,19542,6693,1516,41628,392,1044,378,1814,43442
18-06-2019,18,13860,19440,6655,1494,41451,373,924,357,1654,43105
18-06-2019,19,14036,19233,6543,1316,41128,363,954,351,1668,42796
18-06-2019,20,13527,18805,6427,1249,40008,356,798,249,1403,41411
18-06-2019,21,12989,18502,6481,992,38965,358,577,145,1080,40045
18-06-2019,22,12544,18151,6283,832,37809,369,286,139,794,38603
18-06-2019,23,12219,17501,5972,879,36572,351,269,138,758,37330
19-06-2019,0,11652,16954,5824,744,35172,355,286,145,786,35958
19-06-2019,1,11547,16321,5658,625,34153,350,288,153,791,34944
19-06-2019,2,11374,16189,5660,521,33745,356,296,165,817,34562
19-06-2019,3,11241,16055,5623,538,33457,374,292,179,845,34302
19-06-2019,4,11235,16737,5560,563,34096,393,293,192,878,34974
19-06-2019,5,12281,16870,5762,693,35606,392,296,210,898,36504
19-06-2019,6,14777,17523,5885,828,39014,415,448,203,1066,40080
19-06-2019,7,15933,18236,5960,1141,41269,491,513,335,1339,42608
19-06-2019,8,16186,18691,6261,1078,42216,515,589,376,1480,43696
19-06-2019,9,16350,18847,6253,1504,42955,525,862,385,1772,44727
19-06-2019,10,16556,18924,6230,1256,42966,522,876,383,1781,44747
19-06-2019,11,16580,18946,6296,1300,43122,542,877,383,1802,44924
19-06-2019,12,16489,18830,6231,1667,43218,523,956,383,1862,45080
19-06-2019,13,16149,18906,6212,1874,43143,518,964,389,1871,45014
19-06-2019,14,16234,19010,6112,2069,43426,511,882,389,1782,45208
19-06-2019,15,15737,18735,6074,2175,42723,503,873,382,1758,44481
19-06-2019,16,15537,18463,6015,2266,42282,488,871,379,1738,44020
19-06-2019,17,15424,18566,6036,2496,42523,509,870,374,1753,44276
19-06-2019,18,15782,18692,5969,2383,42826,485,868,367,1720,44546
19-06-2019,19,16100,18586,5984,2046,42715,460,862,368,1690,44405
19-06-2019,20,15740,18488,5789,1785,41803,369,774,331,1474,43277
19-06-2019,21,14702,18217,5810,1598,40327,340,665,352,1357,41684
19-06-2019,22,13966,18016,5675,1344,39002,296,678,251,1225,40227
19-06-2019,23,13147,17387,5441,1095,37071,281,531,206,1018,38089
20-06-2019,0,12337,16885,5258,1226,35707,273,512,223,1008,36715
20-06-2019,1,11589,16612,5036,1043,34279,279,526,270,1075,35354
20-06-2019,2,10801,16601,5018,956,33376,281,467,324,1072,34448
20-06-2019,3,10560,16204,5051,1087,32902,286,466,267,1019,33921
20-06-2019,4,10292,16429,4975,1238,32935,295,474,253,1022,33957
20-06-2019,5,10860,16941,5243,838,33882,305,484,252,1041,34923
20-06-2019,6,13543,17980,5656,927,38107,308,666,229,1203,39310
20-06-2019,7,15403,19289,6051,891,41634,308,823,402,1533,43167
20-06-2019,8,16133,19603,6249,1013,42998,312,801,408,1521,44519
20-06-2019,9,16179,19932,6284,1071,43467,304,797,436,1537,45004
20-06-2019,10,16112,20153,6273,1122,43660,310,805,466,1581,45241
20-06-2019,11,15542,20023,6278,1332,43176,323,799,478,1600,44776
20-06-2019,12,15158,19975,6191,1473,42797,331,849,469,1649,44446
20-06-2019,13,15534,20205,6103,1674,43515,326,806,451,1583,45098
20-06-2019,14,15092,20006,6009,2048,43156,322,789,434,1545,44701
20-06-2019,15,14220,18778,5758,2278,41035,338,794,407,1539,42574
20-06-2019,16,13951,19074,5770,2005,40800,319,872,389,1580,42380
20-06-2019,17,14294,19298,5832,1874,41299,316,880,401,1597,42896
20-06-2019,18,14457,19643,5927,1988,42016,317,828,417,1562,43578
20-06-2019,19,14598,19380,5891,1557,41426,317,878,422,1617,43043
20-06-2019,20,13986,19000,5951,1162,40100,303,764,182,1249,41349
20-06-2019,21,12996,18726,6108,961,38789,319,610,153,1082,39871
20-06-2019,22,12047,18378,6181,903,37508,336,407,158,901,38409
20-06-2019,23,11988,17465,6090,856,36400,345,290,207,842,37242
21-06-2019,0,11617,16602,5911,836,34966,352,270,221,843,35809
21-06-2019,1,10797,16230,5816,813,33657,349,268,255,872,34529
21-06-2019,2,10404,15928,5746,756,32833,335,280,213,828,33661
21-06-2019,3,9988,15651,5661,777,32078,312,270,182,764,32842
21-06-2019,4,10203,16088,5584,715,32590,310,282,162,754,33344
21-06-2019,5,11158,16223,5504,707,33592,333,270,159,762,34354
21-06-2019,6,12425,16873,5594,954,35847,356,418,160,934,36781
21-06-2019,7,13747,17267,5614,1129,37758,389,497,356,1242,39000
21-06-2019,8,14070,17731,5761,1313,38876,409,547,371,1327,40203
21-06-2019,9,14220,18087,5883,1549,39740,359,999,386,1744,41484
21-06-2019,10,14523,18372,5925,1479,40300,377,1037,401,1815,42115
21-06-2019,11,14374,18598,5979,1475,40428,384,1049,397,1830,42258
21-06-2019,12,14069,18743,6002,1768,40583,395,1120,380,1895,42478
21-06-2019,13,14013,18723,5997,1984,40718,378,1190,392,1960,42678
21-06-2019,14,13635,18685,6141,2159,40620,368,966,410,1744,42364
21-06-2019,15,12865,18383,6224,2326,39799,350,872,426,1648,41447
21-06-2019,16,12242,18340,6260,2508,39351,351,717,422,1490,40841
21-06-2019,17,12284,18502,6158,2479,39424,372,703,420,1495,40919
21-06-2019,18,12194,18396,5978,2523,39091,354,754,401,1509,40600
21-06-2019,19,11920,18365,5869,2264,38418,341,668,382,1391,39809
21-06-2019,20,11437,18022,5807,1788,37055,295,594,193,1082,38137
21-06-2019,21,11158,18158,5771,1501,36588,289,474,193,956,37544
21-06-2019,22,11161,18012,5819,1415,36407,280,378,211,869,37276
21-06-2019,23,10808,17625,5857,1549,35840,298,276,246,820,36660
22-06-2019,0,10699,16787,5866,1458,34813,282,272,263,817,35630
22-06-2019,1,9747,16550,5809,1344,33451,288,272,281,841,34292
22-06-2019,2,9217,16360,5719,1475,32770,293,272,266,831,33601
22-06-2019,3,8744,16203,5596,1420,31964,284,274,272,830,32794
22-06-2019,4,8673,15741,5412,1398,31222,285,286,298,869,32091
22-06-2019,5,8965,16212,5330,1384,31892,291,271,294,856,32748
22-06-2019,6,9582,16551,5544,1093,32770,305,293,260,858,33628
22-06-2019,7,10499,16835,5647,1050,34031,348,449,317,1114,35145
22-06-2019,8,10922,17576,5840,1206,35544,322,556,325,1203,36747
22-06-2019,9,10995,18082,5968,1338,36385,412,584,313,1309,37694
22-06-2019,10,10954,18538,6225,1632,37349,415,571,321,1307,38656
22-06-2019,11,10573,18636,6496,1556,37262,419,547,342,1308,38570
22-06-2019,12,10548,18862,6362,1452,37225,424,513,352,1289,38514
22-06-2019,13,10064,18759,6284,1344,36450,432,461,352,1245,37695
22-06-2019,14,10013,18698,6240,1336,36287,433,462,340,1235,37522
22-06-2019,15,10037,18396,6350,1358,36140,433,478,330,1241,37381
22-06-2019,16,10747,18628,6309,1347,37031,419,532,315,1266,38297
22-06-2019,17,11226,18541,6456,1243,37467,384,571,269,1224,38691
22-06-2019,18,11822,18506,6662,1033,38023,358,593,225,1176,39199
22-06-2019,19,11933,18086,6624,749,37393,347,550,186,1083,38476
22-06-2019,20,11787,17960,6507,801,37055,305,685,166,1156,38211
22-06-2019,21,11716,17834,6450,718,36717,288,632,156,1076,37793
22-06-2019,22,11482,17618,6306,726,36132,292,728,159,1179,37311
22-06-2019,23,10446,17358,6439,902,35144,312,641,162,1115,36259
23-06-2019,0,9321,16996,6494,869,33680,305,484,162,951,34631
23-06-2019,1,8433,16593,6238,873,32136,295,482,159,936,33072
23-06-2019,2,8300,16357,6177,1091,31926,301,485,156,942,32868
23-06-2019,3,8114,16224,6153,1008,31498,299,484,162,945,32443
23-06-2019,4,7754,15865,6004,932,30556,282,484,162,928,31484
23-06-2019,5,7898,15602,5911,918,30331,264,485,156,905,31236
23-06-2019,6,8069,15579,5906,999,30553,257,485,151,893,31446
23-06-2019,7,8460,15674,6050,1117,31303,265,254,153,672,31975
23-06-2019,8,9434,15956,6143,1040,32573,350,362,170,882,33455
23-06-2019,9,9403,16348,6160,1188,33100,342,377,334,1053,34153
23-06-2019,10,9379,16839,6189,1361,33768,347,381,317,1045,34813
23-06-2019,11,9485,16920,6344,1374,34123,363,385,376,1124,35247
23-06-2019,12,9136,17017,6265,1345,33763,379,386,377,1142,34905
23-06-2019,13,9027,17146,6165,1363,33701,380,425,329,1134,34835
23-06-2019,14,9147,17046,6180,1349,33722,354,435,202,991,34713
23-06-2019,15,9314,17094,6202,1365,33975,340,440,210,990,34965
23-06-2019,16,9884,17377,6041,1395,34698,350,433,221,1004,35702
23-06-2019,17,10112,17545,6107,1322,35086,310,436,217,963,36049
23-06-2019,18,11446,17912,6205,1091,36654,268,405,211,884,37538
23-06-2019,19,12145,17787,6093,929,36953,268,423,198,889,37842
23-06-2019,20,12719,17613,5854,874,37061,287,365,207,859,37920
23-06-2019,21,12480,17774,5748,889,36891,315,200,233,748,37639
23-06-2019,22,12308,17779,5619,1051,36757,348,117,252,717,37474
23-06-2019,23,10996,17394,5485,1223,35098,306,113,253,672,35770
24-06-2019,0,9081,16303,5254,1267,31904,285,113,246,644,32548
24-06-2019,1,8375,16222,5153,1336,31088,272,113,232,617,31705
24-06-2019,2,8334,16232,5084,1408,31059,275,116,224,615,31674
24-06-2019,3,8316,16259,5103,1476,31155,274,117,216,607,31762
24-06-2019,4,8811,16204,5157,1526,31698,270,117,199,586,32284
24-06-2019,5,9297,15953,5202,1620,32073,268,118,197,583,32656
24-06-2019,6,13247,17248,5549,1643,37688,259,139,185,583,38271
24-06-2019,7,15993,18480,5894,1571,41938,261,127,159,547,42485
24-06-2019,8,16487,18748,6026,1975,43235,284,156,170,610,43845
24-06-2019,9,16423,18501,6123,2213,43261,366,471,227,1064,44325
24-06-2019,10,16157,18161,6345,2493,43155,399,551,344,1294,44449
24-06-2019,11,16161,17927,6454,2542,,386,617,341,1344,
24-06-2019,12,16031,17763,6451,2395,42641,368,620,346,1334,43975
24-06-2019,13,15529,17919,6371,2539,42357,406,560,348,1314,43671
24-06-2019,14,15429,17762,6294,2674,42159,435,567,277,1279,43438
24-06-2019,15,15415,17677,6094,2761,41945,440,567,256,1263,43208
24-06-2019,16,15530,17762,6068,2676,42037,443,622,190,1255,43292
24-06-2019,17,16050,18218,5987,2593,42846,439,658,180,1277,44123
24-06-2019,18,16023,17843,6114,2553,42533,429,629,180,1238,43771
24-06-2019,19,16134,17507,6077,2442,42160,423,886,180,1489,43649
24-06-2019,20,15846,17061,5713,2337,40958,416,758,192,1366,42324
24-06-2019,21,15044,16939,5638,2306,39927,375,327,242,944,40871
24-06-2019,22,14070,16931,5600,2397,38999,365,283,328,976,39975
24-06-2019,23,11726,16378,5334,2855,36294,323,280,379,982,37276
25-06-2019,0,9986,16141,5200,3010,34337,296,281,364,941,35278
25-06-2019,1,9213,15878,5139,3010,33240,280,280,366,926,34166
25-06-2019,2,9060,15724,4993,2998,32774,273,279,341,893,33667
25-06-2019,3,8910,15508,5193,2916,32528,264,278,333,875,33403
25-06-2019,4,9135,15831,5085,2755,32807,262,281,324,867,33674
25-06-2019,5,10544,16200,5528,2645,34918,264,280,311,855,35773
25-06-2019,6,14479,16919,6190,2446,40036,316,315,244,875,40911
25-06-2019,7,16709,17366,6446,2269,42791,374,495,361,1230,44021
25-06-2019,8,17408,17709,6621,2077,43816,389,841,565,1795,45611
25-06-2019,9,17671,17746,6708,2026,44152,398,1125,395,1918,46070
25-06-2019,10,17745,17903,6857,2019,44526,394,1057,399,1850,46376
25-06-2019,11,17979,17934,6877,2004,44795,392,1019,395,1806,46601
25-06-2019,12,17707,18095,6928,1932,44661,393,914,573,1880,46541
25-06-2019,13,17487,18017,6766,2047,44315,393,892,563,1848,46163
25-06-2019,14,17468,17971,6724,2048,44213,396,919,390,1705,45918
25-06-2019,15,17439,17841,6597,1935,43813,395,726,379,1500,45313
25-06-2019,16,17078,17674,6476,1749,42976,392,756,323,1471,44447
25-06-2019,17,17644,17729,6513,1582,43469,391,953,360,1704,45173
25-06-2019,18,17524,17680,6631,1688,43524,387,909,349,1645,45169
25-06-2019,19,17334,17607,6585,1642,43169,378,1078,348,1804,44973
25-06-2019,20,16480,17588,6242,1871,42182,355,954,146,1455,43637
25-06-2019,21,15765,17558,6034,1583,40940,381,747,140,1268,42208
25-06-2019,22,15192,17493,5938,1407,40030,386,518,143,1047,41077
25-06-2019,23,13848,17035,5649,1323,37855,388,463,150,1001,38856
26-06-2019,0,12563,16129,5446,1182,35318,360,463,163,986,36304
26-06-2019,1,12397,15656,5452,1020,34525,373,460,170,1003,35528
26-06-2019,2,12323,15691,5447,832,34294,371,457,221,1049,35343
26-06-2019,3,11957,15414,5463,850,33686,394,456,189,1039,34725
26-06-2019,4,11514,15524,5563,892,33494,415,457,192,1064,34558
26-06-2019,5,12659,15697,6090,871,35318,428,468,180,1076,36394
26-06-2019,6,15139,17160,6590,1035,39925,466,822,253,1541,41466
26-06-2019,7,16534,18016,6745,1268,42565,485,913,360,1758,44323
26-06-2019,8,17002,18595,6829,1535,43962,550,990,562,2102,46064
26-06-2019,9,16800,18553,6859,1988,44202,545,922,546,2013,46215
26-06-2019,10,16956,18507,6954,2311,44727,550,886,578,2014,46741
26-06-2019,11,16808,18248,6953,2667,44675,550,832,568,1950,46625
26-06-2019,12,16651,18320,6994,2934,44898,560,828,583,1971,46869
26-06-2019,13,15811,18514,7065,3143,44532,551,910,479,1940,46472
26-06-2019,14,15403,18338,7019,3441,44200,552,749,402,1703,45903
26-06-2019,15,15048,18561,6550,3692,43851,558,740,295,1593,45444
26-06-2019,16,14227,18502,6385,4034,43148,559,565,230,1354,44502
26-06-2019,17,14556,18445,6528,4021,43551,565,678,273,1516,45067
26-06-2019,18,14207,18749,6794,3942,43692,540,689,280,1509,45201
26-06-2019,19,13895,18762,6774,3992,43424,481,669,428,1578,45002
26-06-2019,20,13170,18629,6342,3863,42003,447,593,292,1332,43335
26-06-2019,21,12298,18583,6058,3941,40882,387,478,348,1213,42095
26-06-2019,22,11192,18753,5961,4045,39950,376,280,363,1019,40969
26-06-2019,23,10138,17830,5499,4054,37521,278,282,279,839,38360
27-06-2019,0,9257,17190,5427,4089,35962,258,277,309,844,36806
27-06-2019,1,9149,16740,5550,4043,35483,259,270,323,852,36335
27-06-2019,2,8864,16450,5530,4100,34945,259,275,350,884,35829
27-06-2019,3,8408,16372,5522,4103,34406,270,276,367,913,35319
27-06-2019,4,8265,16811,5545,3904,34525,293,285,375,953,35478
27-06-2019,5,9100,17533,5908,3777,36319,296,290,416,1002,37321
27-06-2019,6,10842,18718,6211,3700,39471,347,299,433,1079,40550
27-06-2019,7,13106,19719,6550,3678,43050,410,376,659,1445,44495
27-06-2019,8,13833,20014,6918,3654,44419,430,536,839,1805,46224
27-06-2019,9,14287,20109,6970,3822,45188,430,540,864,1834,47022
27-06-2019,10,14462,19784,7024,4019,45288,456,523,902,1881,47169
27-06-2019,11,14330,19768,7011,4092,45201,464,491,931,1886,47087
27-06-2019,12,14122,19976,6973,3876,44947,452,520,956,1928,46875
27-06-2019,13,14130,19986,6915,3710,44742,451,544,751,1746,46488
27-06-2019,14,13893,19691,6891,3751,44227,467,517,750,1734,45961
27-06-2019,15,13243,19747,6839,3506,43336,464,456,604,1524,44860
27-06-2019,16,13395,19833,6760,3218,43207,430,349,603,1382,44589
27-06-2019,17,13803,19644,6942,2941,43331,451,365,574,1390,44721
27-06-2019,18,13910,19585,6806,2776,43078,496,345,670,1511,44589
27-06-2019,19,14084,19601,6577,2569,42829,469,501,501,1471,44300
27-06-2019,20,13860,19226,6408,2181,41675,425,514,384,1323,42998
27-06-2019,21,13431,18912,6517,1978,40838,403,478,363,1244,42082
27-06-2019,22,13135,18317,6666,1838,39958,411,308,384,1103,41061
27-06-2019,23,11549,17904,6800,1981,38234,426,293,417,1136,39370
28-06-2019,0,11211,16907,6579,1866,36563,431,293,413,1137,37700
28-06-2019,1,10665,16168,6488,1863,35186,430,299,432,1161,36347
28-06-2019,2,10555,16146,6469,1655,34826,429,295,449,1173,35999
28-06-2019,3,10542,16070,6330,1474,34416,418,293,439,1150,35566
28-06-2019,4,10727,16335,6190,1375,34627,398,283,428,1109,35736
28-06-2019,5,12369,17232,6319,1266,37185,387,289,382,1058,38243
28-06-2019,6,14134,18689,6536,1414,40773,431,527,444,1402,42175
28-06-2019,7,15507,18988,6736,1504,42737,477,521,581,1579,44316
28-06-2019,8,16277,19387,6867,1538,44070,476,516,799,1791,45861
28-06-2019,9,16170,19781,6997,1578,44527,467,514,839,1820,46347
28-06-2019,10,16020,19694,6957,1713,44385,466,514,838,1818,46203
28-06-2019,11,15916,19427,6907,1540,43790,458,555,833,1846,45636
28-06-2019,12,15907,19206,6970,1641,43724,493,519,865,1877,45601
28-06-2019,13,15653,19086,6949,1795,43484,492,524,679,1695,45179
28-06-2019,14,15301,19238,6893,1757,43187,497,531,521,1549,44736
28-06-2019,15,14901,19312,6668,1721,42603,507,534,534,1575,44178
28-06-2019,16,14513,19214,6430,1773,41930,515,526,653,1694,43624
28-06-2019,17,14796,19154,6548,1595,42093,536,467,660,1663,43756
28-06-2019,18,14907,18794,6776,1478,41955,518,530,703,1751,43706
28-06-2019,19,15054,18465,6602,1313,41437,466,530,565,1561,42998
28-06-2019,20,14572,18086,6209,1252,40119,379,524,400,1303,41422
28-06-2019,21,13565,17665,6025,1413,38670,356,371,463,1190,39860
28-06-2019,22,12897,17677,6040,1288,37903,358,292,358,1008,38911
28-06-2019,23,12472,17634,5884,1367,37356,348,287,337,972,38328
29-06-2019,0,11584,16497,5715,1709,35505,338,269,310,917,36422
29-06-2019,1,10658,16296,5633,1618,34204,350,269,308,927,35131
29-06-2019,2,10206,16302,5579,1541,33628,378,270,298,946,34574
29-06-2019,3,9757,16309,5615,1635,33318,360,268,253,881,34199
29-06-2019,4,9501,16261,5488,1538,32788,335,267,243,845,33633
29-06-2019,5,9394,16570,5554,1531,33050,269,284,227,780,33830
29-06-2019,6,9257,17442,5788,1726,34212,235,270,200,705,34917
29-06-2019,7,10445,17959,6046,1633,36083,233,305,176,714,36797
29-06-2019,8,11032,18718,6307,1825,37881,236,305,319,860,38741
29-06-2019,9,11431,18976,6379,2140,38927,244,475,374,1093,40020
29-06-2019,10,11276,19376,6408,1756,38817,251,404,635,1290,40107
29-06-2019,11,11328,19439,6428,1954,39150,258,499,586,1343,40493
29-06-2019,12,11222,19404,6352,2058,39036,261,448,601,1310,40346
29-06-2019,13,10044,19033,6412,1879,37369,270,476,536,1282,38651
29-06-2019,14,9901,18743,6477,1840,36963,268,448,603,1319,38282
29-06-2019,15,9970,18905,6588,1822,37286,259,492,532,1283,38569
29-06-2019,16,10788,19220,6574,1798,38380,263,503,497,1263,39643
29-06-2019,17,11928,19148,6537,1711,39326,263,472,564,1299,40625
29-06-2019,18,12959,18631,6389,1475,39455,254,395,509,1158,40613
29-06-2019,19,12925,18544,6284,1269,39022,268,436,450,1154,40176
29-06-2019,20,12328,18337,6331,1154,38151,256,356,412,1024,39175
29-06-2019,21,12151,18435,6480,1059,38124,256,321,262,839,38963
29-06-2019,22,11801,17876,6525,981,37186,274,263,205,742,37928
29-06-2019,23,11255,17371,6420,970,36018,263,240,186,689,36707
30-06-2019,0,10368,16876,6312,1195,34751,207,108,182,497,35248
30-06-2019,1,9309,16462,6112,1157,33040,192,110,198,500,33540
30-06-2019,2,8884,16191,5990,1233,32296,186,110,215,511,32807
30-06-2019,3,8183,15927,5719,1512,31340,178,108,237,523,31863
30-06-2019,4,7486,15457,5377,1689,30010,165,107,251,523,30533
30-06-2019,5,7168,14725,5115,2340,29349,152,107,239,498,29847
30-06-2019,6,7561,14801,5114,2730,30206,153,106,214,473,30679
30-06-2019,7,7947,14774,5369,2922,31013,151,114,233,498,31511
30-06-2019,8,8345,14967,5465,3181,31960,152,336,308,796,32756
30-06-2019,9,8821,15407,5633,3340,33201,159,320,557,1036,34237
30-06-2019,10,9043,15557,5727,3961,34288,198,317,501,1016,35304
30-06-2019,11,9354,16161,5791,4429,35735,223,317,533,1073,36808
30-06-2019,12,9356,16605,5795,4718,36473,228,327,547,1102,37575
30-06-2019,13,9165,16556,5714,4680,36118,225,379,582,1186,37304
30-06-2019,14,9177,16831,5729,4538,36275,217,375,566,1158,37433
30-06-2019,15,9806,16425,5504,4192,35927,212,386,375,973,36900
30-06-2019,16,9456,16467,5555,4733,36212,222,378,350,950,37162
30-06-2019,17,9743,18195,5542,4777,38256,235,374,331,940,39196
30-06-2019,18,10730,19673,5634,4176,40212,225,370,261,856,41068
30-06-2019,19,11105,19353,5717,3896,40071,219,375,263,857,40928
30-06-2019,20,11302,19436,5837,3715,40291,262,378,279,919,41210
30-06-2019,21,11292,18905,6076,3482,39755,268,302,413,983,40738
30-06-2019,22,10869,18071,6216,3234,38391,303,302,465,1070,39461
30-06-2019,23,10479,17297,6217,2870,36864,314,303,487,1104,37968
01-07-2019,0,9689,16812,6193,3111,35805,311,310,484,1105,36910
01-07-2019,1,9124,16682,6205,3459,35469,389,293,426,1108,36577
01-07-2019,2,8974,16666,6148,3307,35095,375,292,443,1110,36205
01-07-2019,3,8878,16385,6188,3287,34739,368,285,442,1095,35834
01-07-2019,4,8937,16419,6024,3137,34518,394,288,439,1121,35639
01-07-2019,5,9441,16922,6111,3136,35611,411,294,401,1106,36717
01-07-2019,6,11742,18323,6306,2841,39213,418,303,395,1116,40329
01-07-2019,7,13834,19222,6812,2997,42865,435,314,617,1366,44231
01-07-2019,8,14597,19523,6975,3422,44518,471,542,650,1663,46181
01-07-2019,9,14397,20037,7174,3773,45381,462,539,692,1693,47074
01-07-2019,10,14458,20232,7176,4040,45908,474,540,729,1743,47651
01-07-2019,11,14128,20284,7237,4160,45808,486,545,759,1790,47598
01-07-2019,12,13669,20210,7241,4291,45415,487,551,984,2022,47437
01-07-2019,13,13076,19631,7002,4485,44193,495,552,980,2027,46220
01-07-2019,14,12676,19113,7124,4720,43635,505,561,978,2044,45679
01-07-2019,15,13170,18998,7028,4775,43972,496,565,967,2028,46000
01-07-2019,16,12936,19181,6932,4669,43718,488,565,776,1829,45547
01-07-2019,17,13602,19104,6899,4777,44383,489,567,732,1788,46171
01-07-2019,18,13891,18928,6771,4620,44209,467,567,697,1731,45940
01-07-2019,19,13591,18577,6638,4401,43207,444,562,648,1654,44861
01-07-2019,20,13238,18482,6351,4262,42334,401,517,606,1524,43858
01-07-2019,21,12937,18350,6396,4180,41864,376,554,374,1304,43168
01-07-2019,22,12117,18302,6240,4086,40745,377,317,388,1082,41827
01-07-2019,23,10980,17931,5825,4224,38961,388,319,503,1210,40171
02-07-2019,0,10831,16748,5249,4385,37214,400,311,505,1216,38430
02-07-2019,1,10403,16133,5100,4396,36033,374,312,476,1162,37195
02-07-2019,2,10184,15978,4993,4556,35712,373,311,500,1184,36896
02-07-2019,3,9916,15998,4978,4527,35420,360,312,482,1154,36574
02-07-2019,4,9705,15986,5109,4404,35204,427,314,415,1156,36360
02-07-2019,5,10578,16641,5472,4459,37150,461,312,394,1167,38317
02-07-2019,6,11985,17688,6115,4586,40374,531,386,378,1295,41669
02-07-2019,7,13373,18578,6563,4716,43230,601,547,573,1721,44951
02-07-2019,8,13938,18827,6786,4808,44358,632,535,619,1786,46144
02-07-2019,9,14594,18850,6942,4961,45348,585,537,787,1909,47257
02-07-2019,10,14658,18725,6936,4878,45197,591,539,868,1998,47195
02-07-2019,11,14744,18628,6953,4876,45202,629,542,887,2058,47260
02-07-2019,12,14455,18504,6933,4731,44623,633,547,887,2067,46690
02-07-2019,13,14530,18194,6991,4694,44409,626,536,944,2106,46515
02-07-2019,14,14434,18106,6895,4867,44304,602,516,785,1903,46207
02-07-2019,15,13863,17912,6769,4731,43275,620,497,793,1910,45185
02-07-2019,16,13813,17598,6504,5061,42975,583,544,779,1906,44881
02-07-2019,17,14147,17779,6486,5004,43416,602,536,772,1910,45326
02-07-2019,18,14067,17573,6406,4827,42874,542,540,778,1860,44734
02-07-2019,19,14385,17531,6488,4467,42871,526,529,750,1805,44676
02-07-2019,20,14445,17510,6413,4127,42494,473,384,745,1602,44096
02-07-2019,21,14543,17350,6144,3783,41820,485,302,634,1421,43241
02-07-2019,22,14413,17122,5895,3504,40935,488,298,505,1291,42226
02-07-2019,23,13308,16436,5715,3376,38835,490,293,501,1284,40119
03-07-2019,0,11889,15537,5514,3401,36343,507,293,464,1264,37607
03-07-2019,1,11407,15069,5566,3111,35153,495,295,420,1210,36363
03-07-2019,2,11145,14812,5613,2893,34464,507,301,391,1199,35663
03-07-2019,3,10895,14765,5561,2982,34203,533,299,336,1168,35371
03-07-2019,4,11011,14797,5528,2793,34130,560,288,350,1198,35328
03-07-2019,5,12160,15777,5653,2688,36277,541,288,291,1120,37397
03-07-2019,6,14408,17168,6083,2887,40548,493,288,323,1104,41652
03-07-2019,7,15639,17978,6540,3414,43572,419,453,575,1447,45019
03-07-2019,8,16239,18336,6935,3510,45019,512,522,680,1714,46733
03-07-2019,9,16264,18676,7134,3758,45833,436,524,725,1685,47518
03-07-2019,10,16072,18315,7010,3823,45223,492,520,696,1708,46931
03-07-2019,11,15941,18283,6992,4076,45293,516,517,718,1751,47044
03-07-2019,12,15259,18286,7005,4250,44801,539,610,722,1871,46672
03-07-2019,13,14884,18238,6978,4303,44402,554,533,712,1799,46201
03-07-2019,14,14625,18095,6891,4344,43956,502,601,749,1852,45808
03-07-2019,15,14761,18117,6909,4279,44067,545,623,586,1754,45821
03-07-2019,16,15000,18009,6812,4119,43938,564,533,593,1690,45628
03-07-2019,17,15229,18103,6762,4311,44405,532,531,536,1599,46004
03-07-2019,18,15215,17721,6936,4206,44078,496,651,478,1625,45703
03-07-2019,19,15087,17465,6775,4130,43457,480,667,387,1534,44991
03-07-2019,20,15062,17458,6648,3925,43095,473,534,392,1399,44494
03-07-2019,21,15134,17425,6548,3927,43035,426,291,253,970,44005
03-07-2019,22,14555,17193,6266,3812,41828,358,289,249,896,42724
03-07-2019,23,13620,16552,5955,3696,39823,342,289,311,942,40765
04-07-2019,0,12345,15754,5826,3793,37719,347,291,363,1001,38720
04-07-2019,1,11898,15371,5860,3650,36780,334,283,341,958,37738
04-07-2019,2,11512,15402,5775,3400,36090,331,286,311,928,37018
04-07-2019,3,11652,15371,5659,3187,35870,320,283,323,926,36796
04-07-2019,4,11686,15212,5623,3163,35685,307,282,348,937,36622
04-07-2019,5,12628,15812,5828,3265,37535,288,292,332,912,38447
04-07-2019,6,14282,17052,6565,3519,41420,281,513,319,1113,42533
04-07-2019,7,15486,17997,6838,3918,44240,319,499,511,1329,45569
04-07-2019,8,15722,18395,7090,4329,45536,428,546,763,1737,47273
04-07-2019,9,15647,18476,7175,4329,45626,297,718,786,1801,47427
04-07-2019,10,15658,18495,7123,4677,45955,309,578,826,1713,47668
04-07-2019,11,15393,18499,7156,5059,46109,325,489,844,1658,47767
04-07-2019,12,15058,18286,7199,4885,45428,354,500,663,1517,46945
04-07-2019,13,14856,18121,7146,4879,45001,344,507,657,1508,46509
04-07-2019,14,14827,18060,7000,4852,44740,317,500,700,1517,46257
04-07-2019,15,14765,18044,6818,4951,44579,320,551,684,1555,46134
04-07-2019,16,14631,18039,6683,5267,44621,333,555,679,1567,46188
04-07-2019,17,14911,18299,6759,4878,44847,326,557,705,1588,46435
04-07-2019,18,14993,18124,6879,4448,44444,318,555,827,1700,46144
04-07-2019,19,14809,18066,6742,4312,43929,317,556,636,1509,45438
04-07-2019,20,14777,17947,6555,4119,43397,350,540,615,1505,44902
04-07-2019,21,14151,17584,6317,4317,42369,354,348,466,1168,43537
04-07-2019,22,13574,17243,5999,4186,41002,401,319,521,1241,42243
04-07-2019,23,12488,16579,5516,4379,38961,422,319,555,1296,40257
05-07-2019,0,10844,16098,5209,4511,36662,434,319,536,1289,37951
05-07-2019,1,10707,16005,5187,4272,36171,398,301,517,1216,37387
05-07-2019,2,10503,16027,5263,3790,35584,344,295,516,1155,36739
05-07-2019,3,10833,16079,5324,3455,35692,348,289,462,1099,36791
05-07-2019,4,11067,16033,5433,3133,35667,361,314,367,1042,36709
05-07-2019,5,12121,16842,5776,2594,37334,363,300,376,1039,38373
05-07-2019,6,14020,18448,6048,2299,40816,390,416,359,1165,41981
05-07-2019,7,15043,19026,6562,2231,42861,411,635,537,1583,44444
05-07-2019,8,15595,19196,6855,2268,43914,413,730,764,1907,45821
05-07-2019,9,15632,19275,6784,2167,43858,403,743,812,1958,45816
05-07-2019,10,15629,19366,6758,1968,43721,392,744,931,2067,45788
05-07-2019,11,15550,19322,6741,2010,43624,395,832,888,2115,45739
05-07-2019,12,15515,19464,6799,2167,43944,358,834,760,1952,45896
05-07-2019,13,15097,19445,6857,2451,43850,329,821,798,1948,45798
05-07-2019,14,14858,19319,6814,2417,43409,347,766,773,1886,45295
05-07-2019,15,15025,19252,6865,2641,43784,355,752,638,1745,45529
05-07-2019,16,15109,19246,6403,2788,43547,342,368,635,1345,44892
05-07-2019,17,15277,19218,6434,2567,43497,353,357,609,1319,44816
05-07-2019,18,15293,19061,6721,2656,43730,395,584,585,1564,45294
05-07-2019,19,15247,18803,6645,2618,43313,385,530,551,1466,44779
05-07-2019,20,14915,18647,6280,2443,42285,382,311,508,1201,43486
05-07-2019,21,14689,18453,6083,2302,41528,282,309,475,1066,42594
05-07-2019,22,14004,18225,5998,2054,40282,268,307,471,1046,41328
05-07-2019,23,12946,17851,5647,1965,38409,267,312,435,1014,39423
06-07-2019,0,12463,17061,5587,1885,36997,255,290,451,996,37993
06-07-2019,1,11942,16549,5488,1846,35825,279,282,457,1018,36843
06-07-2019,2,11362,16005,5436,1694,34497,309,282,458,1049,35546
06-07-2019,3,11436,15862,5414,1579,34292,314,281,458,1053,35345
06-07-2019,4,11236,15711,5356,1568,33872,317,274,440,1031,34903
06-07-2019,5,11532,15703,5383,1756,34373,308,270,372,950,35323
06-07-2019,6,11579,15666,5330,1952,34527,298,271,290,859,35386
06-07-2019,7,12076,16198,5302,2109,35685,287,271,283,841,36526
06-07-2019,8,12996,16463,5611,2334,37404,270,272,317,859,38263
06-07-2019,9,13138,16659,5795,2349,37941,254,267,369,890,38831
06-07-2019,10,12629,16237,5688,2893,37446,251,269,381,901,38347
06-07-2019,11,11542,15786,5582,3717,36625,255,273,432,960,37585
06-07-2019,12,10864,15422,5439,4351,36075,244,276,460,980,37055
06-07-2019,13,10692,15359,5443,4463,35956,245,280,422,947,36903
06-07-2019,14,10776,15028,5408,4492,35703,248,279,375,902,36605
06-07-2019,15,10690,15036,5848,4990,36564,244,287,330,861,37425
06-07-2019,16,11246,15170,5877,5548,37841,253,276,279,808,38649
06-07-2019,17,12564,15687,6042,5845,40139,240,274,267,781,40920
06-07-2019,18,12673,16347,6120,5536,40676,224,269,278,771,41447
06-07-2019,19,12817,16778,6105,5095,40796,212,264,221,697,41493
06-07-2019,20,12260,16551,5890,4798,39498,217,259,201,677,40175
06-07-2019,21,12023,16390,5776,4549,38738,216,256,179,651,39389
06-07-2019,22,12348,16316,5644,4473,38782,211,255,177,643,39425
06-07-2019,23,11584,15625,5400,4177,36786,208,253,188,649,37435
07-07-2019,0,9937,14418,5384,4376,34115,202,255,211,668,34783
07-07-2019,1,8831,13536,5320,4213,31900,196,257,224,677,32577
07-07-2019,2,8150,13204,5233,4041,30628,196,288,228,712,31340
07-07-2019,3,7398,13016,5202,3943,29560,194,273,254,721,30281
07-07-2019,4,7211,12978,5100,3915,29203,199,293,250,742,29945
07-07-2019,5,7513,13057,5046,3786,29403,209,327,234,770,30173
07-07-2019,6,7938,13344,4987,3725,29995,211,338,226,775,30770
07-07-2019,7,8298,13820,5021,3738,30876,217,297,282,796,31672
07-07-2019,8,9198,14219,5176,3911,32504,213,256,324,793,33297
07-07-2019,9,10232,15090,5416,3899,34637,213,270,330,813,35450
07-07-2019,10,10412,15206,5756,4038,35412,209,259,401,869,36281
07-07-2019,11,10437,15446,5872,4019,35774,212,261,365,838,36612
07-07-2019,12,10045,15063,5954,4016,35079,224,307,393,924,36003
07-07-2019,13,9631,14827,5853,4158,34468,217,259,402,878,35346
07-07-2019,14,9001,14637,5837,4115,33591,212,264,400,876,34467
07-07-2019,15,8895,14704,5879,4115,33594,216,266,372,854,34448
07-07-2019,16,9298,15082,5878,4138,34397,217,261,400,878,35275
07-07-2019,17,10268,15777,6165,4011,36222,215,369,361,945,37167
07-07-2019,18,11434,16534,6345,3813,38126,218,375,316,909,39035
07-07-2019,19,12560,17244,6526,3494,39825,217,352,323,892,40717
07-07-2019,20,13066,17231,6471,3164,39933,212,467,306,985,40918
07-07-2019,21,13750,17439,6411,2815,40417,236,474,282,992,41409
07-07-2019,22,13015,17602,6450,2562,39631,226,260,206,692,40323
07-07-2019,23,11901,17109,6312,2406,37728,232,260,194,686,38414
08-07-2019,0,11419,15790,6213,2220,35643,221,262,205,688,36331
08-07-2019,1,10656,15463,6165,2133,34418,219,259,233,711,35129
08-07-2019,2,10225,15396,6004,2083,33708,215,259,277,751,34459
08-07-2019,3,10332,15292,5901,2105,33631,210,265,284,759,34390
08-07-2019,4,10062,15606,5861,2085,33612,207,266,256,729,34341
08-07-2019,5,11038,16005,5950,2055,35049,197,265,250,712,35761
08-07-2019,6,14305,17280,6185,2128,39897,193,267,265,725,40622
08-07-2019,7,15335,17624,6485,2453,41897,259,515,426,1200,43097
08-07-2019,8,16101,17867,6746,2397,43112,308,952,653,1913,45025
08-07-2019,9,16400,18170,6842,2558,43969,306,967,688,1961,45930
08-07-2019,10,16383,18697,6899,2541,44520,296,904,770,1970,46490
08-07-2019,11,15858,18606,6923,2635,44023,311,807,806,1924,45947
08-07-2019,12,15724,18464,6859,2620,43667,321,759,771,1851,45518
08-07-2019,13,15300,18542,6816,2449,43107,325,662,777,1764,44871
08-07-2019,14,15357,18437,6700,2493,42989,323,678,842,1843,44832
08-07-2019,15,15627,18150,6623,2573,42974,327,636,638,1601,44575
08-07-2019,16,15712,18098,6534,2738,43082,326,542,446,1314,44396
08-07-2019,17,15741,18026,6623,3045,43435,312,403,577,1292,44727
08-07-2019,18,16070,17712,6560,2996,43337,295,501,772,1568,44905
08-07-2019,19,15883,17749,6428,2238,42298,287,499,756,1542,43840
08-07-2019,20,15686,17627,6070,2043,41426,285,491,532,1308,42734
08-07-2019,21,15156,17660,6041,1977,40835,321,390,320,1031,41866
08-07-2019,22,14218,17363,5961,2011,39554,347,260,303,910,40464
08-07-2019,23,12495,16912,5902,2093,37403,339,254,322,915,38318
09-07-2019,0,11800,16538,5979,2703,37021,338,254,207,799,37820
09-07-2019,1,10605,15552,5760,2589,34507,337,265,178,780,35287
09-07-2019,2,10323,15457,5660,2528,33968,327,256,156,739,34707
09-07-2019,3,10323,15446,5694,2480,33943,342,258,148,748,34691
09-07-2019,4,10505,15652,5740,2390,34288,352,259,138,749,35037
09-07-2019,5,11451,16360,5777,2369,35959,350,270,135,755,36714
09-07-2019,6,13944,17302,6326,2404,39978,350,511,135,996,40974
09-07-2019,7,15225,17621,6705,2706,42256,363,644,398,1405,43661
09-07-2019,8,15968,17965,6883,2894,43710,372,666,546,1584,45294
09-07-2019,9,16346,17736,6934,2862,43880,372,896,575,1843,45723
09-07-2019,10,16148,17902,7021,2940,44010,371,870,539,1780,45790
09-07-2019,11,16236,17925,7127,2918,44207,372,816,592,1780,45987
09-07-2019,12,16344,17871,7175,2569,43959,381,713,600,1694,45653
09-07-2019,13,15727,17819,7167,2856,43570,391,672,676,1739,45309
09-07-2019,14,15492,17564,7084,2767,42910,399,608,719,1726,44636
09-07-2019,15,15808,17519,6974,2482,42783,403,608,551,1562,44345
09-07-2019,16,15505,17409,6823,2401,42137,402,550,513,1465,43602
09-07-2019,17,15459,17880,6731,2516,42586,391,484,541,1416,44002
09-07-2019,18,15417,18164,6796,2761,43138,375,533,616,1524,44662
09-07-2019,19,15075,18591,6674,2682,43021,385,534,512,1431,44452
09-07-2019,20,14859,18391,6434,2517,42202,377,506,497,1380,43582
09-07-2019,21,14822,18011,6581,2453,41867,341,482,473,1296,43163
09-07-2019,22,14686,17594,6535,2392,41208,330,284,268,882,42090
09-07-2019,23,13896,17136,6213,2150,39395,318,281,261,860,40255
10-07-2019,0,12782,16979,6134,1783,37677,313,260,263,836,38513
10-07-2019,1,11887,16719,6111,1685,36403,308,259,254,821,37224
10-07-2019,2,11192,16233,6004,1596,35028,303,257,235,795,35823
10-07-2019,3,10924,15825,5834,1453,34037,305,257,210,772,34809
10-07-2019,4,11019,15747,5779,1584,34129,306,260,191,757,34886
10-07-2019,5,11722,16377,6057,1583,35740,321,258,168,747,36487
10-07-2019,6,13262,17149,6127,1558,38097,340,274,260,874,38971
10-07-2019,7,14234,17711,6336,1838,40118,345,574,453,1372,41490
10-07-2019,8,14885,17936,6505,1988,41314,344,606,560,1510,42824
10-07-2019,9,15237,18189,6544,2175,42146,343,709,599,1651,43797
10-07-2019,10,15397,18231,6543,2260,42431,343,792,598,1733,44164
10-07-2019,11,15272,18318,6496,2424,42510,343,785,607,1735,44245
10-07-2019,12,14945,18010,6560,2497,42011,321,789,619,1729,43740
10-07-2019,13,14777,17936,6602,2607,41923,318,726,445,1489,43412
10-07-2019,14,14768,17850,6687,2677,41982,320,594,537,1451,43433
10-07-2019,15,14645,17736,6712,2620,41713,323,598,538,1459,43172
10-07-2019,16,14346,17962,6668,2460,41437,328,604,480,1412,42849
10-07-2019,17,14864,18204,6657,2282,42007,325,588,484,1397,43404
10-07-2019,18,14596,18215,6717,2184,41713,319,586,488,1393,43106
10-07-2019,19,14775,18000,6503,1900,41180,317,582,457,1356,42536
10-07-2019,20,14674,18029,6195,1726,40625,318,573,467,1358,41983
10-07-2019,21,14812,17962,6260,1570,40603,319,379,393,1091,41694
10-07-2019,22,14664,17740,5946,1414,39764,316,262,226,804,40568
10-07-2019,23,13922,17220,5772,1206,38120,306,260,229,795,38915
11-07-2019,0,12948,16443,5642,1132,36165,300,260,216,776,36941
11-07-2019,1,12427,16138,5669,851,35085,277,258,214,749,35834
11-07-2019,2,12125,15943,5588,722,34378,280,255,205,740,35118
11-07-2019,3,11912,15783,5563,669,33927,298,255,191,744,34671
11-07-2019,4,11776,15898,5524,589,33788,333,259,182,774,34562
11-07-2019,5,12740,16529,5802,598,35668,354,263,174,791,36459
11-07-2019,6,13845,17275,6313,729,38161,366,490,252,1108,39269
11-07-2019,7,14891,17458,6667,1327,40343,458,623,351,1432,41775
11-07-2019,8,15535,17978,6909,1527,41949,493,670,401,1564,43513
11-07-2019,9,16049,18088,6957,1673,42767,497,795,589,1881,44648
11-07-2019,10,16402,18024,6844,1445,42717,505,815,604,1924,44641
11-07-2019,11,16460,18044,7002,1450,42957,508,814,607,1929,44886
11-07-2019,12,16165,17938,6987,1491,42582,503,779,646,1928,44510
11-07-2019,13,16124,18007,6858,1537,42527,500,762,523,1785,44312
11-07-2019,14,16015,17954,6822,1480,42272,505,675,561,1741,44013
11-07-2019,15,15961,17981,6862,1289,42094,507,708,347,1562,43656
11-07-2019,16,15557,18031,6896,1257,41742,508,628,352,1488,43230
11-07-2019,17,15424,17958,6847,1149,41379,505,514,376,1395,42774
11-07-2019,18,15188,17751,6802,1119,40859,499,518,303,1320,42179
11-07-2019,19,15037,17803,6561,927,40328,495,498,319,1312,41640
11-07-2019,20,14832,17636,6324,809,39601,415,494,262,1171,40772
11-07-2019,21,14624,17732,6375,741,39471,309,493,277,1079,40550
11-07-2019,22,14453,17593,6284,702,39032,300,337,234,871,39903
11-07-2019,23,14039,17143,5917,587,37687,286,274,255,815,38502
12-07-2019,0,14212,15940,5926,650,36728,273,323,265,861,37589
12-07-2019,1,14152,14952,5973,486,35563,261,257,246,764,36327
12-07-2019,2,13747,14610,5756,504,34618,283,252,242,777,35395
12-07-2019,3,13512,14494,5626,430,34063,260,251,241,752,34815
12-07-2019,4,13105,15398,5657,530,34690,262,254,199,715,35405
12-07-2019,5,13507,15836,6140,450,35933,286,304,173,763,36696
12-07-2019,6,14146,16618,6478,492,37736,356,484,155,995,38731
12-07-2019,7,14772,17264,6677,610,39322,466,585,337,1388,40710
12-07-2019,8,15389,17724,6891,685,40690,498,669,345,1512,42202
12-07-2019,9,15859,17972,6921,783,41535,513,671,539,1723,43258
12-07-2019,10,16154,18149,6935,846,42086,504,671,546,1721,43807
12-07-2019,11,16051,18151,6986,977,42166,492,820,554,1866,44032
12-07-2019,12,15888,18103,6911,974,41878,480,955,571,2006,43884
12-07-2019,13,15485,18051,6913,969,41418,481,816,388,1685,43103
12-07-2019,14,15196,18089,6877,1084,41245,508,675,386,1569,42814
12-07-2019,15,15103,17732,6758,1159,40753,495,673,387,1555,42308
12-07-2019,16,14898,17542,6617,1170,40228,486,596,379,1461,41689
12-07-2019,17,15113,17469,6596,1105,40284,484,587,366,1437,41721
12-07-2019,18,15025,17388,6615,1113,40142,479,576,340,1395,41537
12-07-2019,19,14772,17097,6546,993,39409,481,573,152,1206,40615
12-07-2019,20,13948,16924,6104,953,37930,384,570,151,1105,39035
12-07-2019,21,13929,17129,6049,834,37942,308,257,164,729,38671
12-07-2019,22,13751,16772,6106,888,37519,309,253,186,748,38267
12-07-2019,23,13052,16251,6031,957,36293,281,254,199,734,37027
13-07-2019,0,12762,15366,5846,739,34712,284,250,193,727,35439
13-07-2019,1,12197,14431,5706,750,33084,283,248,191,722,33806
13-07-2019,2,11412,13774,5599,728,31513,281,247,191,719,32232
13-07-2019,3,10304,13479,5465,792,30040,278,247,199,724,30764
13-07-2019,4,10206,13560,5335,871,29972,274,248,201,723,30695
13-07-2019,5,9806,13503,5273,865,29447,270,249,230,749,30196
13-07-2019,6,11135,14548,5296,903,31882,271,252,204,727,32609
13-07-2019,7,12092,15747,5264,988,34091,269,262,183,714,34805
13-07-2019,8,13254,16449,5507,1165,36374,299,333,256,888,37262
13-07-2019,9,14044,16846,5699,1316,37906,309,531,170,1010,38916
13-07-2019,10,14433,16875,5812,1413,38534,291,513,191,995,39529
13-07-2019,11,14192,17225,5838,1466,38721,276,487,189,952,39673
13-07-2019,12,13115,16774,5909,1527,37325,276,498,194,968,38293
13-07-2019,13,11646,15200,5758,1628,34232,283,528,219,1030,35262
13-07-2019,14,10429,14784,5697,1780,32691,281,494,226,1001,33692
13-07-2019,15,10178,14694,5765,2047,32683,299,488,245,1032,33715
13-07-2019,16,10236,14751,5795,2060,32844,281,364,243,888,33732
13-07-2019,17,11040,15006,5913,2088,34048,275,359,216,850,34898
13-07-2019,18,12632,16050,5968,2062,36714,275,347,211,833,37547
13-07-2019,19,13614,16341,5954,1977,37887,268,341,217,826,38713
13-07-2019,20,13150,16696,5656,1816,37317,262,339,216,817,38134
13-07-2019,21,12788,16554,5487,1672,36502,254,337,238,829,37331
13-07-2019,22,13236,16461,5667,1660,37024,242,335,287,864,37888
13-07-2019,23,12743,15909,5448,1610,35712,244,253,291,788,36500
14-07-2019,0,10786,14230,5301,1597,31914,245,250,287,782,32696
14-07-2019,1,9079,13287,5202,1511,29078,244,250,260,754,29832
14-07-2019,2,8468,12852,5098,1380,27797,244,250,252,746,28543
14-07-2019,3,8015,12386,5087,1326,26815,242,250,247,739,27554
14-07-2019,4,7336,12261,5082,1331,26011,251,252,246,749,26760
14-07-2019,5,7325,12268,5010,1235,25837,249,250,226,725,26562
14-07-2019,6,7906,12654,4933,1196,26690,249,251,192,692,27382
14-07-2019,7,9215,13238,5001,1190,28644,251,253,168,672,29316
14-07-2019,8,10284,14335,5374,1117,31110,255,251,176,682,31792
14-07-2019,9,11426,15071,5573,1135,33206,267,253,188,708,33914
14-07-2019,10,11802,15252,5654,1282,33992,262,270,204,736,34728
14-07-2019,11,11914,15072,5714,1343,34042,262,368,210,840,34882
14-07-2019,12,11738,15321,5724,1379,34162,274,312,224,810,34972
14-07-2019,13,10651,14691,5698,1526,32567,273,264,243,780,33347
14-07-2019,14,10078,14526,5612,1638,31856,279,262,272,813,32669
14-07-2019,15,10115,14636,5550,1672,31973,282,264,295,841,32814
14-07-2019,16,9966,14730,5542,1754,31994,267,263,330,860,32854
14-07-2019,17,10957,15138,5480,1865,33439,266,258,303,827,34266
14-07-2019,18,12320,16060,5628,2106,36115,261,259,292,812,36927
14-07-2019,19,12804,16628,5627,2106,37165,255,279,249,783,37948
14-07-2019,20,13513,16958,5641,1847,37959,249,301,232,782,38741
14-07-2019,21,13313,16913,5694,1900,37820,251,283,248,782,38602
14-07-2019,22,13210,17024,5647,1769,37652,250,343,258,851,38503
14-07-2019,23,12286,16239,5440,1751,35717,249,250,252,751,36468
15-07-2019,0,10673,14953,5119,1770,32514,245,246,235,726,33240
15-07-2019,1,9720,13756,5018,1825,30320,242,245,222,709,31029
15-07-2019,2,9420,13567,5110,1937,30035,264,246,200,710,30745
15-07-2019,3,8608,13160,5106,1899,28772,261,246,176,683,29455
15-07-2019,4,8626,13452,5260,1930,29269,266,248,163,677,29946
15-07-2019,5,10239,15040,5528,2012,32821,281,254,163,698,33519
15-07-2019,6,13303,16114,6231,2074,37723,317,477,164,958,38681
15-07-2019,7,14283,17052,6429,1761,39524,398,544,525,1467,40991
15-07-2019,8,14986,18109,6621,1734,41450,452,570,526,1548,42998
15-07-2019,9,15037,18549,6736,2060,42382,452,765,571,1788,44170
15-07-2019,10,15375,18475,6671,1957,42478,431,770,580,1781,44259
15-07-2019,11,15357,18554,6666,2209,42786,434,816,590,1840,44626
15-07-2019,12,15019,18695,6600,2184,42498,428,910,607,1945,44443
15-07-2019,13,14874,18617,6523,2208,42222,448,912,610,1970,44192
15-07-2019,14,13778,19132,6591,2497,41998,444,654,622,1720,43718
15-07-2019,15,13731,18710,6661,2374,41477,431,641,577,1649,43126
15-07-2019,16,13233,19044,6457,2258,40992,446,619,397,1462,42454
15-07-2019,17,13982,18887,6511,2038,41418,456,642,435,1533,42951
15-07-2019,18,14749,18500,6564,1939,41752,463,546,394,1403,43155
15-07-2019,19,14690,18335,6498,1778,41300,387,543,552,1482,42782
15-07-2019,20,14084,17837,6394,1746,40061,330,540,543,1413,41474
15-07-2019,21,13638,17520,6456,1651,39264,341,481,322,1144,40408
15-07-2019,22,13353,17331,6119,1560,38362,362,268,160,790,39152
15-07-2019,23,12140,16352,5780,1750,36022,361,260,166,787,36809
16-07-2019,0,10679,15304,5598,2017,33598,323,259,170,752,34350
16-07-2019,1,9489,14215,5504,2245,31454,330,263,184,777,32231
16-07-2019,2,9131,14197,5499,2060,30889,348,266,197,811,31700
16-07-2019,3,8791,14333,5539,2107,30770,354,274,211,839,31609
16-07-2019,4,8587,14361,5558,2137,30643,330,264,225,819,31462
16-07-2019,5,9620,15338,5636,2026,32622,322,263,225,810,33432
16-07-2019,6,12060,17130,6083,1694,36969,374,427,231,1032,38001
16-07-2019,7,13317,18086,6301,1792,39496,518,483,598,1599,41095
16-07-2019,8,13833,18925,6526,1743,41027,512,483,574,1569,42596
16-07-2019,9,14324,19151,6631,1940,42047,527,650,569,1746,43793
16-07-2019,10,14512,19478,6689,2011,42692,543,660,573,1776,44468
16-07-2019,11,14684,19465,6725,2041,42915,497,783,567,1847,44762
16-07-2019,12,14479,19689,6702,1838,42707,499,888,578,1965,44672
16-07-2019,13,14329,19451,6648,1814,42243,476,806,577,1859,44102
16-07-2019,14,13989,19213,6663,1806,41671,477,496,594,1567,43238
16-07-2019,15,13431,18671,6629,1844,40574,471,499,654,1624,42198
16-07-2019,16,13339,18448,6663,1971,40422,478,536,484,1498,41920
16-07-2019,17,13880,18713,6582,2043,41218,463,534,531,1528,42746
16-07-2019,18,14413,18273,6572,1970,41228,466,488,511,1465,42693
16-07-2019,19,14375,18309,6572,1631,40889,453,486,454,1393,42282
16-07-2019,20,14300,18017,6254,1339,39911,473,498,415,1386,41297
16-07-2019,21,14359,17433,6192,1318,39302,481,491,219,1191,40493
16-07-2019,22,14173,17036,6111,1325,38646,497,324,201,1022,39668
16-07-2019,23,13903,16452,5350,1092,36796,507,247,173,927,37723
17-07-2019,0,13124,15718,5216,991,35050,332,247,163,742,35792
17-07-2019,1,12183,14922,5124,960,33187,285,247,164,696,33883
17-07-2019,2,11753,14513,5079,785,32130,272,250,174,696,32826
17-07-2019,3,11244,14289,5101,867,31502,270,247,168,685,32187
17-07-2019,4,11530,14450,5184,718,31881,273,253,156,682,32563
17-07-2019,5,11982,15448,5630,634,33694,284,256,162,702,34396
17-07-2019,6,13373,16540,6027,855,36795,330,434,161,925,37720
17-07-2019,7,14477,17395,6253,945,39071,452,507,342,1301,40372
17-07-2019,8,15121,17389,6602,1274,40387,470,721,536,1727,42114
17-07-2019,9,15544,17506,6691,1347,41088,480,748,552,1780,42868
17-07-2019,10,15719,17542,6660,1265,41186,492,758,565,1815,43001
17-07-2019,11,15603,17315,6650,1157,40724,494,745,546,1785,42509
17-07-2019,12,15572,17013,6651,1122,40359,506,636,565,1707,42066
17-07-2019,13,15569,17178,6646,1205,40599,512,593,593,1698,42297
17-07-2019,14,15332,17323,6541,1218,40414,522,588,637,1747,42161
17-07-2019,15,15227,17462,6448,1288,40425,515,506,663,1684,42109
17-07-2019,16,15047,17436,6493,1228,40205,500,504,498,1502,41707
17-07-2019,17,15271,17505,6442,1254,40472,487,521,499,1507,41979
17-07-2019,18,14913,17645,6506,1391,40455,500,540,465,1505,41960
17-07-2019,19,14680,17293,6506,1049,39528,497,544,460,1501,41029
17-07-2019,20,14615,17029,6356,986,38986,491,540,249,1280,40266
17-07-2019,21,14643,16755,6333,862,38594,503,479,260,1242,39836
17-07-2019,22,14704,16656,6176,753,38289,507,473,279,1259,39548
17-07-2019,23,14396,15987,5453,608,36445,482,256,277,1015,37460
18-07-2019,0,13895,15773,5443,499,35609,367,250,261,878,36487
18-07-2019,1,12960,14891,5116,511,33480,343,246,230,819,34299
18-07-2019,2,12107,14292,4964,486,31849,331,245,207,783,32632
18-07-2019,3,12070,14219,4948,552,31788,330,244,202,776,32564
18-07-2019,4,11996,14247,5006,584,31833,326,250,200,776,32609
18-07-2019,5,12169,14680,5691,591,33132,328,254,189,771,33903
18-07-2019,6,13082,15999,6291,708,36080,325,506,183,1014,37094
18-07-2019,7,14275,16787,6488,1054,38604,364,574,367,1305,39909
18-07-2019,8,15070,17077,6742,1177,40067,380,578,521,1479,41546
18-07-2019,9,15542,16960,6770,1365,40638,373,865,551,1789,42427
18-07-2019,10,15844,17065,6792,1383,41085,373,776,549,1698,42783
18-07-2019,11,15868,17004,6742,1530,41143,399,897,567,1863,43006
18-07-2019,12,15538,16775,6702,1597,40612,426,920,583,1929,42541
18-07-2019,13,15061,16670,6683,1588,40004,435,859,561,1855,41859
18-07-2019,14,15048,16821,6695,1582,40146,448,725,591,1764,41910
18-07-2019,15,15028,16948,6714,1638,40330,437,729,660,1826,42156
18-07-2019,16,15241,16941,6717,1592,40491,445,607,682,1734,42225
18-07-2019,17,15407,17234,6675,1578,40896,454,595,505,1554,42450
18-07-2019,18,15232,17157,6708,1569,40666,439,588,294,1321,41987
18-07-2019,19,15211,17149,6620,1430,40410,414,589,252,1255,41665
18-07-2019,20,14957,17097,6421,1245,39720,400,571,227,1198,40918
18-07-2019,21,14788,16848,6454,1051,39142,398,485,233,1116,40258
18-07-2019,22,14660,16567,6332,952,38512,403,510,245,1158,39670
18-07-2019,23,14223,15868,5706,1051,36849,393,259,238,890,37739
19-07-2019,0,12736,15139,5445,1212,34531,417,242,215,874,35405
19-07-2019,1,11613,14416,5188,1335,32551,424,244,185,853,33404
19-07-2019,2,11424,14270,5130,1010,31834,422,244,173,839,32673
19-07-2019,3,11199,14115,5068,1083,31465,402,244,164,810,32275
19-07-2019,4,11099,14206,5060,867,31232,396,250,157,803,32035
19-07-2019,5,12061,14954,5350,786,33152,407,448,156,1011,34163
19-07-2019,6,12902,16689,5999,806,36397,419,478,155,1052,37449
19-07-2019,7,14072,17334,6365,983,38755,412,503,352,1267,40022
19-07-2019,8,15066,17620,6695,1147,40530,421,601,564,1586,42116
19-07-2019,9,15540,17467,6701,1335,41043,435,775,578,1788,42831
19-07-2019,10,15881,17702,6740,1412,41734,455,898,567,1920,43654
19-07-2019,11,15568,17628,6859,1393,41449,441,851,578,1870,43319
19-07-2019,12,15280,17571,6813,1073,40736,446,1026,584,2056,42792
19-07-2019,13,15074,17837,6678,1141,40729,440,813,591,1844,42573
19-07-2019,14,15094,17946,6695,1263,40999,436,602,598,1636,42635
19-07-2019,15,14921,17722,6782,1089,40515,449,621,608,1678,42193
19-07-2019,16,14708,17655,6646,1382,40391,457,568,603,1628,42019
19-07-2019,17,14742,17637,6592,1363,40334,448,547,390,1385,41719
19-07-2019,18,14590,17568,6517,1358,40033,429,649,181,1259,41292
19-07-2019,19,14392,17463,6404,982,39242,431,622,169,1222,40464
19-07-2019,20,13895,17219,5841,940,37894,417,530,169,1116,39010
19-07-2019,21,13592,17006,5962,634,37195,411,535,169,1115,38310
19-07-2019,22,13791,16726,5811,510,36839,379,409,169,957,37796
19-07-2019,23,13541,16010,5331,479,35361,314,251,164,729,36090
20-07-2019,0,13249,14770,5049,534,33604,259,243,165,667,34271
20-07-2019,1,12149,13418,4945,856,31367,256,241,164,661,32028
20-07-2019,2,10705,12744,4865,1054,29368,251,241,173,665,30033
20-07-2019,3,9552,12377,4852,1140,27921,242,240,195,677,28598
20-07-2019,4,8777,12230,4814,1276,27099,237,240,207,684,27783
20-07-2019,5,8488,12286,4814,1441,27030,236,241,199,676,27706
20-07-2019,6,9255,12307,4926,1675,28164,232,247,188,667,28831
20-07-2019,7,9999,12708,5048,2116,29871,236,263,170,669,30540
20-07-2019,8,11392,13455,5305,2111,32264,243,484,229,956,33220
20-07-2019,9,11948,13579,5600,2554,33682,243,594,222,1059,34741
20-07-2019,10,11505,13398,5725,2953,33583,245,613,237,1095,34678
20-07-2019,11,11176,13363,5639,3051,33230,239,630,226,1095,34325
20-07-2019,12,10695,13244,5708,3169,32817,237,601,201,1039,33856
20-07-2019,13,10605,13438,5649,3121,32814,234,552,202,988,33802
20-07-2019,14,10492,13444,5680,3170,32788,226,526,236,988,33776
20-07-2019,15,10111,13447,5756,3128,32443,224,671,249,1144,33587
20-07-2019,16,10358,13544,5798,2979,32679,219,547,255,1021,33700
20-07-2019,17,11132,13806,5775,2689,33402,217,495,249,961,34363
20-07-2019,18,12779,15479,5803,2207,36269,212,491,219,922,37191
20-07-2019,19,13407,16168,5742,2188,37505,208,488,242,938,38443
20-07-2019,20,13352,16282,5564,1656,36855,204,483,219,906,37761
20-07-2019,21,12867,16146,5302,1541,35855,213,475,179,867,36722
20-07-2019,22,12991,16273,5266,1550,36081,214,261,204,679,36760
20-07-2019,23,11901,14367,4978,1465,32710,213,251,213,677,33387
21-07-2019,0,9247,13548,4881,1575,29253,207,253,234,694,29947
21-07-2019,1,8676,12925,4878,1665,28143,207,255,243,705,28848
21-07-2019,2,8611,12531,4902,1841,27886,210,256,241,707,28593
21-07-2019,3,7986,12072,4876,1946,26880,212,260,238,710,27590
21-07-2019,4,7735,11891,4866,1799,26291,208,260,219,687,26978
21-07-2019,5,7831,11627,4859,1844,26162,215,262,215,692,26854
21-07-2019,6,8475,11323,4896,1947,26643,219,263,213,695,27338
21-07-2019,7,9822,11522,4926,2119,28389,216,300,202,718,29107
21-07-2019,8,10859,11848,5125,2432,30264,219,290,199,708,30972
21-07-2019,9,11172,12432,5410,2690,31704,223,419,222,864,32568
21-07-2019,10,11472,12408,5691,2944,32515,225,504,241,970,33485
21-07-2019,11,11255,12684,5665,3288,32893,222,509,261,992,33885
21-07-2019,12,10809,12822,5680,3679,32990,220,515,268,1003,33993
21-07-2019,13,10317,12708,5647,4186,32858,221,502,288,1011,33869
21-07-2019,14,10037,12909,5598,4288,32833,227,480,314,1021,33854
21-07-2019,15,9823,13024,5482,4217,32548,232,480,328,1040,33588
21-07-2019,16,10178,13156,5515,3883,32732,233,499,286,1018,33750
21-07-2019,17,10341,13337,5599,4155,33434,231,472,281,984,34418
21-07-2019,18,11389,14635,5654,3673,35350,217,313,297,827,36177
21-07-2019,19,12654,15956,5709,2793,37112,211,472,284,967,38079
21-07-2019,20,13226,16454,5558,2270,37508,213,455,225,893,38401
21-07-2019,21,13385,16280,5489,1865,37021,217,293,220,730,37751
21-07-2019,22,13258,16178,5275,1841,36551,236,253,202,691,37242
21-07-2019,23,12630,15165,5181,1785,34762,223,246,195,664,35426
22-07-2019,0,10762,13488,5057,1844,31151,245,243,175,663,31814
22-07-2019,1,9459,12417,5049,1761,28686,239,242,170,651,29337
22-07-2019,2,8970,12357,5107,1689,28122,269,243,166,678,28800
22-07-2019,3,8967,12313,5139,1625,28045,277,243,183,703,28748
22-07-2019,4,9087,12315,5240,1585,28227,293,244,207,744,28971
22-07-2019,5,10286,12658,5501,1466,29910,308,254,229,791,30701
22-07-2019,6,11775,14173,5982,1637,33567,325,476,318,1119,34686
22-07-2019,7,13035,14968,6363,1887,36252,379,484,626,1489,37741
22-07-2019,8,13561,15374,6452,2238,37625,388,542,684,1614,39239
22-07-2019,9,13822,15636,6534,2393,38385,398,684,745,1827,40212
22-07-2019,10,13914,15753,6569,2498,38735,401,700,800,1901,40636
22-07-2019,11,13593,15650,6611,2151,38005,399,703,820,1922,39927
22-07-2019,12,13099,15390,6617,2564,37670,404,733,832,1969,39639
22-07-2019,13,12880,15097,6706,3009,37693,399,638,824,1861,39554
22-07-2019,14,12707,15178,6643,3026,37556,403,555,844,1802,39358
22-07-2019,15,13105,15409,6625,2909,38048,405,504,863,1772,39820
22-07-2019,16,13370,15782,6650,2731,38534,405,504,843,1752,40286
22-07-2019,17,13794,15864,6439,2666,38764,402,486,608,1496,40260
22-07-2019,18,14773,16627,6334,2351,40086,392,482,585,1459,41545
22-07-2019,19,14693,16563,6090,2061,39406,388,482,486,1356,40762
22-07-2019,20,14435,16224,6078,2063,38801,365,479,469,1313,40114
22-07-2019,21,14187,15899,6037,1679,37801,366,479,270,1115,38916
22-07-2019,22,13951,15736,5896,1979,37562,369,456,257,1082,38644
22-07-2019,23,13404,15153,5348,1814,35719,378,247,234,859,36578
23-07-2019,0,12821,14428,5410,1705,34365,380,259,240,879,35244
23-07-2019,1,12098,13941,5346,1752,33137,381,246,231,858,33995
23-07-2019,2,11531,13391,5177,1839,31939,375,242,209,826,32765
23-07-2019,3,11253,13234,5073,1879,31439,358,242,201,801,32240
23-07-2019,4,11077,13119,5127,1725,31049,353,243,185,781,31830
23-07-2019,5,12178,13685,5248,1538,32650,361,255,170,786,33436
23-07-2019,6,11959,13960,5966,1556,33442,373,485,210,1068,34510
23-07-2019,7,12996,14276,6371,1683,35325,376,661,374,1411,36736
23-07-2019,8,13610,14619,6590,1769,36588,443,780,558,1781,38369
23-07-2019,9,14147,15035,6538,1877,37597,494,834,559,1887,39484
23-07-2019,10,14111,15270,6518,1801,37699,492,984,589,2065,39764
23-07-2019,11,14168,15375,6466,2006,38016,499,932,606,2037,40053
23-07-2019,12,14023,15341,6589,2290,38242,501,923,648,2072,40314
23-07-2019,13,13879,15195,6627,2068,37769,500,842,676,2018,39787
23-07-2019,14,13888,15225,6586,2295,37995,499,747,695,1941,39936
23-07-2019,15,13834,15252,6618,2132,37837,474,501,687,1662,39499
23-07-2019,16,13716,15177,6435,1799,37126,464,494,694,1652,38778
23-07-2019,17,13696,15125,6317,1782,36920,450,587,498,1535,38455
23-07-2019,18,14499,15678,6331,1522,38029,489,580,454,1523,39552
23-07-2019,19,14244,15555,6318,1472,37590,496,579,439,1514,39104
23-07-2019,20,14000,15406,6098,1204,36708,504,683,232,1419,38127
23-07-2019,21,13926,15253,6001,930,36111,514,678,231,1423,37534
23-07-2019,22,13578,15082,5819,954,35433,511,487,234,1232,36665
23-07-2019,23,13306,14600,5294,903,34103,473,338,224,1035,35138
24-07-2019,0,13313,13708,5124,886,33031,477,511,222,1210,34241
24-07-2019,1,12542,12762,4923,784,31010,440,394,198,1032,32042
24-07-2019,2,12173,12458,4881,426,29940,432,257,189,878,30818
24-07-2019,3,11904,12257,4845,389,29395,430,238,186,854,30249
24-07-2019,4,11584,12305,4949,702,29541,418,239,185,842,30383
24-07-2019,5,11907,12716,5075,730,30429,422,252,176,850,31279
24-07-2019,6,12061,13322,5492,963,31838,473,656,172,1301,33139
24-07-2019,7,12752,14005,6175,1149,34082,473,671,354,1498,35580
24-07-2019,8,13656,14584,6570,1308,36120,463,659,550,1672,37792
24-07-2019,9,14022,15046,6642,1570,37280,485,847,597,1929,39209
24-07-2019,10,14143,15462,6680,1796,38083,480,854,580,1914,39997
24-07-2019,11,14057,15396,6756,1812,38021,503,956,591,2050,40071
24-07-2019,12,13852,15647,6751,1903,38154,510,887,608,2005,40159
24-07-2019,13,13914,15306,6642,1973,37837,517,902,612,2031,39868
24-07-2019,14,13956,15190,6607,1942,37695,550,895,614,2059,39754
24-07-2019,15,13908,15219,6649,2040,37817,526,874,440,1840,39657
24-07-2019,16,13886,15264,6430,2086,37666,542,717,447,1706,39372
24-07-2019,17,13905,15166,6368,2062,37501,535,706,416,1657,39158
24-07-2019,18,14579,15524,6191,2085,38379,556,732,428,1716,40095
24-07-2019,19,14466,15464,6275,2194,38400,556,808,414,1778,40178
24-07-2019,20,14079,15212,5937,2253,37482,557,701,225,1483,38965
24-07-2019,21,13835,15112,5832,1879,36660,520,690,239,1449,38109
24-07-2019,22,13783,15076,5511,1631,36003,515,670,238,1423,37426
24-07-2019,23,13357,14490,5069,1494,34411,510,574,215,1299,35710
25-07-2019,0,13027,13840,4880,1516,33263,500,514,218,1232,34495
25-07-2019,1,12800,13075,4806,1500,32181,486,242,187,915,33096
25-07-2019,2,11921,12842,4846,1430,31041,485,237,170,892,31933
25-07-2019,3,11643,12599,4846,1403,30491,476,238,167,881,31372
25-07-2019,4,11551,12860,4913,1380,30704,480,246,161,887,31591
25-07-2019,5,12056,13719,5106,1451,32333,474,556,155,1185,33518
25-07-2019,6,11944,13859,5491,1513,32807,483,650,155,1288,34095
25-07-2019,7,12817,14594,6073,1480,34965,481,660,347,1488,36453
25-07-2019,8,13546,15155,6392,1583,36676,486,658,539,1683,38359
25-07-2019,9,13960,15504,6512,1684,37661,504,813,566,1883,39544
25-07-2019,10,14011,15718,6612,1754,38097,520,903,576,1999,40096
25-07-2019,11,13856,15526,6623,1781,37787,532,944,603,2079,39866
25-07-2019,12,13961,15597,6621,1899,38080,528,968,618,2114,40194
25-07-2019,13,13868,15558,6602,1970,37999,532,854,632,2018,40017
25-07-2019,14,13836,15614,6508,2105,38063,542,706,658,1906,39969
25-07-2019,15,13739,15697,6433,2083,37953,561,619,507,1687,39640
25-07-2019,16,13475,15605,6309,2039,37428,521,679,521,1721,39149
25-07-2019,17,13503,15771,6247,1885,37407,496,691,543,1730,39137
25-07-2019,18,14189,16195,6153,1897,38434,496,781,467,1744,40178
25-07-2019,19,13952,16087,6063,1863,37965,482,1077,437,1996,39961
25-07-2019,20,13850,15962,5934,1793,37539,492,991,259,1742,39281
25-07-2019,21,13247,15611,5482,1792,36134,502,887,297,1686,37820
25-07-2019,22,12819,15354,5369,2010,35550,485,583,297,1365,36915
25-07-2019,23,12584,14818,5099,1788,34290,452,398,292,1142,35432
26-07-2019,0,12072,14301,5134,1498,33005,361,378,265,1004,34009
26-07-2019,1,11108,13576,5176,1835,31696,359,369,281,1009,32705
26-07-2019,2,10808,13243,5251,1574,30876,367,361,273,1001,31877
26-07-2019,3,10483,12956,5299,1794,30533,371,242,242,855,31388
26-07-2019,4,10401,13017,5264,1759,30440,374,250,225,849,31289
26-07-2019,5,11566,13770,5313,1159,31809,426,375,254,1055,32864
26-07-2019,6,11979,13859,5561,1581,32980,484,654,251,1389,34369
26-07-2019,7,12991,14562,6097,1765,35417,506,657,380,1543,36960
26-07-2019,8,13698,15239,6370,2040,37346,524,740,604,1868,39214
26-07-2019,9,13993,15590,6542,2205,38331,548,774,684,2006,40337
26-07-2019,10,13976,15676,6512,2282,38446,560,902,724,2186,40632
26-07-2019,11,13657,15536,6603,2498,38293,565,913,727,2205,40498
26-07-2019,12,13527,14964,6646,2723,37860,566,913,718,2197,40057
26-07-2019,13,13391,14623,6578,2743,37334,564,721,669,1954,39288
26-07-2019,14,13021,14573,6650,2863,37108,546,630,689,1865,38973
26-07-2019,15,12941,14598,6480,2814,36834,549,631,551,1731,38565
26-07-2019,16,13100,14927,6476,2535,37037,531,696,548,1775,38812
26-07-2019,17,13691,15333,6215,2290,37529,529,682,534,1745,39274
26-07-2019,18,14805,16113,5852,1574,38344,533,603,520,1656,40000
26-07-2019,19,14364,16028,5708,1535,37635,512,604,483,1599,39234
26-07-2019,20,14304,15799,5595,1460,37158,516,657,266,1439,38597
26-07-2019,21,13772,15592,5441,1260,36067,517,579,292,1388,37455
26-07-2019,22,13521,15498,5062,1440,35521,487,572,349,1408,36929
26-07-2019,23,12656,14364,4909,1965,33894,456,392,355,1203,35097
27-07-2019,0,12086,13640,4832,1839,32397,372,383,328,1083,33480
27-07-2019,1,10450,12595,4707,2428,30181,325,378,327,1030,31211
27-07-2019,2,10002,12096,4759,2446,29303,312,375,347,1034,30337
27-07-2019,3,9379,11758,4760,2317,28216,308,370,315,993,29209
27-07-2019,4,8620,11681,4732,2212,27244,313,266,302,881,28125
27-07-2019,5,8726,11627,4754,2365,27474,326,271,292,889,28363
27-07-2019,6,9072,11780,4849,2672,28374,312,275,245,832,29206
27-07-2019,7,9673,12171,4960,3113,29916,314,385,264,963,30879
27-07-2019,8,11079,12963,5347,3258,32647,328,481,494,1303,33950
27-07-2019,9,12589,13738,5649,3264,35240,344,488,525,1357,36597
27-07-2019,10,11241,13306,5843,3740,34130,360,532,513,1405,35535
27-07-2019,11,10610,12984,5829,4193,33617,372,555,500,1427,35044
27-07-2019,12,10325,13047,5868,4522,33763,369,557,522,1448,35211
27-07-2019,13,10099,13037,5991,4448,33576,352,645,318,1315,34891
27-07-2019,14,10044,13087,6004,4380,33516,354,653,339,1346,34862
27-07-2019,15,9951,13057,5969,4525,33505,348,612,301,1261,34766
27-07-2019,16,10061,13101,5872,4460,33493,350,670,355,1375,34868
27-07-2019,17,10173,13339,5794,4475,33779,347,502,309,1158,34937
27-07-2019,18,11110,14081,5594,3488,34274,329,506,282,1117,35391
27-07-2019,19,12171,14705,5574,2449,34898,325,594,317,1236,36134
27-07-2019,20,11363,14290,5548,2853,34053,331,500,298,1129,35182
27-07-2019,21,10526,14455,5400,2756,33137,332,489,281,1102,34239
27-07-2019,22,10291,14201,5355,2805,32652,321,387,274,982,33634
27-07-2019,23,9114,12732,5290,3004,30140,309,260,286,855,30995
28-07-2019,0,8566,12205,5399,2954,29126,307,250,286,843,29969
28-07-2019,1,7596,12052,5480,2796,27925,295,254,304,853,28778
28-07-2019,2,7005,11638,5651,2652,26946,303,255,283,841,27787
28-07-2019,3,6826,11603,5729,2427,26586,302,258,298,858,27444
28-07-2019,4,7120,11767,5655,2477,27019,292,258,298,848,27867
28-07-2019,5,6799,11612,5485,2554,26450,289,253,280,822,27272
28-07-2019,6,7282,11718,5453,2747,27200,295,251,246,792,27992
28-07-2019,7,8966,12185,5403,2744,29299,293,266,223,782,30081
28-07-2019,8,9783,12394,5356,3231,30764,307,378,293,978,31742
28-07-2019,9,10570,12894,5429,3383,32277,319,475,370,1164,33441
28-07-2019,10,10998,13264,5602,3339,33204,325,491,389,1205,34409
28-07-2019,11,10945,13368,5625,3397,33334,335,491,349,1175,34509
28-07-2019,12,10545,13570,5612,3468,33195,339,488,376,1203,34398
28-07-2019,13,10417,13485,5718,3478,33097,330,487,422,1239,34336
28-07-2019,14,10159,13594,5927,3178,32858,329,486,403,1218,34076
28-07-2019,15,10457,13768,5923,2908,33055,350,484,387,1221,34276
28-07-2019,16,11419,13963,5765,2634,33782,356,482,367,1205,34987
28-07-2019,17,12109,14669,5649,2207,34634,358,486,380,1224,35858
28-07-2019,18,13431,15345,5656,1697,36130,352,485,360,1197,37327
28-07-2019,19,14413,15557,5670,1448,37088,352,509,344,1205,38293
28-07-2019,20,14430,15767,5599,1373,37171,347,566,405,1318,38489
28-07-2019,21,14179,15685,5470,1284,36618,377,468,363,1208,37826
28-07-2019,22,13871,15082,5454,1249,35658,392,378,316,1086,36744
28-07-2019,23,12595,13771,5387,1232,32984,388,430,249,1067,34051
29-07-2019,0,9569,11739,5328,1355,27992,362,371,244,977,28969
29-07-2019,1,8587,11354,5318,1267,26526,355,363,228,946,27472
29-07-2019,2,8415,11379,5388,1125,26306,375,245,223,843,27149
29-07-2019,3,8428,11276,5416,1054,26174,403,243,228,874,27048
29-07-2019,4,8326,11222,5282,1086,25917,416,248,215,879,26796
29-07-2019,5,9688,11638,5338,1013,27678,435,375,200,1010,28688
29-07-2019,6,12803,13920,5740,1059,33524,522,497,181,1200,34724
29-07-2019,7,15283,14967,6281,1370,37903,515,482,561,1558,39461
29-07-2019,8,15590,15798,6731,1622,39741,558,597,577,1732,41473
29-07-2019,9,15951,16105,6887,1668,40611,559,672,636,1867,42478
29-07-2019,10,16250,16378,6941,1744,41314,600,738,649,1987,43301
29-07-2019,11,16253,16527,7114,1762,41656,630,828,614,2072,43728
29-07-2019,12,16118,16625,7184,1562,41488,628,874,627,2129,43617
29-07-2019,13,15203,16497,7183,1111,39993,601,861,637,2099,42092
29-07-2019,14,15067,16348,7126,1156,39698,517,752,645,1914,41612
29-07-2019,15,14292,16101,6868,1258,38518,513,765,1013,2291,40809
29-07-2019,16,14491,15766,6551,1273,38081,505,735,880,2120,40201
29-07-2019,17,14893,15794,6483,1230,38399,499,567,684,1750,40149
29-07-2019,18,15182,15830,6480,1232,38724,500,572,963,2035,40759
29-07-2019,19,15024,15834,6498,1030,38389,491,581,719,1791,40180
29-07-2019,20,15048,15733,6314,879,37974,475,672,193,1340,39314
29-07-2019,21,14869,15631,6392,844,37736,463,666,203,1332,39068
29-07-2019,22,14432,15107,6180,891,36610,454,413,236,1103,37713
29-07-2019,23,13378,14747,6094,778,34996,414,354,283,1051,36047
30-07-2019,0,11595,13380,6136,674,31783,398,263,271,932,32715
30-07-2019,1,10892,11982,6125,727,29727,398,244,257,899,30626
30-07-2019,2,10602,12009,6133,716,29460,404,242,234,880,30340
30-07-2019,3,10482,11974,6094,740,29290,414,244,234,892,30182
30-07-2019,4,10517,12076,6022,790,29406,450,246,230,926,30332
30-07-2019,5,11525,13206,6008,826,31566,466,258,218,942,32508
30-07-2019,6,13120,14891,5980,835,34827,475,494,205,1174,36001
30-07-2019,7,14259,15693,6394,877,37222,513,756,376,1645,38867
30-07-2019,8,14910,15915,6770,900,38495,570,770,571,1911,40406
30-07-2019,9,15519,16166,6896,979,39561,582,788,590,1960,41521
30-07-2019,10,16059,16497,6945,979,40481,596,791,616,2003,42484
30-07-2019,11,16038,16574,6878,1065,40555,610,763,614,1987,42542
30-07-2019,12,15617,16568,6906,1126,40216,577,832,598,2007,42223
30-07-2019,13,15636,16255,6876,1123,39892,529,794,654,1977,41869
30-07-2019,14,14932,16052,6869,1287,39142,508,741,640,1889,41031
30-07-2019,15,14974,16175,6915,1438,39502,529,863,330,1722,41224
30-07-2019,16,14792,15726,6899,1599,39017,524,496,332,1352,40369
30-07-2019,17,15763,15757,6856,1706,40082,529,342,295,1166,41248
30-07-2019,18,16021,16094,6813,1662,40590,517,670,297,1484,42074
30-07-2019,19,15772,15949,6683,1596,39999,524,667,342,1533,41532
30-07-2019,20,15512,15544,6456,1562,39074,511,353,408,1272,40346
30-07-2019,21,15344,15316,6350,1547,38556,527,256,359,1142,39698
30-07-2019,22,14629,15025,6151,1602,37406,525,255,331,1111,38517
30-07-2019,23,13003,13580,6099,1558,34241,535,254,315,1104,35345
31-07-2019,0,11415,12277,6021,1491,31205,520,247,309,1076,32281
31-07-2019,1,10808,11700,6020,1470,29998,520,243,307,1070,31068
31-07-2019,2,10186,11552,6022,1495,29256,536,242,294,1072,30328
31-07-2019,3,9788,11413,5986,1647,28835,516,241,278,1035,29870
31-07-2019,4,10034,11443,5970,1521,28968,516,245,243,1004,29972
31-07-2019,5,10841,11890,5927,1315,29973,526,245,198,969,30942
31-07-2019,6,13074,14048,6104,1283,34507,531,260,168,959,35466
31-07-2019,7,14764,15449,6351,1347,37913,555,481,355,1391,39304
31-07-2019,8,15728,16072,6477,1523,39800,543,672,556,1771,41571
31-07-2019,9,15930,16552,6470,1367,40320,534,764,582,1880,42200
31-07-2019,10,15993,16818,6517,1589,40916,528,820,600,1948,42864
31-07-2019,11,16548,16650,6500,1779,41479,522,774,621,1917,43396
31-07-2019,12,16089,16476,6515,1816,40897,514,784,618,1916,42813
31-07-2019,13,15537,16318,6562,1902,40320,514,722,637,1873,42193
31-07-2019,14,15155,16103,6563,1944,39765,509,657,655,1821,41586
31-07-2019,15,15376,16102,6361,1775,39612,509,605,504,1618,41230
31-07-2019,16,14810,15803,6095,1602,38310,457,496,356,1309,39619
31-07-2019,17,15364,15989,6068,1575,38997,436,499,283,1218,40215
31-07-2019,18,16065,16322,6271,1525,40185,456,583,430,1469,41654
31-07-2019,19,15868,16210,6219,1460,39759,463,580,397,1440,41199
31-07-2019,20,15790,15941,5958,1212,38900,452,488,203,1143,40043
31-07-2019,21,15741,15743,5849,1066,38400,465,472,188,1125,39525
31-07-2019,22,15474,15562,5562,1048,37646,460,332,171,963,38609
31-07-2019,23,14866,13648,5378,1099,34991,425,251,166,842,35833
01-08-2019,0,13702,11270,5398,1035,31405,424,248,159,831,32236
01-08-2019,1,12772,10432,5350,1379,29934,425,244,164,833,30767
01-08-2019,2,12043,10313,5362,1400,29116,433,243,156,832,29948
01-08-2019,3,11702,10268,5441,1063,28475,426,243,149,818,29293
01-08-2019,4,11729,10245,5581,1040,28595,427,250,142,819,29414
01-08-2019,5,12679,10961,5795,946,30382,426,461,144,1031,31413
01-08-2019,6,14225,13921,5983,808,34936,447,489,145,1081,36017
01-08-2019,7,15572,15457,6118,854,38003,453,579,508,1540,39543
01-08-2019,8,16249,15857,6246,911,39264,486,582,508,1576,40840
01-08-2019,9,16238,15601,6279,956,39072,501,664,512,1677,40749
01-08-2019,10,15931,15007,6456,1386,38779,503,665,524,1692,40471
01-08-2019,11,15872,14941,6498,1471,38782,512,757,506,1775,40557
01-08-2019,12,15302,14793,6493,1573,38162,510,758,522,1790,39952
01-08-2019,13,15695,14840,6463,1492,38490,525,742,522,1789,40279
01-08-2019,14,15911,14727,6477,1366,38482,507,670,524,1701,40183
01-08-2019,15,15863,14756,6406,1234,38259,494,683,525,1702,39961
01-08-2019,16,16055,15067,6304,1001,38426,465,595,350,1410,39836
01-08-2019,17,16103,15705,6097,973,38877,474,591,346,1411,40288
01-08-2019,18,15946,15831,6126,991,38895,474,573,351,1398,40293
01-08-2019,19,15612,15701,6135,863,38311,449,522,532,1503,39814
01-08-2019,20,15424,15412,5498,806,37139,463,512,523,1498,38637
01-08-2019,21,15435,15036,5201,677,36348,455,504,167,1126,37474
01-08-2019,22,15022,14404,5119,630,35175,417,438,169,1024,36199
01-08-2019,23,14202,13327,5085,642,33256,418,437,170,1025,34281
02-08-2019,0,13793,12267,5159,614,31833,420,435,161,1016,32849
02-08-2019,1,13093,11253,5130,625,30102,420,431,154,1005,31107
02-08-2019,2,11960,11234,5175,658,29027,417,434,158,1009,30036
02-08-2019,3,11340,11255,5179,610,28384,412,435,161,1008,29392
02-08-2019,4,11578,11213,5302,638,28731,418,455,179,1052,29783
02-08-2019,5,12608,12467,5630,697,31403,430,540,184,1154,32557
02-08-2019,6,13907,14003,5886,698,34494,416,503,175,1094,35588
02-08-2019,7,15216,14789,6150,870,37024,418,642,539,1599,38623
02-08-2019,8,15794,15631,6516,959,38902,485,727,573,1785,40687
02-08-2019,9,16214,15622,6555,1058,39450,477,794,562,1833,41283
02-08-2019,10,16291,15733,6646,1185,39856,499,830,528,1857,41713
02-08-2019,11,16490,15438,6667,1176,39771,512,826,545,1883,41654
02-08-2019,12,16447,15465,6501,1210,39622,528,785,579,1892,41514
02-08-2019,13,15917,15009,6418,1119,38464,526,714,595,1835,40299
02-08-2019,14,15494,14636,6340,1151,37622,525,595,604,1724,39346
02-08-2019,15,15248,14389,6412,1129,37179,523,594,410,1527,38706
02-08-2019,16,15070,14584,6396,1154,37204,530,583,252,1365,38569
02-08-2019,17,15887,15154,6244,1129,38414,530,474,233,1237,39651
02-08-2019,18,15840,15278,6228,1014,38360,518,469,394,1381,39741
02-08-2019,19,15847,15024,6314,860,38045,455,430,398,1283,39328
02-08-2019,20,15618,14807,5559,696,36682,385,453,336,1174,37856
02-08-2019,21,15488,14791,5350,593,36223,318,325,212,855,37078
02-08-2019,22,15194,14023,5249,603,35069,330,265,204,799,35868
02-08-2019,23,14480,12722,5212,454,32869,303,279,219,801,33670
03-08-2019,0,12294,11058,5214,518,29084,287,263,237,787,29871
03-08-2019,1,10771,10585,5147,684,27186,290,258,230,778,27964
03-08-2019,2,10574,10832,5118,736,27261,278,258,210,746,28007
03-08-2019,3,10245,10695,5115,751,26807,267,257,196,720,27527
03-08-2019,4,10058,10278,5065,794,26196,270,256,182,708,26904
03-08-2019,5,10260,10481,4977,828,26546,274,265,191,730,27276
03-08-2019,6,10642,10746,4897,864,27149,274,353,168,795,27944
03-08-2019,7,11640,11404,4880,936,28859,266,377,164,807,29666
03-08-2019,8,12756,11552,4991,1047,30346,307,439,171,917,31263
03-08-2019,9,13746,11858,5172,1207,31983,312,618,244,1174,33157
03-08-2019,10,13859,11901,5293,1404,32455,311,668,244,1223,33678
03-08-2019,11,13700,12025,5405,1455,32583,319,617,225,1161,33744
03-08-2019,12,13374,12182,5399,1540,32495,321,591,246,1158,33653
03-08-2019,13,13008,12051,5381,1544,31984,321,520,265,1106,33090
03-08-2019,14,12771,11867,5323,1650,31611,313,515,306,1134,32745
03-08-2019,15,12657,11777,5248,1720,31402,299,651,340,1290,32692
03-08-2019,16,12748,11851,5267,1823,31689,311,653,399,1363,33052
03-08-2019,17,12965,11924,5227,1703,31820,307,695,373,1375,33195
03-08-2019,18,13824,12471,5174,1429,32898,289,728,312,1329,34227
03-08-2019,19,14522,12827,5222,891,33462,283,713,255,1251,34713
03-08-2019,20,14554,12800,5152,723,33229,285,703,241,1229,34458
03-08-2019,21,15005,12771,5261,675,33712,295,748,238,1281,34993
03-08-2019,22,15033,12638,5177,648,33497,305,653,251,1209,34706
03-08-2019,23,13436,11470,5239,685,30832,284,453,243,980,31812
04-08-2019,0,11898,10068,5102,884,27952,270,448,218,936,28888
04-08-2019,1,10751,9719,5092,1170,26731,269,443,210,922,27653
04-08-2019,2,10222,9773,5058,1166,26219,264,443,182,889,27108
04-08-2019,3,9761,9723,4983,1117,25584,255,442,168,865,26449
04-08-2019,4,9408,9649,4988,997,25043,261,533,169,963,26006
04-08-2019,5,9144,9519,4941,1093,24697,268,537,166,971,25668
04-08-2019,6,10000,9631,4916,1061,25608,280,541,178,999,26607
04-08-2019,7,11314,10019,4853,1181,27366,272,541,174,987,28353
04-08-2019,8,12143,10343,5063,1205,28755,281,600,178,1059,29814
04-08-2019,9,13197,10859,5235,1347,30637,297,692,203,1192,31829
04-08-2019,10,13617,11083,5370,1496,31566,312,687,214,1213,32779
04-08-2019,11,13617,11157,5461,1509,31744,300,757,212,1269,33013
04-08-2019,12,13492,11122,5496,1575,31685,324,761,238,1323,33008
04-08-2019,13,13435,10869,5532,1665,31501,325,749,263,1337,32838
04-08-2019,14,13291,10782,5508,1660,31242,329,760,280,1369,32611
04-08-2019,15,13169,10891,5449,1644,31153,320,792,328,1440,32593
04-08-2019,16,13091,11028,5408,1625,31154,317,787,342,1446,32600
04-08-2019,17,13476,11344,5328,1521,31670,314,702,322,1338,33008
04-08-2019,18,14223,12121,5281,1346,32971,318,628,287,1233,34204
04-08-2019,19,15006,12945,5288,878,34119,349,628,270,1247,35366
04-08-2019,20,15657,13523,5532,798,35511,368,647,258,1273,36784
04-08-2019,21,15473,13483,5680,738,35375,396,650,271,1317,36692
04-08-2019,22,15012,12804,5720,718,34252,405,755,276,1436,35688
04-08-2019,23,14070,12202,5716,600,32588,390,542,264,1196,33784
05-08-2019,0,11093,10968,5660,777,28497,394,449,231,1074,29571
05-08-2019,1,9158,10493,5520,738,25908,380,446,208,1034,26942
05-08-2019,2,8857,10538,5320,743,25459,459,444,184,1087,26546
05-08-2019,3,8836,10686,5339,676,25538,459,446,161,1066,26604
05-08-2019,4,8963,10622,5478,721,25783,490,534,156,1180,26963
05-08-2019,5,11578,11074,5561,583,28796,515,545,155,1215,30011
05-08-2019,6,14623,13804,5713,711,34850,562,682,157,1401,36251
05-08-2019,7,16228,15692,5772,784,38479,667,910,529,2106,40585
05-08-2019,8,16842,16558,6163,859,40423,726,1007,562,2295,42718
05-08-2019,9,16693,16386,6243,853,40175,734,1017,578,2329,42504
05-08-2019,10,16830,16350,6160,911,40251,722,1100,576,2398,42649
05-08-2019,11,16999,16444,6175,1275,40893,744,1062,580,2386,43279
05-08-2019,12,16904,16151,6406,1367,40828,762,1011,594,2367,43195
05-08-2019,13,16686,15651,6390,1332,40060,741,835,608,2184,42244
05-08-2019,14,16124,15282,6217,1304,38927,740,825,631,2196,41123
05-08-2019,15,15469,15174,6028,1323,37993,758,950,623,2331,40324
05-08-2019,16,15437,15418,5955,1308,38117,767,844,609,2220,40337
05-08-2019,17,15855,16117,5849,1139,38959,760,831,581,2172,41131
05-08-2019,18,16295,16355,5781,1041,39471,761,728,593,2082,41553
05-08-2019,19,16692,16026,5616,962,39296,764,829,555,2148,41444
05-08-2019,20,16330,15605,5217,950,38102,642,809,167,1618,39720
05-08-2019,21,16258,15435,4993,934,37621,592,671,160,1423,39044
05-08-2019,22,15966,14799,4852,784,36399,559,475,154,1188,37587
05-08-2019,23,14113,12765,4833,858,32569,528,469,145,1142,33711
06-08-2019,0,12018,11307,4792,1268,29385,528,462,140,1130,30515
06-08-2019,1,11054,10361,4742,1607,27765,533,462,138,1133,28898
06-08-2019,2,10216,10290,4736,1702,26945,509,467,140,1116,28061
06-08-2019,3,10160,10286,4762,1842,27051,500,471,143,1114,28165
06-08-2019,4,10186,10281,4818,1830,27116,494,616,152,1262,28378
06-08-2019,5,11627,11414,5088,1667,29796,539,566,167,1272,31068
06-08-2019,6,13838,13558,5460,1356,34212,625,935,188,1748,35960
06-08-2019,7,16118,15559,5832,1529,39038,667,945,601,2213,41251
06-08-2019,8,16873,16261,6100,1921,41156,672,1100,604,2376,43532
06-08-2019,9,16728,16522,6048,2412,41712,664,1100,611,2375,44087
06-08-2019,10,16252,15862,6089,2581,40784,674,1081,632,2387,43171
06-08-2019,11,16052,15004,6083,2911,40049,684,1110,627,2421,42470
06-08-2019,12,15542,13897,6125,3157,38722,689,1192,630,2511,41233
06-08-2019,13,15262,13762,6166,3234,38424,729,1106,622,2457,40881
06-08-2019,14,15014,13672,6180,3096,37964,741,904,631,2276,40240
06-08-2019,15,15276,13610,5948,2685,37521,732,883,628,2243,39764
06-08-2019,16,15694,14029,5800,2247,37770,707,879,608,2194,39964
06-08-2019,17,16113,15228,5794,2161,39298,681,863,604,2148,41446
06-08-2019,18,16115,15748,5775,2057,39695,667,943,380,1990,41685
06-08-2019,19,16071,15783,5754,1653,39261,662,850,388,1900,41161
06-08-2019,20,15999,15521,5333,1384,38236,663,833,204,1700,39936
06-08-2019,21,15995,15536,4992,1318,37840,595,464,218,1277,39117
06-08-2019,22,15555,14380,4817,1271,36024,517,451,216,1184,37208
06-08-2019,23,14284,13347,4792,1296,33720,495,445,202,1142,34862
07-08-2019,0,12095,12176,4836,1327,30433,495,294,240,1029,31462
07-08-2019,1,10357,11100,4799,1596,27851,505,291,251,1047,28898
07-08-2019,2,9978,10946,4732,1739,27395,489,290,250,1029,28424
07-08-2019,3,10206,10978,4718,1648,27549,484,290,243,1017,28566
07-08-2019,4,9999,11393,4710,1747,27850,499,293,223,1015,28865
07-08-2019,5,11478,11842,5118,1681,30120,503,507,229,1239,31359
07-08-2019,6,13814,13140,5742,1607,34303,635,834,215,1684,35987
07-08-2019,7,15546,15538,5764,1696,38543,652,853,529,2034,40577
07-08-2019,8,16109,16021,5938,1853,39921,664,1009,625,2298,42219
07-08-2019,9,16416,16344,6160,2243,41165,660,1107,643,2410,43575
07-08-2019,10,16180,16347,6118,2241,40887,668,1134,637,2439,43326
07-08-2019,11,15916,16068,6266,2102,40351,676,1133,607,2416,42767
07-08-2019,12,15969,15785,6438,2520,40711,669,1082,626,2377,43088
07-08-2019,13,15636,15302,6365,2648,39952,670,1063,620,2353,42305
07-08-2019,14,15146,14577,6314,2666,38702,666,1043,654,2363,41065
07-08-2019,15,15007,14560,6247,2591,38405,665,1032,495,2192,40597
07-08-2019,16,14863,14720,6190,2660,38433,670,1041,449,2160,40593
07-08-2019,17,15171,15465,6229,2520,39385,674,1039,428,2141,41526
07-08-2019,18,15674,15535,6198,2117,39525,666,983,395,2044,41569
07-08-2019,19,15798,15415,6153,1823,39191,671,984,346,2001,41192
07-08-2019,20,15653,15309,5617,1583,38162,600,809,433,1842,40004
07-08-2019,21,15733,15017,5308,1508,37568,530,778,251,1559,39127
07-08-2019,22,14668,13779,5180,1527,35155,505,470,183,1158,36313
07-08-2019,23,12572,12347,5193,1586,31699,502,451,225,1178,32877
08-08-2019,0,11023,10776,5139,2066,29004,512,309,269,1090,30094
08-08-2019,1,10202,10115,5079,2186,27584,540,265,251,1056,28640
08-08-2019,2,10153,10070,5035,2198,27458,508,266,213,987,28445
08-08-2019,3,10102,10020,4999,2129,27249,515,265,179,959,28208
08-08-2019,4,10518,10081,5004,2039,27643,518,308,184,1010,28653
08-08-2019,5,11543,10576,5166,2015,29299,547,781,154,1482,30781
08-08-2019,6,13298,12286,5502,1724,32811,672,814,228,1714,34525
08-08-2019,7,15140,14545,5672,1994,37352,676,857,527,2060,39412
08-08-2019,8,15793,14690,5947,2072,38503,687,920,557,2164,40667
08-08-2019,9,15746,14229,6034,2579,38588,680,1022,554,2256,40844
08-08-2019,10,15134,14307,6135,3002,38577,680,1032,577,2289,40866
08-08-2019,11,15298,14090,6145,3227,38760,671,1004,595,2270,41030
08-08-2019,12,15077,14221,6123,3416,38838,673,981,613,2267,41105
08-08-2019,13,14742,14285,6097,3582,38706,664,943,633,2240,40946
08-08-2019,14,14730,13818,6018,3456,38024,665,935,516,2116,40140
08-08-2019,15,14235,13496,5858,3481,37072,698,855,725,2278,39350
08-08-2019,16,13758,13031,5692,3808,36290,659,824,758,2241,38531
08-08-2019,17,14446,13172,5646,3762,37027,670,827,749,2246,39273
08-08-2019,18,15103,13744,5743,3826,38416,663,844,523,2030,40446
08-08-2019,19,16160,15037,5806,3218,40222,663,856,493,2012,42234
08-08-2019,20,16104,15695,5400,2578,39777,584,841,266,1691,41468
08-08-2019,21,15945,15729,5237,2377,39290,556,816,250,1622,40912
08-08-2019,22,15538,14687,4938,2042,37205,566,490,235,1291,38496
08-08-2019,23,14298,12946,4987,1961,34193,491,446,242,1179,35372
09-08-2019,0,12266,11330,4996,2214,30807,496,446,247,1189,31996
09-08-2019,1,11093,10550,4939,2133,28714,488,444,312,1244,29958
09-08-2019,2,10481,10358,4926,2015,27779,490,441,323,1254,29033
09-08-2019,3,10689,10377,4916,1833,27814,484,441,301,1226,29040
09-08-2019,4,10429,10586,4926,1580,27522,474,440,276,1190,28712
09-08-2019,5,12787,11527,5151,1517,30982,526,509,265,1300,32282
09-08-2019,6,14623,14619,5491,1413,36145,644,809,254,1707,37852
09-08-2019,7,16344,16442,5570,1196,39552,656,832,393,1881,41433
09-08-2019,8,16898,16967,5857,1147,40869,664,939,571,2174,43043
09-08-2019,9,16681,16495,5819,1188,40183,669,1006,572,2247,42430
09-08-2019,10,16566,15156,5754,1239,38717,669,1061,604,2334,41051
09-08-2019,11,16772,14790,5864,1307,38733,672,1097,614,2383,41116
09-08-2019,12,16417,14571,5938,1326,38251,668,1099,627,2394,40645
09-08-2019,13,16245,14291,5928,1213,37678,678,1066,637,2381,40059
09-08-2019,14,16438,13894,5759,1256,37347,678,976,630,2284,39631
09-08-2019,15,16194,13533,5622,1274,36625,672,1166,427,2265,38890
09-08-2019,16,15556,13195,5591,1432,35773,644,965,428,2037,37810
09-08-2019,17,16109,14276,5606,1826,37817,628,1047,423,2098,39915
09-08-2019,18,16022,15114,5595,2181,38910,591,990,399,1980,40890
09-08-2019,19,16124,14935,5396,2336,38791,600,945,373,1918,40709
09-08-2019,20,15949,13931,5196,2501,37578,504,670,201,1375,38953
09-08-2019,21,14355,13063,5168,2748,35335,424,574,194,1192,36527
09-08-2019,22,12606,11828,4917,3157,32509,415,446,190,1051,33560
09-08-2019,23,11354,10648,4768,3296,30065,422,448,176,1046,31111
10-08-2019,0,10008,10325,4693,3430,28456,336,270,171,777,29233
10-08-2019,1,9732,10176,4569,3594,28072,277,292,165,734,28806
10-08-2019,2,9152,10209,4516,3463,27340,274,261,150,685,28025
10-08-2019,3,8761,10337,4533,3258,26888,261,259,143,663,27551
10-08-2019,4,8455,10496,4537,2767,26255,258,260,141,659,26914
10-08-2019,5,8697,10752,4574,2523,26547,262,260,143,665,27212
10-08-2019,6,9346,11028,4616,2385,27374,266,261,143,670,28044
10-08-2019,7,10104,11335,4702,2384,28525,270,278,155,703,29228
10-08-2019,8,11579,12103,4748,2361,30792,289,357,210,856,31648
10-08-2019,9,12619,12704,4862,2250,32437,325,579,183,1087,33524
10-08-2019,10,13059,12896,4881,2630,33466,331,564,198,1093,34559
10-08-2019,11,12665,12916,4845,3335,33761,326,614,200,1140,34901
10-08-2019,12,12115,12943,4849,3478,33385,325,656,205,1186,34571
10-08-2019,13,11723,13001,4829,3637,33191,328,565,268,1161,34352
10-08-2019,14,11344,12966,4780,3713,32802,326,556,268,1150,33952
10-08-2019,15,11190,13055,4781,3776,32801,323,471,257,1051,33852
10-08-2019,16,11748,12991,4811,3608,33158,317,459,261,1037,34195
10-08-2019,17,12109,12953,4795,3927,33786,310,580,267,1157,34943
10-08-2019,18,11217,13612,4792,4046,33667,309,584,259,1152,34819
10-08-2019,19,11391,13731,4879,4220,34221,311,380,312,1003,35224
10-08-2019,20,11240,13432,5031,4171,33874,331,264,322,917,34791
10-08-2019,21,10174,13315,5229,4279,32999,331,473,339,1143,34142
10-08-2019,22,9769,13013,5347,4365,32493,336,487,313,1136,33629
10-08-2019,23,9228,11933,5301,4543,31005,345,295,273,913,31918
11-08-2019,0,7644,11722,5308,4411,29085,329,268,244,841,29926
11-08-2019,1,6844,11656,5337,3954,27792,316,267,210,793,28585
11-08-2019,2,6593,11548,5339,3799,27279,351,267,209,827,28106
11-08-2019,3,6412,11573,5329,3715,27030,360,264,226,850,27880
11-08-2019,4,6528,11469,5379,3515,26891,340,268,243,851,27742
11-08-2019,5,6440,11345,5328,3242,26355,329,271,239,839,27194
11-08-2019,6,6609,11381,5127,3564,26682,335,272,247,854,27536
11-08-2019,7,7053,11521,5002,3771,27347,352,291,227,870,28217
11-08-2019,8,8000,11909,5051,3668,28629,354,305,229,888,29517
11-08-2019,9,9044,12281,5148,3829,30303,344,372,263,979,31282
11-08-2019,10,9690,12695,5265,3864,31513,348,500,311,1159,32672
11-08-2019,11,9784,12774,5377,3879,31813,343,567,347,1257,33070
11-08-2019,12,9229,13124,5405,3909,31669,349,684,376,1409,33078
11-08-2019,13,9110,13287,5356,3730,31485,346,725,491,1562,33047
11-08-2019,14,9153,13522,5391,3741,31807,372,716,530,1618,33425
11-08-2019,15,9086,13542,5411,3940,31979,375,708,524,1607,33586
11-08-2019,16,9241,13459,5355,3879,31934,353,706,437,1496,33430
11-08-2019,17,10021,13405,5364,4267,33058,342,713,337,1392,34450
11-08-2019,18,11802,14655,5424,3553,35435,324,807,245,1376,36811
11-08-2019,19,13092,15155,5416,3347,37012,322,829,202,1353,38365
11-08-2019,20,13699,15187,5420,3098,37403,337,783,180,1300,38703
11-08-2019,21,13965,15312,5549,2818,37643,347,881,173,1401,39044
11-08-2019,22,13353,14955,5587,2696,36593,359,660,179,1198,37791
11-08-2019,23,11869,13304,5460,2629,33264,351,532,186,1069,34333
12-08-2019,0,9055,11818,5388,2779,29039,342,286,191,819,29858
12-08-2019,1,7623,11440,5322,2783,27169,342,267,207,816,27985
12-08-2019,2,7216,11215,5390,2728,26548,355,269,246,870,27418
12-08-2019,3,7193,11225,5378,2589,26385,365,272,287,924,27309
12-08-2019,4,7451,11735,5433,2577,27197,348,273,297,918,28115
12-08-2019,5,8757,13173,5478,2709,30116,372,277,270,919,31035
12-08-2019,6,12391,15164,5770,3026,36350,414,524,329,1267,37617
12-08-2019,7,14271,16638,6005,3196,40110,447,616,563,1626,41736
12-08-2019,8,14928,16746,6174,3884,41733,524,1111,604,2239,43972
12-08-2019,9,14468,16067,6405,4522,41463,581,1055,595,2231,43694
12-08-2019,10,14013,15865,6532,4895,41305,829,653,682,2164,43469
12-08-2019,11,13934,15370,6571,4568,40444,844,630,712,2186,42630
12-08-2019,12,13496,15390,6591,4848,40324,855,623,771,2249,42573
12-08-2019,13,13759,15833,6539,4924,41055,875,567,688,2130,43185
12-08-2019,14,14477,16012,6501,4836,41825,788,521,655,1964,43789
12-08-2019,15,13814,15943,6405,4630,40792,716,525,629,1870,42662
12-08-2019,16,14877,16317,6305,4350,41850,681,590,619,1890,43740
12-08-2019,17,15312,16986,6260,4161,42721,819,543,533,1895,44616
12-08-2019,18,14967,17073,6159,3590,41789,702,533,639,1874,43663
12-08-2019,19,14995,16562,6046,2918,40521,707,593,628,1928,42449
12-08-2019,20,15321,16692,5624,2081,39719,568,532,265,1365,41084
12-08-2019,21,15293,16975,5444,1519,39231,498,457,176,1131,40362
12-08-2019,22,14201,15875,5295,1372,36742,486,444,163,1093,37835
12-08-2019,23,13384,14473,5261,1308,34427,484,423,149,1056,35483
13-08-2019,0,11984,12816,5195,997,30992,478,332,150,960,31952
13-08-2019,1,11186,11570,5126,977,28858,513,287,144,944,29802
13-08-2019,2,10412,11246,5125,1071,27853,542,288,141,971,28824
13-08-2019,3,10301,11097,5123,1127,27649,534,292,142,968,28617
13-08-2019,4,10740,11258,5218,968,28185,541,294,145,980,29165
13-08-2019,5,11984,13012,5465,1083,31543,578,309,150,1037,32580
13-08-2019,6,13920,15086,5751,1265,36021,676,589,170,1435,37456
13-08-2019,7,14945,15675,6218,1377,38215,681,619,412,1712,39927
13-08-2019,8,15625,16352,6548,1471,39996,701,700,547,1948,41944
13-08-2019,9,15733,16393,6642,1603,40371,689,640,557,1886,42257
13-08-2019,10,15025,15316,6700,1641,38683,697,617,569,1883,40566
13-08-2019,11,14662,14471,6813,1780,37728,692,685,597,1974,39702
13-08-2019,12,14213,14494,6754,2353,37814,687,715,603,2005,39819
13-08-2019,13,14108,14458,6754,2688,38009,714,700,599,2013,40022
13-08-2019,14,13932,14278,6490,3052,37751,728,611,609,1948,39699
13-08-2019,15,13912,14312,6584,3198,38006,728,612,421,1761,39767
13-08-2019,16,14178,14583,6550,3277,38589,738,617,437,1792,40381
13-08-2019,17,14737,14760,6368,3288,39154,726,610,399,1735,40889
13-08-2019,18,15226,15826,6310,3175,40537,718,603,411,1732,42269
13-08-2019,19,15574,15999,6275,2808,40656,711,609,405,1725,42381
13-08-2019,20,15590,15886,5744,2345,39565,675,528,223,1426,40991
13-08-2019,21,15451,16226,5506,2316,39499,635,515,207,1357,40856
13-08-2019,22,14464,15335,5391,2131,37322,602,303,216,1121,38443
13-08-2019,23,12993,13905,5298,1863,34061,608,294,233,1135,35196
14-08-2019,0,10937,12474,5222,1797,30430,598,275,238,1111,31541
14-08-2019,1,9270,11901,5148,1849,28169,599,279,276,1154,29323
14-08-2019,2,8723,11826,5135,1668,27353,614,264,307,1185,28538
14-08-2019,3,8618,11908,5123,1540,27189,635,271,263,1169,28358
14-08-2019,4,9190,11981,5121,1445,27738,652,274,270,1196,28934
14-08-2019,5,11003,12524,5236,1483,30246,719,275,265,1259,31505
14-08-2019,6,13933,14847,5541,1512,35834,805,497,238,1540,37374
14-08-2019,7,15379,16741,6006,1631,39758,881,781,402,2064,41822
14-08-2019,8,15911,16988,6229,1818,40947,898,781,567,2246,43193
14-08-2019,9,15203,15973,6261,2025,39462,919,730,553,2202,41664
14-08-2019,10,14639,15234,6255,2182,38310,934,726,542,2202,40512
14-08-2019,11,14113,14741,6286,2365,37505,932,726,565,2223,39728
14-08-2019,12,13962,14940,6269,2475,37646,940,665,570,2175,39821
14-08-2019,13,13685,14735,6161,2701,37282,966,671,531,2168,39450
14-08-2019,14,13571,14711,6095,2724,37101,940,629,380,1949,39050
14-08-2019,15,13533,14675,5993,2611,36812,915,591,372,1878,38690
14-08-2019,16,13619,14876,5967,2477,36938,883,602,395,1880,38818
14-08-2019,17,15001,16445,5871,2192,39510,896,617,403,1916,41426
14-08-2019,18,15574,16726,5999,2175,40475,922,611,398,1931,42406
14-08-2019,19,15465,16579,5966,1937,39949,917,606,387,1910,41859
14-08-2019,20,15382,16451,5660,1491,38985,858,518,223,1599,40584
14-08-2019,21,15224,16354,5405,1326,38309,775,496,235,1506,39815
14-08-2019,22,14347,15668,5174,1143,36332,697,274,231,1202,37534
14-08-2019,23,12872,14270,4992,854,32988,626,273,223,1122,34110
15-08-2019,0,10631,13288,5037,1000,29954,631,310,232,1173,31127
15-08-2019,1,9227,12320,5063,1097,27708,640,271,251,1162,28870
15-08-2019,2,8928,12214,5071,1247,27459,616,270,258,1144,28603
15-08-2019,3,8839,12193,5023,1521,27576,613,269,234,1116,28692
15-08-2019,4,9005,12191,5073,1748,28016,613,273,248,1134,29150
15-08-2019,5,9925,12657,5230,1829,29640,647,329,261,1237,30877
15-08-2019,6,11677,13982,5579,1859,33096,751,615,250,1616,34712
15-08-2019,7,13397,15066,6010,2327,36800,759,626,409,1794,38594
15-08-2019,8,14049,15755,6198,2566,38569,761,688,584,2033,40602
15-08-2019,9,14130,15531,6248,2757,38666,778,686,614,2078,40744
15-08-2019,10,14103,15655,6278,2951,38988,799,683,626,2108,41096
15-08-2019,11,13977,15637,6284,2909,38808,772,684,611,2067,40875
15-08-2019,12,13336,15591,6317,2919,38165,679,635,657,1971,40136
15-08-2019,13,12867,15496,6290,2614,37267,687,629,604,1920,39187
15-08-2019,14,12764,15688,6270,2440,37162,689,581,590,1860,39022
15-08-2019,15,12967,15692,6049,2191,36899,728,533,412,1673,38572
15-08-2019,16,13164,15677,5918,1880,36639,748,591,381,1720,38359
15-08-2019,17,14122,15591,5883,1818,37414,736,591,361,1688,39102
15-08-2019,18,14379,16071,5799,1608,37857,710,587,331,1628,39485
15-08-2019,19,15389,16568,5783,1567,39307,704,602,336,1642,40949
15-08-2019,20,15603,16861,5489,1305,39258,682,523,140,1345,40603
15-08-2019,21,15260,16407,5437,1756,38861,645,448,139,1232,40093
15-08-2019,22,13767,15404,5412,1547,36132,601,432,144,1177,37309
15-08-2019,23,12139,13491,5361,1540,32530,591,432,164,1187,33717
16-08-2019,0,10358,12532,5303,1473,29666,583,431,197,1211,30877
16-08-2019,1,9551,11782,5226,1430,27989,567,433,235,1235,29224
16-08-2019,2,9204,11554,5174,1370,27301,577,434,266,1277,28578
16-08-2019,3,9016,11386,5152,1540,27094,576,433,303,1312,28406
16-08-2019,4,9271,11446,5115,1619,27452,576,444,304,1324,28776
16-08-2019,5,10637,12025,5215,1607,29485,578,679,301,1558,31043
16-08-2019,6,13642,14108,5422,1585,34756,678,902,305,1885,36641
16-08-2019,7,15699,16581,5819,1860,39959,695,905,434,2034,41993
16-08-2019,8,16262,17405,5994,2129,41790,687,903,564,2154,43944
16-08-2019,9,16094,17376,6017,2416,41903,693,968,589,2250,44153
16-08-2019,10,15760,16832,5928,2223,40744,705,1057,596,2358,43102
16-08-2019,11,14724,16097,5898,2277,38995,706,1183,631,2520,41515
16-08-2019,12,14421,15480,5931,2398,38229,682,1229,642,2553,40782
16-08-2019,13,13608,15232,5911,2324,37075,600,1242,647,2489,39564
16-08-2019,14,13573,15015,5932,2234,36754,607,1060,654,2321,39075
16-08-2019,15,13022,14766,5874,2151,35814,607,993,644,2244,38058
16-08-2019,16,13618,14923,5830,2117,36487,604,1017,632,2253,38740
16-08-2019,17,14904,16315,5837,2026,39081,608,995,589,2192,41273
16-08-2019,18,15401,16865,5687,1987,39940,604,987,563,2154,42094
16-08-2019,19,15272,16561,5616,1774,39224,603,916,540,2059,41283
16-08-2019,20,14946,16476,5448,1681,38550,599,687,152,1438,39988
16-08-2019,21,14848,16260,5431,1869,38410,496,454,149,1099,39509
16-08-2019,22,13822,14558,5413,2065,35859,406,439,144,989,36848
16-08-2019,23,11655,12904,5264,2258,32082,418,390,156,964,33046
17-08-2019,0,9802,12036,5337,2575,29750,408,112,175,695,30445
17-08-2019,1,8689,11658,5334,2914,28596,396,107,181,684,29280
17-08-2019,2,7874,11465,5368,3191,27898,386,104,193,683,28581
17-08-2019,3,7340,11462,5425,3117,27344,382,104,184,670,28014
17-08-2019,4,7346,11615,5503,3210,27675,375,101,165,641,28316
17-08-2019,5,7544,11826,5504,3376,28250,351,98,157,606,28856
17-08-2019,6,8220,12002,5407,3622,29252,341,101,148,590,29842
17-08-2019,7,9178,12503,5289,3703,30673,334,155,164,653,31326
17-08-2019,8,10282,13205,5272,3812,32570,343,109,220,672,33242
17-08-2019,9,11782,13985,5312,4186,35264,385,112,253,750,36014
17-08-2019,10,12011,14458,5291,4090,35852,393,113,266,772,36624
17-08-2019,11,11669,14685,5340,3711,35406,403,161,216,780,36186
17-08-2019,12,10882,14755,5495,3519,34649,386,153,230,769,35418
17-08-2019,13,10703,14626,5353,3685,34368,382,121,238,741,35109
17-08-2019,14,10822,14579,5218,3527,34147,371,145,241,757,34904
17-08-2019,15,10912,14636,5211,3551,34311,370,110,265,745,35056
17-08-2019,16,10774,14650,5316,3445,34184,357,108,309,774,34958
17-08-2019,17,11248,15007,5402,3681,35339,352,109,279,740,36079
17-08-2019,18,11615,15488,5534,3371,36008,345,182,254,781,36789
17-08-2019,19,12856,16370,5563,2871,37659,351,177,218,746,38405
17-08-2019,20,13311,16641,5465,2251,37669,368,107,252,727,38396
17-08-2019,21,13469,16654,5597,1945,37665,374,108,167,649,38314
17-08-2019,22,12715,15830,5699,1575,35819,378,110,180,668,36487
17-08-2019,23,11213,14531,5612,1382,32738,401,112,185,698,33436
18-08-2019,0,9595,13521,5504,1132,29752,385,107,200,692,30444
18-08-2019,1,8784,13168,5600,1008,28562,389,106,215,710,29272
18-08-2019,2,8661,12930,5632,820,28045,382,110,223,715,28760
18-08-2019,3,8568,12719,5663,712,27663,370,115,212,697,28360
18-08-2019,4,8593,12458,5731,619,27402,360,116,202,678,28080
18-08-2019,5,8205,12255,5689,636,26786,360,116,191,667,27453
18-08-2019,6,8576,12310,5476,800,27162,348,112,190,650,27812
18-08-2019,7,10408,12398,5367,843,29015,343,141,190,674,29689
18-08-2019,8,11243,12742,5338,871,30195,356,441,194,991,31186
18-08-2019,9,11894,13092,5464,922,31372,353,468,204,1025,32397
18-08-2019,10,12818,13295,5464,1035,32613,376,473,239,1088,33701
18-08-2019,11,12945,13269,5508,1279,33002,352,613,288,1253,34255
18-08-2019,12,12528,12962,5520,1440,32451,345,616,303,1264,33715
18-08-2019,13,12487,13029,5304,1535,32355,352,514,281,1147,33502
18-08-2019,14,12738,13183,5355,1407,32683,355,522,276,1153,33836
18-08-2019,15,12696,13209,5372,1394,32672,364,512,268,1144,33816
18-08-2019,16,12864,13557,5379,1453,33253,348,511,248,1107,34360
18-08-2019,17,13124,14112,5352,1692,34282,345,506,214,1065,35347
18-08-2019,18,13494,14553,5397,1905,35348,341,491,273,1105,36453
18-08-2019,19,13514,15228,5434,1893,36070,356,484,341,1181,37251
18-08-2019,20,14079,15189,5576,1984,36829,393,477,388,1258,38087
18-08-2019,21,13784,14963,5622,2283,36652,389,275,373,1037,37689
18-08-2019,22,12743,14290,5629,2447,35108,402,276,379,1057,36165
18-08-2019,23,10917,12897,5519,2433,31766,430,280,376,1086,32852
19-08-2019,0,8888,11877,5508,2369,,420,283,351,1054,
19-08-2019,1,8998,11685,5539,2230,28453,400,285,334,1019,29472
19-08-2019,2,9116,11789,5625,2108,28636,431,277,355,1063,29699
19-08-2019,3,9088,11797,5545,2154,28585,453,278,319,1050,29635
19-08-2019,4,8644,11754,5590,2272,28260,472,278,286,1036,29296
19-08-2019,5,9512,12662,5731,2421,30328,469,281,268,1018,31346
19-08-2019,6,13172,14936,5954,2627,36688,547,460,365,1372,38060
19-08-2019,7,15151,17270,6204,2695,41321,628,909,460,1997,43318
19-08-2019,8,15976,17915,6476,3004,43372,613,901,709,2223,45595
19-08-2019,9,15169,17513,6561,3410,42655,599,887,747,2233,44888
19-08-2019,10,13472,17226,6663,3682,41043,591,978,747,2316,43359
19-08-2019,11,12562,16652,6707,4111,40031,606,987,730,2323,42354
19-08-2019,12,12141,16604,6714,4194,39652,591,937,747,2275,41927
19-08-2019,13,11980,16712,6585,4219,39496,593,1006,708,2307,41803
19-08-2019,14,11854,16704,6411,4350,39320,580,1001,668,2249,41569
19-08-2019,15,11509,16642,6395,4283,38829,591,924,602,2117,40946
19-08-2019,16,12084,16485,6308,4158,39034,583,916,574,2073,41107
19-08-2019,17,12898,17297,6125,3698,40020,588,916,545,2049,42069
19-08-2019,18,14195,17925,6094,3622,41837,572,914,561,2047,43884
19-08-2019,19,14764,18233,5932,3125,42054,573,894,547,2014,44068
19-08-2019,20,14510,18025,5613,2871,41020,504,664,158,1326,42346
19-08-2019,21,14424,17583,5627,2675,40308,498,435,158,1091,41399
19-08-2019,22,13422,16635,5663,2565,38286,508,426,152,1086,39372
19-08-2019,23,12030,15574,5598,2204,35406,505,427,145,1077,36483
20-08-2019,0,10036,14691,5602,2032,32361,496,430,148,1074,33435
20-08-2019,1,9547,13756,5479,1854,30636,496,432,153,1081,31717
20-08-2019,2,9646,13603,5461,1733,30445,493,430,165,1088,31533
20-08-2019,3,9701,13406,5440,1543,30091,496,428,170,1094,31185
20-08-2019,4,9699,13201,5440,1518,29859,504,431,175,1110,30969
20-08-2019,5,10910,13798,5511,1555,31775,513,444,180,1137,32912
20-08-2019,6,13944,16062,5631,1686,37323,559,880,176,1615,38938
20-08-2019,7,15501,17447,5839,1799,40587,575,1106,356,2037,42624
20-08-2019,8,16061,18016,6094,1737,41906,571,1201,530,2302,44208
20-08-2019,9,15641,17964,6051,2292,41947,571,1208,550,2329,44276
20-08-2019,10,15632,17768,5972,2718,42091,592,1207,559,2358,44449
20-08-2019,11,15484,17564,6035,3109,42193,606,1175,557,2338,44531
20-08-2019,12,15196,17297,6067,3371,41931,609,1180,567,2356,44287
20-08-2019,13,15033,17189,5996,3674,41891,603,1015,557,2175,44066
20-08-2019,14,15205,17439,6163,3616,42422,591,990,443,2024,44446
20-08-2019,15,15692,17612,6088,3311,42705,589,1006,277,1872,44577
20-08-2019,16,15938,17616,6080,3120,42754,552,1013,320,1885,44639
20-08-2019,17,16087,17766,5975,2815,42642,569,999,361,1929,44571
20-08-2019,18,15922,17385,5939,2431,41676,563,929,373,1865,43541
20-08-2019,19,15967,17203,5827,2014,41012,561,883,500,1944,42956
20-08-2019,20,15586,17127,5498,1686,39897,507,855,189,1551,41448
20-08-2019,21,15788,16790,5487,1733,39798,487,627,173,1287,41085
20-08-2019,22,14876,15862,5397,1687,37823,495,442,151,1088,38911
20-08-2019,23,13666,14469,5298,1499,34934,498,437,146,1081,36015
21-08-2019,0,11814,13676,5350,1398,32239,480,407,149,1036,33275
21-08-2019,1,11638,12979,5228,1377,31222,475,407,154,1036,32258
21-08-2019,2,11109,12787,5143,1406,30444,484,404,162,1050,31494
21-08-2019,3,10966,12642,5144,1409,30162,495,401,185,1081,31243
21-08-2019,4,11500,12601,5153,1299,30554,505,402,181,1088,31642
21-08-2019,5,12828,13500,5338,1208,32874,517,418,182,1117,33991
21-08-2019,6,15074,15896,5733,1416,38118,588,893,234,1715,39833
21-08-2019,7,15990,17387,6061,1636,41076,639,916,383,1938,43014
21-08-2019,8,16474,17724,6193,1853,42243,708,1200,602,2510,44753
21-08-2019,9,16130,17389,6165,1927,41611,710,1270,598,2578,44189
21-08-2019,10,15899,16998,6152,2086,41135,709,1377,580,2666,43801
21-08-2019,11,15669,16735,6213,2261,40877,705,1362,600,2667,43544
21-08-2019,12,14928,16279,6175,2355,39736,708,1372,584,2664,42400
21-08-2019,13,14469,15905,6045,2444,38864,707,1370,554,2631,41495
21-08-2019,14,14316,15731,6112,2457,38617,695,1342,401,2438,41055
21-08-2019,15,14064,15856,5916,2394,38231,696,1373,247,2316,40547
21-08-2019,16,14842,16420,5781,2257,39301,700,1376,392,2468,41769
21-08-2019,17,15736,17416,5657,2307,41117,710,1133,591,2434,43551
21-08-2019,18,15617,17406,5476,1976,40476,703,1126,563,2392,42868
21-08-2019,19,15651,17345,5471,1622,40089,609,1115,607,2331,42420
21-08-2019,20,15546,17366,5281,1701,39893,603,1075,232,1910,41803
21-08-2019,21,15567,16507,4966,1819,38860,533,865,227,1625,40485
21-08-2019,22,14750,15631,4640,1722,36743,527,664,234,1425,38168
21-08-2019,23,13830,14545,4420,1604,34399,537,419,226,1182,35581
22-08-2019,0,12512,13437,4493,1649,32092,520,402,226,1148,33240
22-08-2019,1,11192,12692,4438,1757,30080,543,401,222,1166,31246
22-08-2019,2,10505,12591,4368,1875,29339,534,400,214,1148,30487
22-08-2019,3,10532,12450,4288,1919,29190,527,402,208,1137,30327
22-08-2019,4,10488,12371,4317,2121,29297,532,430,208,1170,30467
22-08-2019,5,12075,13170,4741,2240,32224,552,723,207,1482,33706
22-08-2019,6,14359,15316,5120,2390,37186,644,1206,200,2050,39236
22-08-2019,7,15824,17221,5490,2335,40870,714,1309,385,2408,43278
22-08-2019,8,16287,17349,5782,2607,42025,739,1362,581,2682,44707
22-08-2019,9,15887,16789,5820,3108,41605,734,1453,546,2733,44338
22-08-2019,10,15260,16040,5771,3223,40294,683,1387,608,2678,42972
22-08-2019,11,14478,15991,5862,3533,39863,678,1395,589,2662,42525
22-08-2019,12,14117,15946,5902,3906,39873,687,1397,602,2686,42559
22-08-2019,13,13632,16128,5880,4251,39891,682,1295,599,2576,42467
22-08-2019,14,13633,16251,5688,4160,39732,682,1253,591,2526,42258
22-08-2019,15,13675,16052,5790,3783,39300,655,1196,399,2250,41550
22-08-2019,16,14338,15951,5711,3118,39119,574,1180,558,2312,41431
22-08-2019,17,15746,17247,5653,3206,41852,609,1134,544,2287,44139
22-08-2019,18,15931,17825,5717,2771,42244,607,1042,530,2179,44423
22-08-2019,19,15951,17840,5683,2320,41795,610,1123,502,2235,44030
22-08-2019,20,15791,17705,5476,1882,40855,550,1030,139,1719,42574
22-08-2019,21,15689,17501,5270,1837,40298,512,814,138,1464,41762
22-08-2019,22,15009,16495,5245,1694,38443,491,440,135,1066,39509
22-08-2019,23,13997,14975,5085,1658,35715,490,421,143,1054,36769
23-08-2019,0,11894,14029,5127,1683,32732,488,419,164,1071,33803
23-08-2019,1,11039,13313,4904,1883,31139,485,418,193,1096,32235
23-08-2019,2,10977,12760,4771,2256,30765,498,415,220,1133,31898
23-08-2019,3,10688,12534,4727,2424,30374,511,416,250,1177,31551
23-08-2019,4,11047,12631,4905,2716,31300,515,419,280,1214,32514
23-08-2019,5,12341,13717,5165,2879,34103,517,644,304,1465,35568
23-08-2019,6,14186,16193,5591,2911,38882,541,1093,300,1934,40816
23-08-2019,7,15793,17329,5844,2967,41934,568,1220,635,2423,44357
23-08-2019,8,16348,17712,5964,3188,43213,598,1450,592,2640,45853
23-08-2019,9,16514,17656,6033,3245,43449,611,1474,610,2695,46144
23-08-2019,10,15932,17792,6002,3236,42963,623,1502,614,2739,45702
23-08-2019,11,15393,17104,6017,3262,41776,630,1500,642,2772,44548
23-08-2019,12,14759,16675,6118,3127,40680,611,1501,645,2757,43437
23-08-2019,13,14050,16477,5921,3092,39539,634,1501,677,2812,42351
23-08-2019,14,13784,16146,5871,2983,38784,646,1528,468,2642,41426
23-08-2019,15,14041,15964,5939,2833,38777,605,1321,470,2396,41173
23-08-2019,16,15273,16517,5947,2504,40242,522,1369,459,2350,42592
23-08-2019,17,16151,17262,5915,2151,41480,540,1242,438,2220,43700
23-08-2019,18,15931,17282,5713,1857,40784,541,1260,599,2400,43184
23-08-2019,19,15563,17113,5498,1475,39650,538,1277,575,2390,42040
23-08-2019,20,15430,16965,4943,1201,38540,525,1121,320,1966,40506
23-08-2019,21,15193,16630,4842,1119,37784,488,919,244,1651,39435
23-08-2019,22,14755,15487,4604,989,35835,416,454,294,1164,36999
23-08-2019,23,13697,14586,4490,840,33614,376,426,323,1125,34739
24-08-2019,0,12940,13688,4410,741,31781,368,420,335,1123,32904
24-08-2019,1,11642,13277,4389,652,29959,338,412,352,1102,31061
24-08-2019,2,10439,13032,4391,575,28438,334,409,360,1103,29541
24-08-2019,3,10498,12819,4433,495,28246,317,407,351,1075,29321
24-08-2019,4,10357,12599,4429,437,27821,321,404,308,1033,28854
24-08-2019,5,10485,12184,4488,425,27584,331,404,256,991,28575
24-08-2019,6,11809,12028,4474,428,28740,342,404,211,957,29697
24-08-2019,7,13415,12889,4571,499,31373,346,463,255,1064,32437
24-08-2019,8,14612,13418,4887,628,33544,378,885,263,1526,35070
24-08-2019,9,14900,13525,5239,836,34500,413,899,241,1553,36053
24-08-2019,10,14488,13558,5400,1057,34503,433,899,237,1569,36072
24-08-2019,11,13623,13450,5369,1214,33657,447,899,218,1564,35221
24-08-2019,12,13475,13177,5086,1299,33036,415,897,279,1591,34627
24-08-2019,13,13379,12967,4939,1362,32646,359,896,320,1575,34221
24-08-2019,14,13106,12938,4942,1344,32331,349,896,233,1478,33809
24-08-2019,15,13019,12781,4940,1351,32092,334,896,227,1457,33549
24-08-2019,16,13390,12833,4842,1305,32370,307,896,208,1411,33781
24-08-2019,17,13848,13861,4901,1182,33792,287,897,191,1375,35167
24-08-2019,18,14924,14856,4992,1189,35962,261,899,176,1336,37298
24-08-2019,19,15024,15725,4852,1144,36745,264,901,172,1337,38082
24-08-2019,20,14887,15867,4828,1262,36845,269,898,182,1349,38194
24-08-2019,21,14635,15192,4688,1459,35975,267,885,194,1346,37321
24-08-2019,22,13605,14049,4651,1514,33820,259,547,197,1003,34823
24-08-2019,23,11753,12570,4366,1490,30180,242,403,208,853,31033
25-08-2019,0,10291,11997,4090,1423,27803,229,402,203,834,28637
25-08-2019,1,9552,11941,4108,1353,26955,225,400,192,817,27772
25-08-2019,2,9223,11972,4186,1219,26601,225,401,193,819,27420
25-08-2019,3,9294,12080,4336,1174,26886,224,400,184,808,27694
25-08-2019,4,9602,12181,4593,1113,27489,235,402,188,825,28314
25-08-2019,5,9315,12111,4798,1052,27277,237,404,182,823,28100
25-08-2019,6,9118,11948,4951,1024,27041,233,405,177,815,27856
25-08-2019,7,10256,12058,4954,1000,28269,238,398,178,814,29083
25-08-2019,8,12273,12242,4780,978,30273,251,401,178,830,31103
25-08-2019,9,13035,12448,4929,1040,31452,265,544,188,997,32449
25-08-2019,10,13180,12905,5036,1127,32247,254,605,196,1055,33302
25-08-2019,11,13108,12854,5147,1295,32403,252,573,204,1029,33432
25-08-2019,12,12931,12907,5268,1462,32568,254,422,204,880,33448
25-08-2019,13,12690,12958,5337,1573,32557,252,398,202,852,33409
25-08-2019,14,13046,13084,5353,1551,33034,262,397,197,856,33890
25-08-2019,15,12979,12962,5363,1414,32719,261,398,198,857,33576
25-08-2019,16,13069,13363,5463,1271,33167,266,397,187,850,34017
25-08-2019,17,13947,14124,5610,1175,34855,269,413,167,849,35704
25-08-2019,18,15198,15552,5655,1079,37484,265,691,156,1112,38596
25-08-2019,19,15241,16060,5658,1014,37973,281,665,156,1102,39075
25-08-2019,20,15363,16202,5730,1095,38390,296,672,173,1141,39531
25-08-2019,21,15411,15890,5611,1250,38162,324,668,173,1165,39327
25-08-2019,22,14502,15356,5398,1363,36620,325,415,176,916,37536
25-08-2019,23,13391,14029,5208,1266,33894,330,414,193,937,34831
26-08-2019,0,11766,13708,5224,1304,32002,332,407,199,938,32940
26-08-2019,1,11159,13386,5186,1165,30897,340,402,197,939,31836
26-08-2019,2,10883,13103,5174,970,30131,354,400,186,940,31071
26-08-2019,3,11058,13041,5230,810,30139,356,398,177,931,31070
26-08-2019,4,11858,13107,5261,977,31204,358,398,168,924,32128
26-08-2019,5,12615,14116,5458,1081,33271,367,413,160,940,34211
26-08-2019,6,14535,16131,5751,1307,37724,449,945,161,1555,39279
26-08-2019,7,15597,17085,5928,1454,40065,444,1125,552,2121,42186
26-08-2019,8,16126,18020,6015,1541,41705,420,1221,587,2228,43933
26-08-2019,9,16091,18091,6054,1538,41775,450,1412,586,2448,44223
26-08-2019,10,16313,18127,6125,1697,42262,458,1514,601,2573,44835
26-08-2019,11,16279,17861,6150,1860,42149,478,1618,604,2700,44849
26-08-2019,12,15830,17722,6178,1744,41475,486,1535,614,2635,44110
26-08-2019,13,15970,17092,6226,1781,41068,491,1463,598,2552,43620
26-08-2019,14,16017,17403,6118,1907,41445,495,1275,597,2367,43812
26-08-2019,15,15989,17273,6062,2063,41387,496,1221,589,2306,43693
26-08-2019,16,16104,17571,5984,2037,41698,486,1171,593,2250,43948
26-08-2019,17,16094,17783,5846,1763,41486,486,1180,572,2238,43724
26-08-2019,18,15606,17575,5813,1628,40622,472,1159,565,2196,42818
26-08-2019,19,15511,17430,5878,1422,40241,485,1121,564,2170,42411
26-08-2019,20,15451,17157,5405,1417,39431,489,1115,233,1837,41268
26-08-2019,21,15496,16692,5123,1509,38819,432,1047,164,1643,40462
26-08-2019,22,14954,15802,4756,1538,37051,395,918,179,1492,38543
26-08-2019,23,14084,14334,4540,1341,34298,406,884,192,1482,35780
27-08-2019,0,13731,13316,4457,1473,32977,414,868,187,1469,34446
27-08-2019,1,13159,12203,4300,1360,31021,405,655,189,1249,32270
27-08-2019,2,12885,12084,4280,1272,30520,407,426,190,1023,31543
27-08-2019,3,12300,11979,4337,1141,29757,392,412,187,991,30748
27-08-2019,4,12687,12197,4540,1111,30537,376,562,188,1126,31663
27-08-2019,5,13419,14015,4902,1309,33646,365,670,191,1226,34872
27-08-2019,6,14150,15880,5327,1497,36855,440,925,199,1564,38419
27-08-2019,7,15028,17100,5832,1557,39517,445,957,391,1793,41310
27-08-2019,8,15654,17840,6000,1529,41022,455,1075,581,2111,43133
27-08-2019,9,16158,18179,6000,1539,41879,454,1263,597,2314,44193
27-08-2019,10,16174,18395,5972,1722,42264,456,1365,605,2426,44690
27-08-2019,11,16016,18046,6178,1795,42036,460,1347,596,2403,44439
27-08-2019,12,16233,17309,6233,1748,41522,494,1315,619,2428,43950
27-08-2019,13,16210,17037,6188,1766,41201,527,1321,614,2462,43663
27-08-2019,14,15806,17271,6187,2075,41340,450,1265,619,2334,43674
27-08-2019,15,15865,18107,6150,2219,42342,481,1140,610,2231,44573
27-08-2019,16,15744,17818,6121,2257,41941,429,1185,586,2200,44141
27-08-2019,17,15801,18124,5961,1888,41774,433,1237,201,1871,43645
27-08-2019,18,15619,18008,5850,1725,41201,431,1230,192,1853,43054
27-08-2019,19,15321,17724,5800,1768,40612,426,1112,207,1745,42357
27-08-2019,20,14993,17435,5590,1856,39876,398,975,232,1605,41481
27-08-2019,21,14843,16715,5418,2032,39010,370,935,296,1601,40611
27-08-2019,22,14404,15330,5158,2126,37017,344,925,318,1587,38604
27-08-2019,23,13545,13926,5066,2196,34735,407,718,339,1464,36199
28-08-2019,0,13123,13028,5081,1947,33180,452,899,348,1699,34879
28-08-2019,1,12628,12046,5187,1691,31552,451,714,333,1498,33050
28-08-2019,2,12079,11638,5206,1454,30377,464,709,312,1485,31862
28-08-2019,3,11631,11490,5228,1294,29644,486,702,308,1496,31140
28-08-2019,4,12085,11959,5324,1291,30659,502,710,303,1515,32174
28-08-2019,5,13172,13621,5423,1380,33596,532,923,313,1768,35364
28-08-2019,6,14483,15332,5468,1611,36895,587,937,302,1826,38721
28-08-2019,7,15333,17012,5609,1759,39714,622,931,457,2010,41724
28-08-2019,8,15520,17783,5806,1633,40742,625,1078,610,2313,43055
28-08-2019,9,15728,17898,6017,1638,41282,635,1187,617,2439,43721
28-08-2019,10,15510,17994,6095,1881,41481,647,1279,671,2597,44078
28-08-2019,11,15213,17912,6131,2018,41274,657,1477,693,2827,44101
28-08-2019,12,15071,17544,6173,2144,40932,660,1585,709,2954,43886
28-08-2019,13,15188,17423,6090,1912,40615,670,1580,693,2943,43558
28-08-2019,14,15492,17659,6015,1881,41047,669,1405,702,2776,43823
28-08-2019,15,15518,17722,6074,1883,41198,659,1272,530,2461,43659
28-08-2019,16,15307,17564,5999,1799,40670,656,1225,502,2383,43053
28-08-2019,17,15486,17569,5873,1611,40540,654,1225,471,2350,42890
28-08-2019,18,15166,17136,5760,1629,39690,650,1109,649,2408,42098
28-08-2019,19,15142,16994,5874,1293,39303,673,1120,654,2447,41750
28-08-2019,20,15295,17014,5677,1231,39217,712,1071,345,2128,41345
28-08-2019,21,15241,16100,5331,1370,38041,693,957,384,2034,40075
28-08-2019,22,14786,14991,4889,1389,36055,635,932,404,1971,38026
28-08-2019,23,13791,13817,4739,1281,33629,611,805,407,1823,35452
29-08-2019,0,13314,12862,4816,1266,32258,598,923,388,1909,34167
29-08-2019,1,12699,12213,4922,1082,30918,614,880,351,1845,32763
29-08-2019,2,12654,12215,4953,1059,30882,632,705,334,1671,32553
29-08-2019,3,12287,12291,5028,1093,30700,622,700,305,1627,32327
29-08-2019,4,12295,12232,5178,1161,30866,626,708,253,1587,32453
29-08-2019,5,13062,13009,5401,1237,32710,627,927,287,1841,34551
29-08-2019,6,14362,15592,5707,1258,36919,709,931,312,1952,38871
29-08-2019,7,15155,17037,6127,1308,39628,714,928,575,2217,41845
29-08-2019,8,15865,17396,6251,1424,40935,685,1141,734,2560,43495
29-08-2019,9,15879,17462,6299,1343,40984,683,1423,697,2803,43787
29-08-2019,10,15864,17495,6317,1415,41092,678,1692,672,3042,44134
29-08-2019,11,16001,17694,6392,1480,41568,704,1524,682,2910,44478
29-08-2019,12,15942,17416,6488,1622,41468,718,1493,642,2853,44321
29-08-2019,13,16138,17587,6462,1629,41815,701,1303,645,2649,44464
29-08-2019,14,16038,17271,6311,1950,41568,683,1305,616,2604,44172
29-08-2019,15,15813,16926,6405,2088,41232,672,1275,409,2356,43588
29-08-2019,16,15677,16374,6380,2101,40533,652,1089,415,2156,42689
29-08-2019,17,15767,17113,6271,2255,41406,642,1062,397,2101,43507
29-08-2019,18,15505,16655,6191,2154,40507,645,980,384,2009,42516
29-08-2019,19,15575,16605,6194,1766,40140,675,1006,367,2048,42188
29-08-2019,20,15697,17158,6147,1561,40564,644,928,180,1752,42316
29-08-2019,21,15536,16307,5910,1497,39251,608,919,196,1723,40974
29-08-2019,22,14917,14918,5617,1346,36799,576,908,213,1697,38496
29-08-2019,23,14223,13918,5455,1175,34772,533,896,256,1685,36457
30-08-2019,0,13592,13610,5448,1067,33719,548,688,254,1490,35209
30-08-2019,1,13129,12750,5342,1118,32338,540,679,235,1454,33792
30-08-2019,2,12635,12534,5254,1087,31510,538,648,234,1420,32930
30-08-2019,3,12493,12334,5264,1030,31122,537,437,230,1204,32326
30-08-2019,4,12556,12027,5275,1061,30921,529,694,218,1441,32362
30-08-2019,5,13699,13597,5527,1207,34031,534,912,200,1646,35677
30-08-2019,6,14781,15724,5910,1427,37842,635,1072,182,1889,39731
30-08-2019,7,15691,16601,5956,1618,39866,699,1189,361,2249,42115
30-08-2019,8,15969,16535,6265,1798,40569,712,1419,566,2697,43266
30-08-2019,9,16339,16491,6539,2092,41461,722,1447,602,2771,44232
30-08-2019,10,16212,16938,6445,2407,42001,739,1431,628,2798,44799
30-08-2019,11,16248,15724,6374,2981,41325,738,1421,668,2827,44152
30-08-2019,12,15701,14728,6429,3098,39958,747,1413,672,2832,42790
30-08-2019,13,15687,14652,6451,3363,40152,759,1233,669,2661,42813
30-08-2019,14,15546,14332,6348,3129,39353,760,1171,651,2582,41935
30-08-2019,15,15618,14140,6358,3007,39124,770,1200,469,2439,41563
30-08-2019,16,16395,15108,6299,3307,41111,772,1107,465,2344,43455
30-08-2019,17,15940,16482,6083,2907,41411,767,1128,421,2316,43727
30-08-2019,18,15916,16366,5987,2538,40808,755,1056,575,2386,43194
30-08-2019,19,16108,16003,5810,2034,39955,723,1116,573,2412,42367
30-08-2019,20,15855,15913,5457,1801,39027,623,930,218,1771,40798
30-08-2019,21,15419,15456,5117,1668,37662,482,921,204,1607,39269
30-08-2019,22,14614,14680,5033,1606,35934,475,911,182,1568,37502
30-08-2019,23,14193,13585,4944,1495,34220,454,898,169,1521,35741
31-08-2019,0,13606,13484,4923,1624,33637,447,668,166,1281,34918
31-08-2019,1,12654,12359,4878,1503,31394,458,427,168,1053,32447
31-08-2019,2,11641,12044,4846,1511,30041,461,370,164,995,31036
31-08-2019,3,11199,12039,4913,1518,29670,454,369,164,987,30657
31-08-2019,4,10607,11909,4963,1501,28979,455,370,162,987,29966
31-08-2019,5,10437,11830,4981,1539,28788,455,371,164,990,29778
31-08-2019,6,11082,12076,4920,1550,29629,452,373,164,989,30618
31-08-2019,7,12112,12241,4871,1492,30716,456,466,168,1090,31806
31-08-2019,8,13633,12965,4913,1515,33025,452,627,169,1248,34273
31-08-2019,9,14925,13482,5151,1670,35230,461,640,174,1275,36505
31-08-2019,10,15146,13270,5335,1984,35734,473,640,177,1290,37024
31-08-2019,11,14475,13247,5363,2242,35328,477,640,198,1315,36643
31-08-2019,12,13936,12680,5307,2549,34473,482,640,194,1316,35789
31-08-2019,13,13517,12552,5348,2605,34025,479,640,203,1322,35347
31-08-2019,14,13271,12407,5269,2370,33317,481,639,196,1316,34633
31-08-2019,15,13335,12291,5223,2182,33031,475,644,189,1308,34339
31-08-2019,16,13974,12615,5162,1733,33483,460,834,182,1476,34959
31-08-2019,17,14743,13550,5084,1228,34607,457,883,168,1508,36115
31-08-2019,18,15768,14996,5087,960,36812,447,880,159,1486,38298
31-08-2019,19,15428,15596,5155,834,37011,446,884,156,1486,38497
31-08-2019,20,15150,15689,5060,1119,37019,445,884,162,1491,38510
31-08-2019,21,14744,15188,4871,1183,35986,445,888,173,1506,37492
31-08-2019,22,14401,14117,4780,1226,34527,453,643,186,1282,35809
31-08-2019,23,12820,12374,4725,1504,31424,454,393,200,1047,32471
01-09-2019,0,10109,11720,4764,1847,28441,451,394,225,1070,29511
01-09-2019,1,8740,11626,4665,2300,27331,453,394,251,1098,28429
01-09-2019,2,8246,11575,4669,2309,26799,463,394,274,1131,27930
01-09-2019,3,8589,11747,4683,2013,27031,479,401,289,1169,28200
01-09-2019,4,8862,11801,4682,1464,26809,498,403,282,1183,27992
01-09-2019,5,9242,11769,4598,966,26575,509,403,268,1180,27755
01-09-2019,6,9177,11759,4584,1089,26609,514,290,254,1058,27667
01-09-2019,7,10007,12105,4504,1296,27912,510,266,232,1008,28920
01-09-2019,8,11930,12208,4542,1435,30115,531,261,206,998,31113
01-09-2019,9,13827,12999,4973,1574,33373,563,510,217,1290,34663
01-09-2019,10,14497,13454,5099,1686,34736,589,501,232,1322,36058
01-09-2019,11,14120,13760,5106,2004,34989,599,493,263,1355,36344
01-09-2019,12,13789,13931,5113,2076,34907,603,491,295,1389,36296
01-09-2019,13,13244,13931,5134,2111,34420,593,489,312,1394,35814
01-09-2019,14,12908,13732,5204,2158,34004,593,451,316,1360,35364
01-09-2019,15,12723,13592,5215,2235,33765,590,428,307,1325,35090
01-09-2019,16,13145,13590,5278,2172,34183,596,432,291,1319,35502
01-09-2019,17,14412,13777,5337,2071,35597,581,491,267,1339,36936
01-09-2019,18,15491,14268,5411,1874,37045,558,502,250,1310,38355
01-09-2019,19,15404,14508,5587,1543,37042,570,395,281,1246,38288
01-09-2019,20,15882,15679,5826,1456,38843,603,341,361,1305,40148
01-09-2019,21,15687,15147,5712,1607,38153,618,279,405,1302,39455
01-09-2019,22,15459,14355,5604,1643,37062,593,282,405,1280,38342
01-09-2019,23,14577,13104,5477,1560,34717,573,267,394,1234,35951
02-09-2019,0,12065,11959,5404,1692,31120,550,245,373,1168,32288
02-09-2019,1,10793,11387,5335,1766,29281,535,238,342,1115,30396
02-09-2019,2,10620,11144,5337,1885,28985,537,240,313,1090,30075
02-09-2019,3,10021,11022,5277,1998,28319,545,236,270,1051,29370
02-09-2019,4,10224,11022,5333,1880,28460,553,236,259,1048,29508
02-09-2019,5,11734,11978,5443,2279,31434,583,243,242,1068,32502
02-09-2019,6,14366,14676,5961,2283,37288,656,487,268,1411,38699
02-09-2019,7,15710,16611,6315,2387,41023,734,508,568,1810,42833
02-09-2019,8,15909,16638,6418,2607,41572,754,955,564,2273,43845
02-09-2019,9,16081,16616,6677,2867,42243,751,956,640,2347,44590
02-09-2019,10,16165,16895,6685,3249,42996,752,1073,667,2492,45488
02-09-2019,11,16052,16701,6686,3367,42806,753,1085,687,2525,45331
02-09-2019,12,15997,16110,6704,3408,42219,756,1119,729,2604,44823
02-09-2019,13,16146,15847,6651,3536,42180,749,1079,733,2561,44741
02-09-2019,14,16072,15975,6085,3577,41709,759,896,528,2183,43892
02-09-2019,15,15746,16037,6187,3351,41322,793,895,532,2220,43542
02-09-2019,16,15629,15933,6562,3392,41517,817,901,666,2384,43901
02-09-2019,17,16132,17123,6475,2981,42711,817,914,505,2236,44947
02-09-2019,18,15846,17203,6391,2476,41917,810,910,506,2226,44143
02-09-2019,19,15793,17033,6493,1899,41218,786,997,598,2381,43599
02-09-2019,20,15956,17126,5940,1783,40807,704,909,234,1847,42654
02-09-2019,21,15744,16485,5207,1950,39388,634,889,226,1749,41137
02-09-2019,22,15253,15359,4868,2166,37646,629,641,217,1487,39133
02-09-2019,23,14103,13211,4846,2305,34464,623,604,204,1431,35895
03-09-2019,0,13222,12783,4960,2506,33470,599,375,203,1177,34647
03-09-2019,1,11970,12049,4918,2694,31630,573,375,185,1133,32763
03-09-2019,2,11890,11766,4907,3009,31572,572,371,190,1133,32705
03-09-2019,3,11781,11845,4895,3264,31786,572,370,189,1131,32917
03-09-2019,4,11776,12155,5030,3450,32411,585,393,172,1150,33561
03-09-2019,5,12503,13068,5353,3552,34476,593,897,181,1671,36147
03-09-2019,6,14252,14970,5724,3416,38364,701,957,170,1828,40192
03-09-2019,7,15914,16929,5967,3304,42115,744,997,591,2332,44447
03-09-2019,8,16282,17518,6133,3219,43154,741,1222,592,2555,45709
03-09-2019,9,16081,17624,6206,3254,43166,737,1348,554,2639,45805
03-09-2019,10,15865,17446,6191,3363,42865,743,1346,567,2656,45521
03-09-2019,11,15216,17207,6201,3714,42337,750,1351,549,2650,44987
03-09-2019,12,14734,16688,6204,3958,41586,759,1276,582,2617,44203
03-09-2019,13,14844,16497,6160,4067,41567,759,1256,594,2609,44176
03-09-2019,14,14915,16381,5836,4034,41167,750,961,411,2122,43289
03-09-2019,15,15149,16368,5782,3570,40869,736,950,425,2111,42980
03-09-2019,16,15634,16389,5885,3248,41156,718,1024,583,2325,43481
03-09-2019,17,16302,16416,5892,3842,42452,692,934,578,2204,44656
03-09-2019,18,16420,16934,5705,3345,42406,688,921,562,2171,44577
03-09-2019,19,16337,16966,5732,2783,41819,723,1080,321,2124,43943
03-09-2019,20,16539,17069,5768,2377,41752,706,911,176,1793,43545
03-09-2019,21,16639,16763,5373,2084,40859,579,898,199,1676,42535
03-09-2019,22,16073,16054,4907,1797,38833,576,703,234,1513,40346
03-09-2019,23,15033,14263,4842,1554,35693,571,395,279,1245,36938
04-09-2019,0,13004,12887,4841,1532,32266,570,386,281,1237,33503
04-09-2019,1,11576,12434,4900,1447,30356,573,384,294,1251,31607
04-09-2019,2,11023,12331,4970,1424,29748,573,389,301,1263,31011
04-09-2019,3,11312,12288,5004,1517,30122,579,382,297,1258,31380
04-09-2019,4,12708,12465,4983,1562,31718,578,384,289,1251,32969
04-09-2019,5,14209,13834,5233,1608,34885,611,771,285,1667,36552
04-09-2019,6,15731,16195,5572,1820,39318,779,994,290,2063,41381
04-09-2019,7,16917,17292,5868,2259,42337,792,1021,673,2486,44823
04-09-2019,8,16931,17775,6099,2700,43504,777,1101,656,2534,46038
04-09-2019,9,17090,17777,6060,3071,43998,770,1081,658,2509,46507
04-09-2019,10,17040,17420,5883,3474,43818,790,1284,642,2716,46534
04-09-2019,11,16635,17577,5909,3666,43788,781,1242,618,2641,46429
04-09-2019,12,15382,17289,5988,3470,42129,759,1239,644,2642,44771
04-09-2019,13,15007,16992,5922,3830,41751,711,1103,656,2470,44221
04-09-2019,14,15260,16907,5616,3792,41575,714,917,468,2099,43674
04-09-2019,15,14991,16892,5761,3484,41130,713,906,458,2077,43207
04-09-2019,16,15652,16934,5700,3508,41795,736,1081,614,2431,44226
04-09-2019,17,16666,17120,5801,3397,42986,733,1074,561,2368,45354
04-09-2019,18,17246,17575,5751,2868,43439,749,1072,550,2371,45810
04-09-2019,19,16980,18082,5815,2680,43556,742,1065,527,2334,45890
04-09-2019,20,16584,18083,5709,2738,43115,749,907,340,1996,45111
04-09-2019,21,16224,16270,5295,2590,40380,714,912,171,1797,42177
04-09-2019,22,15527,14908,4794,2435,37665,587,862,196,1645,39310
04-09-2019,23,13971,14117,4546,2329,34963,593,401,255,1249,36212
05-09-2019,0,11980,13391,4498,2288,32157,584,390,322,1296,33453
05-09-2019,1,11312,12530,4453,2121,30417,573,393,374,1340,31757
05-09-2019,2,10867,12619,4519,1943,29947,581,394,370,1345,31292
05-09-2019,3,10801,12659,4697,1740,29896,599,394,384,1377,31273
05-09-2019,4,10819,12798,4887,1799,30303,625,406,369,1400,31703
05-09-2019,5,11844,13814,5445,1822,32923,643,912,383,1938,34861
05-09-2019,6,13765,15214,5987,1883,36849,770,950,401,2121,38970
05-09-2019,7,15741,17375,6309,1973,41398,801,965,734,2500,43898
05-09-2019,8,16127,18323,6570,2212,43233,850,1104,675,2629,45862
05-09-2019,9,15817,17422,6372,2455,42066,869,1324,669,2862,44928
05-09-2019,10,15387,16569,6368,3131,41454,896,1350,705,2951,44405
05-09-2019,11,14235,16281,6595,3937,41048,872,1327,730,2929,43977
05-09-2019,12,13507,16161,6669,4364,40701,866,1292,724,2882,43583
05-09-2019,13,13463,16046,6441,4463,40414,893,1195,755,2843,43257
05-09-2019,14,13179,15742,6252,4593,39766,875,977,726,2578,42344
05-09-2019,15,13460,15670,6358,4858,40347,838,974,736,2548,42895
05-09-2019,16,14387,16026,6589,4317,41318,789,1012,658,2459,43777
05-09-2019,17,15393,16535,6724,4180,42831,809,1038,623,2470,45301
05-09-2019,18,15853,16932,6713,4330,43829,830,952,594,2376,46205
05-09-2019,19,15712,17525,6938,4282,44457,855,935,389,2179,46636
05-09-2019,20,15976,17540,6325,4209,44050,871,980,384,2235,46285
05-09-2019,21,16014,16650,5900,4252,42818,841,815,388,2044,44862
05-09-2019,22,15273,15237,5617,4332,40461,719,536,386,1641,42102
05-09-2019,23,13448,13946,5502,4226,37122,655,383,400,1438,38560
06-09-2019,0,11415,13484,5489,3735,34123,640,385,442,1467,35590
06-09-2019,1,10819,13239,5390,3248,32696,629,385,490,1504,34200
06-09-2019,2,10450,13011,5266,2862,31589,635,381,460,1476,33065
06-09-2019,3,10564,12985,5215,2484,31247,657,386,468,1511,32758
06-09-2019,4,11038,13008,5202,2342,31590,652,394,513,1559,33149
06-09-2019,5,12110,13989,5436,2428,33963,637,419,526,1582,35545
06-09-2019,6,14716,15395,5963,2483,38555,803,978,543,2324,40879
06-09-2019,7,16863,17867,6315,2594,43638,813,1111,729,2653,46291
06-09-2019,8,17107,18559,6681,2929,45275,826,1324,915,3065,48340
06-09-2019,9,17351,18315,6822,3137,45624,852,1324,957,3133,48757
06-09-2019,10,17168,17602,6869,3141,44780,836,1324,980,3140,47920
06-09-2019,11,15875,16917,6760,3364,42917,835,1316,982,3133,46050
06-09-2019,12,15426,16015,6726,3373,41539,847,1307,961,3115,44654
06-09-2019,13,14729,15914,6528,3612,40784,849,1302,945,3096,43880
06-09-2019,14,14723,15570,6284,4019,40598,849,1031,775,2655,43253
06-09-2019,15,14497,15169,6287,4125,40079,828,928,781,2537,42616
06-09-2019,16,15320,15037,6473,3995,40825,806,922,722,2450,43275
06-09-2019,17,16708,15586,6550,4102,42948,792,921,659,2372,45320
06-09-2019,18,17206,16311,6614,4069,44199,789,920,596,2305,46504
06-09-2019,19,17191,16406,6714,3763,44074,777,939,570,2286,46360
06-09-2019,20,17031,15964,6475,3539,43008,766,940,374,2080,45088
06-09-2019,21,16815,15665,5912,2823,41216,695,914,373,1982,43198
06-09-2019,22,16382,15106,5395,2778,39662,572,741,371,1684,41346
06-09-2019,23,15482,14397,5092,2659,37631,569,401,389,1359,38990
07-09-2019,0,14674,12816,5032,2768,35291,567,383,390,1340,36631
07-09-2019,1,13791,12173,4974,2471,33411,557,390,405,1352,34763
07-09-2019,2,13121,11749,4914,2379,32164,553,392,397,1342,33506
07-09-2019,3,12850,11729,4893,2440,31912,558,390,462,1410,33322
07-09-2019,4,13066,11774,4862,2379,32081,577,393,531,1501,33582
07-09-2019,5,13552,11873,4848,2182,32456,577,396,550,1523,33979
07-09-2019,6,14436,12700,4811,1827,33776,588,405,540,1533,35309
07-09-2019,7,15243,14453,4886,1663,36244,609,641,524,1774,38018
07-09-2019,8,16133,15658,5130,1671,38592,683,885,467,2035,40627
07-09-2019,9,16798,16356,5215,1729,40098,711,919,608,2238,42336
07-09-2019,10,17094,16500,5200,1809,40604,736,922,614,2272,42876
07-09-2019,11,16769,16164,5155,1880,39968,703,924,594,2221,42189
07-09-2019,12,16285,15770,5139,1811,39007,735,922,583,2240,41247
07-09-2019,13,16102,15345,5045,1751,38243,716,913,594,2223,40466
07-09-2019,14,15803,14614,5148,1588,37154,708,908,445,2061,39215
07-09-2019,15,15738,14420,5334,1379,36872,704,908,393,2005,38877
07-09-2019,16,15766,14733,5387,1231,37117,709,905,368,1982,39099
07-09-2019,17,16307,15333,5380,1150,38170,710,905,529,2144,40314
07-09-2019,18,16333,15584,5425,1110,38451,724,904,346,1974,40425
07-09-2019,19,16416,15630,5455,1024,38525,741,904,415,2060,40585
07-09-2019,20,16687,15839,5524,939,38992,723,903,377,2003,40995
07-09-2019,21,16472,15487,5289,776,38025,720,885,225,1830,39855
07-09-2019,22,16149,15011,5009,684,36854,627,857,245,1729,38583
07-09-2019,23,15308,13928,4663,511,34410,647,382,282,1311,35721
08-09-2019,0,14998,13038,4566,485,33087,671,377,315,1363,34450
08-09-2019,1,14348,11679,4503,527,31058,655,381,330,1366,32424
08-09-2019,2,14232,11204,4438,542,30416,638,384,365,1387,31803
08-09-2019,3,14050,11188,4394,538,30169,636,383,379,1398,31567
08-09-2019,4,13970,11249,4333,568,30120,629,385,364,1378,31498
08-09-2019,5,13857,11329,4316,591,30095,629,392,289,1310,31405
08-09-2019,6,14145,11599,4263,641,30649,630,400,279,1309,31958
08-09-2019,7,14672,12577,4338,719,32308,634,608,343,1585,33893
08-09-2019,8,15312,13371,4458,813,33954,629,681,326,1636,35590
08-09-2019,9,16118,14570,4718,896,36301,634,898,290,1822,38123
08-09-2019,10,16154,14167,4864,1161,36347,663,994,279,1936,38283
08-09-2019,11,16395,14217,4797,1261,36671,677,992,241,1910,38581
08-09-2019,12,16667,14190,4803,1145,36805,690,1004,230,1924,38729
08-09-2019,13,16529,13834,4777,1051,36193,729,997,280,2006,38199
08-09-2019,14,16533,13836,4747,892,36008,806,923,205,1934,37942
08-09-2019,15,16561,14166,4805,890,36422,817,918,195,1930,38352
08-09-2019,16,16493,14204,4881,920,36500,798,919,196,1913,38413
08-09-2019,17,16564,15808,4986,945,38302,715,913,385,2013,40315
08-09-2019,18,16653,16453,5104,814,39025,789,915,409,2113,41138
08-09-2019,19,16508,16295,5066,898,38767,827,1121,436,2384,41151
08-09-2019,20,16548,16239,4957,961,38705,841,1262,423,2526,41231
08-09-2019,21,16435,15732,4629,991,37786,792,1121,388,2301,40087
08-09-2019,22,16123,15144,4340,1001,36608,730,893,243,1866,38474
08-09-2019,23,15755,14647,4159,862,35423,725,797,238,1760,37183
09-09-2019,0,15293,14351,4039,759,,706,389,239,1334,
09-09-2019,1,14424,13743,3970,640,32777,698,386,230,1314,34091
09-09-2019,2,13825,12317,4086,597,30824,682,383,220,1285,32109
09-09-2019,3,13407,12066,4273,602,30349,704,383,209,1296,31645
09-09-2019,4,13637,12902,4560,505,31605,686,389,208,1283,32888
09-09-2019,5,14778,14306,5124,581,34792,741,940,218,1899,36691
09-09-2019,6,16064,15888,5931,908,38790,854,1096,229,2179,40969
09-09-2019,7,17211,16980,6296,1194,41682,898,1090,587,2575,44257
09-09-2019,8,17698,17647,6481,1241,43067,900,1223,614,2737,45804
09-09-2019,9,17721,17611,6452,1487,43271,905,1243,618,2766,46037
09-09-2019,10,17767,17760,6457,1449,43433,891,1297,605,2793,46226
09-09-2019,11,17504,17891,6390,1606,43392,871,1295,632,2798,46190
09-09-2019,12,17118,17821,6387,1597,42923,866,1247,653,2766,45689
09-09-2019,13,16645,17716,6231,1643,42236,866,1200,671,2737,44973
09-09-2019,14,16483,17616,5888,1964,41951,865,979,688,2532,44483
09-09-2019,15,16345,17521,5800,2080,41747,869,978,686,2533,44280
09-09-2019,16,16150,17691,6102,2050,41994,845,996,672,2513,44507
09-09-2019,17,16139,17755,6051,2163,42109,841,1017,689,2547,44656
09-09-2019,18,15956,17612,5995,2078,41641,842,1026,709,2577,44218
09-09-2019,19,16133,17416,6118,1908,41576,850,1088,779,2717,44293
09-09-2019,20,16137,17327,5990,1833,41286,872,1034,764,2670,43956
09-09-2019,21,15910,16560,5597,1614,39682,811,975,460,2246,41928
09-09-2019,22,15461,16131,4995,1499,38087,729,644,450,1823,39910
09-09-2019,23,14590,14865,4563,1532,35551,745,645,449,1839,37390
10-09-2019,0,13641,13987,4340,1115,33083,763,491,452,1706,34789
10-09-2019,1,12884,13393,4081,1325,31681,768,489,455,1712,33393
10-09-2019,2,12172,12608,4084,1557,30421,760,489,448,1697,32118
10-09-2019,3,12005,12318,4158,1803,30284,769,487,437,1693,31977
10-09-2019,4,11928,12733,4423,1641,30726,767,501,456,1724,32450
10-09-2019,5,13158,13918,5102,2057,34234,783,737,469,1989,36223
10-09-2019,6,14897,16319,5812,2047,39077,865,1011,460,2336,41413
10-09-2019,7,16010,17424,6020,2349,41804,916,1013,806,2735,44539
10-09-2019,8,16388,17721,6048,2621,42780,889,1067,792,2748,45528
10-09-2019,9,16338,17834,6069,2906,43148,878,1116,821,2815,45963
10-09-2019,10,16300,17310,6050,2858,42519,888,996,853,2737,45256
10-09-2019,11,15712,16891,5988,3181,41773,894,1105,831,2830,44603
10-09-2019,12,15020,16433,5900,3345,40699,902,1184,872,2958,43657
10-09-2019,13,14787,16433,5915,3349,40484,913,1025,828,2766,43250
10-09-2019,14,14808,16404,5637,3345,40193,882,1029,710,2621,42814
10-09-2019,15,14683,16493,5482,3455,40113,857,1023,708,2588,42701
10-09-2019,16,15154,16720,5663,3537,41073,845,1020,723,2588,43661
10-09-2019,17,15602,17548,5580,3411,42140,877,1021,660,2558,44698
10-09-2019,18,15412,17361,5538,3502,41813,866,1023,613,2502,44315
10-09-2019,19,15720,17642,5898,3458,42717,875,1025,668,2568,45285
10-09-2019,20,15771,17496,5601,3533,42402,849,1006,490,2345,44747
10-09-2019,21,15279,16978,5190,3520,40968,734,1014,487,2235,43203
10-09-2019,22,14381,16057,4840,3223,38501,738,629,498,1865,40366
10-09-2019,23,13018,13805,4647,2966,34437,729,513,488,1730,36167
11-09-2019,0,13397,12545,4611,2764,33316,746,492,488,1726,35042
11-09-2019,1,12471,11743,4610,2582,31406,737,486,486,1709,33115
11-09-2019,2,11513,11453,4569,2554,30091,724,485,474,1683,31774
11-09-2019,3,11119,11511,4710,2417,29757,728,488,466,1682,31439
11-09-2019,4,11132,11823,4832,2545,30332,746,489,463,1698,32030
11-09-2019,5,12814,13198,5306,2482,33798,750,532,479,1761,35559
11-09-2019,6,15010,15618,5759,2356,38744,782,1061,476,2319,41063
11-09-2019,7,16268,17054,5745,3020,42088,826,1097,661,2584,44672
11-09-2019,8,16507,17695,5828,3257,43287,932,1086,653,2671,45958
11-09-2019,9,16131,17625,5980,3894,43630,814,1122,651,2587,46217
11-09-2019,10,16382,17598,6000,4338,44319,816,1094,687,2597,46916
11-09-2019,11,15395,16640,6079,4828,42943,827,1075,710,2612,45555
11-09-2019,12,14648,16060,6189,4745,41642,850,1108,917,2875,44517
11-09-2019,13,14098,16253,6270,5129,41751,821,1104,904,2829,44580
11-09-2019,14,13889,16251,5980,5136,41256,801,1077,675,2553,43809
11-09-2019,15,14203,16394,5985,5087,41670,838,1083,613,2534,44204
11-09-2019,16,14280,16396,6330,4611,41618,848,1104,551,2503,44121
11-09-2019,17,15159,16653,6488,4465,42766,837,1104,487,2428,45194
11-09-2019,18,15486,17693,6388,3768,43335,860,1114,423,2397,45732
11-09-2019,19,15717,18049,6077,3430,43271,851,1295,442,2588,45859
11-09-2019,20,15427,17860,5751,3401,42440,816,1114,257,2187,44627
11-09-2019,21,14991,17208,5154,3283,40635,764,998,277,2039,42674
11-09-2019,22,14583,16068,4793,3218,38663,779,748,304,1831,40494
11-09-2019,23,13341,15060,4599,2792,35793,781,707,325,1813,37606
12-09-2019,0,12345,14647,4688,2886,34566,772,472,331,1575,36141
12-09-2019,1,12059,13795,4621,2794,33269,738,473,336,1547,34816
12-09-2019,2,12054,13551,4589,2750,32944,744,482,345,1571,34515
12-09-2019,3,11936,13233,4638,2703,32510,743,487,356,1586,34096
12-09-2019,4,12650,13326,4907,2541,33425,750,492,375,1617,35042
12-09-2019,5,13814,14744,5182,2463,36202,757,515,400,1672,37874
12-09-2019,6,15337,16988,5961,2734,41021,778,1158,415,2351,43372
12-09-2019,7,16475,18298,6373,2781,43925,809,1221,607,2637,46562
12-09-2019,8,17138,18925,6551,3122,45737,812,1324,755,2891,48628
12-09-2019,9,16855,18511,6786,3236,45389,839,1317,732,2888,48277
12-09-2019,10,16722,18526,6775,3662,45685,868,1315,796,2979,48664
12-09-2019,11,16275,18149,6649,3930,45003,865,1315,775,2955,47958
12-09-2019,12,16188,17804,6684,3669,44346,862,1332,760,2954,47300
12-09-2019,13,16155,17551,6635,3868,44210,869,1341,751,2961,47171
12-09-2019,14,15238,16735,6392,3802,42166,842,983,601,2426,44592
12-09-2019,15,15488,16774,6419,3722,42404,821,1044,502,2367,44771
12-09-2019,16,15833,17415,6500,3821,43569,834,1030,740,2604,46173
12-09-2019,17,16104,17851,6403,3570,43928,801,1047,698,2546,46474
12-09-2019,18,16101,17600,6264,3299,43263,773,1244,701,2718,45981
12-09-2019,19,16403,18062,6411,3216,44091,786,1345,666,2797,46888
12-09-2019,20,16119,18018,6229,3346,43712,766,1172,403,2341,46053
12-09-2019,21,15754,17211,5678,2783,41426,735,903,351,1989,43415
12-09-2019,22,15236,16130,5219,2286,38872,721,664,353,1738,40610
12-09-2019,23,14516,15077,4944,2014,36551,716,498,378,1592,38143
13-09-2019,0,14240,13957,4822,2078,35097,597,438,391,1426,36523
13-09-2019,1,12923,13398,4710,1749,32779,546,406,401,1353,34132
13-09-2019,2,12324,13486,4650,1637,32097,531,405,392,1328,33425
13-09-2019,3,11929,13286,4491,1891,31598,538,408,383,1329,32927
13-09-2019,4,11884,13425,4678,2582,32568,537,414,368,1319,33887
13-09-2019,5,13430,14382,5394,3200,36408,563,1116,368,2047,38455
13-09-2019,6,15419,16144,5959,3240,40766,579,1178,371,2128,42894
13-09-2019,7,16802,17209,6193,3258,43463,568,1437,579,2584,46047
13-09-2019,8,17484,17864,6485,3595,45428,571,1514,770,2855,48283
13-09-2019,9,17305,17929,6547,3714,45496,572,1526,782,2880,48376
13-09-2019,10,16749,17743,6551,3933,44976,573,1408,813,2794,47770
13-09-2019,11,16013,17299,6602,3976,43892,558,1245,837,2640,46532
13-09-2019,12,15810,17027,6543,3858,43238,571,1201,768,2540,45778
13-09-2019,13,15643,17117,6360,3863,42983,571,1196,618,2385,45368
13-09-2019,14,15345,16795,6270,3776,42186,564,1222,649,2435,44621
13-09-2019,15,15493,16662,6133,3752,42040,542,1185,698,2425,44465
13-09-2019,16,15447,16685,6136,3599,41867,535,1158,892,2585,44452
13-09-2019,17,15932,16711,6238,3575,42457,567,1128,667,2362,44819
13-09-2019,18,16406,17283,6060,3373,43123,526,1097,618,2241,45364
13-09-2019,19,16503,17956,6184,2805,43448,551,1197,594,2342,45790
13-09-2019,20,16333,17380,5979,2618,42310,586,1116,425,2127,44437
13-09-2019,21,16171,16644,5580,3068,41461,522,952,405,1879,43340
13-09-2019,22,15441,15771,5259,2894,39367,467,412,373,1252,40619
13-09-2019,23,14685,14854,5169,2815,37522,465,372,324,1161,38683
14-09-2019,0,14491,14117,5348,2734,36691,452,276,329,1057,37748
14-09-2019,1,13774,13825,5325,2549,35473,446,275,322,1043,36516
14-09-2019,2,13586,13794,5210,2429,35019,422,275,305,1002,36021
14-09-2019,3,13827,13848,5157,2349,35179,374,271,312,957,36136
14-09-2019,4,14065,13790,5195,2349,35399,372,268,338,978,36377
14-09-2019,5,14780,13733,5183,2197,35895,417,266,360,1043,36938
14-09-2019,6,15151,14034,5213,2062,36460,437,269,379,1085,37545
14-09-2019,7,15945,14694,5067,1890,37596,453,270,531,1254,38850
14-09-2019,8,16518,15808,5249,2065,39641,460,380,554,1394,41035
14-09-2019,9,16986,16149,5488,2371,40994,529,372,715,1616,42610
14-09-2019,10,16784,16139,5505,2768,41197,556,383,861,1800,42997
14-09-2019,11,16299,15291,5376,3262,40229,613,289,858,1760,41989
14-09-2019,12,15888,14561,5333,3477,39260,624,279,840,1743,41003
14-09-2019,13,15217,14129,5364,3467,38175,627,280,694,1601,39776
14-09-2019,14,14542,14015,5352,3562,37472,619,286,690,1595,39067
14-09-2019,15,14524,13997,5373,3616,37510,617,299,690,1606,39116
14-09-2019,16,16154,14621,5552,3524,39852,611,291,650,1552,41404
14-09-2019,17,16403,15821,5747,3796,41766,595,295,586,1476,43242
14-09-2019,18,16673,16003,5544,3792,42010,558,424,310,1292,43302
14-09-2019,19,16657,15955,5604,3749,41965,547,729,335,1611,43576
14-09-2019,20,15897,15824,5697,3899,41317,537,832,263,1632,42949
14-09-2019,21,15093,15266,5442,3992,39794,476,375,300,1151,40945
14-09-2019,22,14693,14923,5168,3859,38643,375,261,304,940,39583
14-09-2019,23,13511,14180,4894,4258,36843,357,258,320,935,37778
15-09-2019,0,13187,14101,4901,4091,36280,360,297,334,991,37271
15-09-2019,1,11800,14215,5042,4490,35548,353,266,356,975,36523
15-09-2019,2,10931,14430,5156,4579,35095,365,274,356,995,36090
15-09-2019,3,10709,14193,5134,4353,34390,382,274,393,1049,35439
15-09-2019,4,10249,14045,5203,4094,33591,422,280,426,1128,34719
15-09-2019,5,10523,14146,5256,4073,33999,445,297,442,1184,35183
15-09-2019,6,10899,14160,5371,4064,34493,465,299,489,1253,35746
15-09-2019,7,11478,14075,5294,3948,34796,483,299,514,1296,36092
15-09-2019,8,12936,14456,5329,4077,36798,497,296,519,1312,38110
15-09-2019,9,13500,14542,5354,4668,38065,497,294,590,1381,39446
15-09-2019,10,13235,14744,5457,5119,38557,500,294,606,1400,39957
15-09-2019,11,12626,14808,5535,5662,38633,531,293,563,1387,40020
15-09-2019,12,12598,14912,5558,5664,38733,514,304,561,1379,40112
15-09-2019,13,12536,14828,5477,5624,38464,520,305,555,1380,39844
15-09-2019,14,12302,14423,5487,5518,37730,517,305,570,1392,39122
15-09-2019,15,12172,14417,5565,5397,37553,514,321,562,1397,38950
15-09-2019,16,12830,14509,5719,5231,38290,510,400,558,1468,39758
15-09-2019,17,14811,15723,5808,4932,41274,507,400,549,1456,42730
15-09-2019,18,15571,16250,6014,4565,42401,502,384,543,1429,43830
15-09-2019,19,16100,16609,6221,4446,43377,488,384,544,1416,44793
15-09-2019,20,15587,16780,6174,4367,42908,486,383,541,1410,44318
15-09-2019,21,14924,15735,5964,4483,41108,505,382,540,1427,42535
15-09-2019,22,13371,15116,5647,4645,38779,494,325,541,1360,40139
15-09-2019,23,12690,14589,5386,4446,37111,492,307,535,1334,38445
16-09-2019,0,11823,14234,5346,4361,35765,489,287,534,1310,37075
16-09-2019,1,11084,14033,5292,4090,34499,466,284,532,1282,35781
16-09-2019,2,10979,13970,5306,3934,34188,511,283,531,1325,35513
16-09-2019,3,11332,13970,5329,3836,34468,522,284,527,1333,35801
16-09-2019,4,12019,14051,5509,3827,35405,517,285,526,1328,36733
16-09-2019,5,13806,14896,5793,3874,38368,532,290,527,1349,39717
16-09-2019,6,16307,17355,6241,3845,43748,598,306,525,1429,45177
16-09-2019,7,17284,19220,6523,4073,47101,609,564,716,1889,48990
16-09-2019,8,17475,19565,6479,4247,47769,594,906,869,2369,50138
16-09-2019,9,17308,19497,6292,4439,47537,641,1004,870,2515,50052
16-09-2019,10,17124,18896,6451,4730,47202,677,1098,890,2665,49867
16-09-2019,11,17247,18763,6368,4844,47222,692,1095,897,2684,49906
16-09-2019,12,16861,18560,6336,5102,46861,707,1106,905,2718,49579
16-09-2019,13,16756,18465,6292,4975,46488,675,1035,907,2617,49105
16-09-2019,14,16689,18364,5972,5042,46067,659,557,742,1958,48025
16-09-2019,15,16633,18127,6056,5100,45917,614,551,741,1906,47823
16-09-2019,16,16752,18100,6206,4629,45687,676,871,738,2285,47972
16-09-2019,17,17279,18962,6109,4428,46778,611,907,717,2235,49013
16-09-2019,18,17218,19108,6261,4303,46890,611,911,849,2371,49261
16-09-2019,19,17479,19155,6527,3908,47070,587,1133,813,2533,49603
16-09-2019,20,16835,18901,6151,4214,46101,568,696,820,2084,48185
16-09-2019,21,16628,18000,5699,3958,44285,535,452,541,1528,45813
16-09-2019,22,16291,17096,5368,3473,42229,508,416,381,1305,43534
16-09-2019,23,15555,15839,5161,3311,39865,502,402,358,1262,41127
17-09-2019,0,15139,14546,5010,3331,38027,508,280,349,1137,39164
17-09-2019,1,14802,13699,4909,3469,36880,478,272,372,1122,38002
17-09-2019,2,14411,13340,4861,3779,36392,464,270,405,1139,37531
17-09-2019,3,14337,13305,4906,3705,36255,441,273,374,1088,37343
17-09-2019,4,14602,13688,5185,3785,37259,447,268,333,1048,38307
17-09-2019,5,15177,15115,5745,3870,39909,456,267,356,1079,40988
17-09-2019,6,16447,17728,6334,4022,44533,525,521,330,1376,45909
17-09-2019,7,17729,18844,6586,4396,47554,540,667,694,1901,49455
17-09-2019,8,17913,19060,6633,4633,48240,546,1164,718,2428,50668
17-09-2019,9,17589,19176,6587,4707,48060,520,1173,688,2381,50441
17-09-2019,10,17449,18143,6469,4929,46990,560,1144,739,2443,49433
17-09-2019,11,16843,18092,6534,5215,46685,580,1065,726,2371,49056
17-09-2019,12,15306,17797,6450,5279,44832,565,960,528,2053,46885
17-09-2019,13,15054,17452,6488,5614,44608,535,921,339,1795,46403
17-09-2019,14,14350,17309,6285,5986,43930,503,898,348,1749,45679
17-09-2019,15,14553,17398,6197,5712,43862,497,882,547,1926,45788
17-09-2019,16,15045,17668,6338,5200,44251,489,892,667,2048,46299
17-09-2019,17,15620,17933,6368,4661,44581,475,886,714,2075,46656
17-09-2019,18,16019,18147,6368,4090,44627,496,885,674,2055,46682
17-09-2019,19,16942,18832,6368,3716,45857,517,930,658,2105,47962
17-09-2019,20,17100,18590,6368,3507,45567,481,628,260,1369,46936
17-09-2019,21,16517,17280,6368,3363,43530,470,377,270,1117,44647
17-09-2019,22,16216,15250,6368,2897,40732,468,368,243,1079,41811
17-09-2019,23,14986,14086,6368,2894,38334,469,373,220,1062,39396
18-09-2019,0,14057,13610,6368,3042,37076,474,369,211,1054,38130
18-09-2019,1,13784,13022,6368,2795,35968,459,372,234,1065,37033
18-09-2019,2,13659,12859,6368,3270,36157,467,381,205,1053,37210
18-09-2019,3,13774,12918,6368,3469,36529,493,384,201,1078,37607
18-09-2019,4,14191,13271,6368,3633,37465,512,378,231,1121,38586
18-09-2019,5,15142,14498,6368,3784,39792,552,389,283,1224,41016
18-09-2019,6,16469,17104,6368,3837,43777,573,873,323,1769,45546
18-09-2019,7,17381,19178,6368,3798,46725,582,934,496,2012,48737
18-09-2019,8,17560,19109,6368,4289,47325,573,998,658,2229,49554
18-09-2019,9,17274,18797,6368,4494,46933,568,1152,658,2378,49311
18-09-2019,10,16883,17742,6368,4781,45775,571,1175,648,2394,48169
18-09-2019,11,16832,17223,6452,4620,45129,579,1178,666,2423,47552
18-09-2019,12,15896,17137,6451,4436,43919,578,1236,710,2524,46443
18-09-2019,13,15938,17183,6451,4439,44011,563,1248,711,2522,46533
18-09-2019,14,15598,16954,6451,4331,43335,536,665,493,1694,45029
18-09-2019,15,15893,16693,6451,4054,43091,525,665,515,1705,44796
18-09-2019,16,16451,16534,6451,3824,43259,539,905,525,1969,45228
18-09-2019,17,16990,17688,6392,3703,44773,546,982,512,2040,46813
18-09-2019,18,17369,18639,6436,3371,45815,564,1063,490,2117,47932
18-09-2019,19,17565,19091,6958,3372,46985,566,1168,481,2215,49200
18-09-2019,20,17431,19047,6627,3241,46345,528,628,288,1444,47789
18-09-2019,21,16992,18373,6029,3039,44432,494,378,278,1150,45582
18-09-2019,22,16329,17336,5693,2693,42051,478,372,254,1104,43155
18-09-2019,23,15696,15880,5420,2530,39525,462,372,242,1076,40601
19-09-2019,0,15153,14737,5136,2551,37578,448,375,269,1092,38670
19-09-2019,1,15198,14354,4990,2342,36886,437,371,250,1058,37944
19-09-2019,2,14913,14140,4878,2196,36129,432,371,253,1056,37185
19-09-2019,3,14857,14167,5003,2122,36149,431,371,237,1039,37188
19-09-2019,4,14785,14153,5663,1976,36579,458,389,226,1073,37652
19-09-2019,5,15371,15909,6354,1806,39439,479,963,229,1671,41110
19-09-2019,6,16557,18150,6975,1753,43436,484,1018,449,1951,45387
19-09-2019,7,17782,19522,7210,2165,46680,511,1027,673,2211,48891
19-09-2019,8,18174,19794,7212,2175,47356,504,1090,644,2238,49594
19-09-2019,9,18302,19528,7070,2075,46974,515,1137,646,2298,49272
19-09-2019,10,17961,19198,6973,1979,46111,527,1150,685,2362,48473
19-09-2019,11,17743,18896,6666,1988,45292,500,1189,655,2344,47636
19-09-2019,12,17553,18285,6833,1992,44663,512,1180,464,2156,46819
19-09-2019,13,17543,18601,6956,2017,45117,532,1209,262,2003,47120
19-09-2019,14,17231,18478,6666,2133,44509,488,923,313,1724,46233
19-09-2019,15,17163,18220,6430,2033,43846,487,883,483,1853,45699
19-09-2019,16,17571,18668,6484,1976,44699,477,1006,508,1991,46690
19-09-2019,17,17726,19077,6414,2034,45252,495,1104,493,2092,47344
19-09-2019,18,17683,19061,6857,2050,45651,524,1117,479,2120,47771
19-09-2019,19,17775,19124,7220,1893,46012,582,1393,514,2489,48501
19-09-2019,20,17729,18860,6759,1923,45270,575,1016,335,1926,47196
19-09-2019,21,17543,18297,6272,2009,44121,533,649,345,1527,45648
19-09-2019,22,16932,17493,5814,1767,42006,533,414,313,1260,43266
19-09-2019,23,16387,16481,5614,1543,40025,539,379,287,1205,41230
20-09-2019,0,15787,15744,5524,1916,38973,555,383,299,1237,40210
20-09-2019,1,15663,15228,5486,1636,38014,512,428,294,1234,39248
20-09-2019,2,15571,14568,5484,1689,37312,518,378,310,1206,38518
20-09-2019,3,15372,14887,5536,1733,37528,506,380,301,1187,38715
20-09-2019,4,15579,15459,5879,1785,38702,503,461,322,1286,39988
20-09-2019,5,15818,16333,6591,1981,40725,497,717,303,1517,42242
20-09-2019,6,17046,17885,7048,2157,44137,543,875,465,1883,46020
20-09-2019,7,17981,18663,7380,2961,46986,533,976,625,2134,49120
20-09-2019,8,18303,18678,7421,3241,47644,536,1208,591,2335,49979
20-09-2019,9,18130,18802,7273,3372,47577,533,1342,577,2452,50029
20-09-2019,10,17815,18726,7218,3419,47178,489,1272,590,2351,49529
20-09-2019,11,17196,18236,7252,3126,45811,540,1129,564,2233,48044
20-09-2019,12,16876,17302,7286,3382,44846,548,981,585,2114,46960
20-09-2019,13,16539,16605,7003,3296,43443,555,985,415,1955,45398
20-09-2019,14,17001,15787,6569,3301,42658,508,901,237,1646,44304
20-09-2019,15,17047,15728,6522,3189,42486,492,900,347,1739,44225
20-09-2019,16,17661,16697,6798,3440,44597,510,897,404,1811,46408
20-09-2019,17,17163,16919,6902,3388,44372,549,913,400,1862,46234
20-09-2019,18,17217,17000,7030,3628,44875,556,966,580,2102,46977
20-09-2019,19,17217,17222,7076,3452,44966,568,1012,602,2182,47148
20-09-2019,20,16963,16835,6252,3263,43314,521,933,233,1687,45001
20-09-2019,21,16979,15978,5712,3143,41812,512,640,284,1436,43248
20-09-2019,22,16677,15662,5540,2925,40805,477,385,321,1183,41988
20-09-2019,23,16167,14709,5160,2750,38785,468,373,307,1148,39933
21-09-2019,0,15032,13411,4998,2722,36165,341,239,304,884,37049
21-09-2019,1,13689,12446,4884,2394,33412,332,237,313,882,34294
21-09-2019,2,13326,12436,4800,2124,32688,347,239,293,879,33567
21-09-2019,3,13257,12483,4810,1935,32487,355,239,262,856,33343
21-09-2019,4,13546,12872,4874,1929,33222,362,236,262,860,34082
21-09-2019,5,13655,13150,4965,1935,33706,381,254,264,899,34605
21-09-2019,6,14258,14094,5116,1641,35109,401,234,291,926,36035
21-09-2019,7,15018,14944,5143,1434,36538,406,255,342,1003,37541
21-09-2019,8,15913,15658,5509,1462,38540,370,326,426,1122,39662
21-09-2019,9,16411,15539,5624,1367,38941,361,460,436,1257,40198
21-09-2019,10,15648,14078,5805,1383,36915,368,337,459,1164,38079
21-09-2019,11,15041,13816,5791,1494,36140,392,274,485,1151,37291
21-09-2019,12,14327,13514,5739,1604,35183,409,268,507,1184,36367
21-09-2019,13,13880,13591,5609,1579,34658,396,266,477,1139,35797
21-09-2019,14,13476,13242,5664,1447,33830,416,266,447,1129,34959
21-09-2019,15,13998,13313,5642,1339,34293,445,266,420,1131,35424
21-09-2019,16,14829,13437,5748,1153,35166,469,274,403,1146,36312
21-09-2019,17,15812,15466,5876,919,38074,473,373,384,1230,39304
21-09-2019,18,16036,16154,6080,808,39079,477,485,398,1360,40439
21-09-2019,19,16055,16393,6418,969,39836,486,488,367,1341,41177
21-09-2019,20,15706,16310,6109,927,39055,484,381,291,1156,40211
21-09-2019,21,15512,15445,5689,731,37378,458,272,286,1016,38394
21-09-2019,22,15017,14052,5500,566,35134,462,262,287,1011,36145
21-09-2019,23,14165,13095,5435,651,33346,436,268,283,987,34333
22-09-2019,0,12565,11994,5481,687,30727,410,268,278,956,31683
22-09-2019,1,11502,11468,5593,646,29208,390,269,290,949,30157
22-09-2019,2,11697,11526,5734,714,29671,393,267,275,935,30606
22-09-2019,3,11655,11554,5753,773,29734,407,262,270,939,30673
22-09-2019,4,12170,11921,5741,866,30697,388,259,269,916,31613
22-09-2019,5,11790,11905,5738,914,30348,413,257,257,927,31275
22-09-2019,6,11661,12070,5722,792,30245,410,246,247,903,31148
22-09-2019,7,12190,12288,5799,869,31148,410,225,256,891,32039
22-09-2019,8,12798,13082,5746,949,32578,412,224,269,905,33483
22-09-2019,9,13620,13785,5675,1261,34341,403,228,269,900,35241
22-09-2019,10,13293,13946,5713,1467,34419,402,255,266,923,35342
22-09-2019,11,13305,13769,5798,1673,34545,395,256,255,906,35451
22-09-2019,12,13213,13557,5742,1873,34386,395,259,248,902,35288
22-09-2019,13,12836,13455,5698,1879,33870,395,265,248,908,34778
22-09-2019,14,12767,13174,5717,1840,33500,382,275,288,945,34445
22-09-2019,15,13258,13357,5628,1819,34063,374,275,291,940,35003
22-09-2019,16,14639,13709,5598,1873,35818,373,270,313,956,36774
22-09-2019,17,16054,15303,5837,1817,39011,372,258,314,944,39955
22-09-2019,18,16715,16709,6307,2069,41800,383,300,426,1109,42909
22-09-2019,19,16850,17450,6463,2583,43346,382,492,347,1221,44567
22-09-2019,20,16212,17112,6239,3143,42706,389,255,299,943,43649
22-09-2019,21,16302,15893,6202,3173,41570,367,267,262,896,42466
22-09-2019,22,15773,14904,6141,3300,40118,351,268,247,866,40984
22-09-2019,23,14453,13617,5858,3449,37378,334,265,269,868,38246
23-09-2019,0,12104,12318,5766,3655,33842,320,264,301,885,34727
23-09-2019,1,11241,11942,5654,4017,32856,306,259,306,871,33727
23-09-2019,2,11370,11838,5728,4269,33205,318,231,328,877,34082
23-09-2019,3,11346,11709,5795,4374,33225,339,255,362,956,34181
23-09-2019,4,11730,11967,5937,4247,33882,380,348,351,1079,34961
23-09-2019,5,14369,13512,6613,4303,38798,459,377,338,1174,39972
23-09-2019,6,16618,16959,7073,4293,44944,548,881,567,1996,46940
23-09-2019,7,17636,18306,7362,3963,47268,562,904,682,2148,49416
23-09-2019,8,17716,18557,7612,4217,48102,568,994,651,2213,50315
23-09-2019,9,17593,19125,7567,4153,48438,570,1086,636,2292,50730
23-09-2019,10,17340,18770,7412,4091,47613,569,1075,644,2288,49901
23-09-2019,11,17394,18632,7410,4046,47481,559,983,664,2206,49687
23-09-2019,12,17421,18752,7527,3725,47425,543,895,657,2095,49520
23-09-2019,13,17224,18530,7475,3476,46704,541,945,652,2138,48842
23-09-2019,14,16954,18009,6765,3353,45081,534,897,246,1677,46758
23-09-2019,15,17091,17982,6655,3054,44783,536,897,231,1664,46447
23-09-2019,16,17345,18271,6982,3177,45775,534,899,568,2001,47776
23-09-2019,17,17200,18367,7167,3250,45985,531,903,555,1989,47974
23-09-2019,18,17127,18394,7174,2989,45684,528,1016,594,2138,47822
23-09-2019,19,17385,18811,7388,2717,46302,522,1091,636,2249,48551
23-09-2019,20,16955,18128,7026,2728,44837,525,903,340,1768,46605
23-09-2019,21,16905,17470,6356,2592,43324,479,818,307,1604,44928
23-09-2019,22,16551,16758,6070,2365,41743,449,461,321,1231,42974
23-09-2019,23,16041,16080,5863,1965,39951,438,378,313,1129,41080
24-09-2019,0,15036,15239,5743,1639,37658,458,378,298,1134,38792
24-09-2019,1,14355,14698,5686,1478,36218,475,383,274,1132,37350
24-09-2019,2,14205,14187,5700,1194,35285,471,386,266,1123,36408
24-09-2019,3,14191,14780,5702,1132,35807,486,387,269,1142,36949
24-09-2019,4,14173,15337,5939,1121,36570,504,533,254,1291,37861
24-09-2019,5,15143,16077,6530,1037,38787,515,891,233,1639,40426
24-09-2019,6,16224,17761,7052,1287,42323,639,1113,422,2174,44497
24-09-2019,7,17445,18666,7173,1529,44813,712,1302,491,2505,47318
24-09-2019,8,17724,18824,7320,1610,45479,807,1346,540,2693,48172
24-09-2019,9,17653,18724,7247,1643,45267,744,1344,480,2568,47835
24-09-2019,10,17664,18504,7261,1632,45062,705,1322,480,2507,47569
24-09-2019,11,17499,18472,7186,1592,44750,705,1256,497,2458,47208
24-09-2019,12,16966,18510,7201,1567,44245,706,1255,504,2465,46710
24-09-2019,13,16972,18111,7257,1512,43852,683,1248,437,2368,46220
24-09-2019,14,17213,18122,6572,1445,43352,617,1170,230,2017,45369
24-09-2019,15,17387,18233,6649,1597,43866,609,1228,218,2055,45921
24-09-2019,16,17480,18084,7144,1566,44275,608,1202,615,2425,46700
24-09-2019,17,17298,18101,7242,1773,44415,592,1163,403,2158,46573
24-09-2019,18,17107,18287,7239,1546,44180,605,1259,504,2368,46548
24-09-2019,19,17265,18811,7393,1766,45234,607,1408,599,2614,47848
24-09-2019,20,16831,18192,6477,1803,43305,585,1105,418,2108,45413
24-09-2019,21,16509,17247,5860,1765,41381,534,895,411,1840,43221
24-09-2019,22,16441,16544,5725,1715,40426,495,527,397,1419,41845
24-09-2019,23,15217,15244,5375,1530,37366,502,395,392,1289,38655
25-09-2019,0,14538,13885,5071,1547,35041,505,398,402,1305,36346
25-09-2019,1,14366,12837,5044,1565,33812,485,396,358,1239,35051
25-09-2019,2,13516,12815,5016,1538,32883,492,395,328,1215,34098
25-09-2019,3,13367,13063,5032,1520,32981,522,395,326,1243,34224
25-09-2019,4,13422,13545,5268,1564,33798,552,414,365,1331,35129
25-09-2019,5,14353,15762,6001,1755,37872,551,902,328,1781,39653
25-09-2019,6,16003,17654,7029,1957,42642,660,1052,503,2215,44857
25-09-2019,7,17491,18447,7360,2245,45544,686,1168,493,2347,47891
25-09-2019,8,17771,18352,7423,2290,45836,679,1371,459,2509,48345
25-09-2019,9,17785,18102,7378,2390,45654,660,1474,449,2583,48237
25-09-2019,10,17864,18524,7340,2445,46175,666,1316,448,2430,48605
25-09-2019,11,17607,18586,7237,2528,45958,754,1351,456,2561,48519
25-09-2019,12,17214,18361,7129,2572,45277,730,1221,466,2417,47694
25-09-2019,13,17028,18244,7109,2158,44537,717,1307,457,2481,47018
25-09-2019,14,17389,18305,6619,2306,44618,755,1133,275,2163,46781
25-09-2019,15,17425,18362,6828,2183,44798,783,1176,310,2269,47067
25-09-2019,16,17039,17399,7052,1933,43423,676,1176,478,2330,45753
25-09-2019,17,16865,17261,7123,1953,43201,697,1175,494,2366,45567
25-09-2019,18,17024,17344,7335,2123,43825,696,1171,537,2404,46229
25-09-2019,19,17293,17588,7400,2218,44498,698,1375,570,2643,47141
25-09-2019,20,16826,17517,6795,2128,43266,781,1070,354,2205,45471
25-09-2019,21,16606,17148,6007,1955,41716,685,846,357,1888,43604
25-09-2019,22,16092,16260,5768,2001,40122,670,688,375,1733,41855
25-09-2019,23,15536,15265,5687,2064,38553,638,468,360,1466,40019
26-09-2019,0,14718,14092,5599,1882,36291,628,421,365,1414,37705
26-09-2019,1,14024,13175,5371,1799,34370,641,423,324,1388,35758
26-09-2019,2,13391,12895,5250,1719,33257,644,420,305,1369,34626
26-09-2019,3,12876,12829,5398,1741,32843,646,421,337,1404,34247
26-09-2019,4,13331,13150,5638,1787,33906,643,448,338,1429,35335
26-09-2019,5,14416,14560,6282,1877,37136,696,908,339,1943,39079
26-09-2019,6,16635,16921,7321,2200,43078,766,1137,523,2426,45504
26-09-2019,7,17458,18057,7725,2311,45550,765,1304,511,2580,48130
26-09-2019,8,17802,18095,7823,2752,46474,755,1359,434,2548,49022
26-09-2019,9,17867,18197,7598,2648,46311,742,1294,410,2446,48757
26-09-2019,10,17741,18109,7590,2968,46410,753,1289,415,2457,48867
26-09-2019,11,17370,17689,7491,2787,45336,767,1291,386,2444,47780
26-09-2019,12,17171,17444,7275,2557,44449,749,1220,421,2390,46839
26-09-2019,13,17198,17295,7167,2643,44302,772,1282,369,2423,46725
26-09-2019,14,16882,16807,6759,2737,43186,773,1140,396,2309,45495
26-09-2019,15,16954,16584,6775,2799,43112,747,1144,393,2284,45396
26-09-2019,16,17126,16632,6995,2883,43637,765,1146,369,2280,45917
26-09-2019,17,17259,17359,7049,3405,45073,764,1148,174,2086,47159
26-09-2019,18,17190,17452,7466,3548,45657,762,1397,189,2348,48005
26-09-2019,19,17207,17555,7557,3633,45952,780,1552,251,2583,48535
26-09-2019,20,16691,16891,6649,3723,43954,752,1073,431,2256,46210
26-09-2019,21,15613,16030,6216,3934,41795,680,951,295,1926,43721
26-09-2019,22,14057,14646,5903,4482,39088,571,941,322,1834,40922
26-09-2019,23,12738,13570,5340,3892,35540,574,858,319,1751,37291
27-09-2019,0,11935,12946,5349,3571,33802,559,681,281,1521,35323
27-09-2019,1,11262,12582,5156,3402,32402,575,532,249,1356,33758
27-09-2019,2,11371,12611,5124,2991,32098,573,454,219,1246,33344
27-09-2019,3,11858,12657,5288,2662,32467,569,467,197,1233,33700
27-09-2019,4,12481,12864,5703,2384,33432,600,694,184,1478,34910
27-09-2019,5,13764,14098,6442,2178,36480,664,928,200,1792,38272
27-09-2019,6,16063,17009,7030,2181,42282,757,1050,377,2184,44466
27-09-2019,7,17475,18340,7483,2270,45567,777,1051,397,2225,47792
27-09-2019,8,17784,18664,7525,2325,46299,781,1099,380,2260,48559
27-09-2019,9,17522,18559,7429,2416,45926,775,1101,376,2252,48178
27-09-2019,10,17504,18444,7367,2378,45692,775,1101,396,2272,47964
27-09-2019,11,17418,18189,7356,2303,45266,775,1100,388,2263,47529
27-09-2019,12,16999,17842,7246,2074,44161,776,1099,395,2270,46431
27-09-2019,13,16174,17253,7100,1974,42502,765,1091,410,2266,44768
27-09-2019,14,15519,16791,6624,2069,41003,735,943,290,1968,42971
27-09-2019,15,15792,16406,6569,2156,40923,725,941,396,2062,42985
27-09-2019,16,16352,16705,6845,1957,41858,754,1065,413,2232,44090
27-09-2019,17,17007,17073,6829,1938,42846,765,1080,408,2253,45099
27-09-2019,18,16955,17320,7041,2087,43403,771,1087,450,2308,45711
27-09-2019,19,17084,17680,7123,1910,43795,737,1058,500,2295,46090
27-09-2019,20,16906,17125,6505,1945,42482,528,954,440,1922,44404
27-09-2019,21,16514,16351,6054,1725,40644,501,948,402,1851,42495
27-09-2019,22,15365,14986,5591,1835,37778,488,938,397,1823,39601
27-09-2019,23,13025,13929,5252,2055,34262,470,486,396,1352,35614
28-09-2019,0,12238,12844,5065,2199,32346,491,473,385,1349,33695
28-09-2019,1,11273,12176,5030,2232,30713,485,461,374,1320,32033
28-09-2019,2,10112,11985,5036,2669,29803,483,458,360,1301,31104
28-09-2019,3,9972,12258,5070,2955,30256,484,458,373,1315,31571
28-09-2019,4,9918,11957,5137,2991,30004,483,458,396,1337,31341
28-09-2019,5,10215,12096,5286,3076,30672,481,468,395,1344,32016
28-09-2019,6,10205,12305,5703,3164,31377,490,596,401,1487,32864
28-09-2019,7,11137,12737,5991,3252,33116,492,813,404,1709,34825
28-09-2019,8,13326,13482,6316,3168,36292,473,830,532,1835,38127
28-09-2019,9,14855,14064,6475,3150,38544,484,848,475,1807,40351
28-09-2019,10,14452,14449,6500,3416,38817,523,809,471,1803,40620
28-09-2019,11,13588,14209,6469,3386,37652,543,807,491,1841,39493
28-09-2019,12,13133,14185,6309,3079,36707,512,834,562,1908,38615
28-09-2019,13,12782,14115,6269,3119,36285,512,855,418,1785,38070
28-09-2019,14,12604,14071,6280,3235,36191,497,852,406,1755,37946
28-09-2019,15,12435,14012,6365,3071,35884,516,842,373,1731,37615
28-09-2019,16,12665,14002,6432,2981,36082,513,784,497,1794,37876
28-09-2019,17,13550,14214,6683,3132,37578,548,853,451,1852,39430
28-09-2019,18,15111,15149,7058,3551,40872,599,848,426,1873,42745
28-09-2019,19,15707,15698,6999,3555,41959,609,850,422,1881,43840
28-09-2019,20,13612,15076,6456,3656,38802,562,809,372,1743,40545
28-09-2019,21,11325,14460,6181,3751,35718,530,790,311,1631,37349
28-09-2019,22,10546,13952,5966,4003,34467,549,733,294,1576,36043
28-09-2019,23,10607,13362,5522,3770,33262,527,560,307,1394,34656
29-09-2019,0,10047,12764,5354,3502,31669,506,569,287,1362,33031
29-09-2019,1,9928,12568,5295,3386,31178,490,570,280,1340,32518
29-09-2019,2,9515,12528,5254,3269,30568,489,563,267,1319,31887
29-09-2019,3,8912,12208,5169,3390,29679,480,562,274,1316,30995
29-09-2019,4,9020,12208,5183,3387,29798,491,560,253,1304,31102
29-09-2019,5,9483,12323,5193,3238,30238,487,579,260,1326,31564
29-09-2019,6,9426,12559,5272,2961,30219,498,556,253,1307,31526
29-09-2019,7,9707,12620,5335,2723,30386,502,586,269,1357,31743
29-09-2019,8,10633,13011,5582,2539,31766,491,586,335,1412,33178
29-09-2019,9,11761,13374,5766,2357,33260,516,743,360,1619,34879
29-09-2019,10,12606,13515,5963,2251,34335,521,845,320,1686,36021
29-09-2019,11,12552,13832,5991,2194,34569,555,860,358,1773,36342
29-09-2019,12,12673,14618,5935,2142,35369,535,826,422,1783,37152
29-09-2019,13,12442,14936,5903,1873,35155,502,831,440,1773,36928
29-09-2019,14,12648,14926,5824,1787,35186,501,831,444,1776,36962
29-09-2019,15,12567,14904,5887,1661,35020,496,774,389,1659,36679
29-09-2019,16,12767,15147,6036,1781,35733,525,892,327,1744,37477
29-09-2019,17,13368,15302,6123,1857,36651,550,961,369,1880,38531
29-09-2019,18,14902,15605,6459,1724,38690,563,958,412,1933,40623
29-09-2019,19,15852,15886,6619,1484,39839,573,963,395,1931,41770
29-09-2019,20,15260,15905,6192,1486,38844,563,882,329,1774,40618
29-09-2019,21,14161,15710,5876,1759,37507,526,577,386,1489,38996
29-09-2019,22,12832,15237,5530,1724,35323,546,559,381,1486,36809
29-09-2019,23,10991,13983,5442,1792,32208,551,582,287,1420,33628
30-09-2019,0,9800,13076,5457,1963,30295,549,509,278,1336,31631
30-09-2019,1,9046,12529,5412,2087,29076,548,501,288,1337,30413
30-09-2019,2,8928,12379,5398,2050,28757,541,498,265,1304,30061
30-09-2019,3,8954,12525,5407,2042,28927,530,495,231,1256,30183
30-09-2019,4,9332,12686,5612,2349,29980,519,501,247,1267,31247
30-09-2019,5,10885,13874,5993,2631,33385,588,545,254,1387,34772
30-09-2019,6,14355,15438,6492,3002,39288,701,1011,247,1959,41247
30-09-2019,7,16249,17009,7044,3715,44017,707,1068,444,2219,46236
30-09-2019,8,16939,17043,7478,4393,45854,690,1086,437,2213,48067
30-09-2019,9,16347,17011,7571,4742,45670,688,1060,459,2207,47877
30-09-2019,10,16362,16980,7538,5597,46479,706,1062,449,2217,48696
30-09-2019,11,15980,16806,7551,5359,45695,700,1091,446,2237,47932
30-09-2019,12,15905,16538,7319,5267,45030,694,1087,433,2214,47244
30-09-2019,13,15636,16278,7166,5153,44234,603,1110,416,2129,46363
30-09-2019,14,15307,16359,6674,5122,43461,589,1044,276,1909,45370
30-09-2019,15,15315,16649,6523,5058,43545,591,1066,183,1840,45385
30-09-2019,16,15607,16940,6701,5240,44487,582,1032,313,1927,46414
30-09-2019,17,16626,17979,6852,4650,46107,581,1032,466,2079,48186
30-09-2019,18,17000,18516,7280,4985,47782,621,1052,509,2182,49964
30-09-2019,19,17473,18906,7336,5303,49018,615,1122,619,2356,51374
30-09-2019,20,17320,18658,6370,4928,47277,583,756,465,1804,49081
30-09-2019,21,16675,18035,6025,4415,45150,524,598,483,1605,46755
30-09-2019,22,15664,17425,5712,3939,42739,523,551,544,1618,44357
30-09-2019,23,13850,16634,5542,3601,39628,539,554,586,1679,41307
01-10-2019,0,12519,16281,5723,3339,37862,551,419,616,1586,39448
01-10-2019,1,11707,15888,5712,2908,36215,565,427,612,1604,37819
01-10-2019,2,10734,15848,5770,2598,34951,602,419,606,1627,36578
01-10-2019,3,10607,16131,5944,2284,34967,651,405,596,1652,36619
01-10-2019,4,11025,16443,6262,2021,35752,668,416,587,1671,37423
01-10-2019,5,12916,17587,6645,1891,39040,682,441,541,1664,40704
01-10-2019,6,15275,19633,7379,1842,44130,752,653,587,1992,46122
01-10-2019,7,16642,20474,7886,2113,47115,799,809,615,2223,49338
01-10-2019,8,16736,20933,8142,1956,47767,789,852,584,2225,49992
01-10-2019,9,16766,20827,8042,1922,47557,793,799,598,2190,49747
01-10-2019,10,16551,20673,7851,1824,46899,817,708,683,2208,49107
01-10-2019,11,16353,20211,7830,1931,46325,783,691,749,2223,48548
01-10-2019,12,16085,19882,7759,2066,45793,791,726,667,2184,47977
01-10-2019,13,16121,19609,7552,2314,45595,827,691,645,2163,47758
01-10-2019,14,15413,19014,7778,2968,45173,782,686,600,2068,47241
01-10-2019,15,15328,19081,7719,3307,45437,792,679,449,1920,47357
01-10-2019,16,15191,19043,7717,3577,45528,769,715,543,2027,47555
01-10-2019,17,15490,19336,7856,3437,46120,753,793,519,2065,48185
01-10-2019,18,15987,19738,8103,3491,47318,737,904,504,2145,49463
01-10-2019,19,16118,20213,8157,3538,48025,743,902,493,2138,50163
01-10-2019,20,15781,19657,7448,3815,46702,669,791,284,1744,48446
01-10-2019,21,15223,19199,6871,3501,44794,616,670,297,1583,46377
01-10-2019,22,14252,18711,6634,3436,43033,621,512,300,1433,44466
01-10-2019,23,13146,17753,6470,3281,40651,622,363,290,1275,41926
02-10-2019,0,11769,17171,6481,3404,38827,578,321,254,1153,39980
02-10-2019,1,10885,16737,6518,3160,37301,546,322,247,1115,38416
02-10-2019,2,10091,16550,6528,3268,36440,579,330,279,1188,37628
02-10-2019,3,9956,16335,6620,3356,36267,595,331,297,1223,37490
02-10-2019,4,10412,16313,6775,3319,36821,600,333,301,1234,38055
02-10-2019,5,12016,17749,7280,3233,40279,616,359,300,1275,41554
02-10-2019,6,14077,19704,7820,3387,44990,621,471,459,1551,46541
02-10-2019,7,15919,20597,7911,3347,47774,669,649,459,1777,49551
02-10-2019,8,16820,20711,7970,3155,48656,676,660,430,1766,50422
02-10-2019,9,16883,20672,7883,3380,48819,646,749,415,1810,50629
02-10-2019,10,16918,20580,7795,4004,49297,597,654,406,1657,50954
02-10-2019,11,16484,20536,7827,4001,48849,585,648,383,1616,50465
02-10-2019,12,16168,20353,7840,3758,48120,615,639,389,1643,49763
02-10-2019,13,15436,19634,7725,3152,45949,599,632,380,1611,47560
02-10-2019,14,15414,19531,7594,3007,45547,564,633,380,1577,47124
02-10-2019,15,15238,19317,7551,2874,44980,547,627,390,1564,46544
02-10-2019,16,15759,19417,7755,2973,45904,529,634,379,1542,47446
02-10-2019,17,16442,19859,7796,4084,48180,522,671,395,1588,49768
02-10-2019,18,16459,20114,8228,4392,49193,525,732,372,1629,50822
02-10-2019,19,16571,20157,8148,4408,49283,524,883,374,1781,51064
02-10-2019,20,15597,19641,7406,4198,46841,467,369,316,1152,47993
02-10-2019,21,14984,18554,6843,3951,44332,457,350,173,980,45312
02-10-2019,22,13834,17466,6597,3588,41486,465,318,165,948,42434
02-10-2019,23,12180,16556,6499,3190,38424,456,317,167,940,39364
03-10-2019,0,11130,15769,6592,2870,36361,462,318,161,941,37302
03-10-2019,1,9923,15245,6598,2505,34272,456,317,157,930,35202
03-10-2019,2,9628,15172,6621,2323,33745,462,315,159,936,34681
03-10-2019,3,10190,15170,6584,2071,34016,460,321,168,949,34965
03-10-2019,4,10807,15857,6692,2130,35486,461,322,170,953,36439
03-10-2019,5,12484,16933,7178,2098,38693,467,402,175,1044,39737
03-10-2019,6,14942,18131,7660,2153,42886,550,770,380,1700,44586
03-10-2019,7,16640,19735,8046,2235,46656,547,1043,378,1968,48624
03-10-2019,8,17757,20126,8133,2284,48299,535,1082,373,1990,50289
03-10-2019,9,18205,20046,7975,2124,48351,520,1197,376,2093,50444
03-10-2019,10,18653,20385,7830,1922,48791,531,1187,386,2104,50895
03-10-2019,11,18305,20043,7924,1725,47998,528,1204,397,2129,50127
03-10-2019,12,18199,19912,7922,1580,47613,507,1225,450,2182,49795
03-10-2019,13,17726,19618,7953,1463,46760,516,1136,425,2077,48837
03-10-2019,14,17102,19400,7941,1479,45924,502,1039,471,2012,47936
03-10-2019,15,17422,19623,7976,1693,46716,522,963,476,1961,48677
03-10-2019,16,17681,19671,7923,1682,46956,530,835,464,1829,48785
03-10-2019,17,17854,19926,8115,1599,47495,531,962,475,1968,49463
03-10-2019,18,18112,20226,8300,1507,48147,569,1175,472,2216,50363
03-10-2019,19,18545,20174,8234,1507,48461,580,1209,459,2248,50709
03-10-2019,20,17905,19783,7601,1444,46733,587,755,449,1791,48524
03-10-2019,21,17418,19789,7115,1375,45699,525,389,265,1179,46878
03-10-2019,22,16992,18886,6717,1410,44004,516,386,286,1188,45192
03-10-2019,23,15774,17772,6537,1439,41523,514,387,305,1206,42729
04-10-2019,0,15390,17429,6512,1356,40689,527,383,290,1200,41889
04-10-2019,1,13802,16553,6499,1410,38266,509,341,281,1131,39397
04-10-2019,2,13195,16187,6523,1414,37318,499,316,260,1075,38393
04-10-2019,3,12993,16092,6522,1616,37223,499,319,235,1053,38276
04-10-2019,4,13936,16469,6690,1665,38759,524,340,229,1093,39852
04-10-2019,5,15156,17654,7228,1836,41874,541,416,238,1195,43069
04-10-2019,6,17228,19701,7974,2143,47046,577,793,492,1862,48908
04-10-2019,7,19337,20559,8220,2535,50653,589,756,479,1824,52477
04-10-2019,8,19705,20428,8294,2755,51183,593,1079,506,2178,53361
04-10-2019,9,19558,20257,8185,2969,50969,579,1222,484,2285,53254
04-10-2019,10,19262,20160,8092,3680,51194,574,1232,478,2284,53478
04-10-2019,11,18517,19790,8090,3749,50146,539,1189,499,2227,52373
04-10-2019,12,18540,19679,7924,3784,49928,553,971,496,2020,51948
04-10-2019,13,17987,19347,7848,3640,48823,554,811,473,1838,50661
04-10-2019,14,17857,19424,7783,3402,48466,562,819,476,1857,50323
04-10-2019,15,18035,19354,7678,3299,48368,545,820,452,1817,50185
04-10-2019,16,18042,19381,7674,3278,48376,547,830,475,1852,50228
04-10-2019,17,18418,19550,7655,3467,49089,543,895,453,1891,50980
04-10-2019,18,18329,19770,8021,3764,49885,548,902,446,1896,51781
04-10-2019,19,18344,20064,8040,3939,50387,553,814,445,1812,52199
04-10-2019,20,17509,19795,7401,3973,48679,435,430,264,1129,49808
04-10-2019,21,16204,19281,6937,3810,46233,396,418,311,1125,47358
04-10-2019,22,15166,18352,6680,3641,43840,385,391,261,1037,44877
04-10-2019,23,13991,17176,6593,3530,41292,368,331,282,981,42273
05-10-2019,0,13576,16777,6550,3478,40380,354,322,265,941,41321
05-10-2019,1,12692,16269,6531,3526,39019,337,320,270,927,39946
05-10-2019,2,11809,16054,6513,3301,37677,320,318,282,920,38597
05-10-2019,3,11268,16071,6582,3192,37113,324,320,276,920,38033
05-10-2019,4,11112,16125,6635,3186,37058,324,321,287,932,37990
05-10-2019,5,11546,16418,6687,3295,37947,326,324,315,965,38912
05-10-2019,6,12470,17172,6690,3413,39746,330,328,306,964,40710
05-10-2019,7,13575,17940,6717,3526,41759,337,327,312,976,42735
05-10-2019,8,15609,19241,6751,3527,45129,318,326,255,899,46028
05-10-2019,9,17047,19773,6620,3610,47050,318,408,217,943,47993
05-10-2019,10,17703,19917,6570,3849,48041,321,413,223,957,48998
05-10-2019,11,17546,19527,6573,3718,47365,318,355,238,911,48276
05-10-2019,12,16907,19207,6430,3396,45940,323,326,243,892,46832
05-10-2019,13,16294,19029,6356,3497,45178,321,325,242,888,46066
05-10-2019,14,15327,18274,6385,3086,43071,322,329,251,902,43973
05-10-2019,15,15781,18381,6504,2787,43454,316,327,241,884,44338
05-10-2019,16,16766,18775,6629,2599,44769,311,327,236,874,45643
05-10-2019,17,17865,19277,6956,2468,46566,321,329,224,874,47440
05-10-2019,18,18271,19620,7343,2436,47670,356,578,287,1221,48891
05-10-2019,19,18566,19797,7141,2581,48085,357,590,273,1220,49305
05-10-2019,20,17872,19695,6804,2582,46953,332,580,267,1179,48132
05-10-2019,21,16956,19484,6677,2246,45365,338,345,273,956,46321
05-10-2019,22,16765,18902,6390,2041,44099,345,326,256,927,45026
05-10-2019,23,15135,17857,6170,1831,40995,309,331,247,887,41882
06-10-2019,0,13158,16342,6113,1811,37425,311,370,242,923,38348
06-10-2019,1,12610,15632,6013,1814,36069,311,370,235,916,36985
06-10-2019,2,12026,15486,5961,1876,35350,306,326,230,862,36212
06-10-2019,3,11588,15471,5955,1933,34947,302,329,226,857,35804
06-10-2019,4,11882,15616,5965,1940,35402,313,332,225,870,36272
06-10-2019,5,12308,15885,5955,2012,36162,317,331,214,862,37024
06-10-2019,6,12401,16377,5984,2028,36789,318,343,193,854,37643
06-10-2019,7,12821,16878,6007,2055,37760,311,377,186,874,38634
06-10-2019,8,14047,17725,6201,2302,40276,304,375,178,857,41133
06-10-2019,9,14835,17996,6272,2631,41736,303,376,232,911,42647
06-10-2019,10,15200,17761,6296,2780,42037,301,399,185,885,42922
06-10-2019,11,15068,17479,6256,2947,41750,302,392,197,891,42641
06-10-2019,12,14887,17589,6223,3079,41778,314,389,206,909,42687
06-10-2019,13,14335,17042,6169,2891,40437,310,387,196,893,41330
06-10-2019,14,14198,17101,6101,2693,40095,313,386,212,911,41006
06-10-2019,15,14175,17033,6158,2547,39915,299,391,202,892,40807
06-10-2019,16,14486,17295,6258,2307,40347,293,393,190,876,41223
06-10-2019,17,15210,18158,6568,2218,42154,305,398,231,934,43088
06-10-2019,18,16563,19043,6940,2237,44784,328,611,246,1185,45969
06-10-2019,19,17642,19472,6955,2509,46577,331,649,203,1183,47760
06-10-2019,20,16260,19301,6776,2583,44921,330,435,198,963,45884
06-10-2019,21,14964,19322,6531,2513,43332,309,427,190,926,44258
06-10-2019,22,14216,18760,6271,2346,41592,299,379,181,859,42451
06-10-2019,23,13100,17828,6075,2140,39144,294,364,179,837,39981
07-10-2019,0,11567,16999,6030,2178,36775,295,348,179,822,37597
07-10-2019,1,11062,16729,6120,2082,35993,303,349,179,831,36824
07-10-2019,2,10970,16828,6051,1970,35820,328,349,177,854,36674
07-10-2019,3,11384,16911,6119,1770,36184,342,349,182,873,37057
07-10-2019,4,12527,17517,6386,1637,38067,356,350,185,891,38958
07-10-2019,5,14502,18920,6863,1956,42243,454,391,192,1037,43280
07-10-2019,6,18135,20126,7681,2244,48188,534,694,416,1644,49832
07-10-2019,7,19851,20525,8337,2846,51559,565,910,697,2172,53731
07-10-2019,8,19711,20356,8354,3049,51470,561,1159,638,2358,53828
07-10-2019,9,19570,19602,8239,3079,50491,580,1397,584,2561,53052
07-10-2019,10,19392,19350,7992,2633,49367,587,1435,603,2625,51992
07-10-2019,11,18899,19204,7990,2491,48585,587,1397,710,2694,51279
07-10-2019,12,18802,19363,7883,2507,48555,588,1156,736,2480,51035
07-10-2019,13,18631,19252,7779,2413,48077,585,1013,771,2369,50446
07-10-2019,14,18466,19216,7862,2316,47860,595,779,847,2221,50081
07-10-2019,15,18692,19381,7773,2208,48054,576,774,855,2205,50259
07-10-2019,16,18816,19402,7771,2047,48036,571,864,826,2261,50297
07-10-2019,17,18704,19300,8024,2281,48310,569,1114,819,2502,50812
07-10-2019,18,19048,19565,8324,2376,49313,579,1388,836,2803,52116
07-10-2019,19,19537,19676,8260,2726,50199,573,1386,848,2807,53006
07-10-2019,20,19050,19343,7564,2303,48260,571,1072,869,2512,50772
07-10-2019,21,17868,18746,7030,2536,46182,563,680,565,1808,47990
07-10-2019,22,16955,17610,6691,2690,43946,522,544,466,1532,45478
07-10-2019,23,15545,16157,6487,2798,40986,486,392,449,1327,42313
08-10-2019,0,14594,15116,6297,3076,39085,493,411,296,1200,40285
08-10-2019,1,14086,14721,6300,3225,38333,492,415,277,1184,39517
08-10-2019,2,13546,14654,6341,3349,37890,488,361,257,1106,38996
08-10-2019,3,13175,14667,6341,3734,37917,494,352,263,1109,39026
08-10-2019,4,13355,15156,6688,3248,38449,519,369,236,1124,39573
08-10-2019,5,14099,16280,7361,3797,41538,546,460,256,1262,42800
08-10-2019,6,15928,17714,8231,4141,46014,616,830,487,1933,47947
08-10-2019,7,18287,19070,8640,4442,50440,641,943,819,2403,52843
08-10-2019,8,18955,19568,8675,4077,51275,637,1076,922,2635,53910
08-10-2019,9,19853,19328,8735,3861,51777,651,1257,931,2839,54616
08-10-2019,10,19394,19086,8497,3799,50776,641,1255,712,2608,53384
08-10-2019,11,18250,18940,8508,3552,49251,652,1521,543,2716,51967
08-10-2019,12,17543,18838,8358,3354,48092,636,1508,546,2690,50782
08-10-2019,13,17065,18817,8041,3537,47461,645,1415,556,2616,50077
08-10-2019,14,16631,18736,8095,4081,47542,686,1300,544,2530,50072
08-10-2019,15,16914,18731,7840,3724,47211,666,1125,546,2337,49548
08-10-2019,16,17339,19008,7937,3110,47394,615,1115,400,2130,49524
08-10-2019,17,18231,19300,8228,2919,48678,637,1121,593,2351,51029
08-10-2019,18,18574,19240,8470,2894,49178,666,1282,595,2543,51721
08-10-2019,19,18885,19127,8291,3255,49559,647,1063,632,2342,51901
08-10-2019,20,17176,18737,7754,3444,47111,620,752,423,1795,48906
08-10-2019,21,15493,18203,7146,3356,44198,567,546,361,1474,45672
08-10-2019,22,14172,16948,6573,3532,41224,569,520,308,1397,42621
08-10-2019,23,13314,16294,6234,2952,38794,568,496,306,1370,40164
09-10-2019,0,12346,15436,6078,3264,37124,547,498,328,1373,38497
09-10-2019,1,11842,14673,6066,3577,36159,541,493,377,1411,37570
09-10-2019,2,11399,14574,6115,3575,35663,536,490,428,1454,37117
09-10-2019,3,11458,14628,6255,3363,35705,542,486,444,1472,37177
09-10-2019,4,11769,14768,6512,3361,36409,558,501,442,1501,37910
09-10-2019,5,12773,15431,7175,3668,39046,615,689,377,1681,40727
09-10-2019,6,14998,17109,8032,3481,43621,703,1036,354,2093,45714
09-10-2019,7,16645,18628,8225,3666,47166,699,1111,540,2350,49516
09-10-2019,8,17688,18808,8353,3927,48775,721,1161,541,2423,51198
09-10-2019,9,18252,18982,8251,3866,49351,736,1236,524,2496,51847
09-10-2019,10,18383,19157,8195,3881,49616,736,1196,530,2462,52078
09-10-2019,11,17978,18974,8087,4385,49424,714,1201,575,2490,51914
09-10-2019,12,17021,18684,8037,4224,47965,712,1185,541,2438,50403
09-10-2019,13,16644,18351,7929,4078,47001,726,1310,570,2606,49607
09-10-2019,14,16699,18196,7826,3721,46442,710,1308,592,2610,49052
09-10-2019,15,17162,18262,7876,3491,46791,689,1456,541,2686,49477
09-10-2019,16,17393,18271,7912,3116,46692,655,1448,540,2643,49335
09-10-2019,17,18158,18747,8065,3154,48125,682,1445,515,2642,50767
09-10-2019,18,18852,18846,8412,2944,49056,713,1562,485,2760,51816
09-10-2019,19,18597,18673,8259,2787,48316,708,1437,461,2606,50922
09-10-2019,20,17671,18733,7890,2622,46917,686,1058,341,2085,49002
09-10-2019,21,16438,18222,7332,2417,44410,580,889,298,1767,46177
09-10-2019,22,15122,17244,6972,2325,41664,549,648,283,1480,43144
09-10-2019,23,13251,16050,6482,2202,37985,527,550,283,1360,39345
10-10-2019,0,12511,14863,6246,2637,36257,554,486,281,1321,37578
10-10-2019,1,11962,14325,6207,2859,35352,547,486,237,1270,36622
10-10-2019,2,11643,14099,6163,3030,34936,549,487,227,1263,36199
10-10-2019,3,11764,14097,6214,2764,34840,544,484,234,1262,36102
10-10-2019,4,12321,14083,6573,2774,35751,555,514,246,1315,37066
10-10-2019,5,13752,14969,7272,2710,38702,714,735,232,1681,40383
10-10-2019,6,15492,16803,7975,2738,43009,813,1104,300,2217,45226
10-10-2019,7,17267,18115,8149,3025,46555,792,1352,413,2557,49112
10-10-2019,8,18022,18729,8084,3156,47993,814,1445,424,2683,50676
10-10-2019,9,18072,18860,7974,3318,48226,829,1438,432,2699,50925
10-10-2019,10,17239,18516,7940,3459,47153,828,1437,419,2684,49837
10-10-2019,11,16348,18134,7921,3864,46268,831,1437,411,2679,48947
10-10-2019,12,15479,17988,7909,4130,45507,823,1344,434,2601,48108
10-10-2019,13,15115,17696,7752,4344,44907,831,1284,349,2464,47371
10-10-2019,14,15028,17575,7684,4371,44658,830,1153,394,2377,47035
10-10-2019,15,14734,17430,7613,4345,44125,818,1153,492,2463,46588
10-10-2019,16,15435,17730,7607,4184,44957,789,1134,525,2448,47405
10-10-2019,17,16615,18360,7851,3853,46679,805,1130,535,2470,49149
10-10-2019,18,17755,18804,8262,3778,48599,806,1140,529,2475,51074
10-10-2019,19,17709,18837,7995,4050,48591,796,1142,529,2467,51058
10-10-2019,20,16122,18491,7479,3555,45648,681,990,395,2066,47714
10-10-2019,21,14477,17716,7130,4000,43324,533,852,398,1783,45107
10-10-2019,22,13084,16173,6755,4075,40089,512,567,369,1448,41537
10-10-2019,23,11599,15225,6303,3881,37009,540,508,375,1423,38432
11-10-2019,0,10978,14607,6025,3587,35199,528,502,369,1399,36598
11-10-2019,1,11046,14140,6002,3760,34949,526,503,356,1385,36334
11-10-2019,2,10916,13999,5925,3760,34599,572,498,355,1425,36024
11-10-2019,3,10973,14093,5973,4080,35119,590,500,347,1437,36556
11-10-2019,4,11100,14184,6406,4280,35970,581,509,380,1470,37440
11-10-2019,5,11619,14741,7208,4177,37746,663,758,431,1852,39598
11-10-2019,6,13713,16655,8137,3829,42334,702,917,443,2062,44396
11-10-2019,7,16303,18729,8158,3773,46963,709,1044,631,2384,49347
11-10-2019,8,17397,19220,8104,3830,48551,720,1073,662,2455,51006
11-10-2019,9,17132,19137,8162,4642,49073,716,1059,700,2475,51548
11-10-2019,10,16418,18907,8045,5346,48715,726,1100,526,2352,51067
11-10-2019,11,15993,18981,7990,5469,48433,735,1061,711,2507,50940
11-10-2019,12,15596,18459,7967,5262,47284,742,1062,663,2467,49751
11-10-2019,13,14818,18020,7945,5150,45934,734,1069,662,2465,48399
11-10-2019,14,14677,17942,7780,4880,45279,738,1057,553,2348,47627
11-10-2019,15,14710,17810,7618,4731,44871,739,965,532,2236,47107
11-10-2019,16,14869,18022,7633,4373,44897,746,933,563,2242,47139
11-10-2019,17,15211,18749,7346,4301,45607,576,938,781,2295,47902
11-10-2019,18,15493,18470,7362,4130,45456,570,1056,809,2435,47891
11-10-2019,19,15592,18459,7280,3853,45185,614,1018,823,2455,47640
11-10-2019,20,14467,17855,6869,3735,42926,567,283,665,1515,44441
11-10-2019,21,13956,17042,6264,3689,40953,540,238,611,1389,42342
11-10-2019,22,13013,15844,5930,3855,38643,549,242,611,1402,40045
11-10-2019,23,11858,14921,5764,3909,36452,516,243,604,1363,37815
12-10-2019,0,11493,14177,5658,3893,35221,508,243,604,1355,36576
12-10-2019,1,11257,13754,5488,3782,34281,512,239,611,1362,35643
12-10-2019,2,10620,13126,5528,3986,33261,507,238,622,1367,34628
12-10-2019,3,10477,12805,5551,3875,32707,481,238,630,1349,34056
12-10-2019,4,10654,13023,5583,3711,32972,459,234,632,1325,34297
12-10-2019,5,11129,13396,5617,3657,33797,486,232,624,1342,35139
12-10-2019,6,11878,13988,5691,3727,35284,542,228,632,1402,36686
12-10-2019,7,12796,14629,5766,3842,37036,530,235,632,1397,38433
12-10-2019,8,13929,15414,5833,4171,39348,514,264,626,1404,40752
12-10-2019,9,15051,16150,5903,4305,41408,531,264,628,1423,42831
12-10-2019,10,15439,16306,5988,4827,42560,566,265,614,1445,44005
12-10-2019,11,15164,16195,5936,5356,42650,572,281,574,1427,44077
12-10-2019,12,14736,15939,5909,5482,42065,582,284,506,1372,43437
12-10-2019,13,14672,15878,5923,5462,41937,571,278,470,1319,43256
12-10-2019,14,14310,15893,5913,5177,41295,564,237,445,1246,42541
12-10-2019,15,14231,16255,5968,5125,41579,543,254,424,1221,42800
12-10-2019,16,14450,16381,6185,5006,42023,531,248,441,1220,43243
12-10-2019,17,15909,17510,6567,4702,44689,520,255,450,1225,45914
12-10-2019,18,17007,18664,6767,4244,46683,503,398,470,1371,48054
12-10-2019,19,17166,18709,6478,4031,46383,479,491,453,1423,47806
12-10-2019,20,16674,17984,6212,3934,44805,471,267,441,1179,45984
12-10-2019,21,15500,16539,6051,3511,41601,460,275,406,1141,42742
12-10-2019,22,14193,16033,5984,3179,39390,460,237,384,1081,40471
12-10-2019,23,12459,14923,5878,2949,36207,470,224,383,1077,37284
13-10-2019,0,11985,14388,5737,2454,34563,461,221,410,1092,35655
13-10-2019,1,11900,14051,5625,2386,33961,458,219,420,1097,35058
13-10-2019,2,11420,13772,5604,1959,32755,502,213,420,1135,33890
13-10-2019,3,11540,13717,5606,1701,32564,511,210,424,1145,33709
13-10-2019,4,12046,13868,5595,1502,33010,519,211,432,1162,34172
13-10-2019,5,12711,13983,5598,1407,33700,511,213,423,1147,34847
13-10-2019,6,12833,14562,5657,1225,34279,504,214,408,1126,35405
13-10-2019,7,13965,14986,5651,1439,36042,505,220,379,1104,37146
13-10-2019,8,15189,15613,5726,1330,37859,501,228,365,1094,38953
13-10-2019,9,15903,16235,5726,1534,39398,510,245,345,1100,40498
13-10-2019,10,16094,16507,5899,1751,40251,550,241,341,1132,41383
13-10-2019,11,15900,16357,5885,1995,40139,525,323,323,1171,41310
13-10-2019,12,15694,16122,5803,2073,39693,524,318,302,1144,40837
13-10-2019,13,15515,15984,5821,2154,39472,511,305,255,1071,40543
13-10-2019,14,15254,15738,5846,2273,39110,541,213,236,990,40100
13-10-2019,15,15043,15809,5945,2514,39311,530,226,216,972,40283
13-10-2019,16,15137,16263,6085,2878,40363,478,314,191,983,41346
13-10-2019,17,15711,16722,6313,3490,42238,448,568,177,1193,43431
13-10-2019,18,16398,17451,6522,4022,44393,443,787,174,1404,45797
13-10-2019,19,16643,17675,6475,4383,45177,419,675,179,1273,46450
13-10-2019,20,16071,17136,6302,4543,44052,413,420,184,1017,45069
13-10-2019,21,15395,16320,6098,4092,41905,402,307,198,907,42812
13-10-2019,22,13903,15287,5924,4563,39678,383,202,250,835,40513
13-10-2019,23,12546,14355,5824,4892,37618,375,197,313,885,38503
14-10-2019,0,11575,14095,5899,4586,36155,346,197,393,936,37091
14-10-2019,1,11137,13740,5802,5007,35688,333,200,438,971,36659
14-10-2019,2,10942,13567,5773,5013,35295,335,209,492,1036,36331
14-10-2019,3,10908,13495,5826,5031,35258,370,215,563,1148,36406
14-10-2019,4,11333,13988,6046,5099,36467,382,245,590,1217,37684
14-10-2019,5,12407,15100,6719,5452,39678,462,314,568,1344,41022
14-10-2019,6,15864,17740,7205,5258,46067,552,846,582,1980,48047
14-10-2019,7,18399,19847,7437,5020,50704,566,1058,741,2365,53069
14-10-2019,8,18762,20411,7413,4513,51099,561,1076,775,2412,53511
14-10-2019,9,18693,20686,7370,4035,50784,593,1149,785,2527,53311
14-10-2019,10,18642,20609,7345,3461,50058,666,1092,794,2552,52610
14-10-2019,11,18558,20337,7187,2920,49004,689,1068,818,2575,51579
14-10-2019,12,18361,20179,7375,2575,48490,713,1057,820,2590,51080
14-10-2019,13,18043,19429,7274,2199,46945,742,1048,816,2606,49551
14-10-2019,14,17984,19177,7211,2124,46498,756,1061,852,2669,49167
14-10-2019,15,17996,18956,7296,1963,46210,743,1158,805,2706,48916
14-10-2019,16,17933,18647,7604,1774,45957,740,1383,840,2963,48920
14-10-2019,17,18043,18292,7737,1875,45949,741,1535,828,3104,49053
14-10-2019,18,18251,18282,7960,2135,46628,735,1782,755,3272,49900
14-10-2019,19,18266,18114,7907,2293,46581,709,1789,671,3169,49750
14-10-2019,20,18049,17923,7315,2243,45529,688,1010,435,2133,47662
14-10-2019,21,17700,17851,6674,2405,44630,600,514,363,1477,46107
14-10-2019,22,16325,16773,6213,2554,41866,507,502,287,1296,43162
14-10-2019,23,14823,15206,6068,2912,39008,475,487,209,1171,40179
15-10-2019,0,13944,14291,6017,3009,37260,463,487,193,1143,38403
15-10-2019,1,13340,13864,5997,3458,36660,440,488,164,1092,37752
15-10-2019,2,12954,13300,5979,3631,35865,437,489,153,1079,36944
15-10-2019,3,12941,13491,6005,3693,36129,445,493,152,1090,37219
15-10-2019,4,13081,13773,6070,4047,36973,441,515,159,1115,38088
15-10-2019,5,14213,14630,6714,4410,39967,447,541,168,1156,41123
15-10-2019,6,16800,17134,7361,4542,45836,574,1035,174,1783,47619
15-10-2019,7,18391,18451,7414,4753,49009,634,1322,417,2373,51382
15-10-2019,8,18734,18746,7459,4598,49537,639,1396,465,2500,52037
15-10-2019,9,18897,18840,7463,4382,49582,642,1384,472,2498,52080
15-10-2019,10,18913,18849,7308,3823,48893,642,1342,514,2498,51391
15-10-2019,11,18713,19279,7486,3446,48924,629,1323,520,2472,51396
15-10-2019,12,18562,19049,7474,3031,48117,635,1208,475,2318,50435
15-10-2019,13,18510,19283,7412,2808,48012,654,1137,491,2282,50294
15-10-2019,14,18536,19192,7323,2593,47643,621,1082,527,2230,49873
15-10-2019,15,18622,19311,7304,2366,47604,639,1117,612,2368,49972
15-10-2019,16,18611,19325,7503,2281,47719,661,1148,653,2462,50181
15-10-2019,17,18439,19257,7551,2212,47460,677,1447,715,2839,50299
15-10-2019,18,18672,19260,7568,2227,47728,709,1546,731,2986,50714
15-10-2019,19,18442,19051,7875,2253,47623,700,1503,927,3130,50753
15-10-2019,20,18243,18867,7288,1852,46251,653,1210,625,2488,48739
15-10-2019,21,17885,18451,6890,1701,44928,664,581,448,1693,46621
15-10-2019,22,17071,17384,6624,1324,42403,567,557,427,1551,43954
15-10-2019,23,15583,15397,6389,1414,38783,517,526,421,1464,40247
16-10-2019,0,14598,14762,6268,1079,36708,520,497,432,1449,38157
16-10-2019,1,13464,13811,6116,1488,34881,532,493,427,1452,36333
16-10-2019,2,13063,13575,6097,1551,34285,522,492,415,1429,35714
16-10-2019,3,13173,13503,6082,1566,34325,514,494,403,1411,35736
16-10-2019,4,13845,14061,6109,1460,35476,519,502,387,1408,36884
16-10-2019,5,14792,15197,6543,1492,38025,521,540,381,1442,39467
16-10-2019,6,16992,17790,7210,1538,43528,625,949,489,2063,45591
16-10-2019,7,18558,18571,7325,1730,46186,681,1450,551,2682,48868
16-10-2019,8,19018,18769,7484,1760,47031,686,1598,539,2823,49854
16-10-2019,9,18991,18873,7543,1832,47238,674,1535,497,2706,49944
16-10-2019,10,19048,19050,7571,1953,47623,668,1439,461,2568,50191
16-10-2019,11,18894,19092,7619,2096,47702,672,1376,438,2486,50188
16-10-2019,12,18183,19306,7587,2321,47397,658,1412,476,2546,49943
16-10-2019,13,18039,19240,7508,2417,47205,657,1462,506,2625,49830
16-10-2019,14,17756,18935,7397,2291,46378,609,1127,508,2244,48622
16-10-2019,15,17875,19085,7405,2193,46561,580,794,550,1924,48485
16-10-2019,16,18521,19275,7616,2216,47630,587,544,551,1682,49312
16-10-2019,17,18709,19613,7834,2496,48652,623,549,621,1793,50445
16-10-2019,18,18577,19677,7983,2616,48853,670,983,671,2324,51177
16-10-2019,19,18375,19559,7863,2567,48367,650,1029,631,2310,50677
16-10-2019,20,18112,19277,7133,2027,46549,596,555,349,1500,48049
16-10-2019,21,17072,18824,6513,1773,44182,531,533,398,1462,45644
16-10-2019,22,15971,17544,6277,1527,41319,481,519,419,1419,42738
16-10-2019,23,13470,15596,6221,1842,37128,479,460,479,1418,38546
17-10-2019,0,12617,14868,6252,2030,35768,463,479,525,1467,37235
17-10-2019,1,11959,14735,6166,2035,34896,465,486,463,1414,36310
17-10-2019,2,11739,14769,6178,2133,34820,478,476,429,1383,36203
17-10-2019,3,11767,14729,6284,2109,34889,478,480,399,1357,36246
17-10-2019,4,12288,14814,6502,2042,35646,489,480,396,1365,37011
17-10-2019,5,13478,15597,7149,1851,38073,618,513,494,1625,39698
17-10-2019,6,16562,17247,8152,2218,44178,692,844,646,2182,46360
17-10-2019,7,18449,18266,8398,2648,47760,740,996,706,2442,50202
17-10-2019,8,18993,18158,8349,2640,48138,741,1022,794,2557,50695
17-10-2019,9,18839,18163,8501,2804,48310,718,1255,797,2770,51080
17-10-2019,10,18939,18543,8458,3146,49086,727,1103,815,2645,51731
17-10-2019,11,18747,18498,8389,3085,48719,717,1130,717,2564,51283
17-10-2019,12,18395,18244,8363,2928,47931,711,1199,755,2665,50596
17-10-2019,13,18223,18160,8290,2893,47567,730,1283,739,2752,50319
17-10-2019,14,18003,18185,8341,2550,47079,731,1304,670,2705,49784
17-10-2019,15,18396,18278,8242,2272,47189,729,1412,617,2758,49947
17-10-2019,16,18260,18200,8195,2646,47302,717,1486,504,2707,50009
17-10-2019,17,18161,18158,8477,2536,47331,705,1514,481,2700,50031
17-10-2019,18,18546,18567,8194,2471,47778,708,1586,428,2722,50500
17-10-2019,19,18751,19007,7885,2566,48211,714,1610,485,2809,51020
17-10-2019,20,17993,18403,7544,2266,46206,636,1076,450,2162,48368
17-10-2019,21,18006,18269,7186,1771,45233,559,542,260,1361,46594
17-10-2019,22,17156,17490,6619,1505,42771,548,519,257,1324,44095
17-10-2019,23,15516,15636,6369,1673,39196,534,490,253,1277,40473
18-10-2019,0,13374,15156,6301,1519,36350,526,355,232,1113,37463
18-10-2019,1,12843,14102,6248,1589,34782,522,354,222,1098,35880
18-10-2019,2,12309,13816,6256,1613,33995,514,348,215,1077,35072
18-10-2019,3,12369,13848,6284,1643,34143,509,350,207,1066,35209
18-10-2019,4,13162,14205,6490,1749,35607,537,351,194,1082,36689
18-10-2019,5,13789,15109,7145,1818,37860,674,383,197,1254,39114
18-10-2019,6,16102,17047,7956,2071,43176,705,886,399,1990,45166
18-10-2019,7,17614,17779,8209,2314,45918,711,1070,408,2189,48107
18-10-2019,8,17853,18006,8235,2402,46497,716,1223,389,2328,48825
18-10-2019,9,18033,17917,8255,2503,46709,718,1155,387,2260,48969
18-10-2019,10,17774,18247,8090,2559,46670,720,1121,359,2200,48870
18-10-2019,11,17158,18055,8103,2550,45867,715,1239,369,2323,48190
18-10-2019,12,16623,17458,8010,2687,44778,713,1292,375,2380,47158
18-10-2019,13,16255,17405,7923,2772,44355,721,1279,363,2363,46718
18-10-2019,14,15849,17226,7843,2501,43418,729,1275,355,2359,45777
18-10-2019,15,15572,17058,7801,2743,43174,728,1139,425,2292,45466
18-10-2019,16,15412,16938,7954,2855,43159,729,904,458,2091,45250
18-10-2019,17,16077,17700,8182,3271,45230,727,875,466,2068,47298
18-10-2019,18,16901,18050,8342,3746,47039,729,873,445,2047,49086
18-10-2019,19,16715,17896,8210,4109,46931,727,866,443,2036,48967
18-10-2019,20,14483,16969,7395,4205,43052,664,652,449,1765,44817
18-10-2019,21,13378,16396,6956,4287,41016,546,367,284,1197,42213
18-10-2019,22,12508,15801,6831,4417,39556,491,365,297,1153,40709
18-10-2019,23,11621,15297,6325,4573,37815,470,347,306,1123,38938
19-10-2019,0,11271,15349,6058,4588,37266,467,339,304,1110,38376
19-10-2019,1,10717,15157,5782,4598,36254,457,335,296,1088,37342
19-10-2019,2,10472,14724,5708,4464,35367,455,334,304,1093,36460
19-10-2019,3,10440,14683,5690,4180,34991,478,321,299,1098,36089
19-10-2019,4,10321,14670,5662,4164,34817,531,342,313,1186,36003
19-10-2019,5,10372,14874,5883,4112,35242,538,368,298,1204,36446
19-10-2019,6,11253,15725,6102,3973,37053,554,336,297,1187,38240
19-10-2019,7,11847,16108,6286,3900,38142,576,336,262,1174,39316
19-10-2019,8,12312,17003,6404,3981,39699,635,370,241,1246,40945
19-10-2019,9,13191,18071,6724,4062,42050,639,347,215,1201,43251
19-10-2019,10,14000,18484,6926,3881,43291,648,345,206,1199,44490
19-10-2019,11,13864,18390,6800,3804,42859,629,331,202,1162,44021
19-10-2019,12,13210,18391,6706,3656,41963,617,360,200,1177,43140
19-10-2019,13,12904,18010,6632,3564,41109,618,344,185,1147,42256
19-10-2019,14,13022,17565,6585,3241,40414,639,313,177,1129,41543
19-10-2019,15,12878,17518,6841,2844,40081,633,298,168,1099,41180
19-10-2019,16,13939,18401,7158,2778,42276,612,348,167,1127,43403
19-10-2019,17,15070,19538,7669,2727,45004,620,347,168,1135,46139
19-10-2019,18,15718,19474,7920,2530,45640,621,349,172,1142,46782
19-10-2019,19,15057,19380,7571,2579,44589,608,337,184,1129,45718
19-10-2019,20,14513,19258,7144,2417,43333,630,303,219,1152,44485
19-10-2019,21,12715,18315,6899,2173,40102,630,327,229,1186,41288
19-10-2019,22,12063,18072,6842,2127,39106,611,323,204,1138,40244
19-10-2019,23,11490,17019,6657,1961,37127,593,329,210,1132,38259
20-10-2019,0,11678,16155,6585,2059,36477,583,207,217,1007,37484
20-10-2019,1,11277,15342,6527,2167,35313,561,201,214,976,36289
20-10-2019,2,11141,15221,6440,2159,34961,547,208,217,972,35933
20-10-2019,3,11374,15094,6359,2006,34834,546,214,217,977,35811
20-10-2019,4,11494,14985,6268,2019,34766,539,215,232,986,35752
20-10-2019,5,11775,15064,6178,1822,34840,538,218,276,1032,35872
20-10-2019,6,12039,15702,6217,1656,35615,541,223,317,1081,36696
20-10-2019,7,12297,16528,6221,1459,36505,542,228,321,1091,37596
20-10-2019,8,12802,17166,6411,1501,37880,535,235,310,1080,38960
20-10-2019,9,13980,17922,6630,1532,40065,534,230,278,1042,41107
20-10-2019,10,14895,18316,6841,1483,41535,576,218,270,1064,42599
20-10-2019,11,15555,18780,6896,1556,42787,575,226,234,1035,43822
20-10-2019,12,15291,18866,6875,1756,42788,574,216,221,1011,43799
20-10-2019,13,14150,18057,6791,1473,40472,555,212,231,998,41470
20-10-2019,14,13950,17564,6777,1416,39706,551,219,235,1005,40711
20-10-2019,15,14107,17507,6774,1240,39630,544,224,233,1001,40631
20-10-2019,16,14639,17957,6858,1103,40556,561,223,215,999,41555
20-10-2019,17,16219,18973,6908,1050,43150,585,223,237,1045,44195
20-10-2019,18,17504,19433,7013,1133,45083,631,311,228,1170,46253
20-10-2019,19,17642,19338,6727,1109,44816,651,223,219,1093,45909
20-10-2019,20,17323,18798,6472,1066,43659,607,220,230,1057,44716
20-10-2019,21,16796,18713,6311,992,42812,570,221,220,1011,43823
20-10-2019,22,15941,18503,6152,829,41426,600,219,204,1023,42449
20-10-2019,23,13976,17115,5968,821,37881,593,200,202,995,38876
21-10-2019,0,12514,15620,5891,769,34792,598,180,198,976,35768
21-10-2019,1,12276,15230,5756,807,34071,603,176,186,965,35036
21-10-2019,2,12237,15072,5750,811,33870,612,176,174,962,34832
21-10-2019,3,12276,15189,5783,914,34163,627,175,160,962,35125
21-10-2019,4,12726,15682,6017,1143,35568,638,178,151,967,36535
21-10-2019,5,13969,16869,6767,1436,39042,663,188,151,1002,40044
21-10-2019,6,16651,19022,7393,1585,44651,754,715,336,1805,46456
21-10-2019,7,19200,20808,7716,1972,49697,720,902,347,1969,51666
21-10-2019,8,19844,20567,7853,2236,50499,712,1036,372,2120,52619
21-10-2019,9,19672,20323,8043,2416,50453,711,1056,406,2173,52626
21-10-2019,10,19591,20384,8099,2331,50406,702,1089,394,2185,52591
21-10-2019,11,19589,20520,7954,2189,50253,692,1149,388,2229,52482
21-10-2019,12,19091,20366,7915,2480,49852,689,1133,369,2191,52043
21-10-2019,13,19075,20504,7950,2524,50053,680,1004,374,2058,52111
21-10-2019,14,18991,20579,7810,2329,49711,563,1086,381,2030,51741
21-10-2019,15,19156,20734,7755,2247,49893,475,1060,377,1912,51805
21-10-2019,16,18976,20771,7988,2160,49897,472,979,302,1753,51650
21-10-2019,17,18786,21202,8251,2194,50433,449,1230,421,2100,52533
21-10-2019,18,19137,21157,8430,2229,50953,445,1373,457,2275,53228
21-10-2019,19,18820,20938,8166,2098,50023,436,1359,502,2297,52320
21-10-2019,20,18087,20433,7472,1785,47778,441,1008,408,1857,49635
21-10-2019,21,17279,20190,7017,1456,45944,427,683,306,1416,47360
21-10-2019,22,16260,19756,6818,1358,44193,450,389,348,1187,45380
21-10-2019,23,14728,18900,6700,1198,41526,422,370,284,1076,42602
22-10-2019,0,13406,18364,6612,1242,39626,407,352,299,1058,40684
22-10-2019,1,12621,18084,6560,1010,38275,413,348,276,1037,39312
22-10-2019,2,11923,17758,6610,1066,37359,417,347,272,1036,38395
22-10-2019,3,11477,17456,6606,1133,36672,419,344,285,1048,37720
22-10-2019,4,11629,18239,6723,1183,37774,428,353,306,1087,38861
22-10-2019,5,13188,19550,7172,1294,41205,444,362,288,1094,42299
22-10-2019,6,15390,20818,7967,1632,45807,534,722,368,1624,47431
22-10-2019,7,16726,21872,8289,2047,48935,536,771,425,1732,50667
22-10-2019,8,16443,22079,8251,2173,48947,564,1129,416,2109,51056
22-10-2019,9,16038,22223,7978,2145,48383,535,1224,386,2145,50528
22-10-2019,10,16123,22314,7904,2434,48777,523,1155,416,2094,50871
22-10-2019,11,15984,22366,8021,2709,49082,555,1087,359,2001,51083
22-10-2019,12,15841,22311,7944,3085,49182,583,1153,327,2063,51245
22-10-2019,13,15669,22412,7820,3472,49373,644,1051,315,2010,51383
22-10-2019,14,15500,22275,7732,4032,49540,665,960,344,1969,51509
22-10-2019,15,15201,22449,7664,4298,49611,668,866,265,1799,51410
22-10-2019,16,15072,22666,7890,4546,50173,624,857,242,1723,51896
22-10-2019,17,15604,22938,8129,4347,51017,655,1101,256,2012,53029
22-10-2019,18,16154,22766,8204,4305,51430,686,1206,316,2208,53638
22-10-2019,19,15615,22423,7984,4289,50313,672,1245,371,2288,52601
22-10-2019,20,15103,21683,7354,4089,48229,599,871,394,1864,50093
22-10-2019,21,14660,20802,7124,3657,46243,566,413,396,1375,47618
22-10-2019,22,13962,20213,6981,3608,44763,556,384,395,1335,46098
22-10-2019,23,12995,19171,6811,3331,42308,551,383,387,1321,43629
23-10-2019,0,11942,18733,6806,3089,40572,545,382,355,1282,41854
23-10-2019,1,11335,18395,6798,3142,39670,539,378,336,1253,40923
23-10-2019,2,11073,18262,6786,2996,39116,527,378,343,1248,40364
23-10-2019,3,10962,18256,6821,2748,38786,509,371,352,1232,40018
23-10-2019,4,11028,18091,6775,2581,38476,492,366,371,1229,39705
23-10-2019,5,12896,19691,7141,2531,42258,485,375,322,1182,43440
23-10-2019,6,15798,21326,7623,2300,47046,520,642,462,1624,48670
23-10-2019,7,18148,21975,7752,2594,50469,540,714,520,1774,52243
23-10-2019,8,18468,21779,7743,2635,50623,529,1007,522,2058,52681
23-10-2019,9,18136,21838,7607,2728,50308,491,940,523,1954,52262
23-10-2019,10,18471,21981,7544,2684,50680,513,814,529,1856,52536
23-10-2019,11,17980,21575,7602,2800,49956,493,906,560,1959,51915
23-10-2019,12,17726,21226,7532,2537,49023,506,1016,553,2075,51098
23-10-2019,13,17472,21140,7457,2376,48445,480,904,558,1942,50387
23-10-2019,14,17713,20962,7531,2207,48414,480,788,563,1831,50245
23-10-2019,15,17840,21028,7628,2136,48631,507,713,499,1719,50350
23-10-2019,16,17991,20945,7699,2025,48661,458,713,467,1638,50299
23-10-2019,17,17983,21446,7876,2013,49320,484,1109,437,2030,51350
23-10-2019,18,18509,21589,7984,1982,50065,484,1159,425,2068,52133
23-10-2019,19,17892,21447,7653,1993,48984,481,892,437,1810,50794
23-10-2019,20,17277,21094,7065,1852,47289,417,561,343,1321,48610
23-10-2019,21,16215,20522,6642,1870,45250,388,544,329,1261,46511
23-10-2019,22,15140,20067,6290,1904,43401,415,412,193,1020,44421
23-10-2019,23,12735,18549,6032,1803,39119,408,342,185,935,40054
24-10-2019,0,12772,17553,6056,1684,38066,386,342,171,899,38965
24-10-2019,1,11634,16847,5828,1776,36087,380,337,163,880,36967
24-10-2019,2,11239,16540,5736,1905,35421,391,336,156,883,36304
24-10-2019,3,10966,16595,5797,1923,35281,384,337,169,890,36171
24-10-2019,4,11039,16911,6082,2127,36158,396,338,203,937,37095
24-10-2019,5,12497,18257,7027,2374,40155,414,378,241,1033,41188
24-10-2019,6,16374,19977,7624,2602,46577,488,982,483,1953,48530
24-10-2019,7,18670,20856,7748,3091,50365,464,984,564,2012,52377
24-10-2019,8,19092,21026,7845,3152,51115,475,1087,536,2098,53213
24-10-2019,9,18570,21032,7861,3259,50722,474,1102,474,2050,52772
24-10-2019,10,18711,21040,7902,3346,50999,497,1101,419,2017,53016
24-10-2019,11,18613,20977,7840,3329,50761,513,1030,400,1943,52704
24-10-2019,12,18198,20994,7788,3305,50286,471,1012,433,1916,52202
24-10-2019,13,17864,20850,7653,3422,49790,473,1006,436,1915,51705
24-10-2019,14,16353,20559,7511,3312,47734,472,1016,422,1910,49644
24-10-2019,15,15876,20470,7519,3322,47188,452,697,429,1578,48766
24-10-2019,16,15934,20585,7584,3083,47186,452,663,468,1583,48769
24-10-2019,17,17690,21206,7853,2641,49390,508,774,527,1809,51199
24-10-2019,18,18443,21285,7876,3068,50672,534,878,559,1971,52643
24-10-2019,19,17387,21067,7804,3481,49741,556,644,519,1719,51460
24-10-2019,20,15779,20713,7261,3579,47333,506,399,353,1258,48591
24-10-2019,21,13515,19886,6589,3712,43703,496,384,382,1262,44965
24-10-2019,22,12292,18479,6345,3848,40964,477,378,359,1214,42178
24-10-2019,23,10837,17031,6166,3930,37966,479,346,379,1204,39170
25-10-2019,0,10154,16803,6185,4186,37329,465,214,395,1074,38403
25-10-2019,1,9700,16212,6077,4661,36649,467,204,394,1065,37714
25-10-2019,2,9439,16233,6052,4321,36045,489,197,353,1039,37084
25-10-2019,3,9140,16424,6137,3910,35611,487,196,296,979,36590
25-10-2019,4,9377,16818,6259,4187,36641,515,205,269,989,37630
25-10-2019,5,10833,17881,6645,4397,39756,550,256,256,1062,40818
25-10-2019,6,13385,20866,7317,3763,45333,602,732,427,1761,47094
25-10-2019,7,16304,23068,7694,4404,51471,633,821,436,1890,53361
25-10-2019,8,16902,23051,7728,4372,52054,652,843,456,1951,54005
25-10-2019,9,16546,22832,7663,4657,51699,625,855,469,1949,53648
25-10-2019,10,14892,22402,7511,4804,49610,644,851,449,1944,51554
25-10-2019,11,13546,21627,7568,5254,47996,654,757,479,1890,49886
25-10-2019,12,12875,21073,7523,5187,46658,633,781,533,1947,48605
25-10-2019,13,12754,20470,7474,5642,46341,645,636,561,1842,48183
25-10-2019,14,12982,20472,7424,5581,46458,623,533,601,1757,48215
25-10-2019,15,13949,21540,7477,4849,47814,633,388,631,1652,49466
25-10-2019,16,14569,22752,7684,3988,48994,642,352,673,1667,50661
25-10-2019,17,15395,23338,7931,3218,49882,650,547,660,1857,51739
25-10-2019,18,16142,23637,7955,2641,50378,685,454,677,1816,52194
25-10-2019,19,15916,23282,7587,2799,49584,621,306,675,1602,51186
25-10-2019,20,14106,21719,7230,3159,46216,558,254,540,1352,47568
25-10-2019,21,12116,19892,6969,3506,42483,547,246,530,1323,43806
25-10-2019,22,10996,19234,6892,3963,41085,546,242,510,1298,42383
25-10-2019,23,10394,18691,6850,4313,40248,563,228,462,1253,41501
26-10-2019,0,9285,18691,6923,4816,39715,568,226,395,1189,40904
26-10-2019,1,8882,17904,6807,4782,38375,549,208,353,1110,39485
26-10-2019,2,8839,17912,6805,4559,38115,539,221,341,1101,39216
26-10-2019,3,8785,17799,6755,4040,37379,532,195,348,1075,38454
26-10-2019,4,8750,17794,6802,4064,37409,529,183,390,1102,38511
26-10-2019,5,9281,17994,6791,4066,38133,501,187,395,1083,39216
26-10-2019,6,9733,18171,6940,4186,39029,498,211,443,1152,40181
26-10-2019,7,10376,18432,7040,4344,40192,488,229,491,1208,41400
26-10-2019,8,11322,18536,7212,3683,40753,470,273,527,1270,42023
26-10-2019,9,12143,20026,7235,3225,42630,435,423,562,1420,44050
26-10-2019,10,12162,20828,7064,2752,42805,481,426,602,1509,44314
26-10-2019,11,12151,20921,6943,2639,42654,502,424,636,1562,44216
26-10-2019,12,12144,20714,6854,2463,42176,526,428,630,1584,43760
26-10-2019,13,11817,20343,6770,2263,41193,546,510,615,1671,42864
26-10-2019,14,11831,20173,6764,2175,40943,577,510,569,1656,42599
26-10-2019,15,12074,19959,6881,2181,41096,586,655,563,1804,42900
26-10-2019,16,12407,20169,6905,2181,41661,588,682,540,1810,43471
26-10-2019,17,13731,20615,7093,2264,43703,604,834,518,1956,45659
26-10-2019,18,14691,20629,7196,2519,45035,603,808,530,1941,46976
26-10-2019,19,13567,20048,6966,2578,43160,503,804,519,1826,44986
26-10-2019,20,12499,19649,6845,2544,41538,473,537,533,1543,43081
26-10-2019,21,11689,19233,6841,2506,40266,426,515,530,1471,41737
26-10-2019,22,10793,18063,6728,2484,38068,382,273,527,1182,39250
26-10-2019,23,10495,16812,6701,2448,36457,359,237,497,1093,37550
27-10-2019,0,10226,16138,6571,2566,35501,347,239,474,1060,36561
27-10-2019,1,10310,15707,6518,2564,35100,343,238,471,1052,36152
27-10-2019,2,10079,15378,6450,3212,35118,338,235,471,1044,36162
27-10-2019,2,10066,15240,6401,3221,34928,338,233,470,1041,35969
27-10-2019,3,10231,15172,6394,2955,34752,334,236,470,1040,35792
27-10-2019,4,10441,15506,6370,3205,35522,334,241,476,1051,36573
27-10-2019,5,10752,15916,6384,3294,36346,327,239,477,1043,37389
27-10-2019,6,11119,16517,6472,3418,37525,326,242,488,1056,38581
27-10-2019,7,11759,16935,6549,3659,38903,344,244,517,1105,40008
27-10-2019,8,12022,18130,6570,3993,40714,361,261,543,1165,41879
27-10-2019,9,12539,19121,6584,4350,42596,381,266,564,1211,43807
27-10-2019,10,12632,19356,6567,4465,43020,438,266,603,1307,44327
27-10-2019,11,12227,19355,6614,4615,42810,499,241,636,1376,44186
27-10-2019,12,11934,19185,6614,5003,42737,524,262,650,1436,44173
27-10-2019,13,11950,19224,6664,5188,43027,541,270,651,1462,44489
27-10-2019,14,12498,19570,6732,5139,43939,539,396,653,1588,45527
27-10-2019,15,13448,20035,6983,4868,45335,521,442,645,1608,46943
27-10-2019,16,15123,20407,7195,4602,47328,511,590,626,1727,49055
27-10-2019,17,17716,21605,7492,4437,51250,502,656,585,1743,52993
27-10-2019,18,18200,21713,7434,3777,51124,494,583,535,1612,52736
27-10-2019,19,16963,21504,7108,3955,49531,489,530,478,1497,51028
27-10-2019,20,14254,20569,6909,4421,46153,460,503,394,1357,47510
27-10-2019,21,13137,20076,6716,4533,44463,424,414,340,1178,45641
27-10-2019,22,12861,19273,6501,4579,43213,431,352,352,1135,44348
27-10-2019,23,11931,18275,6418,4435,41059,384,268,329,981,42040
28-10-2019,0,11531,17195,6313,4276,39313,361,262,341,964,40277
28-10-2019,1,10996,17104,6310,4060,38471,357,258,358,973,39444
28-10-2019,2,10892,17039,6377,3774,38082,358,257,337,952,39034
28-10-2019,3,11002,17170,6488,3488,38148,372,267,323,962,39110
28-10-2019,4,11996,17423,6889,3110,39419,384,295,265,944,40363
28-10-2019,5,13992,18346,7514,2784,42637,502,271,256,1029,43666
28-10-2019,6,17506,20004,8155,2705,48370,620,439,401,1460,49830
28-10-2019,7,20474,21562,8246,2688,52970,631,510,388,1529,54499
28-10-2019,8,21279,21915,8330,2569,54094,624,870,406,1900,55994
28-10-2019,9,20887,21566,8438,2707,53599,618,888,401,1907,55506
28-10-2019,10,20616,21413,8502,3058,53589,637,949,397,1983,55572
28-10-2019,11,19840,21125,8491,3117,52573,630,941,399,1970,54543
28-10-2019,12,19175,20905,8438,3256,51773,622,941,408,1971,53744
28-10-2019,13,19813,21095,8387,3166,52461,635,917,390,1942,54403
28-10-2019,14,19586,21196,8417,3248,52448,637,840,394,1871,54319
28-10-2019,15,19794,21537,8477,2985,52796,636,932,406,1974,54770
28-10-2019,16,20472,22115,8646,2995,54228,637,1193,447,2277,56505
28-10-2019,17,21226,22174,8626,3106,55135,648,1389,458,2495,57630
28-10-2019,18,21119,22131,8556,3069,54876,651,1293,461,2405,57281
28-10-2019,19,20499,22170,8068,2969,53706,638,941,446,2025,55731
28-10-2019,20,19501,22030,7561,2660,51752,525,676,221,1422,53174
28-10-2019,21,19024,21384,7288,2219,49916,508,443,235,1186,51102
28-10-2019,22,16968,21012,7158,1856,46995,510,438,254,1202,48197
28-10-2019,23,14296,19837,7151,1782,43068,507,438,248,1193,44261
29-10-2019,0,13334,19521,7272,1764,41892,513,428,284,1225,43117
29-10-2019,1,12961,19207,7249,1836,41253,505,431,260,1196,42449
29-10-2019,2,12407,19128,7231,1931,40696,499,432,254,1185,41881
29-10-2019,3,12598,19295,7296,2154,41344,507,436,270,1213,42557
29-10-2019,4,13209,19670,7632,1977,42488,508,425,282,1215,43703
29-10-2019,5,15100,20861,8368,1694,46023,556,435,305,1296,47319
29-10-2019,6,18522,22495,8939,2186,52142,648,822,316,1786,53928
29-10-2019,7,20299,23279,8753,2531,54862,639,918,505,2062,56924
29-10-2019,8,20877,22735,8873,2820,55307,660,1013,437,2110,57417
29-10-2019,9,21142,22178,8700,2885,54906,678,1106,403,2187,57093
29-10-2019,10,21039,21908,8646,2749,54342,695,1026,419,2140,56482
29-10-2019,11,20401,21777,8577,2651,53407,698,937,424,2059,55466
29-10-2019,12,19778,21574,8500,2420,52274,684,881,441,2006,54280
29-10-2019,13,19507,21960,8445,2509,52422,680,866,462,2008,54430
29-10-2019,14,19516,22015,8520,2305,52356,676,911,472,2059,54415
29-10-2019,15,19850,21979,8868,2276,52973,673,1044,495,2212,55185
29-10-2019,16,20763,22028,9114,2320,54227,677,1174,450,2301,56528
29-10-2019,17,21681,22505,9276,2523,55986,684,1301,529,2514,58500
29-10-2019,18,21535,22225,9179,2539,55478,689,1126,518,2333,57811
29-10-2019,19,21115,22117,8600,2501,54332,681,1078,514,2273,56605
29-10-2019,20,20452,22109,8029,2062,52652,632,846,388,1866,54518
29-10-2019,21,20131,21518,7802,1725,51178,525,443,288,1256,52434
29-10-2019,22,18864,20631,7637,1636,48768,501,436,293,1230,49998
29-10-2019,23,17094,19189,7457,1529,45268,551,424,279,1254,46522
30-10-2019,0,15667,18262,7353,1700,42981,535,421,216,1172,44153
30-10-2019,1,15051,17923,7161,1798,41933,553,442,214,1209,43142
30-10-2019,2,14660,17683,7146,1913,41402,555,442,216,1213,42615
30-10-2019,3,14837,17970,7357,1879,42043,534,460,225,1219,43262
30-10-2019,4,15771,18456,7814,1794,43835,536,451,213,1200,45035
30-10-2019,5,17735,19422,8517,1697,47372,637,662,220,1519,48891
30-10-2019,6,20600,21209,8660,2253,52723,682,938,407,2027,54750
30-10-2019,7,22761,22013,8616,2720,56110,713,1387,472,2572,58682
30-10-2019,8,23137,22007,8606,2933,56682,772,1361,456,2589,59271
30-10-2019,9,22371,21473,8700,3029,55572,683,1363,439,2485,58057
30-10-2019,10,21687,21453,8630,2935,54705,681,1345,404,2430,57135
30-10-2019,11,20858,21377,8548,2833,53617,677,1286,380,2343,55960
30-10-2019,12,20037,21247,8525,2826,52635,664,1146,387,2197,54832
30-10-2019,13,20249,21322,8767,3041,53378,641,1127,378,2146,55524
30-10-2019,14,20492,21683,8872,2958,54006,637,943,369,1949,55955
30-10-2019,15,20210,22245,9118,2817,54390,644,1026,373,2043,56433
30-10-2019,16,21012,22782,9517,2829,56141,654,1218,371,2243,58384
30-10-2019,17,21658,23052,9488,2883,57082,672,1299,369,2340,59422
30-10-2019,18,21015,22744,9357,2892,56008,681,1275,372,2328,58336
30-10-2019,19,20080,22693,8847,2591,54210,695,957,382,2034,56244
30-10-2019,20,18534,22562,8501,2439,52037,674,863,290,1827,53864
30-10-2019,21,17698,22476,8317,2359,50849,658,474,208,1340,52189
30-10-2019,22,15707,21786,8132,2129,47755,566,441,255,1262,49017
30-10-2019,23,13945,20876,7830,1910,44562,530,438,274,1242,45804
31-10-2019,0,12741,19989,7677,1933,42339,539,438,264,1241,43580
31-10-2019,1,11495,19463,7530,1907,40396,553,437,274,1264,41660
31-10-2019,2,11201,19667,7498,1907,40275,529,440,274,1243,41518
31-10-2019,3,10994,19821,7490,1952,40256,540,437,280,1257,41513
31-10-2019,4,11624,19881,7651,1958,41114,542,435,315,1292,42406
31-10-2019,5,13416,20376,8277,1979,44051,605,546,324,1475,45526
31-10-2019,6,16536,22486,8933,2294,50249,675,936,345,1956,52205
31-10-2019,7,19581,23397,8975,2568,54522,704,1108,382,2194,56716
31-10-2019,8,20061,23291,9045,2721,55119,782,1092,412,2286,57405
31-10-2019,9,19931,23250,8958,2694,54832,672,1095,424,2191,57023
31-10-2019,10,19031,23133,8630,2555,53351,663,1038,423,2124,55475
31-10-2019,11,17814,22717,8589,2413,51532,611,966,416,1993,53525
31-10-2019,12,16633,22023,8536,2576,49769,636,953,375,1964,51733
31-10-2019,13,17266,21654,8495,2755,50172,683,950,362,1995,52167
31-10-2019,14,18576,22362,8579,2716,52233,636,971,368,1975,54208
31-10-2019,15,19769,22668,8682,2592,53711,631,955,354,1940,55651
31-10-2019,16,20256,22594,9013,2620,54485,699,1106,369,2174,56659
31-10-2019,17,20209,22866,8672,2608,54355,655,1315,362,2332,56687
31-10-2019,18,19951,22528,8486,2641,53605,633,1207,332,2172,55777
31-10-2019,19,19159,22489,8137,2331,52117,658,909,332,1899,54016
31-10-2019,20,18268,22065,7631,1997,49963,614,1128,317,2059,52022
31-10-2019,21,17410,21763,7351,1967,48491,586,679,300,1565,50056
31-10-2019,22,16245,20958,7249,2097,46550,557,524,297,1378,47928
31-10-2019,23,13395,19495,7054,2141,42085,545,426,273,1244,43329
01-11-2019,0,12615,18932,7058,2226,40831,543,424,259,1226,42057
01-11-2019,1,11078,17992,6929,2671,38670,548,422,233,1203,39873
01-11-2019,2,10969,17941,7015,2299,38223,546,420,206,1172,39395
01-11-2019,3,10897,17708,6996,2702,38304,548,420,216,1184,39488
01-11-2019,4,11704,18127,7218,2711,39759,546,424,224,1194,40953
01-11-2019,5,13213,19449,7864,2926,43453,645,536,292,1473,44926
01-11-2019,6,15419,21090,8294,3028,47832,687,849,222,1758,49590
01-11-2019,7,17242,21752,8407,3649,51049,678,946,235,1859,52908
01-11-2019,8,17859,21993,8319,3780,51952,675,981,254,1910,53862
01-11-2019,9,17497,22068,7952,4141,51658,646,865,244,1755,53413
01-11-2019,10,17369,21866,7726,4471,51431,604,740,257,1601,53032
01-11-2019,11,16696,21801,7603,4521,50621,553,742,259,1554,52175
01-11-2019,12,16031,21635,7689,4436,49790,557,818,271,1646,51436
01-11-2019,13,15860,21667,7988,4413,49927,581,967,266,1814,51741
01-11-2019,14,15648,21541,7950,4225,49364,634,937,279,1850,51214
01-11-2019,15,15903,22124,8190,4165,50383,641,936,235,1812,52195
01-11-2019,16,16533,22696,8404,4178,51813,666,976,312,1954,53767
01-11-2019,17,17292,23094,8446,4022,52855,665,978,296,1939,54794
01-11-2019,18,16926,22988,8445,4085,52443,665,934,288,1887,54330
01-11-2019,19,15461,22292,8092,3847,49693,594,510,319,1423,51116
01-11-2019,20,14026,21646,7581,3677,46929,501,455,390,1346,48275
01-11-2019,21,12990,20707,7418,3280,44395,509,457,392,1358,45753
01-11-2019,22,11889,19433,7245,2816,41382,521,426,399,1346,42728
01-11-2019,23,11095,17800,7110,2813,38820,510,367,412,1289,40109
02-11-2019,0,10947,17173,7061,2602,37783,452,215,430,1097,38880
02-11-2019,1,10716,16799,7093,2358,36965,450,216,468,1134,38099
02-11-2019,2,10571,16432,7126,2525,36655,441,216,498,1155,37810
02-11-2019,3,10503,16266,7123,2480,36373,442,222,533,1197,37570
02-11-2019,4,10521,16340,7169,2489,36519,481,225,555,1261,37780
02-11-2019,5,10552,16418,7222,2516,36707,495,245,553,1293,38000
02-11-2019,6,10689,17247,7287,2658,37881,510,296,566,1372,39253
02-11-2019,7,11618,17745,7513,2916,39793,539,300,564,1403,41196
02-11-2019,8,13258,18507,7583,3206,42553,535,299,539,1373,43926
02-11-2019,9,14664,19284,7681,3282,44911,549,293,526,1368,46279
02-11-2019,10,15231,19586,7641,3470,45929,549,293,519,1361,47290
02-11-2019,11,14829,19576,7596,3647,45646,563,294,516,1373,47019
02-11-2019,12,14409,19430,7468,3708,45015,564,290,510,1364,46379
02-11-2019,13,13970,19245,7431,3884,44528,567,293,486,1346,45874
02-11-2019,14,13734,19488,7328,3897,44447,547,302,476,1325,45772
02-11-2019,15,13867,19980,7288,4057,45192,547,307,460,1314,46506
02-11-2019,16,14691,20733,7285,4029,46738,580,312,468,1360,48098
02-11-2019,17,14947,21206,7347,3979,47479,578,307,463,1348,48827
02-11-2019,18,14711,21285,7170,4066,47234,530,303,438,1271,48505
02-11-2019,19,14319,20833,6880,3860,45893,453,301,421,1175,47068
02-11-2019,20,13987,20479,6725,3583,44776,446,299,420,1165,45941
02-11-2019,21,13288,20385,6561,3440,43675,428,294,402,1124,44799
02-11-2019,22,12507,19388,6405,3342,41643,418,297,383,1098,42741
02-11-2019,23,11522,18381,6263,3366,39532,415,282,390,1087,40619
03-11-2019,0,10947,17427,6234,3316,37925,420,212,376,1008,38933
03-11-2019,1,10935,16807,6263,3037,37045,413,211,373,997,38042
03-11-2019,2,10750,16536,6309,2868,36463,383,208,405,996,37459
03-11-2019,3,10669,16647,6321,2911,36548,371,207,437,1015,37563
03-11-2019,4,10570,16738,6370,2917,36596,382,213,409,1004,37600
03-11-2019,5,10492,17190,6420,2964,37066,386,212,393,991,38057
03-11-2019,6,10288,17900,6531,2737,37456,397,211,373,981,38437
03-11-2019,7,10840,19128,6613,2484,39066,377,222,367,966,40032
03-11-2019,8,12139,20214,6695,2420,41469,378,261,343,982,42451
03-11-2019,9,13058,21068,6687,2482,43296,418,275,330,1023,44319
03-11-2019,10,13582,21595,6710,2641,44528,433,283,287,1003,45531
03-11-2019,11,14227,22170,6796,2695,45890,455,275,317,1047,46937
03-11-2019,12,14552,22420,6859,2533,46365,439,272,269,980,47345
03-11-2019,13,14217,21810,6769,2366,45162,449,268,269,986,46148
03-11-2019,14,14662,22336,6907,2378,46284,442,281,291,1014,47298
03-11-2019,15,15255,22593,7068,2163,47079,458,283,308,1049,48128
03-11-2019,16,16157,22875,7261,2197,48491,468,267,367,1102,49593
03-11-2019,17,17966,23299,7477,2132,50874,507,269,323,1099,51973
03-11-2019,18,18392,23344,7469,2251,51457,475,275,325,1075,52532
03-11-2019,19,16743,22769,7237,2233,48982,435,276,310,1021,50003
03-11-2019,20,15319,22086,7135,2056,46597,440,278,295,1013,47610
03-11-2019,21,14343,21385,7065,2198,44991,444,272,273,989,45980
03-11-2019,22,13283,20435,6811,2680,43209,453,250,244,947,44156
03-11-2019,23,11874,19024,6707,2916,40520,473,207,227,907,41427
04-11-2019,0,11698,17910,6752,2951,39311,547,203,201,951,40262
04-11-2019,1,11642,17541,6683,2975,38841,546,203,189,938,39779
04-11-2019,2,11566,17549,6641,3179,38937,532,203,182,917,39854
04-11-2019,3,11724,17454,6649,3474,39299,548,205,174,927,40226
04-11-2019,4,12319,17577,6784,3883,40561,570,229,175,974,41535
04-11-2019,5,13217,19122,7181,3784,43305,600,264,219,1083,44388
04-11-2019,6,16019,21099,7820,4168,49106,669,279,262,1210,50316
04-11-2019,7,19353,22529,7979,5042,54904,691,338,223,1252,56156
04-11-2019,8,20924,22716,7875,5064,56579,678,446,242,1366,57945
04-11-2019,9,21375,22676,7669,5269,56987,735,540,465,1740,58727
04-11-2019,10,21102,22643,7677,5487,56910,764,467,465,1696,58606
04-11-2019,11,20548,22668,7764,5588,56570,758,481,395,1634,58204
04-11-2019,12,19879,22784,7718,5546,55927,766,481,447,1694,57621
04-11-2019,13,20231,22760,7623,5612,56226,803,466,417,1686,57912
04-11-2019,14,20458,22860,7650,5381,56348,802,527,373,1702,58050
04-11-2019,15,20568,23090,7811,5331,56801,793,594,435,1822,58623
04-11-2019,16,21213,23257,8017,5294,57782,818,719,523,2060,59842
04-11-2019,17,21532,23353,7901,5322,58108,839,1023,532,2394,60502
04-11-2019,18,21337,23063,7710,5246,57357,815,827,523,2165,59522
04-11-2019,19,21257,23206,7657,5043,57163,745,458,351,1554,58717
04-11-2019,20,19656,22699,7255,4956,54567,760,451,357,1568,56135
04-11-2019,21,17581,22126,7018,4632,51357,749,447,335,1531,52888
04-11-2019,22,16499,20535,6886,4394,48315,728,447,300,1475,49790
04-11-2019,23,14941,19523,6790,4373,45628,725,457,293,1475,47103
05-11-2019,0,15017,18985,6962,4363,45327,747,376,274,1397,46724
05-11-2019,1,14635,18573,6887,4335,44431,723,330,278,1331,45762
05-11-2019,2,14385,18369,6882,4237,43873,718,303,327,1348,45221
05-11-2019,3,14377,18212,6944,4155,43688,717,298,342,1357,45045
05-11-2019,4,15111,18947,7213,4092,45364,739,327,354,1420,46784
05-11-2019,5,16770,20290,8080,3905,49045,779,300,444,1523,50568
05-11-2019,6,18754,21442,8648,4045,52888,802,471,568,1841,54729
05-11-2019,7,21287,22729,8787,4464,57267,794,549,585,1928,59195
05-11-2019,8,22138,22854,8749,4547,58289,774,901,597,2272,60561
05-11-2019,9,22134,22716,8399,4498,57748,793,553,545,1891,59639
05-11-2019,10,22304,22595,7968,4551,57418,809,578,458,1845,59263
05-11-2019,11,22216,22442,8071,4200,56930,814,616,349,1779,58709
05-11-2019,12,22222,22354,8156,4011,56744,815,732,364,1911,58655
05-11-2019,13,22290,22269,8637,3816,57012,817,866,555,2238,59250
05-11-2019,14,22390,22257,8868,3626,57143,816,1003,558,2377,59520
05-11-2019,15,22468,22559,8955,3589,57570,790,1005,564,2359,59929
05-11-2019,16,22495,22724,9111,3634,57963,755,1223,744,2722,60685
05-11-2019,17,23317,22991,9082,3828,59217,743,1413,688,2844,62061
05-11-2019,18,23713,22840,8952,3805,59310,759,1266,605,2630,61940
05-11-2019,19,23549,22635,8376,3217,57777,718,731,505,1954,59731
05-11-2019,20,23553,22317,7932,3054,56857,678,442,345,1465,58322
05-11-2019,21,21265,21936,7598,2530,53330,663,428,352,1443,54773
05-11-2019,22,18425,20894,7649,2235,49204,655,428,351,1434,50638
05-11-2019,23,16215,19491,7395,2579,45681,655,448,319,1422,47103
06-11-2019,0,16023,18321,7254,2675,44275,665,300,377,1342,45617
06-11-2019,1,15597,17907,7288,2576,43367,671,294,332,1297,44664
06-11-2019,2,15501,17792,7235,2373,42901,690,299,293,1282,44183
06-11-2019,3,15794,17809,7298,2334,43235,712,316,301,1329,44564
06-11-2019,4,16615,18004,7739,2347,44707,700,319,333,1352,46059
06-11-2019,5,17831,19122,8407,2424,47786,905,574,313,1792,49578
06-11-2019,6,22040,20626,8840,2348,53853,929,1099,521,2549,56402
06-11-2019,7,22986,22020,8892,2877,56774,921,1216,512,2649,59423
06-11-2019,8,22678,22094,8959,2847,56578,938,1372,529,2839,59417
06-11-2019,9,22842,21893,8614,2725,56075,926,1150,432,2508,58583
06-11-2019,10,22763,21917,8212,2561,55454,922,1206,437,2565,58019
06-11-2019,11,22891,21864,8110,2598,55462,943,1288,454,2685,58147
06-11-2019,12,22759,21635,8276,2593,55263,932,1310,464,2706,57969
06-11-2019,13,22793,21692,8793,2705,55981,943,1471,544,2958,58939
06-11-2019,14,22407,21684,8914,2645,55651,941,1472,509,2922,58573
06-11-2019,15,22186,21701,9050,2490,55428,951,1472,472,2895,58323
06-11-2019,16,22735,21762,9203,2577,56276,961,1548,496,3005,59281
06-11-2019,17,23306,22069,9212,2999,57586,958,1691,562,3211,60797
06-11-2019,18,23577,21856,9071,2765,57270,950,1697,589,3236,60506
06-11-2019,19,23454,21748,8711,2695,56610,909,1408,571,2888,59498
06-11-2019,20,23147,21597,8327,2307,55380,879,818,555,2252,57632
06-11-2019,21,22633,20966,8010,1912,53521,689,568,449,1706,55227
06-11-2019,22,20839,19974,7578,1640,50031,645,433,443,1521,51552
06-11-2019,23,18046,18598,7257,1825,45726,632,433,417,1482,47208
07-11-2019,0,17278,17551,7216,1907,43951,647,509,394,1550,45501
07-11-2019,1,16416,17274,7161,1820,42670,628,508,400,1536,44206
07-11-2019,2,16133,17225,7151,1770,42278,617,505,353,1475,43753
07-11-2019,3,16454,17221,7331,1721,42728,620,507,313,1440,44168
07-11-2019,4,17600,17460,7667,1874,44601,635,541,315,1491,46092
07-11-2019,5,19198,18040,8432,2144,47814,779,822,434,2035,49849
07-11-2019,6,21706,19966,9011,1996,52679,855,1153,364,2372,55051
07-11-2019,7,22966,21520,9064,2272,55824,860,1223,311,2394,58218
07-11-2019,8,22885,21671,9089,2792,56438,840,1437,296,2573,59011
07-11-2019,9,22945,21511,8832,2677,55965,883,1132,214,2229,58194
07-11-2019,10,22874,21502,8293,2851,55520,928,909,195,2032,57552
07-11-2019,11,22634,21159,8200,2953,54945,927,858,192,1977,56922
07-11-2019,12,22368,20795,8400,2871,54434,935,1081,202,2218,56652
07-11-2019,13,22411,20868,8875,2839,54993,941,1305,396,2642,57635
07-11-2019,14,22276,21011,8785,2820,54893,957,1239,226,2422,57315
07-11-2019,15,22642,21237,9024,2927,55829,951,1318,247,2516,58345
07-11-2019,16,22869,21859,9184,3178,57089,956,1410,266,2632,59721
07-11-2019,17,23195,21830,9077,3570,57673,973,1424,246,2643,60316
07-11-2019,18,23259,21535,9004,3468,57266,978,1395,239,2612,59878
07-11-2019,19,22738,21070,8348,3464,55620,958,1014,179,2151,57771
07-11-2019,20,21389,20808,7651,3358,53206,946,734,184,1864,55070
07-11-2019,21,19465,20507,7522,3526,51022,796,588,185,1569,52591
07-11-2019,22,18172,19868,7228,3307,48575,677,583,194,1454,50029
07-11-2019,23,17057,18505,7127,3185,45872,628,522,186,1336,47208
08-11-2019,0,15988,17133,7147,3410,43679,631,511,196,1338,45017
08-11-2019,1,15293,17110,7079,3483,42967,630,511,191,1332,44299
08-11-2019,2,14711,17010,7064,3590,42375,629,523,183,1335,43710
08-11-2019,3,14677,17050,7151,3782,42660,629,524,177,1330,43990
08-11-2019,4,15569,17240,7553,3506,43868,635,560,173,1368,45236
08-11-2019,5,17690,17866,8351,3394,47302,846,760,174,1780,49082
08-11-2019,6,21535,19867,8885,3285,53571,930,1196,239,2365,55936
08-11-2019,7,23810,21772,8928,2904,57415,940,1330,239,2509,59924
08-11-2019,8,24141,22489,8903,3093,58625,944,1323,409,2676,61301
08-11-2019,9,23874,21955,8429,3042,57300,930,1231,237,2398,59698
08-11-2019,10,24010,22036,8179,2692,56918,899,1227,233,2359,59277
08-11-2019,11,24219,22262,8187,2639,57307,908,1227,248,2383,59690
08-11-2019,12,23769,21811,8358,2651,56590,912,1230,254,2396,58986
08-11-2019,13,23790,21446,8544,2967,56747,932,1322,460,2714,59461
08-11-2019,14,23843,21517,8660,2685,56707,934,1361,483,2778,59485
08-11-2019,15,24464,22065,8747,2766,58043,952,1367,506,2825,60868
08-11-2019,16,24370,22405,8723,2806,58305,989,1371,541,2901,61206
08-11-2019,17,24465,22336,8653,3023,58477,999,1573,592,3164,61641
08-11-2019,18,24082,22141,8637,2978,57838,1023,1417,563,3003,60841
08-11-2019,19,23296,21901,7957,2718,55873,880,958,328,2166,58039
08-11-2019,20,22348,21306,7583,2200,53438,659,496,315,1470,54908
08-11-2019,21,21593,20626,7269,1991,51480,613,502,315,1430,52910
08-11-2019,22,20522,19862,7033,1910,49329,554,422,303,1279,50608
08-11-2019,23,18141,18111,6927,1793,44973,547,364,318,1229,46202
09-11-2019,0,18490,17257,6773,1674,44194,557,273,298,1128,45322
09-11-2019,1,16307,16814,6640,1781,41544,536,274,258,1068,42612
09-11-2019,2,15162,16653,6613,1749,40178,522,270,264,1056,41234
09-11-2019,3,14546,16625,6527,1646,39344,514,270,267,1051,40395
09-11-2019,4,14642,16766,6604,1668,39680,486,269,288,1043,40723
09-11-2019,5,14994,17033,6747,1708,40482,505,271,311,1087,41569
09-11-2019,6,16507,17483,6804,1824,42618,506,270,282,1058,43676
09-11-2019,7,18684,18192,6905,1997,45777,504,271,277,1052,46829
09-11-2019,8,19750,19302,7136,2144,48332,507,271,254,1032,49364
09-11-2019,9,21508,19986,7416,2377,51289,505,305,261,1071,52360
09-11-2019,10,21813,20384,7375,2417,51989,535,321,253,1109,53098
09-11-2019,11,21080,20160,7266,2354,50863,529,280,243,1052,51915
09-11-2019,12,20754,20028,7445,2320,50546,470,477,169,1116,51662
09-11-2019,13,19438,19699,7319,2307,48762,482,481,181,1144,49906
09-11-2019,14,19431,19832,7208,2203,48676,478,463,197,1138,49814
09-11-2019,15,20950,20461,7245,2246,50903,501,594,206,1301,52204
09-11-2019,16,22135,21227,7607,2478,53448,533,836,231,1600,55048
09-11-2019,17,22678,22265,7779,2772,55495,531,843,246,1620,57115
09-11-2019,18,22556,22155,7730,2813,55255,497,624,275,1396,56651
09-11-2019,19,22024,21452,7471,2684,53630,483,532,317,1332,54962
09-11-2019,20,20709,20757,7252,2370,51089,477,369,346,1192,52281
09-11-2019,21,18204,19994,7077,2247,47521,484,248,349,1081,48602
09-11-2019,22,16356,19583,6925,2137,45003,485,247,349,1081,46084
09-11-2019,23,14564,18749,6881,1719,41913,484,244,354,1082,42995
10-11-2019,0,13923,18158,6861,1449,40391,491,247,348,1086,41477
10-11-2019,1,13283,17628,6836,1378,39125,503,247,378,1128,40253
10-11-2019,2,12973,17246,6751,1432,38403,506,276,401,1183,39586
10-11-2019,3,12898,17218,6812,1540,38469,504,278,374,1156,39625
10-11-2019,4,13106,17321,6829,1826,39081,518,275,393,1186,40267
10-11-2019,5,13256,17546,6911,1772,39486,543,276,366,1185,40671
10-11-2019,6,13350,17965,7006,1751,40072,568,280,378,1226,41298
10-11-2019,7,14259,18375,7051,1912,41599,584,278,413,1275,42874
10-11-2019,8,15458,18648,7163,1922,43192,586,280,424,1290,44482
10-11-2019,9,16520,19176,7101,2202,45000,586,332,431,1349,46349
10-11-2019,10,17615,19342,7185,2191,46332,588,406,395,1389,47721
10-11-2019,11,18094,19549,7235,2169,47048,606,487,352,1445,48493
10-11-2019,12,18435,19421,7248,2244,47350,621,491,313,1425,48775
10-11-2019,13,18200,19637,7381,2102,47319,632,484,287,1403,48722
10-11-2019,14,18220,19295,7427,1959,46900,611,589,255,1455,48355
10-11-2019,15,19992,19738,7435,1882,49047,614,582,252,1448,50495
10-11-2019,16,22104,21094,7589,2213,53000,646,665,235,1546,54546
10-11-2019,17,22825,21417,7784,2420,54448,666,831,221,1718,56166
10-11-2019,18,22784,21544,7837,2597,54764,672,704,187,1563,56327
10-11-2019,19,22404,21318,7723,2780,54225,645,652,170,1467,55692
10-11-2019,20,22273,20941,7646,3004,53864,634,649,162,1445,55309
10-11-2019,21,21757,20509,7517,2649,52434,588,558,163,1309,53743
10-11-2019,22,20922,19350,7361,2727,50361,567,550,160,1277,51638
10-11-2019,23,17721,17943,7077,2932,45674,541,316,154,1011,46685
11-11-2019,0,15094,17144,6960,3004,42202,531,374,155,1060,43262
11-11-2019,1,14381,17051,6964,2850,41245,504,372,159,1035,42280
11-11-2019,2,14102,16957,6986,2895,40943,495,370,171,1036,41979
11-11-2019,3,14351,17068,7014,2855,41288,491,376,168,1035,42323
11-11-2019,4,15023,17314,7126,2726,42189,485,487,168,1140,43329
11-11-2019,5,17129,18495,7560,2508,45693,528,784,167,1479,47172
11-11-2019,6,20929,20689,8055,2678,52350,558,899,162,1619,53969
11-11-2019,7,23072,22700,8282,2995,57048,561,1021,168,1750,58798
11-11-2019,8,23350,22750,8303,3442,57846,557,1106,199,1862,59708
11-11-2019,9,23594,22809,7978,3721,58104,529,1075,169,1773,59877
11-11-2019,10,23080,22445,7650,4059,57234,521,1072,170,1763,58997
11-11-2019,11,23203,22301,7578,3904,56986,517,1107,175,1799,58785
11-11-2019,12,22793,22237,7715,4047,56793,503,1103,183,1789,58582
11-11-2019,13,23336,22662,8013,4511,58521,550,1179,205,1934,60455
11-11-2019,14,22932,22267,8083,4544,57826,548,1278,215,2041,59867
11-11-2019,15,23613,22523,8266,4408,58810,559,1300,208,2067,60877
11-11-2019,16,23929,22901,8421,4374,59624,567,1294,183,2044,61668
11-11-2019,17,24565,22857,8370,4805,60599,568,1120,238,1926,62525
11-11-2019,18,23339,22491,8197,4738,58766,623,1090,193,1906,60672
11-11-2019,19,21738,21554,7902,5032,56227,544,801,187,1532,57759
11-11-2019,20,19682,20822,7480,5358,53343,544,621,205,1370,54713
11-11-2019,21,18160,20280,7171,5460,51070,532,666,222,1420,52490
11-11-2019,22,16698,19625,6908,5391,48622,516,514,210,1240,49862
11-11-2019,23,14773,18652,6729,5343,45498,517,502,213,1232,46730
12-11-2019,0,13670,18136,6815,4920,43542,550,403,233,1186,44728
12-11-2019,1,13068,17666,6717,4740,42191,566,406,265,1237,43428
12-11-2019,2,13002,17704,6751,4774,42232,562,398,280,1240,43472
12-11-2019,3,13042,17650,6829,4914,42435,561,401,374,1336,43771
12-11-2019,4,13660,17890,7142,4929,43621,557,408,407,1372,44993
12-11-2019,5,15367,18680,7740,4999,46786,618,657,413,1688,48474
12-11-2019,6,18178,20658,8328,5027,52189,679,896,483,2058,54247
12-11-2019,7,21330,22275,8325,4969,56898,747,936,501,2184,59082
12-11-2019,8,21854,22140,8190,5409,57593,829,934,562,2325,59918
12-11-2019,9,21430,21991,7937,5871,57229,775,659,566,2000,59229
12-11-2019,10,21214,22199,7544,6085,57043,723,654,572,1949,58992
12-11-2019,11,20469,21976,7429,6134,56009,719,634,531,1884,57893
12-11-2019,12,20019,21896,7711,5853,55478,780,630,495,1905,57383
12-11-2019,13,20983,21998,8212,5727,56921,841,975,442,2258,59179
12-11-2019,14,21681,22024,8387,5208,57300,851,983,405,2239,59539
12-11-2019,15,22783,22452,8700,5290,59225,910,983,435,2328,61553
12-11-2019,16,23488,22632,8842,5322,60285,968,1000,590,2558,62843
12-11-2019,17,23883,22276,8754,5332,60243,970,1207,637,2814,63057
12-11-2019,18,23177,22069,8551,5327,59124,937,1122,412,2471,61595
12-11-2019,19,20896,21612,8298,4757,55562,817,482,371,1670,57232
12-11-2019,20,18854,21029,8085,4506,52476,768,434,361,1563,54039
12-11-2019,21,17300,20088,7903,4521,49812,759,427,327,1513,51325
12-11-2019,22,15349,19008,7775,4146,46278,745,422,320,1487,47765
12-11-2019,23,13727,18144,7761,3817,43449,725,416,357,1498,44947
13-11-2019,0,12079,17554,7745,3656,41034,701,416,369,1486,42520
13-11-2019,1,11617,17186,7646,3480,39929,676,411,378,1465,41394
13-11-2019,2,11431,16946,7625,3375,39378,658,409,386,1453,40831
13-11-2019,3,11800,17156,7653,3207,39817,656,420,414,1490,41307
13-11-2019,4,12907,17655,7615,3197,41375,657,462,444,1563,42938
13-11-2019,5,15283,19023,7814,3376,45496,672,568,468,1708,47204
13-11-2019,6,18513,20505,8284,3532,50835,799,1111,448,2358,53193
13-11-2019,7,22278,21101,8451,4119,55950,879,1316,648,2843,58793
13-11-2019,8,22069,20423,8637,4444,55573,912,1334,600,2846,58419
13-11-2019,9,21803,20205,8191,4398,54597,902,1367,339,2608,57205
13-11-2019,10,22059,19908,7955,4403,54325,911,1322,303,2536,56861
13-11-2019,11,21957,19897,7699,4723,54276,926,1319,330,2575,56851
13-11-2019,12,22364,19861,7857,4614,54697,907,1262,279,2448,57145
13-11-2019,13,22171,19596,8044,4986,54800,919,1627,289,2835,57635
13-11-2019,14,22483,20053,8278,4626,55440,920,1649,299,2868,58308
13-11-2019,15,22776,20279,8321,4912,56288,911,1651,529,3091,59379
13-11-2019,16,22944,20242,8399,5435,57020,898,1651,576,3125,60145
13-11-2019,17,22979,20117,8321,5696,57114,908,1648,619,3175,60289
13-11-2019,18,22955,20056,7997,5642,56651,860,1643,598,3101,59752
13-11-2019,19,22372,20657,7722,5313,56066,822,1117,377,2316,58382
13-11-2019,20,21468,20463,7223,4593,53748,661,610,393,1664,55412
13-11-2019,21,20139,19629,6841,3954,50564,655,482,389,1526,52090
13-11-2019,22,17839,18528,6507,3226,46101,625,497,348,1470,47571
13-11-2019,23,15354,17590,6246,2991,42181,619,501,380,1500,43681
14-11-2019,0,14099,16081,6284,2865,39329,617,540,391,1548,40877
14-11-2019,1,13314,15873,6209,2607,38003,609,537,458,1604,39607
14-11-2019,2,12880,15661,6169,2551,37262,606,534,529,1669,38931
14-11-2019,3,13043,15610,6320,2420,37392,605,540,546,1691,39083
14-11-2019,4,13746,15790,6627,2201,38366,646,631,527,1804,40170
14-11-2019,5,16020,16761,7214,2282,42278,716,973,523,2212,44490
14-11-2019,6,19930,19801,7766,2757,50254,873,1018,520,2411,52665
14-11-2019,7,22437,20916,7816,3248,54418,967,1400,526,2893,57311
14-11-2019,8,22605,20707,7972,3343,54627,993,1471,537,3001,57628
14-11-2019,9,21926,20736,7702,3121,53486,988,1299,378,2665,56151
14-11-2019,10,21613,20616,7344,3075,52649,970,1066,358,2394,55043
14-11-2019,11,22297,20758,7267,3041,53363,949,1063,351,2363,55726
14-11-2019,12,21930,20920,7339,3166,53354,965,1264,301,2530,55884
14-11-2019,13,22043,21041,7754,3175,54014,1005,1641,316,2962,56976
14-11-2019,14,22545,21044,7907,3272,54767,999,1678,287,2964,57731
14-11-2019,15,22762,21122,8071,3223,55177,964,1675,468,3107,58284
14-11-2019,16,22998,21283,8275,3288,55843,947,1732,458,3137,58980
14-11-2019,17,22770,21131,8427,3635,55962,938,1753,411,3102,59064
14-11-2019,18,21514,20896,8149,3540,54099,910,1555,175,2640,56739
14-11-2019,19,20761,20949,7696,3131,52537,793,840,168,1801,54338
14-11-2019,20,19531,20566,7397,3213,50707,642,738,167,1547,52254
14-11-2019,21,18483,19864,7259,3185,48792,609,651,169,1429,50221
14-11-2019,22,16609,18924,7087,3129,45750,550,648,172,1370,47120
14-11-2019,23,15154,17752,6916,3164,42987,590,648,198,1436,44423
15-11-2019,0,13539,17285,6845,3066,40735,600,878,235,1713,42448
15-11-2019,1,12643,16959,6825,3156,39583,594,889,310,1793,41376
15-11-2019,2,12200,16791,6900,3488,39378,578,889,333,1800,41178
15-11-2019,3,11960,16497,7045,3855,39359,561,892,393,1846,41205
15-11-2019,4,12380,16611,7279,4138,40409,573,1080,460,2113,42522
15-11-2019,5,13980,18009,7660,4731,44381,612,1094,433,2139,46520
15-11-2019,6,16797,19387,8110,5042,49337,713,1284,414,2411,51748
15-11-2019,7,18870,20746,8132,5405,53152,769,1545,423,2737,55889
15-11-2019,8,19597,21168,8153,5955,54873,788,1603,402,2793,57666
15-11-2019,9,19323,21385,7656,6163,54527,768,1376,398,2542,57069
15-11-2019,10,19458,21119,7489,6413,54479,738,1372,385,2495,56974
15-11-2019,11,19212,21239,7368,6302,54121,722,1371,349,2442,56563
15-11-2019,12,19454,21875,7583,6193,55105,781,1372,304,2457,57562
15-11-2019,13,19287,22012,7896,6248,55442,807,1648,464,2919,58361
15-11-2019,14,19446,21553,7998,6619,55616,791,1657,373,2821,58437
15-11-2019,15,20791,22091,8261,5973,57118,821,1659,411,2891,60009
15-11-2019,16,21388,22339,8355,5793,57876,827,1656,624,3107,60983
15-11-2019,17,22023,22551,8251,5623,58449,850,1657,518,3025,61474
15-11-2019,18,21595,22305,7978,5696,57574,855,1650,386,2891,60465
15-11-2019,19,20298,21936,7410,5603,55247,688,1291,327,2306,57553
15-11-2019,20,18435,21438,7078,5528,52478,594,1266,339,2199,54677
15-11-2019,21,17581,21096,6922,5466,51067,571,886,333,1790,52857
15-11-2019,22,16095,20436,6894,5175,48599,591,874,325,1790,50389
15-11-2019,23,14507,19153,6773,4604,45037,586,862,314,1762,46799
16-11-2019,0,13641,17952,6574,4159,42326,579,433,292,1304,43630
16-11-2019,1,13248,17195,6418,3813,40674,555,424,288,1267,41941
16-11-2019,2,12821,16941,6456,3393,39611,553,423,289,1265,40876
16-11-2019,3,13228,17208,6488,3312,40238,554,425,282,1261,41499
16-11-2019,4,13202,17348,6537,3166,40253,545,427,304,1276,41529
16-11-2019,5,13309,17571,6573,2800,40252,537,648,315,1500,41752
16-11-2019,6,13399,18398,6734,2719,41250,538,688,311,1537,42787
16-11-2019,7,15287,19330,6983,2933,44533,540,863,322,1725,46258
16-11-2019,8,17647,21092,7250,3145,49136,560,896,336,1792,50928
16-11-2019,9,19082,21448,7340,3116,50986,555,1076,355,1986,52972
16-11-2019,10,18402,21312,7404,2932,50051,567,1104,406,2077,52128
16-11-2019,11,17528,21285,7379,2765,48957,571,1130,387,2088,51045
16-11-2019,12,15812,20816,7347,2654,46630,577,1133,396,2106,48736
16-11-2019,13,15969,20946,7333,2706,46953,588,1154,412,2154,49107
16-11-2019,14,15903,20963,7344,2935,47144,580,1356,409,2345,49489
16-11-2019,15,16222,21001,7726,2968,47916,601,1303,421,2325,50241
16-11-2019,16,17328,21529,7994,3070,49921,619,1357,439,2415,52336
16-11-2019,17,18385,21681,7447,3142,50655,598,1089,448,2135,52790
16-11-2019,18,17458,21042,7241,3236,48977,601,1073,459,2133,51110
16-11-2019,19,15775,20691,7246,3241,46954,617,957,449,2023,48977
16-11-2019,20,14456,20225,7095,3275,45050,592,816,422,1830,46880
16-11-2019,21,14115,19518,6992,3417,44042,581,452,437,1470,45512
16-11-2019,22,13503,18834,6897,3585,42818,594,443,430,1467,44285
16-11-2019,23,12866,17795,6753,3851,41265,568,438,405,1411,42676
17-11-2019,0,12760,16684,6826,4015,40285,606,435,401,1442,41727
17-11-2019,1,12474,16410,6864,3992,39739,601,434,402,1437,41176
17-11-2019,2,12258,16261,6843,3911,39274,645,396,368,1409,40683
17-11-2019,3,12117,16160,6846,3876,38998,654,374,312,1340,40338
17-11-2019,4,12207,16133,6968,3610,38917,665,440,253,1358,40275
17-11-2019,5,12585,16286,7108,3361,39339,686,621,217,1524,40863
17-11-2019,6,12675,16451,7106,3113,39346,679,617,197,1493,40839
17-11-2019,7,13417,16828,7199,3083,40528,659,624,191,1474,42002
17-11-2019,8,14235,17517,7180,3142,42075,667,622,196,1485,43560
17-11-2019,9,14611,18478,7208,3218,43515,651,623,188,1462,44977
17-11-2019,10,15346,19460,7435,3186,45427,643,711,180,1534,46961
17-11-2019,11,16359,20068,7523,3086,47036,642,831,183,1656,48692
17-11-2019,12,15099,19406,7429,2742,44677,620,978,191,1789,46466
17-11-2019,13,15126,19336,7290,2518,44270,594,982,200,1776,46046
17-11-2019,14,15184,19220,7266,2401,44072,566,979,211,1756,45828
17-11-2019,15,16622,19566,7264,2315,45767,587,973,242,1802,47569
17-11-2019,16,18858,20306,7459,2452,49077,587,991,284,1862,50939
17-11-2019,17,20626,20900,7607,2556,51689,640,983,294,1917,53606
17-11-2019,18,20111,20554,7513,2522,50700,636,975,312,1923,52623
17-11-2019,19,18447,19699,7374,2507,48026,602,950,353,1905,49931
17-11-2019,20,16489,19218,7289,2519,45515,572,846,367,1785,47300
17-11-2019,21,15381,18524,7214,2264,43384,549,449,352,1350,44734
17-11-2019,22,14599,17429,6927,2311,41267,553,425,321,1299,42566
17-11-2019,23,13802,16520,6741,2387,39449,549,436,330,1315,40764
18-11-2019,0,12806,16525,6528,2592,38453,476,406,341,1223,39676
18-11-2019,1,12274,16238,6408,2734,37654,448,396,338,1182,38836
18-11-2019,2,12263,16378,6479,2936,38057,441,381,368,1190,39247
18-11-2019,3,12038,16311,6582,3518,38450,436,381,375,1192,39642
18-11-2019,4,12549,17111,6995,3954,40609,432,388,372,1192,41801
18-11-2019,5,13911,18409,7733,4602,44657,493,677,382,1552,46209
18-11-2019,6,17738,20615,8033,4614,51001,519,1033,393,1945,52946
18-11-2019,7,21460,21842,8130,4301,55732,531,1069,559,2159,57891
18-11-2019,8,22880,22068,8083,3987,57016,552,1441,554,2547,59563
18-11-2019,9,22970,22508,7929,3715,57123,564,1220,420,2204,59327
18-11-2019,10,22914,22484,7766,3880,57046,573,1072,417,2062,59108
18-11-2019,11,22711,22487,7931,3632,56763,631,1022,417,2070,58833
18-11-2019,12,22390,22596,8117,3540,56643,629,1209,547,2385,59028
18-11-2019,13,22501,22778,8340,3459,57078,627,1565,645,2837,59915
18-11-2019,14,22517,22793,8213,3591,57114,621,1573,628,2822,59936
18-11-2019,15,22596,23006,8141,3086,56830,641,1556,620,2817,59647
18-11-2019,16,22626,23233,8047,3158,57065,673,1559,681,2913,59978
18-11-2019,17,22571,23105,7924,3396,56996,720,1486,709,2915,59911
18-11-2019,18,21528,22711,7899,3231,55370,663,1345,637,2645,58015
18-11-2019,19,19670,21723,7484,3286,52163,618,1034,477,2129,54292
18-11-2019,20,16908,20871,7147,3245,48172,613,785,454,1852,50024
18-11-2019,21,15724,20658,7087,3242,46711,596,431,398,1425,48136
18-11-2019,22,14576,19283,7014,3154,44028,582,418,361,1361,45389
18-11-2019,23,13546,18138,7035,3164,41885,596,417,331,1344,43229
19-11-2019,0,12483,17331,7016,3180,40010,604,524,351,1479,41489
19-11-2019,1,11736,16752,6939,3418,38847,614,528,367,1509,40356
19-11-2019,2,11042,16619,6987,3609,38257,615,455,386,1456,39713
19-11-2019,3,10778,16667,7108,3763,38316,622,461,381,1464,39780
19-11-2019,4,11557,16776,7247,3739,39319,646,668,353,1667,40986
19-11-2019,5,13421,18278,7815,3742,43256,684,845,333,1862,45118
19-11-2019,6,16382,19562,8235,3648,47829,755,1126,335,2216,50045
19-11-2019,7,19562,21603,8560,3725,53449,788,1247,313,2348,55797
19-11-2019,8,20921,22731,8508,3258,55417,747,1251,302,2300,57717
19-11-2019,9,20138,22357,7935,3487,53917,702,1137,250,2089,56006
19-11-2019,10,19684,22049,7829,3503,53066,688,1140,265,2093,55159
19-11-2019,11,19881,22302,7853,3374,53409,718,1134,288,2140,55549
19-11-2019,12,20080,22252,7954,3599,53885,683,1144,328,2155,56040
19-11-2019,13,20969,22491,8389,3828,55678,673,1308,342,2323,58001
19-11-2019,14,20866,22639,8612,4059,56177,696,1319,380,2395,58572
19-11-2019,15,20900,22924,8919,3630,56375,700,1393,424,2517,58892
19-11-2019,16,21183,23174,8931,3674,56962,715,1465,446,2626,59588
19-11-2019,17,21187,23133,8838,4447,57604,715,1547,460,2722,60326
19-11-2019,18,21022,22758,8515,4441,56737,725,1473,427,2625,59362
19-11-2019,19,20196,22181,8082,4107,54566,682,1143,384,2209,56775
19-11-2019,20,19365,21491,7856,3748,52462,693,841,363,1897,54359
19-11-2019,21,18581,21171,7676,3385,50814,692,653,357,1702,52516
19-11-2019,22,17239,19704,7427,2876,47245,677,550,326,1553,48798
19-11-2019,23,14938,18915,7211,2534,43597,674,539,303,1516,45113
20-11-2019,0,13596,17976,7044,2135,40752,662,533,281,1476,42228
20-11-2019,1,13252,17774,7096,1796,39920,672,532,268,1472,41392
20-11-2019,2,13082,17800,7173,1663,39718,669,531,264,1464,41182
20-11-2019,3,13574,17581,7294,1618,40067,634,529,261,1424,41491
20-11-2019,4,14769,17613,7536,1584,41503,648,529,265,1442,42945
20-11-2019,5,17302,18809,8075,1621,45808,677,736,299,1712,47520
20-11-2019,6,19905,20818,8548,1933,51204,676,1262,328,2266,53470
20-11-2019,7,21647,21903,8750,2299,54600,770,1364,625,2759,57359
20-11-2019,8,21960,22014,8756,2454,55184,793,1376,623,2792,57976
20-11-2019,9,21679,21962,8502,2574,54717,779,1299,347,2425,57142
20-11-2019,10,21581,21926,8271,2589,54367,772,1085,428,2285,56652
20-11-2019,11,21696,21783,8073,2821,54373,776,1073,361,2210,56583
20-11-2019,12,21519,21866,8139,2883,54409,756,1282,383,2421,56830
20-11-2019,13,21688,22025,8364,2875,54952,757,1524,535,2816,57768
20-11-2019,14,21733,22179,8433,2761,55107,749,1537,548,2834,57941
20-11-2019,15,22065,22261,8620,2946,55892,773,1698,641,3112,59004
20-11-2019,16,22233,22588,8654,3261,56736,805,1703,661,3169,59905
20-11-2019,17,21820,22955,8619,3415,56810,811,1704,727,3242,60052
20-11-2019,18,21376,23101,8443,3415,56335,771,1693,603,3067,59402
20-11-2019,19,21109,22473,7893,3253,54730,662,1030,459,2151,56881
20-11-2019,20,19958,22215,7374,3106,52655,641,942,461,2044,54699
20-11-2019,21,18983,21053,7117,2668,49822,643,751,470,1864,51686
20-11-2019,22,16822,20291,7028,2538,46680,642,543,444,1629,48309
20-11-2019,23,14491,19233,6825,2607,43157,645,533,463,1641,44798
21-11-2019,0,13915,18407,6685,2362,41370,636,538,440,1614,42984
21-11-2019,1,13151,18067,6573,2475,40267,648,539,482,1669,41936
21-11-2019,2,12333,17624,6537,2363,38858,656,545,499,1700,40558
21-11-2019,3,12446,17798,6621,2280,39145,664,547,497,1708,40853
21-11-2019,4,13833,18072,6826,2295,41027,680,555,492,1727,42754
21-11-2019,5,16163,18851,7250,2432,44697,681,766,512,1959,46656
21-11-2019,6,19273,20854,7823,2366,50316,694,1158,590,2442,52758
21-11-2019,7,20904,22121,8237,2734,53997,748,1382,790,2920,56917
21-11-2019,8,21750,22314,8107,2840,55012,788,1384,795,2967,57979
21-11-2019,9,22071,22228,7611,3228,55137,747,1083,548,2378,57515
21-11-2019,10,21847,22219,7342,3347,54756,719,1081,562,2362,57118
21-11-2019,11,21588,22227,7281,3163,54260,740,1083,555,2378,56638
21-11-2019,12,21576,22087,7427,2606,53697,710,1095,578,2383,56080
21-11-2019,13,21803,22192,7878,2983,54857,768,1418,582,2768,57625
21-11-2019,14,22104,21929,7889,3080,55003,778,1446,586,2810,57813
21-11-2019,15,22241,22168,8265,2713,55387,774,1700,628,3102,58489
21-11-2019,16,22212,22530,8296,3337,56376,760,1612,631,3003,59379
21-11-2019,17,22063,22545,8237,3547,56392,771,1713,665,3149,59541
21-11-2019,18,22137,22324,7918,3207,55586,754,1609,610,2973,58559
21-11-2019,19,21379,22010,7551,3186,54126,689,1004,614,2307,56433
21-11-2019,20,20379,21306,7149,3552,52387,646,997,621,2264,54651
21-11-2019,21,18297,20342,6863,3634,49136,636,761,608,2005,51141
21-11-2019,22,15986,19739,6723,3595,46044,621,566,612,1799,47843
21-11-2019,23,13744,18531,6574,3472,42321,627,564,629,1820,44141
22-11-2019,0,12391,18210,6638,3364,40603,638,572,624,1834,42437
22-11-2019,1,11811,17676,6597,3295,39378,648,567,628,1843,41221
22-11-2019,2,11783,17722,6563,3267,39335,647,564,620,1831,41166
22-11-2019,3,11768,17794,6590,3096,39249,641,566,614,1821,41070
22-11-2019,4,12166,18135,6755,3190,40247,675,567,613,1855,42102
22-11-2019,5,13948,19235,7285,3352,43821,713,772,599,2084,45905
22-11-2019,6,17392,21246,7789,3494,49922,709,1130,603,2442,52364
22-11-2019,7,20575,23055,8229,3640,55499,793,1404,632,2829,58328
22-11-2019,8,21462,23340,8264,3830,56896,848,1385,750,2983,59879
22-11-2019,9,21163,23071,7868,3644,55746,737,1299,609,2645,58391
22-11-2019,10,20983,23027,7625,3425,55061,746,1297,559,2602,57663
22-11-2019,11,20977,22861,7652,3357,54847,742,1322,566,2630,57477
22-11-2019,12,20838,22852,7820,3118,54628,719,1421,559,2699,57327
22-11-2019,13,20945,22737,8014,3011,54709,733,1606,547,2886,57595
22-11-2019,14,21149,22893,8261,3093,55395,733,1619,545,2897,58292
22-11-2019,15,21602,23052,8509,3169,56332,747,1755,612,3114,59446
22-11-2019,16,21927,23144,8515,3519,57106,745,1752,569,3066,60172
22-11-2019,17,21677,23027,8284,3658,56646,744,1762,573,3079,59725
22-11-2019,18,20477,22457,8370,3309,54614,736,1564,511,2811,57425
22-11-2019,19,18631,21675,7832,3183,51321,660,1006,515,2181,53502
22-11-2019,20,17066,21348,7151,3179,48745,680,456,521,1657,50402
22-11-2019,21,15540,20630,7038,3158,46366,705,450,503,1658,48024
22-11-2019,22,14042,19660,6867,3344,43912,679,447,501,1627,45539
22-11-2019,23,12529,18078,6488,3311,40407,688,444,482,1614,42021
23-11-2019,0,11478,17318,6537,3399,38733,687,454,480,1621,40354
23-11-2019,1,11271,16833,6581,3325,38009,658,444,466,1568,39577
23-11-2019,2,10700,16379,6735,3277,37092,664,451,467,1582,38674
23-11-2019,3,10333,16123,6736,3498,36690,656,453,480,1589,38279
23-11-2019,4,10394,16163,6758,3570,36885,607,456,465,1528,38413
23-11-2019,5,10733,16316,6829,3913,37792,611,459,449,1519,39311
23-11-2019,6,10948,17011,6899,4374,39231,622,447,455,1524,40755
23-11-2019,7,12468,17771,6982,4474,41695,603,449,457,1509,43204
23-11-2019,8,13468,18460,7108,4852,43888,599,698,465,1762,45650
23-11-2019,9,14448,19081,7224,5197,45951,624,855,488,1967,47918
23-11-2019,10,14982,20115,7241,5257,47596,635,859,477,1971,49567
23-11-2019,11,14879,20090,7227,5120,47316,638,858,450,1946,49262
23-11-2019,12,14970,20228,7220,5124,47543,643,905,447,1995,49538
23-11-2019,13,14777,20237,7355,5074,47442,637,906,430,1973,49415
23-11-2019,14,14814,20205,7481,5070,47571,629,1000,400,2029,49600
23-11-2019,15,15443,20485,7657,5211,48796,649,1083,418,2150,50946
23-11-2019,16,15906,21080,7685,5448,50119,643,1170,411,2224,52343
23-11-2019,17,16424,20963,7540,5756,50683,617,1297,397,2311,52994
23-11-2019,18,15655,20956,7567,5713,49892,622,1293,406,2321,52213
23-11-2019,19,14664,20141,7581,5810,48197,629,920,389,1938,50135
23-11-2019,20,14255,19877,7355,5821,47307,583,555,373,1511,48818
23-11-2019,21,13700,19330,7147,5726,45904,583,547,371,1501,47405
23-11-2019,22,13059,18506,7031,5337,43934,588,446,352,1386,45320
23-11-2019,23,12091,17744,6901,4923,41659,587,438,346,1371,43030
24-11-2019,0,11287,17025,6830,4694,39836,570,433,332,1335,41171
24-11-2019,1,10939,16856,6810,4704,39308,564,433,332,1329,40637
24-11-2019,2,10632,16736,6746,4794,38909,559,434,319,1312,40221
24-11-2019,3,10358,16473,6723,4854,38409,554,435,326,1315,39724
24-11-2019,4,10644,16608,6775,4749,38776,555,436,332,1323,40099
24-11-2019,5,10980,16656,6841,4850,39328,562,442,315,1319,40647
24-11-2019,6,11317,17050,6950,5220,40538,563,445,303,1311,41849
24-11-2019,7,12173,17518,7031,5443,42165,561,446,314,1321,43486
24-11-2019,8,12776,18146,7202,5557,43681,556,533,308,1397,45078
24-11-2019,9,13705,18941,7387,5653,45688,554,557,288,1399,47087
24-11-2019,10,14405,20056,7744,5613,47818,590,685,290,1565,49383
24-11-2019,11,15837,21176,7925,5440,50377,605,678,302,1585,51962
24-11-2019,12,16139,21154,8016,5189,50499,598,743,272,1613,52112
24-11-2019,13,16179,21235,8013,4965,50393,598,733,278,1609,52002
24-11-2019,14,16161,21124,7956,5051,50292,597,882,288,1767,52059
24-11-2019,15,17212,21263,7974,5146,51595,608,970,303,1881,53476
24-11-2019,16,19226,21933,8078,5119,54357,627,1048,331,2006,56363
24-11-2019,17,19383,22001,8127,5159,54671,642,1134,326,2102,56773
24-11-2019,18,18826,22350,8197,5042,54415,663,1065,323,2051,56466
24-11-2019,19,18940,22145,8138,4803,54026,643,987,328,1958,55984
24-11-2019,20,18482,21964,8097,4611,53156,640,745,336,1721,54877
24-11-2019,21,17738,21557,8003,4251,51551,640,742,358,1740,53291
24-11-2019,22,16636,20964,7832,3844,49277,639,723,328,1690,50967
24-11-2019,23,15282,19906,7621,3347,46157,632,514,315,1461,47618
25-11-2019,0,13446,18009,7367,2785,41607,567,443,293,1303,42910
25-11-2019,1,12035,17080,7192,2663,38971,554,441,312,1307,40278
25-11-2019,2,11691,16908,7227,2718,38543,564,441,332,1337,39880
25-11-2019,3,11689,16777,7202,2707,38376,570,442,320,1332,39708
25-11-2019,4,13266,17608,7444,2661,40978,585,462,302,1349,42327
25-11-2019,5,15860,19670,8153,2914,46596,665,813,341,1819,48415
25-11-2019,6,20120,21539,8773,2833,53265,688,1000,387,2075,55340
25-11-2019,7,22378,22521,9032,3582,57514,736,1282,638,2656,60170
25-11-2019,8,22927,22438,9070,3891,58327,816,1395,711,2922,61249
25-11-2019,9,22836,22463,8543,3838,57680,669,1230,565,2464,60144
25-11-2019,10,22933,22245,8229,3725,57133,707,1215,462,2384,59517
25-11-2019,11,23033,22156,8181,3508,56878,728,1204,359,2291,59169
25-11-2019,12,22890,22209,8587,3312,56996,732,1305,389,2426,59422
25-11-2019,13,22874,22195,8991,3452,57511,754,1589,481,2824,60335
25-11-2019,14,23128,22297,9018,3432,57876,772,1670,505,2947,60823
25-11-2019,15,23653,22261,9018,3473,58406,778,1662,617,3057,61463
25-11-2019,16,23887,22572,9004,3660,59121,803,1699,572,3074,62195
25-11-2019,17,23884,22519,8857,3738,58998,803,1687,520,3010,62008
25-11-2019,18,23028,22439,8797,3378,57642,771,1528,440,2739,60381
25-11-2019,19,22252,22136,8286,3147,55821,729,1103,224,2056,57877
25-11-2019,20,21510,21815,7798,2780,53903,735,906,222,1863,55766
25-11-2019,21,20764,21661,7678,2408,52512,786,608,229,1623,54135
25-11-2019,22,19345,20920,7393,2075,49733,776,550,220,1546,51279
25-11-2019,23,16591,19996,7111,2125,45824,681,572,210,1463,47287
26-11-2019,0,15151,17836,7007,2491,42484,717,536,201,1454,43938
26-11-2019,1,14142,16943,6964,2184,40233,716,536,194,1446,41679
26-11-2019,2,13616,16658,6912,1991,39177,712,535,182,1429,40606
26-11-2019,3,13189,16491,7060,2004,38744,704,536,176,1416,40160
26-11-2019,4,14306,16912,7422,1902,40543,712,535,178,1425,41968
26-11-2019,5,16354,18422,8014,1949,44739,793,697,251,1741,46480
26-11-2019,6,19963,20281,8637,2287,51169,813,1017,402,2232,53401
26-11-2019,7,22916,21860,8884,2938,56598,809,1336,518,2663,59261
26-11-2019,8,23474,21856,8889,3091,57311,820,1339,454,2613,59924
26-11-2019,9,23228,21802,8399,3155,56583,812,1003,255,2070,58653
26-11-2019,10,23214,21788,8160,3124,56286,808,914,196,1918,58204
26-11-2019,11,23073,21786,8259,3079,56197,767,907,194,1868,58065
26-11-2019,12,23304,21895,8472,3053,56725,811,916,215,1942,58667
26-11-2019,13,22933,21925,8734,3128,56721,823,1377,465,2665,59386
26-11-2019,14,23103,21832,8841,3222,56998,822,1388,455,2665,59663
26-11-2019,15,23460,21948,8981,3332,57721,830,1371,504,2705,60426
26-11-2019,16,23661,22234,8956,3301,58152,840,1292,465,2597,60749
26-11-2019,17,23751,22395,8841,3432,58419,838,1293,414,2545,60964
26-11-2019,18,23164,22056,8696,3592,57510,840,1158,402,2400,59910
26-11-2019,19,22475,22259,8206,3392,56331,793,754,217,1764,58095
26-11-2019,20,21386,21829,7714,3000,53929,785,697,222,1704,55633
26-11-2019,21,20282,21368,7571,2566,51787,782,594,271,1647,53434
26-11-2019,22,17839,20449,7311,2383,47982,736,542,213,1491,49473
26-11-2019,23,14825,19143,7116,2257,43341,694,461,214,1369,44710
27-11-2019,0,13850,18507,6924,2158,41438,688,446,214,1348,42786
27-11-2019,1,13141,17622,6872,2135,39770,682,399,215,1296,41066
27-11-2019,2,12752,17246,6909,2200,39107,722,359,218,1299,40406
27-11-2019,3,12736,17327,6919,2322,39304,723,363,224,1310,40614
27-11-2019,4,13346,17783,7168,2345,40642,728,451,236,1415,42057
27-11-2019,5,15543,18974,7990,2500,45008,780,471,281,1532,46540
27-11-2019,6,18741,20604,8566,2780,50692,810,745,515,2070,52762
27-11-2019,7,22251,22204,8898,3272,56625,839,1094,515,2448,59073
27-11-2019,8,23489,22303,8964,3566,58323,843,1209,529,2581,60904
27-11-2019,9,22644,21772,8567,3617,56600,828,827,278,1933,58533
27-11-2019,10,21951,21555,8445,3610,55561,837,609,312,1758,57319
27-11-2019,11,21879,21552,8416,3837,55685,850,573,270,1693,57378
27-11-2019,12,22028,21750,8588,3934,56300,850,787,282,1919,58219
27-11-2019,13,22080,21876,8983,4163,57103,862,1083,526,2471,59574
27-11-2019,14,21571,21829,9137,4327,56865,855,1024,512,2391,59256
27-11-2019,15,22688,22247,9288,4464,58688,857,1231,516,2604,61292
27-11-2019,16,22708,22633,9254,4361,58956,856,1398,502,2756,61712
27-11-2019,17,22427,22760,9139,4206,58532,863,1190,533,2586,61118
27-11-2019,18,22123,22763,9029,4110,58025,851,971,517,2339,60364
27-11-2019,19,20058,21982,8652,3772,54463,819,525,327,1671,56134
27-11-2019,20,18365,21649,8172,3253,51437,831,456,360,1647,53084
27-11-2019,21,17155,21298,7990,3055,49498,812,450,378,1640,51138
27-11-2019,22,15851,20472,7845,2833,47001,805,453,405,1663,48664
27-11-2019,23,14608,19328,7646,2746,44329,779,463,411,1653,45982
28-11-2019,0,13809,17947,7581,2581,41918,764,436,382,1582,43500
28-11-2019,1,12680,17534,7487,2282,39984,761,439,389,1589,41573
28-11-2019,2,12217,17542,7446,2143,39348,781,441,397,1619,40967
28-11-2019,3,12336,17529,7400,2136,39401,804,442,387,1633,41034
28-11-2019,4,13189,17883,7584,2178,40834,800,451,387,1638,42472
28-11-2019,5,15765,19565,8332,2182,45842,876,463,400,1739,47581
28-11-2019,6,18591,21330,8885,2239,51046,906,879,438,2223,53269
28-11-2019,7,21184,22515,8996,2414,55109,931,1087,678,2696,57805
28-11-2019,8,21684,22516,9062,2335,55597,923,1082,681,2686,58283
28-11-2019,9,20871,22177,8646,2353,54050,874,872,432,2178,56228
28-11-2019,10,20730,22275,8262,2378,53645,890,815,425,2130,55775
28-11-2019,11,20172,22148,8087,2393,52800,907,828,425,2160,54960
28-11-2019,12,21095,22195,8336,2343,53971,901,819,425,2145,56116
28-11-2019,13,21514,22579,8806,2285,55184,960,1320,469,2749,57933
28-11-2019,14,21159,22663,9016,2629,55468,924,1409,481,2814,58282
28-11-2019,15,20810,22862,9222,3138,56030,954,1438,501,2893,58923
28-11-2019,16,21056,23097,9265,3424,56843,946,1431,478,2855,59698
28-11-2019,17,21119,23012,9150,3439,56719,959,1415,481,2855,59574
28-11-2019,18,20638,22755,8899,3412,55705,957,1233,474,2664,58369
28-11-2019,19,18953,22466,8360,3558,53335,914,785,488,2187,55522
28-11-2019,20,18170,22515,7936,3580,52201,876,458,474,1808,54009
28-11-2019,21,17114,21993,7638,3649,50394,882,438,465,1785,52179
28-11-2019,22,15702,20418,7275,3955,47349,839,430,475,1744,49093
28-11-2019,23,13933,19245,6898,4096,44173,841,393,471,1705,45878
29-11-2019,0,13230,18710,6712,4244,42896,810,372,473,1655,44551
29-11-2019,1,11842,18181,6664,4126,40814,809,373,476,1658,42472
29-11-2019,2,11071,18121,6676,4744,40612,814,376,482,1672,42284
29-11-2019,3,11166,18117,6747,4892,40924,805,377,476,1658,42582
29-11-2019,4,11892,18762,7025,5017,42696,804,383,478,1665,44361
29-11-2019,5,14020,20067,7675,5417,47180,830,456,477,1763,48943
29-11-2019,6,16953,22236,8388,5008,52585,890,843,499,2232,54817
29-11-2019,7,20179,23882,8609,5169,57839,915,1210,514,2639,60478
29-11-2019,8,21084,24188,8475,4832,58578,903,1407,518,2828,61406
29-11-2019,9,21319,24403,8027,4815,58565,895,849,505,2249,60814
29-11-2019,10,21232,24364,7701,4910,58207,885,832,503,2220,60427
29-11-2019,11,20165,23919,7744,4513,56343,864,837,486,2187,58530
29-11-2019,12,19535,23750,7985,4425,55695,862,856,512,2230,57925
29-11-2019,13,20056,24053,8537,3752,56399,825,1386,493,2704,59103
29-11-2019,14,20557,24225,8891,3404,57076,832,1403,527,2762,59838
29-11-2019,15,21458,24986,8998,3125,58568,823,1587,517,2927,61495
29-11-2019,16,22465,25466,8979,3292,60202,827,1661,587,3075,63277
29-11-2019,17,22260,25472,8819,3526,60075,897,1686,503,3086,63161
29-11-2019,18,21289,25065,8614,3718,58686,889,1503,508,2900,61586
29-11-2019,19,20563,24864,8380,4257,58064,903,630,473,2006,60070
29-11-2019,20,19766,24598,8231,4473,57070,844,475,550,1869,58939
29-11-2019,21,18641,24407,8129,4125,55303,838,471,606,1915,57218
29-11-2019,22,17271,23504,8067,3652,52494,828,448,573,1849,54343
29-11-2019,23,14958,21574,7855,3510,47899,801,450,522,1773,49672
30-11-2019,0,14623,20805,8053,3294,46776,741,463,487,1691,48467
30-11-2019,1,14032,20279,8157,3149,45617,703,452,458,1613,47230
30-11-2019,2,13425,19768,8192,3195,44579,724,437,411,1572,46151
30-11-2019,3,13443,19513,8134,3267,44357,689,430,411,1530,45887
30-11-2019,4,13417,19358,8274,3324,44376,679,441,352,1472,45848
30-11-2019,5,13723,19585,8274,3638,45221,671,433,306,1410,46631
30-11-2019,6,14005,20498,8336,3673,46512,679,435,334,1448,47960
30-11-2019,7,16358,22181,8539,3758,50836,724,449,336,1509,52345
30-11-2019,8,18907,22880,8913,3917,54619,752,562,366,1680,56299
30-11-2019,9,20482,22687,8973,4064,56208,771,655,352,1778,57986
30-11-2019,10,20803,22621,8903,3900,56226,783,813,370,1966,58192
30-11-2019,11,20092,22693,8732,3887,55404,774,1071,353,2198,57602
30-11-2019,12,18987,22612,8649,3808,54056,764,1023,345,2132,56188
30-11-2019,13,18096,22383,8632,3568,52679,800,952,362,2114,54793
30-11-2019,14,18747,22335,8586,3500,53168,763,928,384,2075,55243
30-11-2019,15,20635,22313,8787,3404,55140,754,1113,368,2235,57375
30-11-2019,16,23449,22437,9065,3451,58400,745,1069,383,2197,60597
30-11-2019,17,23855,22190,9207,3701,58953,751,1052,372,2175,61128
30-11-2019,18,23471,22022,9075,3755,58324,761,1064,358,2183,60507
30-11-2019,19,22642,21852,9007,3468,56967,762,1062,403,2227,59194
30-11-2019,20,21604,21744,8970,3175,55493,807,942,442,2191,57684
30-11-2019,21,20649,21350,8851,2895,53746,789,718,414,1921,55667
30-11-2019,22,19289,21382,8917,2719,52307,784,705,425,1914,54221
30-11-2019,23,17793,20994,8720,2389,49896,786,458,403,1647,51543
01-12-2019,0,15493,20622,8648,2218,46982,636,456,329,1421,48403
01-12-2019,1,14009,19511,8587,2175,44282,628,444,271,1343,45625
01-12-2019,2,13668,19248,8521,2296,43733,644,439,237,1320,45053
01-12-2019,3,13515,19085,8525,2305,43430,687,439,232,1358,44788
01-12-2019,4,13487,19085,8568,2171,43313,691,438,215,1344,44657
01-12-2019,5,13534,19397,8642,2106,43678,713,441,198,1352,45030
01-12-2019,6,13526,19849,8754,2175,44304,713,446,197,1356,45660
01-12-2019,7,14336,21009,8868,2410,46625,701,446,203,1350,47975
01-12-2019,8,16462,22206,9003,2616,50287,789,458,211,1458,51745
01-12-2019,9,18958,22555,9192,3033,53738,825,686,237,1748,55486
01-12-2019,10,20456,22728,9243,3158,55585,882,688,256,1826,57411
01-12-2019,11,20723,22743,9243,3221,55933,890,688,258,1836,57769
01-12-2019,12,20136,22775,9181,3348,55440,867,826,242,1935,57375
01-12-2019,13,19623,23187,9076,3470,55355,867,816,272,1955,57310
01-12-2019,14,20356,23267,8951,3600,56174,871,823,319,2013,58187
01-12-2019,15,21154,23630,9064,3773,57622,884,835,363,2082,59704
01-12-2019,16,21905,23818,9160,4004,58888,902,907,348,2157,61045
01-12-2019,17,21747,23964,9219,4361,59290,902,947,353,2202,61492
01-12-2019,18,21244,24132,9170,4475,59021,897,831,383,2111,61132
01-12-2019,19,20535,24027,9120,4536,58220,891,801,420,2112,60332
01-12-2019,20,19652,23928,9034,4280,56893,878,693,423,1994,58887
01-12-2019,21,18442,23609,8919,3973,54945,856,558,427,1841,56786
01-12-2019,22,17216,23056,8862,4205,53339,789,458,440,1687,55026
01-12-2019,23,15172,21653,8675,4064,49564,814,452,467,1733,51297
02-12-2019,0,13569,20328,8444,3991,46333,804,447,447,1698,48031
02-12-2019,1,13402,20157,8556,4056,46171,732,443,409,1584,47755
02-12-2019,2,13184,19841,8509,4054,45589,649,442,361,1452,47041
02-12-2019,3,12690,19577,8417,4071,44756,622,443,361,1426,46182
02-12-2019,4,13430,19623,8618,4088,45759,615,440,346,1401,47160
02-12-2019,5,15864,22597,9148,4037,51648,743,444,329,1516,53164
02-12-2019,6,20630,24490,9681,4173,58975,782,755,365,1902,60877
02-12-2019,7,24601,24665,9930,4876,64072,783,845,667,2295,66367
02-12-2019,8,24991,24385,10051,5344,64773,794,1030,621,2445,67218
02-12-2019,9,24940,24486,10009,5168,64603,779,1060,512,2351,66954
02-12-2019,10,24228,24491,9773,5012,63503,775,850,299,1924,65427
02-12-2019,11,23159,24366,9487,5184,62197,769,850,287,1906,64103
02-12-2019,12,21986,24181,9624,5128,60919,764,1150,481,2395,63314
02-12-2019,13,22693,24362,9824,5207,62086,758,1172,314,2244,64330
02-12-2019,14,23553,24420,9910,5207,63092,777,968,609,2354,65446
02-12-2019,15,24177,24728,9997,5102,64004,770,1195,644,2609,66613
02-12-2019,16,24731,24877,10057,4913,64579,782,1144,670,2596,67175
02-12-2019,17,24802,24771,10225,4777,64575,778,1263,659,2700,67275
02-12-2019,18,24418,24744,10021,4554,63739,762,1182,544,2488,66227
02-12-2019,19,23321,24439,9670,4122,61552,770,1173,339,2282,63834
02-12-2019,20,22713,24261,9360,3628,59964,762,642,361,1765,61729
02-12-2019,21,22175,24247,9202,3100,58724,775,573,340,1688,60412
02-12-2019,22,20651,23809,8982,2589,56032,781,513,259,1553,57585
02-12-2019,23,17874,23257,8770,2239,52138,744,543,261,1548,53686
03-12-2019,0,16962,21796,8601,2060,49419,750,552,268,1570,50989
03-12-2019,1,15717,21351,8429,2145,47643,745,545,248,1538,49181
03-12-2019,2,15318,20966,8411,2163,46859,742,546,247,1535,48394
03-12-2019,3,14935,20455,8290,2261,45942,750,536,269,1555,47497
03-12-2019,4,16021,21273,8450,2404,48148,759,580,286,1625,49773
03-12-2019,5,19858,22635,9024,2839,54355,754,598,311,1663,56018
03-12-2019,6,22572,23510,9465,3842,59390,767,921,684,2372,61762
03-12-2019,7,23801,24172,9334,4324,61631,826,1418,721,2965,64596
03-12-2019,8,24120,23772,9421,4561,61875,795,1822,721,3338,65213
03-12-2019,9,23536,23803,9201,4492,61033,782,1806,713,3301,64334
03-12-2019,10,23919,23833,9084,4467,61305,779,1805,460,3044,64349
03-12-2019,11,23995,23624,8988,4612,61219,812,1606,454,2872,64091
03-12-2019,12,23597,23771,9283,5173,61824,820,1714,522,3056,64880
03-12-2019,13,23486,23673,9667,5150,61975,786,1398,593,2777,64752
03-12-2019,14,23512,24054,9684,5255,62504,807,1435,519,2761,65265
03-12-2019,15,23942,24625,9715,5328,63609,812,1454,557,2823,66432
03-12-2019,16,23958,24598,9945,5522,64021,838,1562,564,2964,66985
03-12-2019,17,23667,24374,9905,6315,64262,838,1409,595,2842,67104
03-12-2019,18,22959,24737,9740,5650,63087,830,1146,502,2478,65565
03-12-2019,19,21269,24146,9217,5431,60065,790,997,501,2288,62353
03-12-2019,20,19566,24064,8859,5306,57796,779,601,531,1911,59707
03-12-2019,21,17520,23754,8466,5111,54852,783,591,557,1931,56783
03-12-2019,22,15237,22819,8015,5069,51140,721,585,542,1848,52988
03-12-2019,23,13390,21288,7675,5084,47437,669,491,557,1717,49154
04-12-2019,0,12278,20504,7627,5045,45454,706,481,558,1745,47199
04-12-2019,1,12480,20387,7684,4115,44667,627,459,540,1626,46293
04-12-2019,2,12148,20243,7758,4246,44396,637,445,517,1599,45995
04-12-2019,3,12181,20203,7775,4400,44559,646,441,493,1580,46139
04-12-2019,4,13121,20674,8024,4364,46185,658,443,492,1593,47778
04-12-2019,5,15014,22243,8490,4301,50048,767,453,488,1708,51756
04-12-2019,6,19323,23292,9048,4495,56158,856,663,442,1961,58119
04-12-2019,7,22494,23950,9246,4724,60414,911,993,435,2339,62753
04-12-2019,8,23057,23694,9324,4743,60819,894,1069,426,2389,63208
04-12-2019,9,22764,23610,9354,4899,60630,890,1074,427,2391,63021
04-12-2019,10,22458,23357,9026,4750,59591,869,704,418,1991,61582
04-12-2019,11,21949,23294,9063,4854,59161,837,697,434,1968,61129
04-12-2019,12,21957,23261,9188,4897,59304,853,1039,472,2364,61668
04-12-2019,13,21348,23467,9192,5026,59032,891,995,513,2399,61431
04-12-2019,14,21515,23681,9312,5424,59932,857,1035,649,2541,62473
04-12-2019,15,22241,24160,9416,5249,61065,848,1329,704,2881,63946
04-12-2019,16,22620,23992,9500,5383,61496,835,1348,695,2878,64374
04-12-2019,17,22173,24453,9403,4717,60748,820,1357,691,2868,63616
04-12-2019,18,21847,24307,9264,4590,60009,845,1325,538,2708,62717
04-12-2019,19,20557,24115,8913,4474,58060,832,579,498,1909,59969
04-12-2019,20,18796,23710,8582,4709,55798,823,473,535,1831,57629
04-12-2019,21,17745,23960,8282,4483,54470,798,468,556,1822,56292
04-12-2019,22,15829,22947,8155,4339,51270,711,380,574,1665,52935
04-12-2019,23,14153,21578,7940,4534,48205,669,409,557,1635,49840
05-12-2019,0,13054,20646,7819,4347,45866,675,381,530,1586,47452
05-12-2019,1,11638,19921,7726,4871,44156,677,377,491,1545,45701
05-12-2019,2,11529,19950,7678,4421,43579,686,368,499,1553,45132
05-12-2019,3,11986,19641,7830,4364,43822,674,365,489,1528,45350
05-12-2019,4,12830,19849,8050,4294,45023,683,371,501,1555,46578
05-12-2019,5,14425,21488,8482,4314,48710,781,399,500,1680,50390
05-12-2019,6,17524,23227,9040,4489,54281,871,730,511,2112,56393
05-12-2019,7,20943,23865,9242,4933,58983,888,889,668,2445,61428
05-12-2019,8,21775,23912,9103,5291,60083,864,1158,661,2683,62766
05-12-2019,9,21111,24015,9063,5371,59560,902,888,607,2397,61957
05-12-2019,10,20258,24004,8837,5382,58482,886,665,467,2018,60500
05-12-2019,11,19796,24019,8723,5570,58109,882,636,458,1976,60085
05-12-2019,12,19424,23969,8917,5781,58092,911,855,563,2329,60421
05-12-2019,13,19020,23980,9006,5772,57777,925,844,471,2240,60017
05-12-2019,14,19046,24102,9098,5887,58134,937,813,472,2222,60356
05-12-2019,15,20092,24386,9129,6053,59662,935,888,670,2493,62155
05-12-2019,16,21040,24385,9159,5850,60436,934,889,509,2332,62768
05-12-2019,17,21063,24441,9099,5694,60298,942,784,439,2165,62463
05-12-2019,18,18925,24307,9045,5465,57743,946,638,489,2073,59816
05-12-2019,19,16121,24116,8672,5923,54833,891,580,505,1976,56809
05-12-2019,20,15028,23366,8449,5961,52804,862,481,491,1834,54638
05-12-2019,21,14250,22374,8281,6028,50934,792,412,494,1698,52632
05-12-2019,22,12901,20519,8215,5755,47389,741,404,487,1632,49021
05-12-2019,23,11294,19516,7806,5627,44244,740,380,474,1594,45838
06-12-2019,0,10590,18907,7489,5454,42439,611,257,505,1373,43812
06-12-2019,1,10066,18374,7452,5691,41584,591,248,531,1370,42954
06-12-2019,2,10026,18422,7434,5843,41725,591,245,547,1383,43108
06-12-2019,3,10475,18376,7490,5490,41831,582,244,579,1405,43236
06-12-2019,4,10651,18183,7483,5505,41822,591,244,595,1430,43252
06-12-2019,5,12152,19454,7650,5620,44877,585,259,598,1442,46319
06-12-2019,6,14732,21739,7954,6037,50463,595,494,786,1875,52338
06-12-2019,7,17113,23702,8216,5822,54854,582,527,979,2088,56942
06-12-2019,8,19124,23880,8306,6223,57535,557,516,1014,2087,59622
06-12-2019,9,18336,23528,8322,6473,56658,571,502,1007,2080,58738
06-12-2019,10,18378,23528,8003,6287,56196,556,504,611,1671,57867
06-12-2019,11,18477,23775,7990,6053,56294,554,516,594,1664,57958
06-12-2019,12,17695,23293,8277,5884,55149,510,893,776,2179,57328
06-12-2019,13,17779,23294,8379,5981,55435,529,898,788,2215,57650
06-12-2019,14,17773,23290,8543,5964,55569,495,742,973,2210,57779
06-12-2019,15,17809,23984,8712,5855,56361,498,1043,993,2534,58895
06-12-2019,16,18193,24359,8645,6145,57342,530,1021,995,2546,59888
06-12-2019,17,18497,24055,8680,5875,57107,507,1030,768,2305,59412
06-12-2019,18,16805,23170,8571,6278,54822,442,750,738,1930,56752
06-12-2019,19,15189,22307,7932,6039,51467,424,488,497,1409,52876
06-12-2019,20,13771,21281,7456,5827,48335,445,339,482,1266,49601
06-12-2019,21,13132,20343,7257,5706,46438,436,322,446,1204,47642
06-12-2019,22,12269,18982,7151,5306,43707,428,249,409,1086,44793
06-12-2019,23,11132,18018,7088,5189,41428,420,242,365,1027,42455
07-12-2019,0,10578,17319,7156,5167,40220,409,238,348,995,41215
07-12-2019,1,10624,16673,7147,4768,39214,408,237,357,1002,40216
07-12-2019,2,10698,16676,7103,4573,39050,390,235,399,1024,40074
07-12-2019,3,10784,16630,7135,4264,38813,386,235,407,1028,39841
07-12-2019,4,10407,16499,7125,4623,38656,390,237,407,1034,39690
07-12-2019,5,10516,16374,7150,5075,39116,433,239,417,1089,40205
07-12-2019,6,11161,16803,7310,5064,40339,452,246,409,1107,41446
07-12-2019,7,12430,17782,7673,5307,43193,486,255,400,1141,44334
07-12-2019,8,13666,18911,7670,5645,45893,506,340,431,1277,47170
07-12-2019,9,14742,19647,7769,5869,48028,495,462,444,1401,49429
07-12-2019,10,15313,20253,7612,6015,49193,514,515,474,1503,50696
07-12-2019,11,15151,20718,7490,6007,49367,517,530,500,1547,50914
07-12-2019,12,14971,20693,7475,5979,49119,502,532,496,1530,50649
07-12-2019,13,14659,20818,7389,5970,48837,516,528,541,1585,50422
07-12-2019,14,14951,21519,7495,5753,49717,537,666,567,1770,51487
07-12-2019,15,16010,22845,7473,5625,51953,535,693,584,1812,53765
07-12-2019,16,16975,23756,7694,5423,53850,613,694,605,1912,55762
07-12-2019,17,18232,24390,7833,4630,55086,583,698,647,1928,57014
07-12-2019,18,18435,24374,7802,4038,54648,579,698,654,1931,56579
07-12-2019,19,16643,23971,7555,4010,52179,522,667,646,1835,54014
07-12-2019,20,14397,22247,7271,3646,47561,523,674,644,1841,49402
07-12-2019,21,13379,21101,7231,3628,45340,521,358,642,1521,46861
07-12-2019,22,12861,20105,7182,3429,43577,522,329,625,1476,45053
07-12-2019,23,11435,18736,7067,3585,40823,498,283,616,1397,42220
08-12-2019,0,10814,18004,6951,3660,39430,514,243,612,1369,40799
08-12-2019,1,10706,17530,6867,3840,38943,523,241,599,1363,40306
08-12-2019,2,10529,17369,6929,3906,38734,556,232,539,1327,40061
08-12-2019,3,11183,17175,6981,3816,39156,544,222,497,1263,40419
08-12-2019,4,11206,16952,6988,3901,39048,522,221,478,1221,40269
08-12-2019,5,11395,17159,7126,3892,39572,494,221,431,1146,40718
08-12-2019,6,11783,17631,7358,3810,40582,461,219,433,1113,41695
08-12-2019,7,12431,18218,7429,3959,42038,488,226,470,1184,43222
08-12-2019,8,13229,18664,7703,4361,43958,468,247,469,1184,45142
08-12-2019,9,14144,19208,7712,4944,46008,454,492,479,1425,47433
08-12-2019,10,14776,20245,7658,5200,47880,465,580,546,1591,49471
08-12-2019,11,14623,20490,7700,5356,48170,476,578,571,1625,49795
08-12-2019,12,14681,20452,7590,5372,48096,487,527,586,1600,49696
08-12-2019,13,14538,20740,7570,5305,48153,488,627,596,1711,49864
08-12-2019,14,14732,20482,7515,5269,47997,482,646,619,1747,49744
08-12-2019,15,15218,20899,7664,5152,48934,507,654,796,1957,50891
08-12-2019,16,15652,21646,7872,5446,50617,534,658,841,2033,52650
08-12-2019,17,16000,22339,7864,5861,52065,546,674,822,2042,54107
08-12-2019,18,15632,21726,7871,5825,51054,564,666,706,1936,52990
08-12-2019,19,15012,21221,7756,5688,49675,574,532,649,1755,51430
08-12-2019,20,13979,20242,7671,5629,47521,580,462,648,1690,49211
08-12-2019,21,13050,19759,7654,5431,45892,590,259,640,1489,47381
08-12-2019,22,12556,19075,7491,5166,44287,590,258,633,1481,45768
08-12-2019,23,11836,18462,7339,4762,42400,582,259,631,1472,43872
09-12-2019,0,12102,18159,7283,4405,41947,593,258,624,1475,43422
09-12-2019,1,11907,17861,7390,3917,41077,590,258,611,1459,42536
09-12-2019,2,11533,17846,7406,3955,40742,584,254,561,1399,42141
09-12-2019,3,11354,17899,7453,4258,40966,572,255,531,1358,42324
09-12-2019,4,11690,18456,7603,4376,42125,565,260,546,1371,43496
09-12-2019,5,12394,19755,8024,4662,44834,561,353,557,1471,46305
09-12-2019,6,13630,22353,8421,5651,50055,741,515,545,1801,51856
09-12-2019,7,16507,24251,8586,5591,54934,822,683,720,2225,57159
09-12-2019,8,19297,24533,8641,5746,58216,704,877,889,2470,60686
09-12-2019,9,19197,24237,8639,6072,58145,702,1100,888,2690,60835
09-12-2019,10,19069,24066,8381,5783,57299,702,980,688,2370,59669
09-12-2019,11,19072,23993,8301,5531,56899,673,907,680,2260,59159
09-12-2019,12,19496,23931,8568,6031,58026,680,921,715,2316,60342
09-12-2019,13,19346,23630,8632,6353,57961,683,926,705,2314,60275
09-12-2019,14,19730,23866,8818,6123,58536,672,926,711,2309,60845
09-12-2019,15,19695,24149,8984,6297,59125,673,1012,875,2560,61685
09-12-2019,16,20587,24461,8856,6258,60162,664,984,817,2465,62627
09-12-2019,17,20888,24859,8717,6087,60553,674,1007,691,2372,62925
09-12-2019,18,19224,24597,8489,6473,58782,665,1079,852,2596,61378
09-12-2019,19,17534,24361,8139,6223,56257,668,764,511,1943,58200
09-12-2019,20,16182,24125,7880,5890,54078,643,457,523,1623,55701
09-12-2019,21,15119,23288,7730,5812,51951,592,362,524,1478,53429
09-12-2019,22,14750,21963,7542,5567,49823,571,320,489,1380,51203
09-12-2019,23,13373,20209,7339,5222,46142,576,279,472,1327,47469
10-12-2019,0,13071,19785,7239,5014,45110,493,267,466,1226,46336
10-12-2019,1,13079,19076,7167,4808,44130,486,248,465,1199,45329
10-12-2019,2,12792,19491,7285,4159,43725,479,242,472,1193,44918
10-12-2019,3,12933,19894,7520,3790,44137,461,242,445,1148,45285
10-12-2019,4,13960,20340,7777,3431,45509,479,266,428,1173,46682
10-12-2019,5,16304,22508,8171,3041,50024,567,417,392,1376,51400
10-12-2019,6,21063,24306,8701,3518,57590,640,867,562,2069,59659
10-12-2019,7,24819,24597,9029,3623,62069,596,1122,860,2578,64647
10-12-2019,8,25075,23847,9153,3880,61957,570,1295,844,2709,64666
10-12-2019,9,25050,23548,9059,3777,61432,566,1290,799,2655,64087
10-12-2019,10,24691,22987,8772,4104,60555,548,1063,570,2181,62736
10-12-2019,11,24114,22470,8378,4511,59474,539,939,595,2073,61547
10-12-2019,12,24812,22541,8690,4829,60873,552,1202,757,2511,63384
10-12-2019,13,24426,22023,8850,5129,60429,507,1278,735,2520,62949
10-12-2019,14,24556,22396,8912,5130,60993,498,1382,766,2646,63639
10-12-2019,15,24928,23195,9026,5674,62822,485,1530,881,2896,65718
10-12-2019,16,24459,23375,9156,6156,63146,476,1624,823,2923,66069
10-12-2019,17,23314,23792,9159,6754,63019,467,1561,777,2805,65824
10-12-2019,18,21300,24076,9032,5894,60302,468,1553,670,2691,62993
10-12-2019,19,18823,23961,8868,5784,57435,472,942,249,1663,59098
10-12-2019,20,16275,23267,8684,6737,54962,463,552,237,1252,56214
10-12-2019,21,15174,22698,8672,6955,53499,390,442,194,1026,54525
10-12-2019,22,14182,21867,8494,6873,51416,348,436,177,961,52377
10-12-2019,23,12977,20900,8208,6425,48509,395,368,175,938,49447
11-12-2019,0,11836,20432,8096,6242,46606,460,389,183,1032,47638
11-12-2019,1,11543,19941,7891,5754,45129,472,392,198,1062,46191
11-12-2019,2,11339,19710,7780,5466,44295,495,396,239,1130,45425
11-12-2019,3,11404,19792,7933,5780,44909,513,397,288,1198,46107
11-12-2019,4,11799,20379,8278,6010,46466,535,407,338,1280,47746
11-12-2019,5,13163,21666,8855,6033,49717,597,430,378,1405,51122
11-12-2019,6,14824,24064,9296,5920,54105,703,625,734,2062,56167
11-12-2019,7,17899,25809,9406,5743,58859,742,942,895,2579,61438
11-12-2019,8,19717,26136,9508,5332,60692,759,862,894,2515,63207
11-12-2019,9,20245,25685,9456,5060,60447,777,846,906,2529,62976
11-12-2019,10,20656,25553,9580,4927,60715,782,814,465,2061,62776
11-12-2019,11,20827,25290,9592,5001,60710,806,816,493,2115,62825
11-12-2019,12,21492,25107,9566,4966,61132,817,881,652,2350,63482
11-12-2019,13,21106,24839,9620,5004,60569,822,938,618,2378,62947
11-12-2019,14,21278,24473,9585,4575,59911,819,973,648,2440,62351
11-12-2019,15,21889,24171,9689,4439,60188,825,1148,871,2844,63032
11-12-2019,16,22489,23970,9661,4578,60698,819,1385,956,3160,63858
11-12-2019,17,22632,23730,9521,4777,60661,810,1482,942,3234,63895
11-12-2019,18,22350,23452,9455,4544,59802,785,1309,954,3048,62850
11-12-2019,19,21264,23356,9191,4399,58212,791,1006,488,2285,60497
11-12-2019,20,20010,23150,8983,4105,56249,708,685,489,1882,58131
11-12-2019,21,19069,22988,8809,3577,54444,668,574,470,1712,56156
11-12-2019,22,17527,22439,8489,3265,51721,629,469,472,1570,53291
11-12-2019,23,15905,21204,8334,3006,48448,623,487,465,1575,50023
12-12-2019,0,14936,19545,8195,2513,45190,629,469,460,1558,46748
12-12-2019,1,14354,18733,8088,2349,43525,617,461,423,1501,45026
12-12-2019,2,13608,18398,7997,2435,42438,608,463,446,1517,43955
12-12-2019,3,13197,18276,7911,2444,41828,601,456,469,1526,43354
12-12-2019,4,14011,18757,8116,2535,43419,606,453,459,1518,44937
12-12-2019,5,16214,21270,8463,2701,48648,604,463,438,1505,50153
12-12-2019,6,20023,22266,8892,3640,54819,724,887,428,2039,56858
12-12-2019,7,22128,22176,9368,4421,58093,786,1421,819,3026,61119
12-12-2019,8,22763,21984,9696,4633,59076,852,1687,809,3348,62424
12-12-2019,9,22958,21858,9698,4618,59131,712,1690,774,3176,62307
12-12-2019,10,22939,22173,9622,4608,59344,684,1434,594,2712,62056
12-12-2019,11,22417,21769,9512,4675,58375,672,1205,431,2308,60683
12-12-2019,12,22295,21681,9574,4848,58398,669,1180,467,2316,60714
12-12-2019,13,22599,22021,9615,4771,59006,651,1137,397,2185,61191
12-12-2019,14,23039,21963,9604,4841,59449,653,976,490,2119,61568
12-12-2019,15,23431,21967,9742,4878,60018,678,1082,467,2227,62245
12-12-2019,16,23514,22125,9764,5001,60405,714,1146,446,2306,62711
12-12-2019,17,23270,22219,9753,5154,60396,730,1144,472,2346,62742
12-12-2019,18,22803,22073,9492,5080,59450,720,974,474,2168,61618
12-12-2019,19,20367,22119,9074,4938,56498,706,923,443,2072,58570
12-12-2019,20,18326,22216,8676,4569,53789,708,833,403,1944,55733
12-12-2019,21,16647,21747,8565,4275,51234,653,682,389,1724,52958
12-12-2019,22,15173,20710,8246,4279,48409,559,469,372,1400,49809
12-12-2019,23,13823,19095,7939,4161,45017,526,474,350,1350,46367
13-12-2019,0,13417,17689,7854,4266,43226,529,381,348,1258,44484
13-12-2019,1,12903,17006,7825,4491,42225,547,378,354,1279,43504
13-12-2019,2,12337,16751,7800,4673,41563,541,375,360,1276,42839
13-12-2019,3,12579,16766,7887,4978,42209,548,382,348,1278,43487
13-12-2019,4,12934,17622,7956,5043,43553,530,466,340,1336,44889
13-12-2019,5,14316,19993,8534,5303,48147,581,458,374,1413,49560
13-12-2019,6,16390,21923,9081,5446,52839,645,860,410,1915,54754
13-12-2019,7,20615,23662,9532,5668,59477,705,1250,643,2598,62075
13-12-2019,8,22081,23580,9468,5830,60960,797,1118,672,2587,63547
13-12-2019,9,22430,23685,9424,5948,61488,653,1097,702,2452,63940
13-12-2019,10,22322,23528,9053,6125,61029,649,962,517,2128,63157
13-12-2019,11,21960,23510,8950,6307,60727,648,965,536,2149,62876
13-12-2019,12,22298,23430,9154,6289,61172,644,1240,536,2420,63592
13-12-2019,13,22052,23311,9113,6155,60631,653,1146,554,2353,62984
13-12-2019,14,21872,23367,9357,5748,60344,646,1152,578,2376,62720
13-12-2019,15,22151,23535,9368,5704,60759,650,1468,589,2707,63466
13-12-2019,16,22567,23405,9340,5667,60980,641,1380,595,2616,63596
13-12-2019,17,22844,23148,9292,5469,60753,663,1264,583,2510,63263
13-12-2019,18,22355,23141,9135,5059,59691,664,1082,568,2314,62005
13-12-2019,19,21253,22922,8666,4420,57262,653,970,547,2170,59432
13-12-2019,20,19317,22658,8291,4124,54389,589,777,559,1925,56314
13-12-2019,21,17432,21894,8101,3587,51015,511,685,553,1749,52764
13-12-2019,22,16034,20461,7861,3430,47787,515,469,561,1545,49332
13-12-2019,23,14932,19379,7687,3373,45372,522,456,545,1523,46895
14-12-2019,0,13129,17486,7477,3075,41167,509,296,537,1342,42509
14-12-2019,1,12079,16213,7328,3035,38657,505,240,541,1286,39943
14-12-2019,2,11338,16108,7270,3106,37822,509,233,559,1301,39123
14-12-2019,3,11298,16247,7254,3134,37934,499,233,563,1295,39229
14-12-2019,4,11259,16449,7203,3256,38166,510,236,559,1305,39471
14-12-2019,5,11688,16718,7234,3308,38947,528,240,560,1328,40275
14-12-2019,6,12471,17806,7468,3427,41171,552,254,572,1378,42549
14-12-2019,7,13147,18615,7782,3544,43088,564,410,594,1568,44656
14-12-2019,8,14343,20037,8081,3821,46283,563,614,581,1758,48041
14-12-2019,9,15210,20954,8108,4014,48285,579,623,600,1802,50087
14-12-2019,10,15526,21545,8168,4014,49253,583,758,604,1945,51198
14-12-2019,11,15411,21507,8203,3927,49048,581,756,618,1955,51003
14-12-2019,12,15568,21697,8218,3844,49328,591,746,620,1957,51285
14-12-2019,13,15864,21813,8285,4020,49983,590,764,612,1966,51949
14-12-2019,14,15493,22059,8374,4296,50222,596,873,591,2060,52282
14-12-2019,15,15966,22179,8479,4591,51214,600,875,579,2054,53268
14-12-2019,16,16707,22669,8508,4584,52469,593,866,568,2027,54496
14-12-2019,17,16986,22428,8442,4957,52813,598,860,548,2006,54819
14-12-2019,18,16499,21947,8300,5124,51870,599,848,488,1935,53805
14-12-2019,19,16175,20912,8154,5060,50301,604,609,438,1651,51952
14-12-2019,20,15459,20108,7919,5054,48542,593,322,397,1312,49854
14-12-2019,21,14202,19088,7883,4978,46151,599,237,350,1186,47337
14-12-2019,22,13344,18178,7785,5134,44442,613,225,328,1166,45608
14-12-2019,23,12275,17558,7638,4959,42430,571,221,328,1120,43550
15-12-2019,0,11942,16648,7729,4813,41133,554,216,309,1079,42212
15-12-2019,1,11544,16309,7759,4477,40089,547,216,286,1049,41138
15-12-2019,2,11428,16255,7636,4396,39716,541,216,296,1053,40769
15-12-2019,3,11492,16280,7657,4401,39830,525,215,294,1034,40864
15-12-2019,4,11659,16408,7638,4029,39734,536,213,330,1079,40813
15-12-2019,5,11507,15959,7525,3951,38942,514,214,408,1136,40078
15-12-2019,6,11710,16165,7569,4212,39657,511,225,437,1173,40830
15-12-2019,7,12080,17054,7833,4263,41230,491,379,472,1342,42572
15-12-2019,8,13101,17930,8030,4602,43662,501,385,478,1364,45026
15-12-2019,9,13929,18955,8159,5274,46319,494,467,483,1444,47763
15-12-2019,10,14465,19554,8121,5640,47780,488,619,497,1604,49384
15-12-2019,11,14582,19868,8196,5783,48430,483,678,518,1679,50109
15-12-2019,12,14571,20001,8237,5905,48713,483,772,472,1727,50440
15-12-2019,13,14843,20090,8217,5768,48919,470,771,535,1776,50695
15-12-2019,14,15381,20283,8182,5725,49573,491,773,482,1746,51319
15-12-2019,15,15617,20925,8181,5761,50484,515,858,421,1794,52278
15-12-2019,16,15701,21669,8345,5903,51620,523,840,470,1833,53453
15-12-2019,17,16042,21850,8337,6179,52410,509,843,507,1859,54269
15-12-2019,18,15988,21788,8147,6100,52025,515,862,561,1938,53963
15-12-2019,19,15579,21244,7991,5843,50657,527,847,584,1958,52615
15-12-2019,20,15277,21003,7931,5558,49769,538,547,587,1672,51441
15-12-2019,21,14695,20262,7710,5432,48101,539,466,612,1617,49718
15-12-2019,22,13794,19049,7483,5233,45561,523,316,632,1471,47032
15-12-2019,23,13094,17082,7111,4812,42099,514,330,644,1488,43587
16-12-2019,0,12628,16268,7084,4773,40753,540,319,646,1505,42258
16-12-2019,1,12210,16251,7024,4606,40091,575,331,647,1553,41644
16-12-2019,2,12315,16146,6774,4559,39795,559,331,644,1534,41329
16-12-2019,3,12713,16723,6750,4416,40602,486,355,638,1479,42081
16-12-2019,4,12856,17850,6901,4275,41882,494,450,646,1590,43472
16-12-2019,5,14132,19369,7584,4440,45525,556,594,649,1799,47324
16-12-2019,6,17485,21478,8086,4814,51863,572,1024,688,2284,54147
16-12-2019,7,21480,23075,8414,5599,58569,572,1290,1026,2888,61457
16-12-2019,8,22663,23248,8362,5803,60077,577,1282,1026,2885,62962
16-12-2019,9,22275,23322,8214,5881,59693,599,1303,1010,2912,62605
16-12-2019,10,22355,23109,8021,5854,59339,618,1143,551,2312,61651
16-12-2019,11,22701,22994,8004,5536,59235,633,1300,523,2456,61691
16-12-2019,12,23402,23262,8378,5143,60186,622,1524,653,2799,62985
16-12-2019,13,23609,23307,8535,5021,60471,670,1526,645,2841,63312
16-12-2019,14,23615,23316,8634,4913,60477,709,1534,771,3014,63491
16-12-2019,15,23767,23713,8778,4762,61020,706,1537,776,3019,64039
16-12-2019,16,24103,23919,8716,4579,61317,709,1533,779,3021,64338
16-12-2019,17,24040,23962,8641,4934,61578,724,1520,804,3048,64626
16-12-2019,18,23461,23540,8632,4685,60318,712,1373,619,2704,63022
16-12-2019,19,22755,23111,8115,4781,58763,661,1220,380,2261,61024
16-12-2019,20,21838,22834,7716,4555,56943,675,809,389,1873,58816
16-12-2019,21,20257,22723,7660,3957,54597,691,660,396,1747,56344
16-12-2019,22,18009,21684,7578,3365,50637,722,460,386,1568,52205
16-12-2019,23,15855,19774,7343,2775,45747,729,455,394,1578,47325
17-12-2019,0,14712,17890,7132,2546,42281,643,455,383,1481,43762
17-12-2019,1,14157,16975,7125,2466,40723,633,451,352,1436,42159
17-12-2019,2,13794,16829,7094,2329,40047,622,444,311,1377,41424
17-12-2019,3,13807,17117,7103,2227,40253,580,439,268,1287,41540
17-12-2019,4,13888,17443,7330,2229,40890,559,532,241,1332,42222
17-12-2019,5,15761,18862,7934,2263,44821,626,731,239,1596,46417
17-12-2019,6,18482,21003,8282,2456,50225,699,838,411,1948,52173
17-12-2019,7,22306,22439,8475,2815,56035,698,1259,659,2616,58651
17-12-2019,8,23846,22922,8597,3306,58671,680,1313,706,2699,61370
17-12-2019,9,23134,22590,8530,3264,57517,652,1355,729,2736,60253
17-12-2019,10,22261,22508,8152,3081,56003,628,1073,400,2101,58104
17-12-2019,11,21635,22429,8242,3082,55388,627,1072,459,2158,57546
17-12-2019,12,21089,22508,8584,2877,55058,620,1480,420,2520,57578
17-12-2019,13,21160,22311,8717,2984,55172,619,1495,404,2518,57690
17-12-2019,14,22042,22753,8691,3224,56711,637,1487,633,2757,59468
17-12-2019,15,23256,22934,8814,3518,58521,621,1488,676,2785,61306
17-12-2019,16,23587,23262,8650,3814,59314,622,1477,702,2801,62115
17-12-2019,17,23202,23265,8593,4040,59101,627,1485,685,2797,61898
17-12-2019,18,21222,23077,8618,3835,56752,620,1473,519,2612,59364
17-12-2019,19,19566,22805,8164,3932,54468,619,930,340,1889,56357
17-12-2019,20,17490,22122,7762,3712,51086,605,871,350,1826,52912
17-12-2019,21,16764,21364,7754,3673,49554,603,663,345,1611,51165
17-12-2019,22,15605,20899,7530,3465,47498,553,460,329,1342,48840
17-12-2019,23,14269,19446,7351,3427,44494,477,467,324,1268,45762
18-12-2019,0,13558,18003,7280,3721,42562,468,480,334,1282,43844
18-12-2019,1,12998,17507,7158,3881,41544,485,482,372,1339,42883
18-12-2019,2,12581,17105,7120,4030,40837,488,482,378,1348,42185
18-12-2019,3,12781,17180,7083,3937,40982,488,482,388,1358,42340
18-12-2019,4,13521,17779,7293,4058,42652,516,545,432,1493,44145
18-12-2019,5,14616,19945,7965,4186,46714,609,585,392,1586,48300
18-12-2019,6,17167,22541,8410,4200,52319,674,751,517,1942,54261
18-12-2019,7,21843,24111,8635,4499,59088,703,949,586,2238,61326
18-12-2019,8,23273,24573,8636,4669,61150,712,883,613,2208,63358
18-12-2019,9,23118,24829,8624,4734,61305,758,955,636,2349,63654
18-12-2019,10,22893,25034,8191,4847,60967,787,691,618,2096,63063
18-12-2019,11,22461,24898,8098,5165,60625,818,694,648,2160,62785
18-12-2019,12,21901,24936,8390,5370,60598,821,1001,826,2648,63246
18-12-2019,13,21362,24910,8679,4801,59752,820,955,826,2601,62353
18-12-2019,14,21456,25104,8740,4681,59981,819,1055,852,2726,62707
18-12-2019,15,22203,25571,8785,4984,61542,810,1227,809,2846,64388
18-12-2019,16,22639,25674,8718,5009,62040,798,1200,798,2796,64836
18-12-2019,17,22718,24999,8653,4734,61104,804,1158,781,2743,63847
18-12-2019,18,22347,25104,8595,4363,60411,802,1119,759,2680,63091
18-12-2019,19,21866,25166,8277,3597,58905,808,513,565,1886,60791
18-12-2019,20,20657,24751,7921,3218,56546,809,506,592,1907,58453
18-12-2019,21,18012,24367,7732,3035,53147,761,505,604,1870,55017
18-12-2019,22,15813,22908,7497,2837,49055,659,504,616,1779,50834
18-12-2019,23,14161,20867,7366,2770,45166,653,502,615,1770,46936
19-12-2019,0,13482,19661,7399,2703,43246,668,497,579,1744,44990
19-12-2019,1,12974,18856,7428,2693,41952,643,492,555,1690,43642
19-12-2019,2,13032,18664,7404,2829,41929,635,490,514,1639,43568
19-12-2019,3,13006,18600,7553,3135,42296,627,486,459,1572,43868
19-12-2019,4,13542,19483,7833,3500,44360,652,577,441,1670,46030
19-12-2019,5,14577,20899,8429,3986,47892,728,857,407,1992,49884
19-12-2019,6,16390,22680,8779,4499,52349,735,1063,427,2225,54574
19-12-2019,7,20334,23667,9066,5340,58408,729,1246,753,2728,61136
19-12-2019,8,22130,23926,9119,5324,60499,719,1295,708,2722,63221
19-12-2019,9,21583,24010,8965,5453,60011,695,1275,659,2629,62640
19-12-2019,10,20113,23853,8580,5864,58412,670,859,254,1783,60195
19-12-2019,11,19130,23589,8610,5823,57154,641,851,242,1734,58888
19-12-2019,12,18734,23276,8763,5741,56514,658,1426,399,2483,58997
19-12-2019,13,18992,23547,8885,5568,56992,642,1453,393,2488,59480
19-12-2019,14,20098,23782,8974,5721,58576,623,1469,576,2668,61244
19-12-2019,15,21420,24188,9084,5503,60195,623,1474,583,2680,62875
19-12-2019,16,22219,24439,9082,5655,61393,611,1465,595,2671,64064
19-12-2019,17,22061,24562,8947,5691,61260,635,1369,622,2626,63886
19-12-2019,18,20838,24400,9011,5426,59675,626,1320,452,2398,62073
19-12-2019,19,19349,24493,8393,5388,57622,610,736,313,1659,59281
19-12-2019,20,16512,23311,8047,5017,52886,615,718,331,1664,54550
19-12-2019,21,14918,22554,7937,4590,50000,556,599,334,1489,51489
19-12-2019,22,14505,21344,7696,4438,47986,486,482,380,1348,49334
19-12-2019,23,13416,19394,7399,4271,44480,481,414,425,1320,45800
20-12-2019,0,12782,18458,7187,3941,42368,479,298,440,1217,43585
20-12-2019,1,12504,17985,7145,3603,41236,502,297,472,1271,42507
20-12-2019,2,12221,17521,7166,3588,40495,512,294,475,1281,41776
20-12-2019,3,12019,17406,7278,3633,40337,523,301,478,1302,41639
20-12-2019,4,12826,17569,7432,3646,41472,518,453,474,1445,42917
20-12-2019,5,13680,18970,7947,3969,44567,597,574,482,1653,46220
20-12-2019,6,15158,20744,8598,4318,48819,670,791,453,1914,50733
20-12-2019,7,17880,22515,8943,4787,54124,689,883,574,2146,56270
20-12-2019,8,19214,22948,9018,5134,56314,675,938,624,2237,58551
20-12-2019,9,19132,22906,9072,5289,56399,656,905,642,2203,58602
20-12-2019,10,18659,22727,8438,5224,55050,646,748,414,1808,56858
20-12-2019,11,18497,22509,8408,5267,54682,609,796,402,1807,56489
20-12-2019,12,18328,22312,8528,5366,54533,622,1075,608,2305,56838
20-12-2019,13,17649,22113,8605,5606,53973,595,1082,620,2297,56270
20-12-2019,14,17469,22137,8665,5564,53835,594,1210,658,2462,56297
20-12-2019,15,17713,22592,8765,5591,54660,592,1213,722,2527,57187
20-12-2019,16,17823,22731,8843,5653,55050,613,1154,722,2489,57539
20-12-2019,17,17821,22885,8781,5637,55125,630,1156,545,2331,57456
20-12-2019,18,17630,22657,8525,5456,54269,658,1158,517,2333,56602
20-12-2019,19,16481,21937,8120,5161,51698,613,901,491,2005,53703
20-12-2019,20,14943,20437,7654,4853,47889,545,637,502,1684,49573
20-12-2019,21,14093,19654,7427,4590,45764,483,409,493,1385,47149
20-12-2019,22,13458,18642,7392,4207,43701,496,337,507,1340,45041
20-12-2019,23,12428,17696,7173,3900,41199,467,268,498,1233,42432
21-12-2019,0,11625,16825,7119,3624,39194,485,263,475,1223,40417
21-12-2019,1,11075,16312,7099,3421,37907,475,258,454,1187,39094
21-12-2019,2,10851,16103,7064,3365,37383,468,258,440,1166,38549
21-12-2019,3,10850,16242,7039,3429,37560,471,260,429,1160,38720
21-12-2019,4,10588,16275,7062,3644,37570,483,263,428,1174,38744
21-12-2019,5,10568,16192,7086,3760,37606,486,266,421,1173,38779
21-12-2019,6,11081,16700,7160,3656,38598,502,356,414,1272,39870
21-12-2019,7,12553,17626,7397,3762,41339,513,391,412,1316,42655
21-12-2019,8,13376,18517,7684,3900,43477,519,523,389,1431,44908
21-12-2019,9,14651,19938,7823,3644,46056,529,867,352,1748,47804
21-12-2019,10,15424,19960,7833,3571,46788,518,881,310,1709,48497
21-12-2019,11,15542,20058,7715,3369,46683,518,983,341,1842,48525
21-12-2019,12,15072,20257,7685,3332,46347,499,1078,331,1908,48255
21-12-2019,13,14821,20100,7707,3108,45735,489,982,285,1756,47491
21-12-2019,14,16042,20410,7773,2944,47170,490,1114,295,1899,49069
21-12-2019,15,16987,20802,7847,2888,48525,489,1131,283,1903,50428
21-12-2019,16,18713,21465,8011,3277,51466,479,1189,290,1958,53424
21-12-2019,17,19074,21504,8064,3415,52057,477,1152,290,1919,53976
21-12-2019,18,17887,20713,7859,3552,50011,465,1053,308,1826,51837
21-12-2019,19,16230,19982,7635,3543,47392,459,1038,286,1783,49175
21-12-2019,20,14459,19573,7643,3245,44919,447,766,278,1491,46410
21-12-2019,21,14075,18807,7478,3174,43534,448,566,278,1292,44826
21-12-2019,22,13401,18203,7335,2968,41909,455,458,283,1196,43105
21-12-2019,23,12549,17553,7068,2736,39906,451,266,273,990,40896
22-12-2019,0,11924,16084,6944,2589,37541,452,349,253,1054,38595
22-12-2019,1,11492,15453,6867,2525,36335,452,267,211,930,37265
22-12-2019,2,11181,15386,6866,2552,35986,464,266,186,916,36902
22-12-2019,3,11015,15292,6750,2656,35712,445,263,180,888,36600
22-12-2019,4,10928,15209,6738,2615,35491,441,259,174,874,36365
22-12-2019,5,10889,15618,6734,2488,35730,440,291,173,904,36634
22-12-2019,6,11271,16413,6850,2591,37126,457,372,171,1000,38126
22-12-2019,7,11967,17000,7087,2749,38804,456,466,173,1095,39899
22-12-2019,8,13001,17859,7364,3025,41249,445,750,182,1377,42626
22-12-2019,9,14235,19082,7474,3208,43998,451,976,193,1620,45618
22-12-2019,10,15535,20283,7507,3365,46690,458,986,203,1647,48337
22-12-2019,11,16677,21112,7673,3451,48913,454,1074,199,1727,50640
22-12-2019,12,16227,21318,7692,3483,48721,451,1074,211,1736,50457
22-12-2019,13,15277,20857,7605,3525,47264,446,1089,232,1767,49031
22-12-2019,14,15505,20853,7660,3705,47723,436,1101,277,1814,49537
22-12-2019,15,16342,21431,7787,3789,49349,432,1092,284,1808,51157
22-12-2019,16,17877,21709,7847,3963,51397,428,1085,263,1776,53173
22-12-2019,17,18652,21843,7946,4075,52517,428,1086,253,1767,54284
22-12-2019,18,17721,21291,7955,3994,50963,427,1069,258,1754,52717
22-12-2019,19,15660,20560,7830,3760,47810,429,1040,289,1758,49568
22-12-2019,20,14143,19024,7599,3644,44410,424,759,282,1465,45875
22-12-2019,21,13490,18434,7431,3342,42698,416,580,255,1251,43949
22-12-2019,22,12874,17724,7333,3142,41073,418,330,209,957,42030
22-12-2019,23,12055,16613,7356,3102,39126,418,345,188,951,40077
23-12-2019,0,11480,15938,7243,2848,37510,420,246,183,849,38359
23-12-2019,1,11285,15530,7036,2680,36530,415,244,195,854,37384
23-12-2019,2,11051,15388,6945,2548,35933,416,246,218,880,36813
23-12-2019,3,10950,15359,7047,2601,35957,422,243,234,899,36856
23-12-2019,4,11577,15816,7167,2494,37054,411,253,236,900,37954
23-12-2019,5,12414,17518,7387,2493,39812,416,424,212,1052,40864
23-12-2019,6,13607,18968,7714,2774,43064,468,760,207,1435,44499
23-12-2019,7,15243,20511,8123,2797,46674,564,767,387,1718,48392
23-12-2019,8,17081,21742,8163,3205,50192,558,733,361,1652,51844
23-12-2019,9,17660,22044,8261,3605,51570,545,766,319,1630,53200
23-12-2019,10,17408,21866,7986,3627,50888,538,747,181,1466,52354
23-12-2019,11,17168,21733,7964,3619,50485,545,809,183,1537,52022
23-12-2019,12,17022,21971,8223,3742,50958,548,1087,179,1814,52772
23-12-2019,13,16835,21987,8179,3698,50700,542,1091,362,1995,52695
23-12-2019,14,16693,21776,8215,3807,50492,531,1057,347,1935,52427
23-12-2019,15,17475,21698,8302,3966,51442,560,1041,372,1973,53415
23-12-2019,16,18958,21960,8312,3931,53161,569,1038,383,1990,55151
23-12-2019,17,20418,22444,8258,4116,55236,576,1035,404,2015,57251
23-12-2019,18,20327,22490,8094,3881,54792,583,1062,183,1828,56620
23-12-2019,19,17966,21535,7594,3751,50846,497,770,174,1441,52287
23-12-2019,20,15890,20999,7421,3395,47706,437,528,169,1134,48840
23-12-2019,21,14234,20207,7344,3271,45056,436,432,170,1038,46094
23-12-2019,22,13169,18626,7105,3195,42095,435,325,170,930,43025
23-12-2019,23,12593,17730,6858,3013,40193,434,307,170,911,41104
24-12-2019,0,12712,16741,6836,2862,39151,431,305,172,908,40059
24-12-2019,1,11960,16077,6634,2891,37562,428,304,171,903,38465
24-12-2019,2,10943,15583,6606,3065,36196,428,238,172,838,37034
24-12-2019,3,10960,15179,6555,3026,35721,424,236,171,831,36552
24-12-2019,4,11484,15258,6615,2895,36251,428,243,173,844,37095
24-12-2019,5,12379,16595,6776,2968,38719,435,403,185,1023,39742
24-12-2019,6,12942,17864,6900,3115,40822,437,407,173,1017,41839
24-12-2019,7,13546,18756,7146,3372,42819,442,546,175,1163,43982
24-12-2019,8,14309,20052,7389,3694,45444,438,698,182,1318,46762
24-12-2019,9,15567,20796,7553,3912,47828,436,785,190,1411,49239
24-12-2019,10,14994,20414,7369,3617,46395,430,803,198,1431,47826
24-12-2019,11,15234,20582,7404,3561,46783,424,803,235,1462,48245
24-12-2019,12,15774,20893,7586,3386,47640,480,952,301,1733,49373
24-12-2019,13,15931,21020,7517,3198,47666,561,960,259,1780,49446
24-12-2019,14,16189,21072,7586,2881,47729,580,959,321,1860,49589
24-12-2019,15,17156,21380,7717,2751,49005,585,960,280,1825,50830
24-12-2019,16,17804,21391,7652,2725,49572,583,1001,479,2063,51635
24-12-2019,17,18103,21442,7518,2660,49723,572,1000,255,1827,51550
24-12-2019,18,15571,19905,7433,2459,45370,298,988,226,1512,46882
24-12-2019,19,13255,18621,7290,2112,41277,300,762,221,1283,42560
24-12-2019,20,12773,17853,7087,2020,39732,291,770,226,1287,41019
24-12-2019,21,12636,18125,6848,1909,39518,285,560,226,1071,40589
24-12-2019,22,12890,18018,6863,1863,39636,289,318,216,823,40459
24-12-2019,23,12509,17059,6759,1911,38238,287,312,218,817,39055
25-12-2019,0,12350,15935,6632,1814,36731,293,309,218,820,37551
25-12-2019,1,12089,15236,6677,1692,35694,298,308,209,815,36509
25-12-2019,2,11611,14901,6698,1698,34909,290,308,212,810,35719
25-12-2019,3,11531,14860,6683,1702,34777,286,310,215,811,35588
25-12-2019,4,12087,14878,6681,1778,35426,281,311,217,809,36235
25-12-2019,5,12896,16500,6854,1914,38164,285,400,212,897,39061
25-12-2019,6,13035,17198,6839,2121,39194,288,563,216,1067,40261
25-12-2019,7,13462,17694,6850,2250,40258,289,837,204,1330,41588
25-12-2019,8,13963,18468,7022,2441,41893,293,860,192,1345,43238
25-12-2019,9,14748,18923,7056,2527,43254,293,859,193,1345,44599
25-12-2019,10,14438,18999,7276,2670,43383,289,806,195,1290,44673
25-12-2019,11,14964,19474,7409,2647,44496,277,808,200,1285,45781
25-12-2019,12,15464,20175,7360,2677,45678,293,912,206,1411,47089
25-12-2019,13,15175,20199,7306,2760,45440,307,997,204,1508,46948
25-12-2019,14,15197,20402,7287,2974,45861,305,1004,206,1515,47376
25-12-2019,15,16143,20769,7333,3202,47448,294,1091,214,1599,49047
25-12-2019,16,17465,21338,7441,3430,49674,312,1110,225,1647,51321
25-12-2019,17,17936,21480,7443,3439,50298,282,1107,230,1619,51917
25-12-2019,18,17737,21324,7396,3230,49686,301,1155,227,1683,51369
25-12-2019,19,16022,20174,7242,3291,46729,294,1147,241,1682,48411
25-12-2019,20,15331,19522,7254,3230,45338,295,833,235,1363,46701
25-12-2019,21,14779,19343,7194,3208,44525,292,604,229,1125,45650
25-12-2019,22,14432,18482,7101,3082,43098,295,339,209,843,43941
25-12-2019,23,13475,17030,7017,2913,40437,280,279,202,761,41198
26-12-2019,0,12715,16729,6865,2875,39186,278,277,206,761,39947
26-12-2019,1,12254,16050,6864,2835,38004,277,277,206,760,38764
26-12-2019,2,11875,15761,6770,2460,36865,278,279,193,750,37615
26-12-2019,3,12094,15738,6862,2253,36946,280,279,186,745,37691
26-12-2019,4,12164,16265,7019,2250,37698,291,276,185,752,38450
26-12-2019,5,13131,17073,7183,2336,39725,303,283,230,816,40541
26-12-2019,6,13663,18380,7348,2313,41706,302,287,183,772,42478
26-12-2019,7,14046,19165,7377,2165,42753,307,534,187,1028,43781
26-12-2019,8,14948,19814,7365,2190,44317,303,788,189,1280,45597
26-12-2019,9,16183,20206,7433,2082,45905,300,919,192,1411,47316
26-12-2019,10,16287,20169,7449,2088,45993,302,778,189,1269,47262
26-12-2019,11,17230,20359,7401,2067,47059,299,790,202,1291,48350
26-12-2019,12,17352,21101,7646,2136,48236,290,858,264,1412,49648
26-12-2019,13,17195,21016,7670,2195,48076,297,1023,195,1515,49591
26-12-2019,14,18268,21347,7633,2159,49407,302,1005,195,1502,50909
26-12-2019,15,20108,21988,7862,2251,52208,309,1010,264,1583,53791
26-12-2019,16,20855,22745,8094,2505,54198,323,1019,268,1610,55808
26-12-2019,17,21554,22959,8244,2566,55323,312,1094,297,1703,57026
26-12-2019,18,21272,23149,8192,2580,55195,328,1099,256,1683,56878
26-12-2019,19,19752,22594,7923,2444,52712,320,1005,242,1567,54279
26-12-2019,20,17470,21522,7741,2292,49026,320,858,238,1416,50442
26-12-2019,21,16069,21053,7800,2243,47165,323,757,314,1394,48559
26-12-2019,22,15411,20515,7821,2209,45958,320,560,264,1144,47102
26-12-2019,23,13727,18872,7780,2148,42527,332,288,265,885,43412
27-12-2019,0,13386,16559,7740,2190,39875,341,281,261,883,40758
27-12-2019,1,12991,15815,7737,2197,38739,330,282,245,857,39596
27-12-2019,2,12547,15579,7685,2196,38006,331,284,242,857,38863
27-12-2019,3,12592,15671,7663,2134,38058,338,316,249,903,38961
27-12-2019,4,13358,15885,7823,2229,39295,346,320,261,927,40222
27-12-2019,5,14336,18262,7903,2343,42843,369,331,296,996,43839
27-12-2019,6,15564,19915,8010,2417,45908,378,589,319,1286,47194
27-12-2019,7,18742,21254,8312,2918,51226,388,804,386,1578,52804
27-12-2019,8,20515,22026,8619,3214,54374,397,1009,346,1752,56126
27-12-2019,9,21544,22618,8832,3300,56295,401,1074,416,1891,58186
27-12-2019,10,21961,22561,8594,3186,56303,406,942,313,1661,57964
27-12-2019,11,22708,22782,8582,3029,57102,418,1050,276,1744,58846
27-12-2019,12,22961,23048,8725,3009,57744,428,1340,337,2105,59849
27-12-2019,13,23229,23027,8804,2899,57960,411,1403,495,2309,60269
27-12-2019,14,23921,23161,8825,2812,58719,402,1477,573,2452,61171
27-12-2019,15,24314,23392,8981,2883,59572,419,1491,783,2693,62265
27-12-2019,16,24470,23644,8896,3010,60020,420,1489,777,2686,62706
27-12-2019,17,24291,23717,8793,3127,59928,426,1488,780,2694,62622
27-12-2019,18,24122,23693,8494,3234,59544,438,1492,771,2701,62245
27-12-2019,19,23508,23271,8189,3138,58106,434,1178,376,1988,60094
27-12-2019,20,21745,22217,7972,2871,54805,552,990,390,1932,56737
27-12-2019,21,19280,21031,7741,2553,50606,537,852,417,1806,52412
27-12-2019,22,17462,20195,7657,2271,47585,511,450,433,1394,48979
27-12-2019,23,15183,19175,7541,2207,44106,427,433,414,1274,45380
28-12-2019,0,14897,18088,7509,2046,42540,402,302,413,1117,43657
28-12-2019,1,14374,17385,7304,2096,41160,408,283,398,1089,42249
28-12-2019,2,13553,17549,7262,2092,40456,422,261,386,1069,41525
28-12-2019,3,13263,17661,7277,2169,40370,417,222,404,1043,41413
28-12-2019,4,13014,17874,7416,2143,40446,467,220,388,1075,41521
28-12-2019,5,13126,18064,7714,2220,41126,508,234,353,1095,42221
28-12-2019,6,13504,18237,7896,2362,42000,547,309,377,1233,43233
28-12-2019,7,14702,19220,8069,2625,44618,566,584,398,1548,46166
28-12-2019,8,16759,21839,8468,3049,50117,530,697,425,1652,51769
28-12-2019,9,19324,22921,8786,3326,54359,511,842,494,1847,56206
28-12-2019,10,20100,23458,8775,3392,55726,515,1008,517,2040,57766
28-12-2019,11,18584,22760,8752,3386,53481,486,1035,454,1975,55456
28-12-2019,12,17346,22437,8699,3478,51961,509,1121,484,2114,54075
28-12-2019,13,17191,22339,8848,3591,51967,455,1120,351,1926,53893
28-12-2019,14,18228,22645,8981,3750,53605,420,1121,336,1877,55482
28-12-2019,15,20331,23153,9085,4098,56667,464,1226,488,2178,58845
28-12-2019,16,21389,23663,9068,4392,58513,500,1250,740,2490,61003
28-12-2019,17,21555,23918,9095,4461,59029,519,1191,708,2418,61447
28-12-2019,18,20689,23686,9071,4387,57834,537,1186,506,2229,60063
28-12-2019,19,19456,23585,8948,4233,56224,496,994,476,1966,58190
28-12-2019,20,18057,23245,8938,4443,54684,454,836,464,1754,56438
28-12-2019,21,16608,22808,8845,4402,52662,498,680,416,1594,54256
28-12-2019,22,15526,21859,8699,4536,50621,526,586,283,1395,52016
28-12-2019,23,13683,19863,8430,4419,46396,558,394,357,1309,47705
29-12-2019,0,13266,19396,8353,4556,45571,448,209,191,848,46419
29-12-2019,1,12822,18992,8132,4592,44539,426,207,185,818,45357
29-12-2019,2,12586,18920,8089,4455,44050,429,207,179,815,44865
29-12-2019,3,11834,18983,8121,4412,43350,441,207,175,823,44173
29-12-2019,4,11583,19103,8081,4549,43316,474,219,175,868,44184
29-12-2019,5,11475,19112,8092,4662,43342,480,357,181,1018,44360
29-12-2019,6,11480,19325,8161,4754,43721,499,422,187,1108,44829
29-12-2019,7,11120,19219,8075,4796,43208,548,688,200,1436,44644
29-12-2019,8,11119,19583,8051,4887,43640,571,745,225,1541,45181
29-12-2019,9,12614,20501,8041,5277,46433,605,1011,239,1855,48288
29-12-2019,10,13135,20111,8156,5776,47179,611,1039,243,1893,49072
29-12-2019,11,13282,20156,8084,5811,47333,613,1048,263,1924,49257
29-12-2019,12,13708,20578,8195,6023,48504,635,1074,305,2014,50518
29-12-2019,13,13028,20321,8142,5762,47253,652,1030,343,2025,49278
29-12-2019,14,13771,20866,8189,5679,48506,652,907,386,1945,50451
29-12-2019,15,14772,21919,8267,5945,50904,670,1286,434,2390,53294
29-12-2019,16,14855,22751,8272,6286,52164,667,1154,474,2295,54459
29-12-2019,17,14969,23168,8295,6348,52779,656,1150,505,2311,55090
29-12-2019,18,14322,22870,8176,6706,52075,658,1126,505,2289,54364
29-12-2019,19,13901,22367,8171,6361,50801,645,1069,472,2186,52987
29-12-2019,20,13429,21807,8212,6134,49582,650,902,464,2016,51598
29-12-2019,21,12745,21221,8062,5850,47879,666,764,519,1949,49828
29-12-2019,22,12172,21138,7983,5855,47149,669,558,526,1753,48902
29-12-2019,23,11655,20836,7630,5087,45209,657,256,516,1429,46638
30-12-2019,0,11231,20607,7557,5013,44409,650,253,525,1428,45837
30-12-2019,1,11118,19889,7504,4988,43500,654,251,536,1441,44941
30-12-2019,2,10985,19687,7439,4835,42947,620,251,568,1439,44386
30-12-2019,3,10928,19756,7393,4899,42976,625,253,576,1454,44430
30-12-2019,4,10855,19739,7507,5072,43175,611,357,614,1582,44757
30-12-2019,5,11186,20176,7700,4988,44049,611,509,635,1755,45804
30-12-2019,6,11810,20434,8018,4590,44852,603,691,628,1922,46774
30-12-2019,7,13201,20861,8151,5377,47590,607,971,614,2192,49782
30-12-2019,8,14725,22378,8317,4997,50416,617,1178,578,2373,52789
30-12-2019,9,14785,22340,8317,5701,51143,654,1152,618,2424,53567
30-12-2019,10,13942,21141,8209,5929,49222,626,1107,612,2345,51567
30-12-2019,11,14070,21126,8181,5898,49274,644,1080,635,2359,51633
30-12-2019,12,14208,21500,8342,6008,50058,647,1173,641,2461,52519
30-12-2019,13,14014,21627,8470,6010,50122,662,1140,645,2447,52569
30-12-2019,14,14769,22246,8522,6229,51766,669,1163,629,2461,54227
30-12-2019,15,15894,23467,8580,5443,53384,675,1164,633,2472,55856
30-12-2019,16,16095,23720,8536,5509,53860,661,1139,634,2434,56294
30-12-2019,17,16265,24163,8584,5068,54079,606,1185,620,2411,56490
30-12-2019,18,16179,23691,8494,5133,53498,632,1182,634,2448,55946
30-12-2019,19,14172,22024,8171,5044,49411,568,1054,637,2259,51670
30-12-2019,20,13126,21274,7889,4718,47009,521,917,635,2073,49082
30-12-2019,21,12428,20867,7565,4620,45479,498,883,630,2011,47490
30-12-2019,22,12101,20298,7434,4622,44455,530,656,631,1817,46272
30-12-2019,23,11486,19757,7355,4723,43321,523,339,648,1510,44831
31-12-2019,0,11446,19313,7442,4477,42679,521,241,640,1402,44081
31-12-2019,1,11340,18907,7338,4512,42095,498,234,637,1369,43464
31-12-2019,2,11192,18762,7189,4447,41591,478,238,636,1352,42943
31-12-2019,3,11117,18681,7096,4586,41482,453,239,636,1328,42810
31-12-2019,4,11424,18971,7196,4548,42140,434,240,625,1299,43439
31-12-2019,5,11945,19411,7351,4591,43298,427,339,622,1388,44686
31-12-2019,6,12500,19535,7378,4863,44276,435,479,617,1531,45807
31-12-2019,7,13679,20222,7970,5184,47055,451,785,587,1823,48878
31-12-2019,8,14987,21197,8207,5325,49717,458,978,558,1994,51711
31-12-2019,9,15924,22405,7987,5444,51760,654,1143,514,2311,54071
31-12-2019,10,15647,21706,7978,5865,51196,626,1089,490,2205,53401
31-12-2019,11,15671,22439,8028,5300,51439,644,1165,542,2351,53790
31-12-2019,12,16487,23312,8317,5059,53175,647,1215,610,2472,55647
31-12-2019,13,16731,23531,8440,4626,53329,662,1233,614,2509,55838
31-12-2019,14,17634,23999,8594,4550,54777,669,1236,594,2499,57276
31-12-2019,15,18851,24195,8754,4359,56159,675,1223,619,2517,58676
31-12-2019,16,19742,24381,8956,4962,58040,661,1222,615,2498,60538
31-12-2019,17,20397,24203,9072,4708,58380,606,1202,613,2421,60801
31-12-2019,18,19470,23641,8981,4636,56727,632,1220,593,2445,59172
31-12-2019,19,17911,22257,8881,4164,53215,568,1075,579,2222,55437
31-12-2019,20,16897,21257,8766,3602,50524,521,1030,583,2134,52658
31-12-2019,21,16651,21129,8516,3276,49572,498,837,559,1894,51466
31-12-2019,22,16750,20796,8389,3067,49003,530,566,514,1610,50613
31-12-2019,23,16068,19675,8199,3312,47254,523,471,407,1401,48655
